word,label,polarity,count,pos_count,neg_count,neu_count,pos_score,neg_score
성장능력/NNG;괜찮/VA;경로이/VVX,1,1.0,34,34,0,0,0.7959067335414008,0.00016991281107300488
금리/NNG;너무/MAG;낮/VA;아니/VCN;올리/VV,1,0.9999910847547218,32,32,0,0,0.7796413852078593,0.00016991281107300488
금리인상/NNG;부동산가격/NNG;영향/NNG;주/VV;아니/VCN,1,0.9999863125108495,31,31,0,0,0.7712048669049105,0.00016991281107300488
흑자/NNG;정부/NNG;가/VV,1,0.9999706099273782,28,28,0,0,0.7446895659675214,0.00016991281107300488
경상수지/NNG;흑자/NNG;기조다/VVX,1,0.9999525750111755,25,25,0,0,0.7163995971856332,0.00016991281107300488
가계부채/NNG;문제/NNG;있/VA;정상/NNG;돌아가/VV,1,0.9999390724862505,23,23,0,0,0.696587050806759,0.00016991281107300488
수요압력/NNG;증대될/VVX,1,0.9998899695766574,17,17,0,14,0.6329300066439936,0.00016991281107300488
물가안정기조/NNG;유지될/VVX,1,0.9992916577765942,30,29,1,28,0.753691056089686,0.00042770141653204123
환율하락/NNG;예상하/VVX,1,0.9991253956034805,27,26,1,3,0.7259832068892278,0.00047232557467976726
인플레이션기대심리/NNG;확산될/VVX,1,0.9983956183418867,20,19,1,14,0.6547587947328967,0.000664991768758794
수출/NNG;높/VA;증가세/NNG;지속하/VVX,1,0.9979999626560583,18,17,1,2,0.632869976749208,0.0007680782404446693
통화정책/NNG;방향/NNG;조정/NNG;검토해/VVX;할/VX,1,0.9970225660876906,15,14,1,5,0.5989302999069609,0.0010200610654401364
콜금리/NNG;올렸/VV,1,0.9966967982785695,26,24,2,13,0.7064426165163362,0.001318500300294074
경제위기/NNG;겪/VV,1,0.993283367951364,20,18,2,18,0.643726504923722,0.002304677475791063
금리인상/NNG;이뤄지지/VV,1,0.993283367951364,20,18,2,29,0.643726504923722,0.002304677475791063
경제성장/NNG;가능할/VVX,1,0.9909904300084333,26,23,3,6,0.6962051043469283,0.003296356083404979
금리/NNG;낮/VA;있/VV,1,0.9909904300084333,26,23,3,3,0.6962051043469283,0.003296356083404979
경기회복세/NNG;되/VV,1,0.9909904300084333,26,23,3,36,0.6962051043469283,0.003296356083404979
금융완화/NNG;줄여/VV,1,0.9897956447927656,25,22,3,39,0.6859908726426417,0.0036614064080383677
금리/NNG;상승세/NNG;쉬/VV,1,0.9891018127075402,17,15,2,21,0.6101416360258306,0.003470301945299014
인플레이션억제/NNG;위한/VV,1,0.986906565938487,30,26,4,38,0.7253893801239237,0.004930936891107329
금융위기/NNG;극복/NNG;위한/VV,1,0.9868163145594497,16,14,2,13,0.5986513244335006,0.0040967661748299595
기준금리/NNG;상향조정하/VVX,1,0.9811094856485936,39,33,6,26,0.786695629813731,0.007662828446158998
잠재성장률/NNG;웃돌/VV,1,0.9810717520457484,27,23,4,14,0.6957727744397378,0.006790559143304083
콜금리/NNG;올린/VV,1,0.9810717520457484,27,23,4,17,0.6957727744397378,0.006790559143304083
견실한/VAX;성장세/NNG;이/VV,1,0.9810717520457484,27,23,4,26,0.6957727744397378,0.006790559143304083
경기회복세/NNG;진행되/VVX,1,0.9783136361644726,20,17,3,24,0.6322297245236852,0.007059473397524306
물가안정기조/NNG;하/VV,1,0.9739288222557385,19,16,3,25,0.6209595675334815,0.00832689613297798
금리/NNG;상승세/NNG;지속하/VVX,1,0.9739288222557385,19,16,3,20,0.6209595675334815,0.00832689613297798
불확실성/NNG;상존한/VVX,1,0.9727295939939362,46,38,8,20,0.8240239724160456,0.011557026258339846
성장/NNG;될/VV,1,0.9727295939939362,46,38,8,16,0.8240239724160456,0.011557026258339846
금융완화/NNG;유지하/VVX,1,0.9689039532431611,116,94,22,118,0.9891770364139181,0.015820152760369667
경기/NNG;상승세/NNG;이어질/VV,1,0.968211914433591,18,15,3,7,0.6095196445361871,0.00996570070506415
물가상승압력/NNG;크/VA;않/VX;전망되/VVX,1,0.9646265930455533,28,23,5,20,0.6950348954546586,0.012651610670777212
높/VA;물가오름세/NNG;지속될/VVX,1,0.9606293131563368,17,14,3,19,0.5979069442188979,0.01212343581641213
변동성/NNG;과도하/VVX,1,0.9593022975007324,22,18,4,18,0.642531839062532,0.013471789389866843
견조한/VAX;성장/NNG;지속할/VVX,1,0.9541596956254343,31,25,6,15,0.7141840112597313,0.016890862674009185
기준금리/NNG;동결한/VAX;배경/NNG;설명했/VVX,1,0.9526207558486564,26,21,5,21,0.6741199119727193,0.01648659379584676
gdp/NNG;상회하/VVX,1,0.9503863019946532,16,13,3,30,0.5861135406697076,0.01502141401092604
콜금리/NNG;조정하/VVX,1,0.9503863019946532,16,13,3,11,0.5861135406697076,0.01502141401092604
출구전략/NNG;지연될/VVX,1,0.9503863019946532,16,13,3,16,0.5861135406697076,0.01502141401092604
금리동결/NNG;내리/VV,1,0.9503863019946532,16,13,3,4,0.5861135406697076,0.01502141401092604
기준금리/NNG;유지한/VVX,1,0.9466928616112975,61,48,13,58,0.8825524913290386,0.02433428445546236
채권시장/NNG;강세/NNG;작용할/VVX,1,0.9408164576857867,20,16,4,20,0.6198683259500142,0.01901785135215367
금리상승/NNG;축소되/VVX,1,0.9408164576857867,20,16,4,45,0.6198683259500142,0.01901785135215367
물가/NNG;올리/VV,1,0.9408164576857867,20,16,4,26,0.6198683259500142,0.01901785135215367
통화정책/NNG;완화/NNG;유지해/VVX,1,0.9399214609658018,29,23,6,31,0.6938752951148648,0.021618001440833697
부동산가격/NNG;잡/VV,1,0.9388196733394483,59,46,13,22,0.8711941068817491,0.027652390257912503
금리하락/NNG;이어졌/VV,1,0.9362818579147976,15,12,3,12,0.5741231634746109,0.01899863151118654
신용등급/NNG;강등당/VVX,1,0.9362818579147976,15,12,3,12,0.5741231634746109,0.01899863151118654
생산/NNG;증가했/VVX,1,0.9362818579147976,15,12,3,22,0.5741231634746109,0.01899863151118654
높/VA;변동성/NNG;지속될/VVX,1,0.9362818579147976,15,12,3,14,0.5741231634746109,0.01899863151118654
국제원자재가격/NNG;상승하/VVX,1,0.9346267514251632,24,19,5,19,0.6523488487409689,0.022163166928408824
성장경로/NNG;크/VA;벗어나/VV;않/VX,1,0.9346267514251632,24,19,5,30,0.6523488487409689,0.022163166928408824
물가상승압력/NNG;이어질/VV,1,0.9346267514251632,24,19,5,14,0.6523488487409689,0.022163166928408824
금리인상/NNG;대비해/VVX,1,0.9346267514251632,24,19,5,33,0.6523488487409689,0.022163166928408824
경기/NNG;상승세/NNG;따른/VV,1,0.927377924363693,19,15,4,23,0.6082195747625431,0.02302648895117044
경기/NNG;위험요인/NNG;상존하/VVX,1,0.9170070451495429,39,30,9,33,0.7575184076482521,0.03292729020777005
콜금리/NNG;인상하/VVX,1,0.9126907546824345,157,118,39,105,0.9873241768068961,0.045238626748003254
물가안정/NNG;있/VV,1,0.9097888874274349,18,14,4,23,0.5963354597183451,0.028270316749247078
금리/NNG;인상되/VVX;않/VX,1,0.9097888874274349,18,14,4,30,0.5963354597183451,0.028270316749247078
경제성장률/NNG;낮추/VV,1,0.9094554556344254,46,35,11,59,0.7972329368608871,0.03793986009267279
물가/NNG;낮/VA;유지하/VVX,1,0.9068592203601589,22,17,5,19,0.6296610280753862,0.03086229678329624
콜금리/NNG;경기회복/NNG;뒷받침하/VVX,1,0.9068592203601589,22,17,5,8,0.6296610280753862,0.03086229678329624
콜금리/NNG;인상된/VVX,1,0.9068592203601589,22,17,5,21,0.6296610280753862,0.03086229678329624
금리/NNG;인상해/VVX;한다는/VX,1,0.905884307888726,26,20,6,38,0.6616645397688937,0.032785571414758026
경기회복세/NNG;둔화될/VVX,1,0.905884307888726,26,20,6,35,0.6616645397688937,0.032785571414758026
경기상승/NNG;이어지/VV,1,0.8986658656306652,41,31,10,23,0.7646962115631456,0.04093867737883597
경기/NNG;찬물/NNG;끼얹/VV,1,0.8894013137701793,25,19,6,15,0.6504231208513253,0.03817720605578649
흑자/NNG;줄어들/VV,1,0.8865434698414134,17,13,4,30,0.5841829934459672,0.03522501155820681
기준금리인상/NNG;시작될/VVX,1,0.8865434698414134,17,13,4,24,0.5841829934459672,0.03522501155820681
소비지출/NNG;증가하/VVX,1,0.8865434698414134,17,13,4,23,0.5841829934459672,0.03522501155820681
금리상승/NNG;기다리/VV,1,0.8865434698414134,17,13,4,34,0.5841829934459672,0.03522501155820681
성장/NNG;이/VV;갈/VX,1,0.88389891485447,36,27,9,69,0.7288765230769362,0.04503336265734897
콜금리/NNG;올릴/VV,1,0.8716972115394053,53,39,14,22,0.8223414496845929,0.056493655191012994
기준금리인상/NNG;단행되/VVX,1,0.8692930790314941,24,18,6,37,0.6389008117022111,0.0447686970386895
듀레이션/NNG;늘리/VV,1,0.8692930790314941,24,18,6,41,0.6389008117022111,0.0447686970386895
확장/NNG;유지하/VVX,1,0.8692930790314941,24,18,6,11,0.6389008117022111,0.0447686970386895
재정위기/NNG;인해/VV,1,0.8692930790314941,24,18,6,37,0.6389008117022111,0.0447686970386895
리스크/NNG;완화될/VVX,1,0.8629211776670953,20,15,5,36,0.6059130115298448,0.04467231765508694
금리/NNG;동결함/VVX,1,0.8629211776670953,20,15,5,32,0.6059130115298448,0.04467231765508694
수출/NNG;타격/NNG;입/VV,1,0.8555943512748629,16,12,4,38,0.571708283097156,0.04457152300432665
자산/NNG;늘리/VV,1,0.8555943512748629,16,12,4,16,0.571708283097156,0.04457152300432665
안전자산선호심리/NNG;약화될/VVX,1,0.8555943512748629,16,12,4,24,0.571708283097156,0.04457152300432665
금리상승/NNG;예상하/VVX,1,0.8555943512748629,16,12,4,61,0.571708283097156,0.04457152300432665
동결/NNG;가/VV,1,0.8555943512748629,16,12,4,9,0.571708283097156,0.04457152300432665
경기/NNG;상승세/NNG;지속하/VVX,1,0.8547173023228993,27,20,7,11,0.6592080547224288,0.05172881770209257
금리인상/NNG;나타나/VV,1,0.8516238101095086,58,42,16,12,0.8393617582205749,0.06737629292236083
물가상승률/NNG;낮추/VV,1,0.8447139439540576,23,17,6,37,0.6270693602950256,0.052869851491349686
물가목표/NNG;달성/NNG;위해/VV,1,0.8318443634066379,19,14,5,21,0.5935511966353972,0.05456012192353496
출구전략/NNG;시행되/VVX,1,0.8318443634066379,19,14,5,33,0.5935511966353972,0.05456012192353496
경기둔화우려/NNG;부각되/VVX,1,0.8318443634066379,19,14,5,32,0.5935511966353972,0.05456012192353496
국제원자재가격/NNG;오르/VV,1,0.8260201081495195,36,26,10,8,0.7158786521401996,0.06829497020889826
인플레이션기대심리/NNG;확산되/VVX,1,0.8199638742870801,29,21,8,29,0.667507227526593,0.06611061094727431
신흥시장/NNG;경제/NNG;호조/NNG;지속하/VVX,1,0.8199638742870801,29,21,8,18,0.667507227526593,0.06611061094727431
경기/NNG;상승세/NNG;지속되/VVX,1,0.8198047142820293,39,28,11,18,0.7332721323844338,0.07269443626176796
침체/NNG;벗어나/VV,1,0.8198047142820293,39,28,11,77,0.7332721323844338,0.07269443626176796
양적완화/NNG;지속되/VVX,1,0.8146651557726687,22,16,6,29,0.6148885867570436,0.0628701380889645
금리인상/NNG;했/VV,1,0.8146651557726687,22,16,6,17,0.6148885867570436,0.0628701380889645
성장속도/NNG;둔화되/VVX,1,0.8146651557726687,22,16,6,14,0.6148885867570436,0.0628701380889645
금리하락압력/NNG;지속될/VVX,1,0.8146651557726687,22,16,6,53,0.6148885867570436,0.0628701380889645
인플레이션/NNG;억제될/VVX,1,0.8146651557726687,22,16,6,22,0.6148885867570436,0.0628701380889645
인플레이션/NNG;완화될/VVX,1,0.8146651557726687,22,16,6,24,0.6148885867570436,0.0628701380889645
금리인상/NNG;나올/VV,1,0.8142490176697434,15,11,4,28,0.5588228413575479,0.05727873534034685
금리메리트/NNG;인해/VV,1,0.8142490176697434,15,11,4,21,0.5588228413575479,0.05727873534034685
경제/NNG;활력/NNG;회복하/VVX,1,0.8142490176697434,15,11,4,5,0.5588228413575479,0.05727873534034685
금리/NNG;인상시/VVX,1,0.8142490176697434,15,11,4,12,0.5588228413575479,0.05727873534034685
금리/NNG;올리/VV;쉽/VA;않/VX,1,0.8142490176697434,15,11,4,33,0.5588228413575479,0.05727873534034685
금융완화/NNG;유지한/VVX,1,0.8142490176697434,15,11,4,13,0.5588228413575479,0.05727873534034685
금리인상/NNG;검토하/VVX,1,0.8142490176697434,15,11,4,18,0.5588228413575479,0.05727873534034685
물가안정/NNG;웃돌/VV,1,0.8142490176697434,15,11,4,6,0.5588228413575479,0.05727873534034685
경기회복/NNG;고유가/NNG;따른/VV,1,0.8142490176697434,15,11,4,8,0.5588228413575479,0.05727873534034685
물가오름세/NNG;확대될/VVX,1,0.8142490176697434,15,11,4,19,0.5588228413575479,0.05727873534034685
금리정상화/NNG;나서/VV,1,0.8142490176697434,15,11,4,30,0.5588228413575479,0.05727873534034685
견조한/VAX;성장/NNG;지속하/VVX,1,0.8116596766678299,116,81,35,97,0.9557526055505112,0.09946786410555586
물가/NNG;있/VV,1,0.8116058453676425,32,23,9,32,0.6867129708676142,0.07149065444905592
대외불확실성/NNG;완화되/VVX,1,0.8116058453676425,32,23,9,55,0.6867129708676142,0.07149065444905592
마이너스/NNG;보였/VV,1,0.8021831720318253,25,18,7,19,0.6356676534654696,0.06984176600154646
물가안정/NNG;두/VV,1,0.7957953035126748,41,29,12,71,0.7399287449130396,0.08421480782084537
금리인상/NNG;인해/VV,1,0.7951020451905308,63,44,19,84,0.844437290269431,0.09647222252381488
금리/NNG;올린/VV,1,0.7935240755695194,139,96,43,172,0.9634877036465489,0.11101647107223137
경제지표/NNG;하회하/VVX,1,0.7925028476880633,18,13,5,52,0.5807767664827471,0.06728772471197095
정책금리/NNG;인하될/VVX,1,0.7925028476880633,18,13,5,26,0.5807767664827471,0.06728772471197095
금리/NNG;올릴/VV;필요/NNG;있/VA,1,0.7925028476880633,18,13,5,9,0.5807767664827471,0.06728772471197095
성장/NNG;기대된/VVX,1,0.7925028476880633,18,13,5,18,0.5807767664827471,0.06728772471197095
금리인상/NNG;배제하/VVX,1,0.7925028476880633,18,13,5,18,0.5807767664827471,0.06728772471197095
경기둔화/NNG;나타나/VV,1,0.7780146089392077,21,15,6,24,0.6023010225139561,0.07525138381752605
금리인상/NNG;미룰/VV,1,0.7780146089392077,21,15,6,26,0.6023010225139561,0.07525138381752605
경기둔화/NNG;심화될/VVX,1,0.7780146089392077,21,15,6,24,0.6023010225139561,0.07525138381752605
경제/NNG;둔화시/VVX,1,0.7780146089392077,21,15,6,12,0.6023010225139561,0.07525138381752605
기준금리/NNG;올라갈/VV,1,0.7780146089392077,21,15,6,11,0.6023010225139561,0.07525138381752605
금리인상/NNG;통한/VV,1,0.7747883859760596,40,28,12,83,0.7296292129448837,0.09264998054305079
경제지표/NNG;양호하/VVX,1,0.7573383111492398,30,21,9,50,0.6636106206350136,0.0916840334917992
금리/NNG;인상된/VVX,1,0.7544427723702285,33,23,10,67,0.6827768040040733,0.09561299874042212
채권시장/NNG;우호적/VAX;작용할/VVX,1,0.7525904074533913,36,25,11,126,0.7012398865262737,0.09904240330340575
하방위험/NNG;작용할/VVX,1,0.7505987363382158,48,33,15,41,0.7676090899833893,0.10941176355044445
물가상승/NNG;인해/VV,1,0.7429681557870864,17,12,5,29,0.5674799090729072,0.08372120199774558
경기/NNG;부양할/VVX;있/VV,1,0.7429681557870864,17,12,5,22,0.5674799090729072,0.08372120199774558
금리인상/NNG;자제해/VVX,1,0.7429681557870864,17,12,5,11,0.5674799090729072,0.08372120199774558
고용지표부진/NNG;따른/VV,1,0.7429681557870864,17,12,5,31,0.5674799090729072,0.08372120199774558
가계대출/NNG;증가세/NNG;둔화되/VVX,1,0.7429681557870864,17,12,5,8,0.5674799090729072,0.08372120199774558
주택시장/NNG;지원하/VVX,1,0.7429681557870864,17,12,5,9,0.5674799090729072,0.08372120199774558
금리/NNG;동결됐/VVX,1,0.7429681557870864,17,12,5,35,0.5674799090729072,0.08372120199774558
성장률전망/NNG;낮췄/VV,1,0.7429681557870864,17,12,5,10,0.5674799090729072,0.08372120199774558
단기금리/NNG;상승/NNG;따른/VV,1,0.7429681557870864,17,12,5,18,0.5674799090729072,0.08372120199774558
물가안정/NNG;상단인/VVX,1,0.7429681557870864,17,12,5,15,0.5674799090729072,0.08372120199774558
콜금리/NNG;인상했/VVX,1,0.735041954216749,59,40,19,40,0.8134824028375855,0.12427356901477393
인플레이션/NNG;인해/VV,1,0.7335611816358738,20,14,6,24,0.589223812792456,0.09059364777412293
불안/NNG;야기하/VVX,1,0.7335611816358738,20,14,6,33,0.589223812792456,0.09059364777412293
금리인상/NNG;결정했/VVX,1,0.7335611816358738,20,14,6,17,0.589223812792456,0.09059364777412293
인플레이션/NNG;유발하/VVX;않/VX,1,0.7335611816358738,20,14,6,18,0.589223812792456,0.09059364777412293
금융위기/NNG;극복하/VVX,1,0.7296317383509354,47,32,15,70,0.7577862451579686,0.1184940609685286
인플레이션기대심리/NNG;높/VA;물가상승률/NNG;이어질/VV,1,0.7282381457836189,23,16,7,1,0.6105156277177033,0.09603411744438459
금리인상/NNG;신중하/VVX,1,0.7282381457836189,23,16,7,32,0.6105156277177033,0.09603411744438459
내수/NNG;증가하/VVX,1,0.728215713522598,44,30,14,40,0.7419342812669454,0.11671740497869464
기준금리/NNG;인상한/VVX,1,0.7274747518625531,76,51,25,67,0.8688760661689467,0.13711803320958987
내수/NNG;개선되/VVX,1,0.7246891751625029,35,24,11,54,0.6898113143716237,0.11014802595391524
잠재성장률/NNG;웃도/VV,1,0.7242828423557777,29,20,9,26,0.6514469812022868,0.10419987487046718
하방위험/NNG;있/VV,1,0.724152083899638,32,22,10,48,0.6709718836624488,0.10738186287973613
금리동결/NNG;예상되/VVX,1,0.6971446238263186,37,25,12,67,0.6964848138794455,0.12430598929071726
침체/NNG;빠지/VV;않/VX,1,0.6901567518345804,31,21,10,22,0.6587192486164374,0.12077117841469892
리스크/NNG;지속되/VVX,1,0.6867713422039934,28,19,9,22,0.638809775957345,0.11863618041256757
양적완화/NNG;축소할/VVX,1,0.6867713422039934,28,19,9,101,0.638809775957345,0.11863618041256757
경제성장률/NNG;떨어질/VV,1,0.6867713422039934,28,19,9,26,0.638809775957345,0.11863618041256757
잠재성장률/NNG;밑도/VV,1,0.6837088710312378,25,17,8,29,0.6182712232012685,0.11615359005241226
gdp/NNG;증가하/VVX,1,0.6837088710312378,25,17,8,56,0.6182712232012685,0.11615359005241226
금리하락/NNG;동조화되/VVX,1,0.6837088710312378,25,17,8,27,0.6182712232012685,0.11615359005241226
gdp/NNG;감소했/VVX,1,0.6813292328626099,16,11,5,15,0.5534899089589459,0.10491258873663332
변동성/NNG;제한되/VVX,1,0.6813292328626099,16,11,5,27,0.5534899089589459,0.10491258873663332
경기둔화우려/NNG;확대되/VVX,1,0.6813292328626099,16,11,5,8,0.5534899089589459,0.10491258873663332
기준금리/NNG;상승할/VVX,1,0.6813292328626099,16,11,5,16,0.5534899089589459,0.10491258873663332
기준금리/NNG;만장일치/NNG;동결했/VVX,1,0.6813292328626099,16,11,5,33,0.5534899089589459,0.10491258873663332
경제/NNG;반등하/VVX,1,0.6813292328626099,16,11,5,24,0.5534899089589459,0.10491258873663332
기준금리인상/NNG;시사했/VVX,1,0.6813292328626099,16,11,5,26,0.5534899089589459,0.10491258873663332
금리하락/NNG;나타날/VV,1,0.6813292328626099,16,11,5,14,0.5534899089589459,0.10491258873663332
기준금리/NNG;통화정책방향/NNG;유지하/VVX,1,0.6813123393082308,22,15,7,31,0.5971577883097023,0.11319685132228705
금리/NNG;끌어올렸/VV,1,0.6801676702374584,19,13,6,15,0.5755362439880553,0.10956412004216907
수출호조/NNG;이어지/VV,1,0.6801676702374584,19,13,6,15,0.5755362439880553,0.10956412004216907
경제성장률/NNG;하락할/VVX,1,0.6801676702374584,19,13,6,21,0.5755362439880553,0.10956412004216907
금리/NNG;유지될/VVX,1,0.6801676702374584,19,13,6,29,0.5755362439880553,0.10956412004216907
경기/NNG;회복된/VVX,1,0.6658035262437125,36,24,12,23,0.6845931618235195,0.13734311524911866
금리인상/NNG;남/VV,1,0.6658035262437125,36,24,12,48,0.6845931618235195,0.13734311524911866
불확실성/NNG;줄어들/VV,1,0.659304845081786,33,22,11,55,0.6656319884961,0.13666504324600376
물가안정/NNG;위한/VV,1,0.656188850079849,85,55,30,172,0.8717663157809266,0.1809621219441132
기준금리/NNG;인상한/VAX;이/VV,1,0.6522209796491198,30,20,10,19,0.6459667470739632,0.13596132975078473
동결/NNG;이어질/VV,1,0.6522209796491198,30,20,10,53,0.6459667470739632,0.13596132975078473
금리/NNG;내려갈/VV,1,0.6502656513351086,71,46,25,52,0.8334537884797828,0.17661691684905412
금리/NNG;인상해/VVX;할/VX,1,0.6445024496404841,27,18,9,41,0.6256316420457428,0.1352310966359527
금리인상/NNG;필요하/VVX,1,0.641556365417352,84,54,30,102,0.8653995210197889,0.188943605342453
금리인상/NNG;되/VV,1,0.6360956269906572,24,16,8,24,0.6046682020891421,0.13447344863564448
경기둔화우려/NNG;지속될/VVX,1,0.6269424907948171,21,14,7,22,0.5831254747157132,0.13368747489475338
수출호조/NNG;지속되/VVX,1,0.6269424907948171,21,14,7,38,0.5831254747157132,0.13368747489475338
물가안정/NNG;지키/VV,1,0.6269424907948171,21,14,7,5,0.5831254747157132,0.13368747489475338
콜금리/NNG;인하하/VVX,1,0.6269424907948171,21,14,7,10,0.5831254747157132,0.13368747489475338
금융시장/NNG;변동성/NNG;확대되/VVX,1,0.6269424907948171,21,14,7,16,0.5831254747157132,0.13368747489475338
경기/NNG;나아질/VV,1,0.6269424907948171,21,14,7,38,0.5831254747157132,0.13368747489475338
성장/NNG;기록하/VVX,1,0.6214924569255511,32,21,11,59,0.6527883352565698,0.15235195596163384
성장률/NNG;달성할/VVX,1,0.6169919321417792,48,31,17,52,0.7366106033678861,0.17444025994759937
재고조정/NNG;마무리되/VVX,1,0.6169804053670289,18,12,6,32,0.5610601009522819,0.13287225080147705
경기/NNG;호전되/VVX,1,0.6169804053670289,18,12,6,39,0.5610601009522819,0.13287225080147705
금리인상/NNG;단행된/VVX;하/VV,1,0.6169804053670289,18,12,6,17,0.5610601009522819,0.13287225080147705
인플레이션기대심리/NNG;억제하/VVX,1,0.6169804053670289,18,12,6,28,0.5610601009522819,0.13287225080147705
원자재가격/NNG;하락하/VVX,1,0.6093557830294944,53,34,19,60,0.756981592935155,0.18370084342309848
불확실성/NNG;해소하/VVX,1,0.6064528308411778,37,24,13,45,0.6785016348513188,0.16617728674367016
경기회복/NNG;인해/VV,1,0.6061419347957373,15,10,5,21,0.5385362484245956,0.13202684012924515
기준금리인상/NNG;예상했/VVX,1,0.6061419347957373,15,10,5,26,0.5385362484245956,0.13202684012924515
기준금리인상/NNG;필요하/VVX,1,0.6061419347957373,15,10,5,14,0.5385362484245956,0.13202684012924515
부동산가격안정/NNG;위해/VV,1,0.6061419347957373,15,10,5,16,0.5385362484245956,0.13202684012924515
경제/NNG;불확실성/NNG;커지/VV,1,0.6061419347957373,15,10,5,21,0.5385362484245956,0.13202684012924515
수출/NNG;부정적/VAX;영향/NNG;줄/VV,1,0.6061419347957373,15,10,5,18,0.5385362484245956,0.13202684012924515
금리인상/NNG;가져올/VV,1,0.6061419347957373,15,10,5,18,0.5385362484245956,0.13202684012924515
금리인상/NNG;재개되/VVX,1,0.6061419347957373,15,10,5,8,0.5385362484245956,0.13202684012924515
인플레이션/NNG;잘/MAG;제어될/VVX,1,0.6061419347957373,15,10,5,26,0.5385362484245956,0.13202684012924515
gdp/NNG;하락하/VVX,1,0.6061419347957373,15,10,5,5,0.5385362484245956,0.13202684012924515
정치적/VAX;불확실성/NNG;따른/VV,1,0.6061419347957373,15,10,5,19,0.5385362484245956,0.13202684012924515
수출/NNG;호조세/NNG;지속하/VVX,1,0.6061419347957373,15,10,5,5,0.5385362484245956,0.13202684012924515
수출/NNG;급감했/VVX,1,0.6061419347957373,15,10,5,9,0.5385362484245956,0.13202684012924515
콜금리/NNG;위한/VV,1,0.6061419347957373,15,10,5,12,0.5385362484245956,0.13202684012924515
기준금리/NNG;낮/VA;수준이/VVX,1,0.6061419347957373,15,10,5,29,0.5385362484245956,0.13202684012924515
소비/NNG;투자/NNG;늘어나/VV,1,0.6061419347957373,15,10,5,7,0.5385362484245956,0.13202684012924515
기준금리인상/NNG;이/VV,1,0.6061419347957373,15,10,5,13,0.5385362484245956,0.13202684012924515
기준금리/NNG;올려/VV,1,0.5997293743824308,50,32,18,47,0.7415159703741361,0.18548522112708862
성장동력/NNG;약화되/VVX,1,0.5972928762420713,26,17,9,6,0.6118243679192051,0.15420890033244242
경제과열/NNG;막/VV,1,0.5972928762420713,26,17,9,10,0.6118243679192051,0.15420890033244242
불확실성/NNG;고려하/VVX,1,0.5972928762420713,26,17,9,25,0.6118243679192051,0.15420890033244242
금리인상/NNG;필요할/VVX,1,0.5962190214858307,42,27,15,55,0.702673965792041,0.1776984066351045
금리인상/NNG;가능하/VVX,1,0.5939958411392006,55,35,20,91,0.7613445895554138,0.19386416222980052
금리인상/NNG;있/VV,1,0.5844290806386969,224,140,84,248,0.9252855412820717,0.24260907980099217
내수/NNG;회복세/NNG;보이/VV,1,0.5824027906129094,23,15,8,34,0.5903469950537905,0.15574134397421524
기준금리/NNG;유지했/VVX,1,0.5824027906129094,23,15,8,33,0.5903469950537905,0.15574134397421524
성장률/NNG;나타낼/VV,1,0.5824027906129094,23,15,8,34,0.5903469950537905,0.15574134397421524
경제/NNG;악영향/NNG;미치/VV,1,0.5801508574177612,31,20,11,32,0.6393607540236467,0.16982181874842628
유동성/NNG;줄이/VV,1,0.5801508574177612,31,20,11,58,0.6393607540236467,0.16982181874842628
인플레이션/NNG;대응하/VVX,1,0.5801508574177612,31,20,11,26,0.6393607540236467,0.16982181874842628
선진국/NNG;경제/NNG;회복세/NNG;이/VV,1,0.5801508574177612,31,20,11,23,0.6393607540236467,0.16982181874842628
금리/NNG;올려서/VV,1,0.5801508574177612,31,20,11,47,0.6393607540236467,0.16982181874842628
유가급락/NNG;따른/VV,1,0.5698129816369346,36,23,13,43,0.6655485042137431,0.18231709781685246
금리인상/NNG;할/VV,1,0.5689913996004812,134,83,51,151,0.9071871652215856,0.24911474913202894
수출호조/NNG;힘입/VV,1,0.5686824707541072,54,34,20,84,0.7506115082951579,0.20630703129021996
불확실성/NNG;큰/VA;상황이/VVX,1,0.5648873877446707,20,13,7,22,0.5682432148574914,0.15793718679532406
경제/NNG;안정시/VVX,1,0.5648873877446707,20,13,7,23,0.5682432148574914,0.15793718679532406
금융완화/NNG;유지할/VVX,1,0.5648873877446707,20,13,7,27,0.5682432148574914,0.15793718679532406
경제성장률/NNG;밑돌/VV,1,0.5648873877446707,20,13,7,28,0.5682432148574914,0.15793718679532406
불안/NNG;심화될/VVX,1,0.5648873877446707,20,13,7,25,0.5682432148574914,0.15793718679532406
경제성장/NNG;미치/VV,1,0.5648873877446707,20,13,7,31,0.5682432148574914,0.15793718679532406
글로벌/NNG;경기회복/NNG;따른/VV,1,0.5648873877446707,20,13,7,43,0.5682432148574914,0.15793718679532406
견조한/VAX;성장세/NNG;보이/VV,1,0.5639956719019492,28,18,10,38,0.618678341391037,0.17240526053203925
경기/NNG;부양해/VVX,1,0.5639956719019492,28,18,10,25,0.618678341391037,0.17240526053203925
장단기금리스프레드/NNG;축소되/VVX,1,0.5639956719019492,28,18,10,23,0.618678341391037,0.17240526053203925
경기/NNG;회복세/NNG;지속하/VVX,1,0.5639956719019492,28,18,10,39,0.618678341391037,0.17240526053203925
기준금리인상/NNG;이뤄질/VV,1,0.5633804588552676,41,26,15,49,0.6902549638877372,0.1926981484788245
성장/NNG;예상된/VVX,1,0.5633804588552676,41,26,15,47,0.6902549638877372,0.1926981484788245
경기/NNG;위축될/VVX,1,0.5633804588552676,41,26,15,33,0.6902549638877372,0.1926981484788245
금리하락/NNG;이끌/VV,1,0.5546791334104779,56,35,21,117,0.754824464393058,0.21612058169843726
금리인상/NNG;시사할/VVX,1,0.5480262197621117,38,24,14,45,0.6715345251281383,0.19598031784114742
소비/NNG;개선되/VVX,1,0.5480262197621117,38,24,14,46,0.6715345251281383,0.19598031784114742
내수/NNG;부진하/VVX,1,0.5451258809232351,25,16,9,37,0.597271434997642,0.17575372724077842
기준금리인상/NNG;지연될/VVX,1,0.5451258809232351,25,16,9,35,0.597271434997642,0.17575372724077842
불확실성/NNG;완화될/VVX,1,0.5447928073670194,43,27,16,97,0.6957586792380179,0.2049285750264125
콜금리/NNG;하/VV,1,0.543724316975088,17,11,6,5,0.5455279384988502,0.16116777699249876
금리인하/NNG;기정사실화하/VVX,1,0.543724316975088,17,11,6,35,0.5455279384988502,0.16116777699249876
내수/NNG;부진해/VVX,1,0.543724316975088,17,11,6,9,0.5455279384988502,0.16116777699249876
투자심리/NNG;개선시/VVX,1,0.543724316975088,17,11,6,49,0.5455279384988502,0.16116777699249876
경기회복/NNG;확인되/VVX,1,0.543724316975088,17,11,6,27,0.5455279384988502,0.16116777699249876
채권시장/NNG;강세/NNG;이/VV,1,0.543724316975088,17,11,6,29,0.5455279384988502,0.16116777699249876
동결/NNG;전망하/VVX,1,0.543724316975088,17,11,6,11,0.5455279384988502,0.16116777699249876
금리인상/NNG;나/VV,1,0.543724316975088,17,11,6,31,0.5455279384988502,0.16116777699249876
금리/NNG;하향안정되/VVX,1,0.543724316975088,17,11,6,32,0.5455279384988502,0.16116777699249876
성장률/NNG;낮추/VV,1,0.543724316975088,17,11,6,74,0.5455279384988502,0.16116777699249876
경기침체/NNG;우려하/VVX,1,0.543724316975088,17,11,6,15,0.5455279384988502,0.16116777699249876
성장률/NNG;그친/VV,1,0.543724316975088,17,11,6,6,0.5455279384988502,0.16116777699249876
자본확충/NNG;위한/VV,1,0.543724316975088,17,11,6,49,0.5455279384988502,0.16116777699249876
불확실성/NNG;있/VV,1,0.541563932228829,134,82,52,164,0.8990704035228313,0.2672463727091155
콜금리/NNG;올리/VV,1,0.541560159432708,58,36,22,68,0.758827771569561,0.22556201569910017
콜금리/NNG;인상할/VVX,1,0.541210419123429,116,71,45,111,0.8851647910163376,0.2633759836905006
콜금리/NNG;동결하/VVX,1,0.5410722318215775,68,42,26,63,0.792865862360218,0.23600505991417706
수출/NNG;늘어날/VV,1,0.535298930632655,30,19,11,26,0.625268664590472,0.18916481173247573
성장률/NNG;하/VV,1,0.535298930632655,30,19,11,48,0.625268664590472,0.18916481173247573
인플레이션압력/NNG;대응하/VVX,1,0.535298930632655,30,19,11,17,0.625268664590472,0.18916481173247573
콜금리/NNG;인상되/VVX,1,0.535298930632655,30,19,11,27,0.625268664590472,0.18916481173247573
인플레이션/NNG;유발할/VVX,1,0.535298930632655,30,19,11,48,0.625268664590472,0.18916481173247573
정책금리/NNG;유지하/VVX,1,0.535298930632655,30,19,11,37,0.625268664590472,0.18916481173247573
금리/NNG;오르/VV;않/VX,1,0.5305229000441571,35,22,13,50,0.6519929955445091,0.19989619347992707
금리상승/NNG;되돌리/VV,1,0.5305229000441571,35,22,13,62,0.6519929955445091,0.19989619347992707
물가/NNG;안정세/NNG;유지하/VVX,1,0.5305229000441571,35,22,13,21,0.6519929955445091,0.19989619347992707
내수/NNG;회복세/NNG;이/VV,1,0.5285609297077849,55,34,21,18,0.7437164283037095,0.22926342736477362
세계경제/NNG;회복세/NNG;이/VV,1,0.5284497436406099,40,25,15,13,0.6772822327637281,0.20884830574782579
기준금리/NNG;인상해/VVX,1,0.5268598617144606,148,90,58,201,0.9010403153530334,0.27907268675975777
경제둔화/NNG;따른/VV,1,0.5226922835427084,22,14,8,21,0.5751407133739326,0.1801929630652982
신용등급/NNG;유지하/VVX,1,0.5226922835427084,22,14,8,25,0.5751407133739326,0.1801929630652982
금리역전/NNG;따른/VV,1,0.5226922835427084,22,14,8,38,0.5751407133739326,0.1801929630652982
금리인상/NNG;가능성/NNG;반영해/VVX,1,0.5226922835427084,22,14,8,20,0.5751407133739326,0.1801929630652982
경제/NNG;위축되/VVX,1,0.5226922835427084,22,14,8,37,0.5751407133739326,0.1801929630652982
경기/NNG;나아지/VV,1,0.5226922835427084,22,14,8,41,0.5751407133739326,0.1801929630652982
금리인상/NNG;시사하/VVX;않/VX,1,0.5226922835427084,22,14,8,19,0.5751407133739326,0.1801929630652982
기준금리/NNG;인상된/VVX,1,0.5176467922072927,62,38,24,121,0.7662413531845056,0.24340604543309027
금리인상/NNG;예상된/VVX,1,0.5141325289917054,52,32,20,60,0.7277592557143759,0.23340426040768258
고용지표/NNG;상회하/VVX,1,0.5137320354968813,27,17,10,20,0.6039478849038874,0.1939066717473059
기준금리/NNG;인상됐/VVX,1,0.5137320354968813,27,17,10,39,0.6039478849038874,0.1939066717473059
경기부양/NNG;따른/VV,1,0.5137320354968813,27,17,10,28,0.6039478849038874,0.1939066717473059
금리인상/NNG;위한/VV,1,0.5123494953778904,79,48,31,157,0.8144172322024746,0.26246322079862366
기준금리/NNG;인상하/VVX;않/VX,1,0.5108103864006952,74,45,29,135,0.8009655766177595,0.25920554131121765
콜금리/NNG;인상해/VVX,1,0.5107751793941397,42,26,16,29,0.6828058504697253,0.220988155848641
불확실성/NNG;완화된/VVX,1,0.5107751793941397,42,26,16,73,0.6828058504697253,0.220988155848641
변동성/NNG;줄어들/VV,1,0.5107751793941397,42,26,16,61,0.6828058504697253,0.220988155848641
물가상승압력/NNG;커질/VV,1,0.5104065218845857,32,20,12,42,0.6316237218414629,0.2046269782318904
변동성/NNG;축소되/VVX,1,0.5098865653948093,37,23,14,84,0.6579558509839251,0.21345734953117923
정책금리/NNG;인상될/VVX,1,0.5098865653948093,37,23,14,58,0.6579558509839251,0.21345734953117923
물가안정기조/NNG;유지되/VVX,1,0.4965834275466059,125,75,50,104,0.8787630350574342,0.2954234417750233
기준금리인상/NNG;하/VV,1,0.49537620773309676,19,12,7,26,0.552258758190246,0.18625377424765316
기준금리인상/NNG;가능성/NNG;시사했/VVX,1,0.49537620773309676,19,12,7,26,0.552258758190246,0.18625377424765316
리스크/NNG;반영하/VVX,1,0.49537620773309676,19,12,7,43,0.552258758190246,0.18625377424765316
유동성/NNG;넘쳐나/VV,1,0.49537620773309676,19,12,7,25,0.552258758190246,0.18625377424765316
물가상승률/NNG;안정될/VVX,1,0.49537620773309676,19,12,7,17,0.552258758190246,0.18625377424765316
채권시장/NNG;호재/NNG;작용할/VVX,1,0.49537620773309676,19,12,7,20,0.552258758190246,0.18625377424765316
금리하락/NNG;견인했/VVX,1,0.49537620773309676,19,12,7,30,0.552258758190246,0.18625377424765316
금융완화/NNG;크/VA;축소될/VVX,1,0.49537620773309676,19,12,7,16,0.552258758190246,0.18625377424765316
금리/NNG;큰/VA;하락했/VVX,1,0.4930449891751234,61,37,24,97,0.755411399839866,0.25634367864325514
금리/NNG;동결한/VVX,1,0.49146846868382865,39,24,15,44,0.6637044150002649,0.2261618125299491
흑자/NNG;기록하/VVX,1,0.48865427697455144,34,21,13,46,0.637764418648166,0.2189367351302701
금리인상우려/NNG;따른/VV,1,0.4881909574260852,24,15,9,27,0.5818174499768496,0.1999737939262738
기준금리/NNG;인상함/VVX,1,0.4881909574260852,24,15,9,54,0.5818174499768496,0.1999737939262738
침체/NNG;보이/VV,1,0.4881909574260852,24,15,9,8,0.5818174499768496,0.1999737939262738
경제/NNG;회복세/NNG;이/VV,1,0.4881909574260852,24,15,9,19,0.5818174499768496,0.1999737939262738
정책금리/NNG;인상해/VVX,1,0.48705660537489814,29,18,11,39,0.6104100654888954,0.21042599997180592
불안요인/NNG;남/VV,1,0.4849115855309363,51,31,20,75,0.7155849805285855,0.24807086744466084
성장/NNG;따른/VV,1,0.48260132483792684,63,38,25,83,0.7589425798730303,0.26469188484227446
콜금리/NNG;유지하/VVX,1,0.4810244204210752,109,65,44,116,0.8576082448267704,0.3003327357280578
경기회복/NNG;따른/VV,1,0.480948075588298,211,126,85,377,0.8961525112913903,0.31389314874860846
금리인상/NNG;가능성/NNG;열/VV,1,0.47514128347729656,143,85,58,246,0.8826035773903911,0.31383183116989555
경기/NNG;둔화하/VVX,1,0.47272686457525137,53,32,21,68,0.7200423417392494,0.2576269725764274
금리인상/NNG;미루/VV,1,0.4695010567240405,36,22,14,31,0.6437062151918989,0.23223017863267406
불확실성/NNG;해소된/VVX,1,0.46747983465895615,60,36,24,111,0.7441168345931182,0.26984798566552354
큰/VA;변동성/NNG;보이/VV,1,0.46416749364068477,31,19,12,26,0.6166809732120666,0.22553263420472647
생산/NNG;늘/VV,1,0.46416749364068477,31,19,12,22,0.6166809732120666,0.22553263420472647
수출/NNG;증가해/VVX,1,0.46416749364068477,31,19,12,32,0.6166809732120666,0.22553263420472647
경기/NNG;회복세/NNG;보이/VV,1,0.46140238519040944,55,33,22,100,0.724315468260003,0.26676567164463993
금리인상/NNG;우려하/VVX,1,0.4609968357430918,16,10,6,11,0.5285303285237951,0.19485837898422229
경상수지/NNG;개선되/VVX,1,0.4609968357430918,16,10,6,11,0.5285303285237951,0.19485837898422229
금리인상/NNG;가능성/NNG;확대되/VVX,1,0.4609968357430918,16,10,6,6,0.5285303285237951,0.19485837898422229
경기/NNG;불확실성/NNG;상존하/VVX,1,0.4609968357430918,16,10,6,22,0.5285303285237951,0.19485837898422229
금리정상화/NNG;나설/VV,1,0.4609968357430918,16,10,6,18,0.5285303285237951,0.19485837898422229
기준금리/NNG;유지되/VVX,1,0.4609968357430918,16,10,6,23,0.5285303285237951,0.19485837898422229
금리인상/NNG;그치/VV,1,0.4609968357430918,16,10,6,17,0.5285303285237951,0.19485837898422229
유동성/NNG;늘/VV,1,0.4609968357430918,16,10,6,10,0.5285303285237951,0.19485837898422229
금리인하기대감/NNG;확산되/VVX,1,0.4609968357430918,16,10,6,17,0.5285303285237951,0.19485837898422229
유동성/NNG;지속되/VVX,1,0.4609968357430918,16,10,6,17,0.5285303285237951,0.19485837898422229
금리상승압력/NNG;지속되/VVX,1,0.4609968357430918,16,10,6,18,0.5285303285237951,0.19485837898422229
불안/NNG;확대될/VVX,1,0.4609968357430918,16,10,6,11,0.5285303285237951,0.19485837898422229
투자심리/NNG;고무시/VVX,1,0.4609968357430918,16,10,6,29,0.5285303285237951,0.19485837898422229
성장/NNG;하방리스크/NNG;작용할/VVX,1,0.4609968357430918,16,10,6,13,0.5285303285237951,0.19485837898422229
전망경로/NNG;크/VA;벗어나/VV;않/VX,1,0.4609968357430918,16,10,6,18,0.5285303285237951,0.19485837898422229
금융위기/NNG;진정되/VVX,1,0.4609968357430918,16,10,6,12,0.5285303285237951,0.19485837898422229
금리동결/NNG;점쳤/VV,1,0.4609968357430918,16,10,6,17,0.5285303285237951,0.19485837898422229
금리인상/NNG;힘/NNG;실/VV,1,0.4609968357430918,16,10,6,16,0.5285303285237951,0.19485837898422229
기준금리인상/NNG;가능성/NNG;부각되/VVX,1,0.4609968357430918,16,10,6,12,0.5285303285237951,0.19485837898422229
불확실성/NNG;대비해/VVX,1,0.4609968357430918,16,10,6,16,0.5285303285237951,0.19485837898422229
성장/NNG;둔화되/VVX,1,0.460024078349875,74,44,30,97,0.7842821427966871,0.28986300585023705
지준율/NNG;인상했/VVX,1,0.4596216982666672,26,16,10,40,0.5883139239063935,0.21765686797990347
불확실성/NNG;지속될/VVX,1,0.4575920970139542,62,37,25,140,0.7477577450957025,0.2780701743313287
경기회복세/NNG;강화되/VVX,1,0.4573584358281715,21,13,8,27,0.5588177070279653,0.2079313970408429
경제체질/NNG;개선하/VVX,1,0.4573584358281715,21,13,8,24,0.5588177070279653,0.2079313970408429
실업률/NNG;나타내/VV,1,0.4573584358281715,21,13,8,17,0.5588177070279653,0.2079313970408429
고용지표/NNG;개선된/VVX,1,0.4573584358281715,21,13,8,21,0.5588177070279653,0.2079313970408429
기준금리동결/NNG;예상하/VVX,1,0.4573584358281715,21,13,8,39,0.5588177070279653,0.2079313970408429
기준금리/NNG;묶/VV,1,0.4573584358281715,21,13,8,35,0.5588177070279653,0.2079313970408429
양적완화/NNG;확대하/VVX,1,0.4573584358281715,21,13,8,39,0.5588177070279653,0.2079313970408429
생산/NNG;감소하/VVX,1,0.4573584358281715,21,13,8,27,0.5588177070279653,0.2079313970408429
수출부진/NNG;이어지/VV,1,0.4573584358281715,21,13,8,42,0.5588177070279653,0.2079313970408429
경제지표/NNG;개선되/VVX;모습/NNG,1,0.4573584358281715,21,13,8,43,0.5588177070279653,0.2079313970408429
경제회복/NNG;위한/VV,1,0.4573584358281715,21,13,8,22,0.5588177070279653,0.2079313970408429
불안/NNG;해소하/VVX,1,0.4573584358281715,21,13,8,28,0.5588177070279653,0.2079313970408429
인플레이션/NNG;나타나/VV,1,0.4573584358281715,21,13,8,16,0.5588177070279653,0.2079313970408429
기준금리/NNG;올린/VV,1,0.4551394719002648,129,76,53,124,0.8676421411709183,0.32465510287690397
경제/NNG;살아나/VV,1,0.4525100886820721,38,23,15,50,0.6494606332679282,0.24462896244777388
금리인상/NNG;단행하/VVX;않/VX,1,0.4525100886820721,38,23,15,67,0.6494606332679282,0.24462896244777388
금리/NNG;동결해/VVX,1,0.4482753386995262,64,38,26,63,0.7512318760187298,0.28598211540112484
금리인상/NNG;지연될/VVX,1,0.4472228510541285,90,53,37,88,0.8161417683531066,0.31151055996538224
기준금리/NNG;동결한/VVX,1,0.44643388081888724,45,27,18,71,0.679771676380219,0.2599714462368834
물가상승압력/NNG;작용할/VVX,1,0.44096239210120336,59,35,24,74,0.7323342036326347,0.28391193227180367
금리인상/NNG;이어지/VV,1,0.4373295069493579,40,24,16,53,0.6550363602673996,0.2562390893093877
금리/NNG;올리/VV;않/VX,1,0.4371143608022874,193,113,80,258,0.8810701595484005,0.3448428962127632
경제/NNG;호조/NNG;보이/VV,1,0.4356474976767608,28,17,11,23,0.5946548252691711,0.23358664986170713
경기회복/NNG;기대/NNG;커지/VV,1,0.4356474976767608,28,17,11,47,0.5946548252691711,0.23358664986170713
고용/NNG;늘어나/VV,1,0.4356474976767608,28,17,11,47,0.5946548252691711,0.23358664986170713
성장/NNG;예상되/VVX,1,0.4341773497001835,94,55,39,78,0.8187181607475511,0.3227682511948924
성장세/NNG;나타낼/VV,1,0.43405227294581694,47,28,19,66,0.6847610287430556,0.2700406598148008
실업률/NNG;하락했/VVX,1,0.4324969588079801,54,32,22,80,0.7117923230232001,0.2817766286518849
금리인상/NNG;이/VV,1,0.429916474515474,82,48,34,67,0.7933115113725686,0.31604295245037534
성장세/NNG;이/VV,1,0.4291107898402555,163,95,68,216,0.8737718543188605,0.3487849164983747
금리인상/NNG;이뤄질/VV,1,0.4278043774250959,146,85,61,197,0.867588230628264,0.34742562205994615
금리인상/NNG;선반영하/VVX,1,0.42698551048905786,35,21,14,60,0.628706296065228,0.2522698697352354
경제성장/NNG;뒷받침하/VVX,1,0.42698551048905786,35,21,14,21,0.628706296065228,0.2522698697352354
유동성/NNG;줄어들/VV,1,0.42698551048905786,35,21,14,45,0.628706296065228,0.2522698697352354
불안심리/NNG;완화되/VVX,1,0.42698551048905786,35,21,14,55,0.628706296065228,0.2522698697352354
금리/NNG;높이/VV,1,0.4268986391986158,23,14,9,41,0.565252949939509,0.22685721569982523
금리인하기대/NNG;강화되/VVX,1,0.4268986391986158,23,14,9,32,0.565252949939509,0.22685721569982523
성장세/NNG;둔화할/VVX,1,0.4268986391986158,23,14,9,27,0.565252949939509,0.22685721569982523
정책금리인상/NNG;따른/VV,1,0.42367521611133196,42,25,17,36,0.6604400538196787,0.2671516946699207
금리상승/NNG;제한할/VVX,1,0.4226783724540897,56,33,23,73,0.715997308481761,0.2903284744649953
금리/NNG;높여/VV,1,0.4191982128369369,18,11,7,25,0.5348034075263014,0.21869692178452635
물가상승압력/NNG;나타날/VV,1,0.4191982128369369,18,11,7,10,0.5348034075263014,0.21869692178452635
소비/NNG;증가했/VVX,1,0.4191982128369369,18,11,7,24,0.5348034075263014,0.21869692178452635
금리인상지연/NNG;따른/VV,1,0.4191982128369369,18,11,7,16,0.5348034075263014,0.21869692178452635
수출증가율/NNG;둔화될/VVX,1,0.4191982128369369,18,11,7,30,0.5348034075263014,0.21869692178452635
경기선행지수/NNG;상승했/VVX,1,0.4191982128369369,18,11,7,22,0.5348034075263014,0.21869692178452635
가계대출/NNG;증가하/VVX,1,0.4191982128369369,18,11,7,12,0.5348034075263014,0.21869692178452635
금리인상/NNG;이루어지/VV,1,0.4191982128369369,18,11,7,15,0.5348034075263014,0.21869692178452635
금리인상시기/NNG;앞당길/VV,1,0.4191982128369369,18,11,7,6,0.5348034075263014,0.21869692178452635
양적완화/NNG;가능성/NNG;열/VV,1,0.4191982128369369,18,11,7,21,0.5348034075263014,0.21869692178452635
고용지표/NNG;하회하/VVX,1,0.4191982128369369,18,11,7,24,0.5348034075263014,0.21869692178452635
경기회복/NNG;저해하/VVX,1,0.4191982128369369,18,11,7,17,0.5348034075263014,0.21869692178452635
변동성/NNG;키울/VV;있/VV,1,0.4191982128369369,18,11,7,34,0.5348034075263014,0.21869692178452635
경기회복/NNG;뒷받침할/VVX,1,0.4191982128369369,18,11,7,43,0.5348034075263014,0.21869692178452635
경기회복/NNG;저해할/VVX,1,0.4191982128369369,18,11,7,31,0.5348034075263014,0.21869692178452635
마이너스/NNG;될/VV,1,0.4152686552054976,30,18,12,34,0.6008547035971438,0.24805420993760777
금리인하기대감/NNG;유지되/VVX,1,0.4152686552054976,30,18,12,61,0.6008547035971438,0.24805420993760777
침체/NNG;빠지/VV,1,0.4152686552054976,30,18,12,38,0.6008547035971438,0.24805420993760777
금리인상/NNG;시작하/VVX,1,0.4113168036651256,44,26,18,49,0.665676927125526,0.2774446223700145
물가안정/NNG;위해/VV,1,0.40869744957998533,123,71,52,185,0.8459220020676327,0.3547932951057764
기준금리/NNG;인상했/VVX,1,0.4063351829843054,325,188,137,363,0.8728300215122328,0.36815681759320046
성장률/NNG;달성하/VVX,1,0.4025356609095687,53,31,22,81,0.6987091665809346,0.2974003259668943
금융시장안정/NNG;도모하/VVX,1,0.40203479847570733,25,15,10,5,0.5715887439426373,0.24358313295741624
금리인상/NNG;검토할/VVX,1,0.40203479847570733,25,15,10,14,0.5715887439426373,0.24358313295741624
금리인상/NNG;가능성/NNG;있/VV,1,0.39773716177580565,32,19,13,63,0.6069216622094225,0.26129756697684303
금리인상/NNG;진행될/VVX,1,0.39353236158808524,55,32,23,88,0.7030330370800421,0.3057062631052073
리스크관리/NNG;강화하/VVX,1,0.3897694909080385,48,28,20,38,0.6756662808257399,0.2964269773977048
대외여건/NNG;개선되/VVX,1,0.38712937692089855,20,12,8,40,0.5410519114372967,0.23884850322051618
성장세/NNG;회복할/VVX,1,0.38712937692089855,20,12,8,40,0.5410519114372967,0.23884850322051618
부동산가격/NNG;상승하/VVX,1,0.38712937692089855,20,12,8,23,0.5410519114372967,0.23884850322051618
인플레이션/NNG;위험/NNG;상존해/VVX,1,0.38712937692089855,20,12,8,23,0.5410519114372967,0.23884850322051618
소비자물가/NNG;미치/VV,1,0.38712937692089855,20,12,8,25,0.5410519114372967,0.23884850322051618
유동성/NNG;축소되/VVX,1,0.38712937692089855,20,12,8,25,0.5410519114372967,0.23884850322051618
경제/NNG;성장하/VVX,1,0.3860788342919492,126,72,54,191,0.8396918967492085,0.37159970781000284
생산/NNG;증가하/VVX,1,0.38248902750347114,34,20,14,43,0.6128597547167679,0.27350880811997236
금리/NNG;올리/VV;어려울/VA,1,0.38248902750347114,34,20,14,13,0.6128597547167679,0.27350880811997236
출구전략/NNG;시행할/VVX,1,0.38248902750347114,34,20,14,37,0.6128597547167679,0.27350880811997236
성장/NNG;기록할/VVX,1,0.3813856018668582,27,16,11,35,0.5778355511801967,0.25854462409030404
물가/NNG;하/VV,1,0.3813856018668582,27,16,11,35,0.5778355511801967,0.25854462409030404
대외불확실성/NNG;지속되/VVX,1,0.3813856018668582,27,16,11,43,0.5778355511801967,0.25854462409030404
노동시장/NNG;개선되/VVX,1,0.3813856018668582,27,16,11,82,0.5778355511801967,0.25854462409030404
수출/NNG;줄어들/VV,1,0.3802988267937928,50,29,21,49,0.6804252459598573,0.3052212153839703
불확실성/NNG;해소되/VVX;않/VX,1,0.3752308542825855,68,39,29,84,0.7379270783564424,0.33494816354942836
원자재가격/NNG;상승하/VVX,1,0.37483612073021555,43,25,18,59,0.650886474354412,0.2957113517258721
금리인상우려/NNG;완화되/VVX,1,0.37346718470096274,77,44,33,81,0.7607261620354672,0.34671479210197614
금리상승/NNG;보였/VV,1,0.3703885130775606,15,9,6,12,0.5094252715945042,0.23384330113585128
마이너스/NNG;머물/VV,1,0.3703885130775606,15,9,6,23,0.5094252715945042,0.23384330113585128
성장/NNG;둔화할/VVX,1,0.3703885130775606,15,9,6,13,0.5094252715945042,0.23384330113585128
재정지출/NNG;줄어들/VV,1,0.3703885130775606,15,9,6,11,0.5094252715945042,0.23384330113585128
경상수지흑자/NNG;유지하/VVX,1,0.3703885130775606,15,9,6,25,0.5094252715945042,0.23384330113585128
성장세/NNG;힘입/VV,1,0.3703885130775606,15,9,6,18,0.5094252715945042,0.23384330113585128
유동성흡수/NNG;위한/VV,1,0.3703885130775606,15,9,6,21,0.5094252715945042,0.23384330113585128
성장/NNG;했/VV,1,0.3703885130775606,15,9,6,27,0.5094252715945042,0.23384330113585128
기준금리/NNG;낮/VA;유지할/VVX,1,0.3703885130775606,15,9,6,17,0.5094252715945042,0.23384330113585128
적자폭/NNG;확대되/VVX,1,0.3703885130775606,15,9,6,22,0.5094252715945042,0.23384330113585128
금리메리트/NNG;부각되/VVX,1,0.3703885130775606,15,9,6,37,0.5094252715945042,0.23384330113585128
정책금리인상/NNG;단행될/VVX,1,0.3703885130775606,15,9,6,12,0.5094252715945042,0.23384330113585128
양적완화/NNG;단행할/VVX,1,0.3703885130775606,15,9,6,22,0.5094252715945042,0.23384330113585128
경기부양/NNG;나섰/VV,1,0.3703885130775606,15,9,6,30,0.5094252715945042,0.23384330113585128
리스크/NNG;줄/VV,1,0.3703885130775606,15,9,6,23,0.5094252715945042,0.23384330113585128
인플레이션/NNG;잘/MAG;통제되/VVX,1,0.3703885130775606,15,9,6,13,0.5094252715945042,0.23384330113585128
자금이탈/NNG;이어지/VV,1,0.3703885130775606,15,9,6,9,0.5094252715945042,0.23384330113585128
소비자물가/NNG;선행하/VVX,1,0.3703885130775606,15,9,6,8,0.5094252715945042,0.23384330113585128
국제금융시장/NNG;불안해/VVX,1,0.3703885130775606,15,9,6,9,0.5094252715945042,0.23384330113585128
금리/NNG;인상해/VVX;한다/VX,1,0.3703885130775606,15,9,6,18,0.5094252715945042,0.23384330113585128
경기/NNG;악영향/NNG;미칠/VV,1,0.3703885130775606,15,9,6,19,0.5094252715945042,0.23384330113585128
통화정책완화/NNG;조정/NNG;필요할/VVX,1,0.3703885130775606,15,9,6,42,0.5094252715945042,0.23384330113585128
경제성장/NNG;이루/VV,1,0.3703885130775606,15,9,6,14,0.5094252715945042,0.23384330113585128
국제금융시장/NNG;변동성/NNG;확대될/VVX,1,0.3703885130775606,15,9,6,14,0.5094252715945042,0.23384330113585128
투자심리/NNG;위축되/VVX,1,0.3697851646757635,111,63,48,168,0.8184308564598977,0.3762123880727899
금리인상/NNG;늦춰질/VV,1,0.3690944366400781,36,21,15,55,0.6186705403597492,0.2848424130797421
성장세/NNG;지속되/VVX,1,0.3648323828757982,45,26,19,78,0.6560609482495071,0.3050446351990304
기준금리/NNG;오를/VV,1,0.3648323828757982,45,26,19,71,0.6560609482495071,0.3050446351990304
금융시장/NNG;불안해/VVX,1,0.3639687090831323,29,17,12,29,0.5839960049511711,0.2720779190134836
금리동결/NNG;예상된/VVX,1,0.3639687090831323,29,17,12,24,0.5839960049511711,0.2720779190134836
불확실성/NNG;이어지/VV,1,0.3639687090831323,29,17,12,56,0.5839960049511711,0.2720779190134836
세계경제/NNG;회복되/VVX,1,0.3639687090831323,29,17,12,36,0.5839960049511711,0.2720779190134836
금리상승/NNG;요인이/VVX,1,0.3639687090831323,29,17,12,45,0.5839960049511711,0.2720779190134836
경기/NNG;하강할/VVX,1,0.3639687090831323,29,17,12,14,0.5839960049511711,0.2720779190134836
콜금리/NNG;인상될/VVX,1,0.36342914391008097,54,31,23,45,0.6894852598901605,0.3216236628965778
금리/NNG;올라/VV,1,0.36208221542911057,81,46,35,110,0.7655340541465415,0.3582064828789585
소비자물가/NNG;하락하/VVX,1,0.36185057461713543,22,13,9,26,0.5472922336409053,0.2562238348716712
인플레이션우려/NNG;완화되/VVX,1,0.36185057461713543,22,13,9,44,0.5472922336409053,0.2562238348716712
금리인상/NNG;단행되/VVX;않/VX,1,0.36185057461713543,22,13,9,31,0.5472922336409053,0.2562238348716712
불확실성/NNG;줄이/VV,1,0.36185057461713543,22,13,9,32,0.5472922336409053,0.2562238348716712
낮/VA;금리/NNG;유지하/VVX,1,0.36185057461713543,22,13,9,24,0.5472922336409053,0.2562238348716712
경기회복/NNG;기대감/NNG;커지/VV,1,0.36185057461713543,22,13,9,42,0.5472922336409053,0.2562238348716712
물가상승압력/NNG;완화하/VVX,1,0.36185057461713543,22,13,9,8,0.5472922336409053,0.2562238348716712
부양책/NNG;내놓/VV;않/VX,1,0.36185057461713543,22,13,9,54,0.5472922336409053,0.2562238348716712
금리동결/NNG;예상하/VVX,1,0.36185057461713543,22,13,9,53,0.5472922336409053,0.2562238348716712
기준금리/NNG;동결해/VVX,1,0.3572219332889812,38,22,16,60,0.6243540951872619,0.29542282001584635
리스크/NNG;커지/VV,1,0.3511617674017462,76,43,33,104,0.7496915790211011,0.3596738333027367
금리/NNG;인상할/VVX;전망했/VVX,1,0.34907442678002587,31,18,13,38,0.5900684274788268,0.28444149094887616
유동성/NNG;증가하/VVX,1,0.34907442678002587,31,18,13,37,0.5900684274788268,0.28444149094887616
수출/NNG;의존하/VVX,1,0.34661283440406954,40,23,17,57,0.6299096699145716,0.30535071124840535
경기둔화우려/NNG;커지/VV,1,0.34661283440406954,40,23,17,56,0.6299096699145716,0.30535071124840535
성장/NNG;달성할/VVX,1,0.34661283440406954,40,23,17,59,0.6299096699145716,0.30535071124840535
경기회복세/NNG;지속되/VVX,1,0.3455942681609807,139,78,61,189,0.8322781548168852,0.4043833889355129
경제지표/NNG;부진하/VVX;나오/VV,1,0.34144710008201984,24,14,10,51,0.5535230820766232,0.2714818344781443
변동성/NNG;보일/VV,1,0.34144710008201984,24,14,10,39,0.5535230820766232,0.2714818344781443
경기/NNG;회복될/VVX,1,0.34068353731094514,80,45,35,131,0.7548033933226002,0.3708418082259652
인플레이션/NNG;우려하/VVX,1,0.34068353731094514,80,45,35,92,0.7548033933226002,0.3708418082259652
금리인상시기/NNG;늦추/VV,1,0.3376428761603927,17,10,7,22,0.5153277555832799,0.2549293854847722
경기불확실성/NNG;인해/VV,1,0.3376428761603927,17,10,7,37,0.5153277555832799,0.2549293854847722
부동산가격/NNG;오르/VV,1,0.3376428761603927,17,10,7,20,0.5153277555832799,0.2549293854847722
경제/NNG;타격/NNG;입/VV,1,0.3376428761603927,17,10,7,24,0.5153277555832799,0.2549293854847722
물가/NNG;두/VV,1,0.3376428761603927,17,10,7,26,0.5153277555832799,0.2549293854847722
장단기금리스프레드/NNG;확대되/VVX,1,0.3376428761603927,17,10,7,25,0.5153277555832799,0.2549293854847722
기준금리/NNG;인상되/VVX;않/VX,1,0.3376428761603927,17,10,7,31,0.5153277555832799,0.2549293854847722
인플레이션압력/NNG;선제적/VAX;대응하/VVX,1,0.3376428761603927,17,10,7,8,0.5153277555832799,0.2549293854847722
금리/NNG;최저치/NNG;경신했/VVX,1,0.3376428761603927,17,10,7,13,0.5153277555832799,0.2549293854847722
불확실성/NNG;언급하/VVX,1,0.3376428761603927,17,10,7,20,0.5153277555832799,0.2549293854847722
경제/NNG;확산될/VVX,1,0.3376428761603927,17,10,7,12,0.5153277555832799,0.2549293854847722
유동성/NNG;흡수할/VVX,1,0.3376428761603927,17,10,7,39,0.5153277555832799,0.2549293854847722
gdp/NNG;성장했/VVX,1,0.3376428761603927,17,10,7,31,0.5153277555832799,0.2549293854847722
불확실성/NNG;우려하/VVX,1,0.3376428761603927,17,10,7,19,0.5153277555832799,0.2549293854847722
물가상승률/NNG;상승할/VVX,1,0.3376428761603927,17,10,7,21,0.5153277555832799,0.2549293854847722
물가상승률/NNG;하회하/VVX,1,0.3376428761603927,17,10,7,21,0.5153277555832799,0.2549293854847722
물가상승압력/NNG;커지/VV,1,0.3370628889294942,42,24,18,63,0.6353361170005305,0.3147080330361975
불확실성/NNG;확대될/VVX,1,0.33618104241356517,33,19,14,55,0.5960489087024354,0.2958347585192322
기준금리/NNG;인상되/VVX,1,0.33592814156742246,161,90,71,245,0.8376960306615983,0.4160074940466225
금리인상/NNG;단행해/VVX,1,0.3300460698641563,64,36,28,67,0.7095740259245229,0.3570698259408304
통화완화/NNG;유지하/VVX,1,0.32489834717863864,35,20,15,21,0.6019325348201511,0.30641271985111507
금리/NNG;상승세/NNG;이어지/VV,1,0.3246403655921226,26,15,11,29,0.5597350683958893,0.28509641029267596
신용등급/NNG;강등하/VVX,1,0.3246403655921226,26,15,11,84,0.5597350683958893,0.28509641029267596
낮/VA;금리/NNG;유지할/VVX,1,0.3246403655921226,26,15,11,61,0.5597350683958893,0.28509641029267596
금리인상/NNG;주장하/VVX,1,0.32051970464675406,46,26,20,73,0.6457965985785799,0.3319678263330677
금리인상/NNG;하/VV,1,0.31990729070539903,155,86,69,154,0.8289528855130694,0.4266995915424254
금리하락/NNG;제한하/VVX,1,0.31949230266907747,57,32,25,95,0.6840955694937358,0.3524603423832123
물가/NNG;상승할/VVX,1,0.3192037578887703,68,38,30,97,0.7166335141042891,0.3694616922114008
금리인상/NNG;나서/VV;않/VX,1,0.31492965672010853,37,21,16,57,0.6077141101889395,0.31629695126688173
금리상승/NNG;확대되/VVX,1,0.3136533310510272,59,33,26,103,0.6882756506116807,0.3592419231595465
금융시장/NNG;변동성/NNG;커질/VV,1,0.31296681505349966,19,11,8,28,0.5213771178153545,0.2725443229168439
콜금리/NNG;유지될/VVX,1,0.31296681505349966,19,11,8,15,0.5213771178153545,0.2725443229168439
불확실성/NNG;확대됐/VVX,1,0.31296681505349966,19,11,8,19,0.5213771178153545,0.2725443229168439
금리인상/NNG;뒷받침할/VVX,1,0.31296681505349966,19,11,8,22,0.5213771178153545,0.2725443229168439
경기선행지수/NNG;비/VV,1,0.31296681505349966,19,11,8,17,0.5213771178153545,0.2725443229168439
금리차/NNG;따른/VV,1,0.31296681505349966,19,11,8,39,0.5213771178153545,0.2725443229168439
불안/NNG;대응하/VVX,1,0.31296681505349966,19,11,8,21,0.5213771178153545,0.2725443229168439
금리/NNG;고시됐/VVX,1,0.31296681505349966,19,11,8,11,0.5213771178153545,0.2725443229168439
금리/NNG;인하해/VVX;할/VX,1,0.31296681505349966,19,11,8,23,0.5213771178153545,0.2725443229168439
경제상황/NNG;악화되/VVX,1,0.31296681505349966,19,11,8,12,0.5213771178153545,0.2725443229168439
성장경로/NNG;불확실성/NNG;높/VA;판단된/VVX,1,0.31055267945296716,28,16,12,43,0.5659155850362658,0.2974111302564747
출구전략/NNG;따른/VV,1,0.31055267945296716,28,16,12,62,0.5659155850362658,0.2974111302564747
금융완화/NNG;유지되/VVX,1,0.31055267945296716,28,16,12,16,0.5659155850362658,0.2974111302564747
금리인상시기/NNG;될/VV,1,0.31055267945296716,28,16,12,31,0.5659155850362658,0.2974111302564747
금리인상/NNG;단행될/VVX,1,0.3087390573029971,235,130,105,367,0.834787329240016,0.44047581996357504
성장률/NNG;하락하/VVX,1,0.30604592421408316,39,22,17,53,0.6133885747639809,0.3255837541771149
금리/NNG;동결될/VVX,1,0.3052834835049376,147,81,66,193,0.8192624704582961,0.43559199941357946
금리/NNG;올려도/VV,1,0.30050320355162574,76,42,34,90,0.7291857328067582,0.391797873640998
물가/NNG;잡/VV,1,0.29973985315336016,151,83,68,217,0.8186078698045188,0.44058305471379416
금리인하/NNG;시사하/VVX,1,0.29856528253947934,30,17,13,68,0.572051269133959,0.30867839379726897
금리인하기대/NNG;유지될/VVX,1,0.29856528253947934,30,17,13,60,0.572051269133959,0.30867839379726897
양적완화/NNG;나서/VV,1,0.29856528253947934,30,17,13,58,0.572051269133959,0.30867839379726897
리스크/NNG;존재하/VVX,1,0.29856528253947934,30,17,13,27,0.572051269133959,0.30867839379726897
수출/NNG;회복되/VVX,1,0.2980678187959849,41,23,18,57,0.6189512373480133,0.33435017338211803
성장/NNG;지속되/VVX,1,0.2980678187959849,41,23,18,50,0.6189512373480133,0.33435017338211803
금리/NNG;올린다고/VV,1,0.2947276388667459,54,30,24,66,0.6651205571233553,0.3619287335822593
금리인상/NNG;예상하/VVX,1,0.29437571335962986,91,50,41,134,0.7571694756038648,0.41233498298077187
추경/NNG;통한/VV,1,0.2937447046769517,21,12,9,33,0.5275406013105859,0.2876817796997474
금리/NNG;변동성/NNG;확대될/VVX,1,0.2937447046769517,21,12,9,17,0.5275406013105859,0.2876817796997474
경제/NNG;연착륙할/VVX,1,0.2937447046769517,21,12,9,21,0.5275406013105859,0.2876817796997474
불확실성/NNG;증폭되/VVX,1,0.2937447046769517,21,12,9,34,0.5275406013105859,0.2876817796997474
소비자물가/NNG;급등하/VVX,1,0.2937447046769517,21,12,9,19,0.5275406013105859,0.2876817796997474
물가상승률/NNG;밑돌/VV,1,0.2937447046769517,21,12,9,30,0.5275406013105859,0.2876817796997474
기준금리/NNG;동결키/VVX,1,0.2937447046769517,21,12,9,20,0.5275406013105859,0.2876817796997474
금리/NNG;치솟/VV,1,0.2934612093096365,67,37,30,149,0.7036377712226821,0.38395012921111943
금리인상/NNG;될/VV,1,0.2934612093096365,67,37,30,71,0.7036377712226821,0.38395012921111943
성장률/NNG;그칠/VV,1,0.29085311752922616,43,24,19,58,0.6243978970119974,0.34265845733116645
채권시장/NNG;약세/NNG;보임/VV,1,0.28849564929787874,82,45,37,88,0.7373101849959283,0.40670855283330504
경기/NNG;판단하/VVX,1,0.28823114494791446,32,18,14,25,0.5781292170241418,0.3190864244438695
리스크/NNG;상존하/VVX,1,0.28823114494791446,32,18,14,64,0.5781292170241418,0.3190864244438695
기준금리인상/NNG;따른/VV,1,0.28644666610783953,130,71,59,120,0.8005876635134648,0.4435883358603362
금리인상/NNG;빨라질/VA;있/VV,1,0.2842876944991619,45,25,20,44,0.6297248966878994,0.3505593844651129
금리/NNG;인상함/VVX,1,0.2842876944991619,45,25,20,20,0.6297248966878994,0.3505593844651129
변동성/NNG;확대시/VVX,1,0.2796706917934946,60,33,27,96,0.6782046540520568,0.3813501526835578
경제성장률/NNG;높이/VV,1,0.2792200984464839,34,19,15,34,0.5841375465753844,0.32877773269631955
성장/NNG;유지하/VVX,1,0.2792200984464839,34,19,15,60,0.5841375465753844,0.32877773269631955
경기/NNG;바닥/NNG;쳤/VV,1,0.2783618195421371,23,13,10,10,0.5337824657138549,0.3009948749141357
동결/NNG;전망했/VVX,1,0.2783618195421371,23,13,10,21,0.5337824657138549,0.3009948749141357
경제/NNG;경착륙할/VVX,1,0.2783618195421371,23,13,10,27,0.5337824657138549,0.3009948749141357
시장금리/NNG;하락했/VVX,1,0.2783618195421371,23,13,10,31,0.5337824657138549,0.3009948749141357
불안/NNG;잠재우/VV,1,0.2783618195421371,23,13,10,31,0.5337824657138549,0.3009948749141357
금융위기/NNG;이전/NNG;회복하/VVX,1,0.2783618195421371,23,13,10,28,0.5337824657138549,0.3009948749141357
경기침체/NNG;빠질/VV,1,0.2783618195421371,23,13,10,42,0.5337824657138549,0.3009948749141357
경기과열/NNG;막/VV,1,0.2782789827260088,47,26,21,58,0.634929135934359,0.35809476326808726
금리/NNG;올려야/VV,1,0.27725632199659556,180,98,82,280,0.8168318547465302,0.461707542646073
기준금리/NNG;유지하/VVX,1,0.27375485789067855,641,349,292,902,0.8202267880459516,0.46714979206604945
고용/NNG;감소했/VVX,1,0.27275116208875083,49,27,22,20,0.6400080595619259,0.3652993271999715
주택가격/NNG;하락하/VVX,1,0.27275116208875083,49,27,22,33,0.6400080595619259,0.3652993271999715
금리/NNG;상승세/NNG;출발했/VVX,1,0.27275116208875083,49,27,22,60,0.6400080595619259,0.3652993271999715
재정위기/NNG;따른/VV,1,0.27275116208875083,49,27,22,97,0.6400080595619259,0.3652993271999715
금리인상/NNG;예상했/VVX,1,0.2712834281887131,36,20,16,78,0.5900656187782607,0.33786181349662836
금리인상/NNG;가능성/NNG;시사하/VVX,1,0.269876519373619,79,43,36,82,0.7228091420686057,0.41512577233864484
금리상승/NNG;제한하/VVX,1,0.268227496805187,94,51,43,151,0.7505583564915762,0.43259659684223
금리동결/NNG;예상했/VVX,1,0.2676415698744059,51,28,23,60,0.6449596324769273,0.3722021833997646
재정지출/NNG;확대하/VVX,1,0.2657752812498422,25,14,11,29,0.540069184162632,0.3129242600621215
금리/NNG;인상해/VVX;한다고/VX,1,0.2657752812498422,25,14,11,35,0.540069184162632,0.3129242600621215
경제성장/NNG;발목/NNG;잡/VV,1,0.2657752812498422,25,14,11,25,0.540069184162632,0.3129242600621215
안전자산선호/NNG;강화되/VVX,1,0.2657752812498422,25,14,11,71,0.540069184162632,0.3129242600621215
금리/NNG;인상할/VVX;필요/NNG;있/VA,1,0.2657752812498422,25,14,11,20,0.540069184162632,0.3129242600621215
금리/NNG;내려간/VV,1,0.26423045184279403,38,21,17,56,0.5959040832615431,0.3464239748781474
금리인상/NNG;지연되/VVX,1,0.26423045184279403,38,21,17,40,0.5959040832615431,0.3464239748781474
금리인상/NNG;따른/VV,1,0.2634784780028474,550,298,252,743,0.8155918947128874,0.4749039875312011
유가상승/NNG;따른/VV,1,0.26326117049093933,124,67,57,156,0.7850017785940328,0.45730523608772705
불확실성/NNG;존재하/VVX,1,0.26289798963287314,53,29,24,74,0.6497823071826855,0.3788279297121951
금리인하/NNG;가능할/VVX,1,0.26289798963287314,53,29,24,76,0.6497823071826855,0.3788279297121951
금리인상/NNG;늦출/VV,1,0.26289798963287314,53,29,24,41,0.6497823071826855,0.3788279297121951
인플레이션억제/NNG;위해/VV,1,0.2597333577171168,70,38,32,95,0.6973704501073257,0.4093407210602318
성장률/NNG;둔화되/VVX,1,0.2584765794283117,55,30,25,91,0.6544749879276313,0.38519752311603445
기준금리동결/NNG;전망했/VVX,1,0.25528446386326675,27,15,12,21,0.5463711066020198,0.3237753122340421
금리하락/NNG;견인하/VVX,1,0.25528446386326675,27,15,12,59,0.5463711066020198,0.3237753122340421
경기회복/NNG;힘입/VV,1,0.25528446386326675,27,15,12,42,0.5463711066020198,0.3237753122340421
금리인상/NNG;반영하/VVX,1,0.25434027142515236,57,31,26,57,0.6590369939496744,0.39132896024378466
경기회복세/NNG;지속될/VVX,1,0.25434027142515236,57,31,26,98,0.6590369939496744,0.39132896024378466
채권시장/NNG;강세/NNG;보임/VV,1,0.2522127733179029,42,23,19,68,0.6072809340819519,0.3622383814083087
금리인상/NNG;막/VV,0,0.2521901709871446,16,9,7,24,0.4929951074449407,0.2940819519082837
적자/NNG;지속되/VVX,0,0.2521901709871446,16,9,7,21,0.4929951074449407,0.2940819519082837
대외불확실성/NNG;남/VV,0,0.2521901709871446,16,9,7,23,0.4929951074449407,0.2940819519082837
내수/NNG;성장기여/VVX,0,0.2521901709871446,16,9,7,11,0.4929951074449407,0.2940819519082837
불안/NNG;보이/VV,0,0.2521901709871446,16,9,7,15,0.4929951074449407,0.2940819519082837
적자/NNG;줄이/VV,0,0.2521901709871446,16,9,7,43,0.4929951074449407,0.2940819519082837
기준금리인상/NNG;가능성/NNG;열려/VV,0,0.2521901709871446,16,9,7,13,0.4929951074449407,0.2940819519082837
수출/NNG;회복세/NNG;보이/VV,0,0.2521901709871446,16,9,7,23,0.4929951074449407,0.2940819519082837
금리상승/NNG;대비해/VVX,0,0.2521901709871446,16,9,7,38,0.4929951074449407,0.2940819519082837
금리변동성/NNG;확대시/VVX,0,0.2521901709871446,16,9,7,27,0.4929951074449407,0.2940819519082837
물가/NNG;달성하/VVX,0,0.2521901709871446,16,9,7,15,0.4929951074449407,0.2940819519082837
금융시장/NNG;안정/NNG;위해/VV,0,0.2521901709871446,16,9,7,20,0.4929951074449407,0.2940819519082837
금리인상/NNG;가능성/NNG;반영했/VVX,0,0.2521901709871446,16,9,7,19,0.4929951074449407,0.2940819519082837
산업생산/NNG;감소해/VVX,0,0.2521901709871446,16,9,7,17,0.4929951074449407,0.2940819519082837
변동성/NNG;따른/VV,0,0.2521901709871446,16,9,7,17,0.4929951074449407,0.2940819519082837
대외불확실성/NNG;상존하/VVX,0,0.2521901709871446,16,9,7,25,0.4929951074449407,0.2940819519082837
물가/NNG;상승세/NNG;지속되/VVX,0,0.2521901709871446,16,9,7,17,0.4929951074449407,0.2940819519082837
신용스프레드/NNG;확대된/VVX,0,0.2521901709871446,16,9,7,40,0.4929951074449407,0.2940819519082837
고용지표/NNG;부진할/VVX,0,0.2521901709871446,16,9,7,9,0.4929951074449407,0.2940819519082837
고용부진/NNG;지속되/VVX,0,0.2521901709871446,16,9,7,12,0.4929951074449407,0.2940819519082837
변동성/NNG;확대할/VVX;있/VV,0,0.2521901709871446,16,9,7,11,0.4929951074449407,0.2940819519082837
물가상승/NNG;유발하/VVX;않/VX,0,0.2521901709871446,16,9,7,5,0.4929951074449407,0.2940819519082837
물가/NNG;상회하/VVX,0,0.2521901709871446,16,9,7,22,0.4929951074449407,0.2940819519082837
물가/NNG;시차/NNG;두/VV,0,0.2521901709871446,16,9,7,23,0.4929951074449407,0.2940819519082837
양적완화/NNG;축소될/VVX,0,0.2521901709871446,16,9,7,30,0.4929951074449407,0.2940819519082837
내수부진/NNG;지속되/VVX,0,0.2521901709871446,16,9,7,32,0.4929951074449407,0.2940819519082837
실물경제/NNG;제약하/VVX,0,0.2521901709871446,16,9,7,4,0.4929951074449407,0.2940819519082837
소비자물가지수/NNG;올라/VV,0,0.2521901709871446,16,9,7,15,0.4929951074449407,0.2940819519082837
금리/NNG;유지키/VVX,0,0.2521901709871446,16,9,7,6,0.4929951074449407,0.2940819519082837
금리/NNG;올리/VV;못할/VX,0,0.2521901709871446,16,9,7,25,0.4929951074449407,0.2940819519082837
디레버리징/NNG;따른/VV,0,0.2521901709871446,16,9,7,16,0.4929951074449407,0.2940819519082837
내수/NNG;회복되/VVX,1,0.25045752302742175,59,32,27,61,0.6634680232932115,0.3972378146786281
변동성/NNG;크/VA;확대되/VVX,1,0.24703696171115053,44,24,20,61,0.6128064994955662,0.36958795788887366
변동성/NNG;키울/VV,1,0.246402444477674,29,16,13,36,0.5526627060152326,0.33376506597892985
금리/NNG;올린다는/VV,1,0.246402444477674,29,16,13,29,0.5526627060152326,0.33376506597892985
금리인상/NNG;진행되/VVX,1,0.246402444477674,29,16,13,64,0.5526627060152326,0.33376506597892985
물가상승압력/NNG;지속될/VVX,1,0.246402444477674,29,16,13,40,0.5526627060152326,0.33376506597892985
경기회복/NNG;되/VV,1,0.246402444477674,29,16,13,23,0.5526627060152326,0.33376506597892985
유럽재정위기/NNG;따른/VV,1,0.246402444477674,29,16,13,54,0.5526627060152326,0.33376506597892985
성장세/NNG;확대되/VVX,1,0.246402444477674,29,16,13,39,0.5526627060152326,0.33376506597892985
금리/NNG;올리/VV,1,0.24576342931643458,1020,548,472,1255,0.8074023534736464,0.4882710315023636
채권시장강세/NNG;지지하/VVX,1,0.24334846041038416,63,34,29,94,0.6719376315587832,0.40844043281148606
정책금리/NNG;인상하/VVX,1,0.24298968034704238,142,76,66,154,0.7879094440069387,0.47929947705427906
성장/NNG;가능할/VVX,1,0.24108318029918108,99,53,46,124,0.7456607118081722,0.4554378877859613
불확실성/NNG;높/VA;상황이/VVX,1,0.2387808277087624,31,17,14,53,0.55892228931938,0.3430513615734499
경기/NNG;회복되/VVX;않/VX,0,0.2358241742404723,18,10,8,18,0.49911539622983186,0.30826719586560936
마이너스/NNG;이/VV,0,0.2358241742404723,18,10,8,25,0.49911539622983186,0.30826719586560936
금리/NNG;상승한/VAX;스프레드/NNG;확대된/VVX,0,0.2358241742404723,18,10,8,17,0.49911539622983186,0.30826719586560936
경제위기/NNG;극복하/VVX,0,0.2358241742404723,18,10,8,18,0.49911539622983186,0.30826719586560936
주택시장/NNG;둔화되/VVX,0,0.2358241742404723,18,10,8,20,0.49911539622983186,0.30826719586560936
금리인상/NNG;미뤄질/VV,0,0.2358241742404723,18,10,8,28,0.49911539622983186,0.30826719586560936
gdp갭/NNG;마이너스/NNG;유지하/VVX,0,0.2358241742404723,18,10,8,31,0.49911539622983186,0.30826719586560936
유동성/NNG;사정/NNG;원활하/VVX,0,0.2358241742404723,18,10,8,9,0.49911539622983186,0.30826719586560936
기준금리인상/NNG;인해/VV,0,0.2358241742404723,18,10,8,23,0.49911539622983186,0.30826719586560936
금융시장/NNG;출렁이/VV,0,0.2358241742404723,18,10,8,22,0.49911539622983186,0.30826719586560936
신흥시장/NNG;성장세약화/NNG;영향/NNG;받/VV,0,0.2358241742404723,18,10,8,25,0.49911539622983186,0.30826719586560936
주택가격/NNG;상승세/NNG;둔화되/VVX,0,0.2358241742404723,18,10,8,11,0.49911539622983186,0.30826719586560936
인플레율억제/NNG;두/VV,0,0.2358241742404723,18,10,8,28,0.49911539622983186,0.30826719586560936
금리인하/NNG;반영하/VVX,0,0.2358241742404723,18,10,8,47,0.49911539622983186,0.30826719586560936
금리인상/NNG;단행하/VVX,1,0.23533430136364974,219,117,102,270,0.8012646966158494,0.49539589022535946
금리인상/NNG;나서/VV,1,0.23426961708664296,193,103,90,293,0.798689307982527,0.49491658497428526
금리인상/NNG;지속될/VVX,1,0.2341047287750655,105,56,49,135,0.750613634353498,0.4652881195301224
물가/NNG;끌어올리/VV,1,0.23216400784100677,33,18,15,38,0.5651315417261003,0.3517514030285637
인플레이션/NNG;완화되/VVX,1,0.23216400784100677,33,18,15,37,0.5651315417261003,0.3517514030285637
경기회복세/NNG;이어질/VV,1,0.23216400784100677,33,18,15,30,0.5651315417261003,0.3517514030285637
금융위기/NNG;대응하/VVX,1,0.2302473117174746,52,28,24,25,0.6337174682208675,0.39603998437082555
수출/NNG;호조/NNG;지속하/VVX,1,0.2302473117174746,52,28,24,28,0.6337174682208675,0.39603998437082555
고용지표/NNG;부진하/VVX,1,0.2302473117174746,52,28,24,65,0.6337174682208675,0.39603998437082555
불확실성/NNG;지속되/VVX,1,0.22937432675027902,126,67,59,198,0.7703167698041239,0.48229464881201445
재정위기/NNG;겪/VV,1,0.22678997230236542,54,29,25,137,0.638632529497708,0.4020311045637464
수출/NNG;늘/VV,1,0.2265780202643366,94,50,44,73,0.7310068513491701,0.4603879429461892
불확실성/NNG;존재한/VVX,1,0.2263603405811918,35,19,16,38,0.5712750552390695,0.3599538712050412
금리하락/NNG;작용할/VVX,1,0.2263603405811918,35,19,16,47,0.5712750552390695,0.3599538712050412
금리인상/NNG;시사했/VVX,1,0.22346720934161857,77,41,36,95,0.6975497938058571,0.44220225550903214
지준율/NNG;올리/VV,1,0.2231986332829301,20,11,9,14,0.5054455626908115,0.3206013937745685
산업생산/NNG;감소했/VVX,1,0.2231986332829301,20,11,9,38,0.5054455626908115,0.3206013937745685
금리/NNG;낮춰야/VV,1,0.2231986332829301,20,11,9,26,0.5054455626908115,0.3206013937745685
실업률/NNG;유지하/VVX,1,0.2231986332829301,20,11,9,20,0.5054455626908115,0.3206013937745685
수익성/NNG;개선될/VVX,1,0.2231986332829301,20,11,9,26,0.5054455626908115,0.3206013937745685
금리인상/NNG;가능성/NNG;커졌/VV,1,0.2231986332829301,20,11,9,20,0.5054455626908115,0.3206013937745685
금리/NNG;최저치/NNG;경신하/VVX,1,0.2231986332829301,20,11,9,43,0.5054455626908115,0.3206013937745685
소비/NNG;줄/VV,1,0.2231986332829301,20,11,9,27,0.5054455626908115,0.3206013937745685
금리/NNG;하락세/NNG;재개될/VVX,1,0.2231986332829301,20,11,9,55,0.5054455626908115,0.3206013937745685
자산가격상승/NNG;따른/VV,1,0.2231986332829301,20,11,9,25,0.5054455626908115,0.3206013937745685
유동성/NNG;흡수해/VVX,1,0.2231986332829301,20,11,9,31,0.5054455626908115,0.3206013937745685
경상수지흑자/NNG;줄어들/VV,1,0.2231986332829301,20,11,9,33,0.5054455626908115,0.3206013937745685
경제/NNG;부정적/VAX;영향/NNG;미치/VV,1,0.2231986332829301,20,11,9,22,0.5054455626908115,0.3206013937745685
경상수지흑자/NNG;따른/VV,1,0.2231986332829301,20,11,9,42,0.5054455626908115,0.3206013937745685
수입/NNG;늘어나/VV,1,0.2231986332829301,20,11,9,27,0.5054455626908115,0.3206013937745685
경기/NNG;회복되/VVX,0,0.22175785270214532,290,154,136,382,0.7958422267188963,0.5063295478026706
양적완화/NNG;유지하/VVX,1,0.22122339436770444,37,20,17,84,0.5773398980965939,0.3677270192993853
기준금리인상/NNG;있/VV,1,0.22122339436770444,37,20,17,52,0.5773398980965939,0.3677270192993853
경제성장/NNG;이끌/VV,1,0.22122339436770444,37,20,17,47,0.5773398980965939,0.3677270192993853
유가하락/NNG;따른/VV,0,0.2206295771252036,183,97,86,197,0.7905763455177547,0.5041728833723028
수출/NNG;부진하/VVX,1,0.22052947893818953,58,31,27,58,0.6480752880330758,0.4133828234092804
물가/NNG;급등하/VVX,1,0.21663941338270365,39,21,18,38,0.5833152418179748,0.375124203092889
금리동결/NNG;이어질/VV,1,0.21663941338270365,39,21,18,70,0.5833152418179748,0.375124203092889
금리/NNG;인상해/VVX,1,0.21453264410079087,125,66,59,184,0.7620708642154568,0.49224835189661686
설비투자/NNG;늘어나/VV,1,0.2131825444971569,22,12,10,19,0.5119134666040339,0.33159891052483054
자산가격/NNG;상승하/VVX,1,0.2131825444971569,22,12,10,21,0.5119134666040339,0.33159891052483054
리스크/NNG;완화된/VVX,1,0.2131825444971569,22,12,10,28,0.5119134666040339,0.33159891052483054
금리인상/NNG;가능성/NNG;시사할/VVX,1,0.2131825444971569,22,12,10,33,0.5119134666040339,0.33159891052483054
물가/NNG;상승세/NNG;둔화되/VVX,1,0.2131825444971569,22,12,10,24,0.5119134666040339,0.33159891052483054
경제/NNG;성장세/NNG;지속하/VVX,1,0.2131825444971569,22,12,10,27,0.5119134666040339,0.33159891052483054
가계대출/NNG;늘/VV,1,0.2131825444971569,22,12,10,13,0.5119134666040339,0.33159891052483054
금리인상/NNG;시작된/VVX,1,0.2131825444971569,22,12,10,21,0.5119134666040339,0.33159891052483054
gdp/NNG;성장하/VVX,1,0.2131825444971569,22,12,10,33,0.5119134666040339,0.33159891052483054
양적완화/NNG;할/VV,1,0.2131825444971569,22,12,10,29,0.5119134666040339,0.33159891052483054
금리/NNG;인하된/VVX,1,0.2131825444971569,22,12,10,24,0.5119134666040339,0.33159891052483054
기업실적/NNG;개선되/VVX,1,0.2131825444971569,22,12,10,20,0.5119134666040339,0.33159891052483054
변동성/NNG;커질/VA;있/VV,1,0.2131825444971569,22,12,10,36,0.5119134666040339,0.33159891052483054
금리/NNG;하락/NNG;압력/NNG;받/VV,1,0.2125187245797735,41,22,19,92,0.5891920459590533,0.38218773545327034
신용등급/NNG;강등되/VVX,1,0.2125187245797735,41,22,19,67,0.5891920459590533,0.38218773545327034
기준금리/NNG;동결함/VVX,1,0.2125187245797735,41,22,19,94,0.5891920459590533,0.38218773545327034
성장/NNG;지속하/VVX,1,0.2124421480941472,64,34,30,57,0.661262987131772,0.4290063027781012
불확실성/NNG;해소되/VVX,0,0.21187763835594553,180,95,85,326,0.7856728583873792,0.5103217990849594
금리하락/NNG;제한될/VVX,1,0.20878971676921898,43,23,20,59,0.5949627945310739,0.38895162251114374
금리상승압력/NNG;작용하/VVX,1,0.20878971676921898,43,23,20,49,0.5949627945310739,0.38895162251114374
금리인상/NNG;가능성/NNG;커지/VV,1,0.20878971676921898,43,23,20,48,0.5949627945310739,0.38895162251114374
불안/NNG;지속되/VVX,1,0.20668301062427963,93,49,44,99,0.7197020463548656,0.47257303977204634
경제성장률/NNG;둔화될/VVX,1,0.20553505104458036,70,37,33,77,0.6732852430260456,0.44315491503461396
국제유가상승/NNG;따른/VV,1,0.20539453782362416,45,24,21,61,0.600621276399981,0.39544353860108367
경제/NNG;안정되/VVX,1,0.20505612437200527,24,13,11,40,0.5184630292162605,0.34159233322066496
금리인상/NNG;카드/NNG;꺼내/VV,1,0.20505612437200527,24,13,11,17,0.5184630292162605,0.34159233322066496
재정/NNG;풀/VV,1,0.20505612437200527,24,13,11,20,0.5184630292162605,0.34159233322066496
연착륙/NNG;유도하/VVX,1,0.20505612437200527,24,13,11,21,0.5184630292162605,0.34159233322066496
경제/NNG;미칠/VV;부정적/VAX,1,0.20505612437200527,24,13,11,42,0.5184630292162605,0.34159233322066496
성장/NNG;보였/VV,1,0.20505612437200527,24,13,11,24,0.5184630292162605,0.34159233322066496
수출호조/NNG;따른/VV,1,0.20505612437200527,24,13,11,29,0.5184630292162605,0.34159233322066496
금리상승/NNG;막/VV,1,0.20505612437200527,24,13,11,30,0.5184630292162605,0.34159233322066496
성장률/NNG;높이/VV,1,0.20228596467933424,47,25,22,70,0.6061624022094229,0.4016862735014235
성장률/NNG;기록할/VVX,0,0.20196850854182746,141,74,67,167,0.7668531736286528,0.5085075465551995
성장세/NNG;둔화될/VVX,1,0.20143504625929576,74,39,35,83,0.680665234578236,0.45185725927784076
기준금리/NNG;동결되/VVX,0,0.20069059802500488,162,85,77,438,0.775439321951528,0.515571235581905
금리/NNG;동결했/VVX,0,0.2000782240344119,200,105,95,272,0.7824985681094732,0.5209283470795655
유동성/NNG;공급했/VVX,1,0.19951123617158295,76,40,36,103,0.6841690304676559,0.45600570483413727
기준금리/NNG;낮춰/VV,1,0.1994250897023051,49,26,23,42,0.6115820512712621,0.4076988076759298
경기회복/NNG;지속될/VVX,1,0.1983398722615164,26,14,12,44,0.5250503938770299,0.35080527129441574
세계경제/NNG;미국/NNG;선진국/NNG;회복세/NNG;이/VV,1,0.1983398722615164,26,14,12,13,0.5250503938770299,0.35080527129441574
불확실성/NNG;증가하/VVX,1,0.1983398722615164,26,14,12,36,0.5250503938770299,0.35080527129441574
재정지출/NNG;줄이/VV,1,0.1983398722615164,26,14,12,18,0.5250503938770299,0.35080527129441574
금리/NNG;인상할/VVX;있/VA,1,0.19677958548153085,51,27,24,59,0.6168769429221085,0.41349712120441245
금리/NNG;인상하/VVX;않/VX,0,0.1964926569713703,149,78,71,185,0.7681655482625594,0.5152141190054008
기준금리/NNG;인상될/VVX,0,0.196213982812681,450,236,214,783,0.7831281347798786,0.5255538913020016
경기부양/NNG;나설/VV,1,0.19432238613288222,53,28,25,131,0.6220445278399063,0.41909480934096555
소비자물가/NNG;상승했/VVX,1,0.19432238613288222,53,28,25,77,0.6220445278399063,0.41909480934096555
경기회복/NNG;지연되/VVX,1,0.19432238613288222,53,28,25,72,0.6220445278399063,0.41909480934096555
불확실성/NNG;남/VV,0,0.19391888028400417,273,143,130,459,0.7818391944798833,0.5271959593081045
마이너스/NNG;벗어나/VV,1,0.19270216740213675,28,15,13,29,0.5316409546688875,0.359393130321443
과잉유동성/NNG;흡수하/VVX,1,0.19270216740213675,28,15,13,26,0.5316409546688875,0.359393130321443
금융시장/NNG;안정될/VVX,1,0.19270216740213675,28,15,13,18,0.5316409546688875,0.359393130321443
안전자산선호/NNG;따른/VV,1,0.19270216740213675,28,15,13,71,0.5316409546688875,0.359393130321443
경제성장률/NNG;하향조정하/VVX,1,0.1920306729765937,55,29,26,103,0.6270828956765512,0.4245035558184542
취업자수/NNG;증가하/VVX,1,0.1920306729765937,55,29,26,93,0.6270828956765512,0.4245035558184542
불안/NNG;지속될/VVX,1,0.1920306729765937,55,29,26,67,0.6270828956765512,0.4245035558184542
금리인상/NNG;가능할/VVX,1,0.19091124114062286,86,45,41,120,0.6998989410207309,0.47489761904439065
물가/NNG;안정시/VVX,1,0.19091124114062286,86,45,41,132,0.6998989410207309,0.47489761904439065
산업생산/NNG;증가하/VVX,1,0.18988508566809004,57,30,27,59,0.6319906960776591,0.4297335002404742
부양책/NNG;내놓/VV,0,0.18934717284461722,115,60,55,207,0.7398115143564781,0.503609318383332
리스크/NNG;인해/VV,1,0.1879064105090429,30,16,14,57,0.5382071476839823,0.3674670281437619
물가상승압력/NNG;지속되/VVX,1,0.1879064105090429,30,16,14,29,0.5382071476839823,0.3674670281437619
산업생산/NNG;증가해/VVX,1,0.1879064105090429,30,16,14,42,0.5382071476839823,0.3674670281437619
금리동결/NNG;유지할/VVX,1,0.1879064105090429,30,16,14,35,0.5382071476839823,0.3674670281437619
경제성장률/NNG;하향조정했/VVX,1,0.18786910241195187,59,31,28,99,0.6367670707404053,0.43479352574103786
금리/NNG;동결하/VVX,0,0.18739786804872938,316,165,151,438,0.7785819138939453,0.5321457341593924
자본확충/NNG;위해/VV,1,0.18377931406038717,32,17,15,70,0.5447268266232339,0.375108400227305
양적완화/NNG;축소하/VVX,1,0.18377931406038717,32,17,15,116,0.5447268266232339,0.375108400227305
수입/NNG;감소하/VVX,1,0.18377931406038717,32,17,15,42,0.5447268266232339,0.375108400227305
금리인상/NNG;이루어질/VV,1,0.18377931406038717,32,17,15,29,0.5447268266232339,0.375108400227305
성장률/NNG;기록하/VVX,0,0.18290776362794658,125,65,60,123,0.7457782327166663,0.5144820884860344
임금/NNG;상승하/VVX,1,0.18019109630768915,34,18,16,32,0.5511820659928534,0.3823782380533549
금리/NNG;유지했/VVX,1,0.18019109630768915,34,18,16,29,0.5511820659928534,0.3823782380533549
물가/NNG;오르/VV;않/VX,1,0.18019109630768915,34,18,16,43,0.5511820659928534,0.3823782380533549
자산/NNG;줄이/VV,1,0.18019109630768915,34,18,16,44,0.5511820659928534,0.3823782380533549
수출/NNG;개선되/VVX,1,0.18019109630768915,34,18,16,74,0.5511820659928534,0.3823782380533549
금융시장/NNG;안정된/VVX,1,0.1770426749113594,36,19,17,33,0.5575582726272985,0.3893231149607805
금리하락압력/NNG;작용할/VVX,1,0.1770426749113594,36,19,17,55,0.5575582726272985,0.3893231149607805
기준금리/NNG;올리/VV,0,0.17635615965322504,337,175,162,495,0.77282177748458,0.5403985138426578
기준금리인상/NNG;가능성/NNG;반영했/VVX,0,0.17453652054512547,166,86,80,122,0.7629872865260031,0.53552665172107
고용/NNG;증가하/VVX,1,0.17425713477855376,38,20,18,79,0.5638435192126486,0.3959792239147804
금리인상/NNG;서두르/VV;않/VX,1,0.17177389300350732,40,21,19,80,0.5700280384290473,0.4023751481340246
경기/NNG;살아나/VV,1,0.17126590711870016,81,42,39,141,0.6807352490639896,0.48102460790578044
경기둔화/NNG;인해/VV,1,0.16753030042351447,44,23,21,59,0.5820643793704133,0.41447382025305785
금리인상/NNG;주장했/VVX,1,0.16569915728055018,46,24,22,61,0.5879043770761117,0.42021055815973896
금리/NNG;인상할/VVX;있/VV,0,0.16568587696065395,128,66,62,180,0.739027534334674,0.5282417635721413
금리/NNG;인상되/VVX,0,0.16568587696065395,128,66,62,134,0.739027534334674,0.5282417635721413
완화적/VAX;통화정책/NNG;지속될/VVX,0,0.1638659617989755,15,8,7,33,0.46650198303272233,0.33469463708184194
경기부양책/NNG;쓰/VV,0,0.1638659617989755,15,8,7,28,0.46650198303272233,0.33469463708184194
채권시장/NNG;강세/NNG;보일/VV,0,0.1638659617989755,15,8,7,25,0.46650198303272233,0.33469463708184194
디플레이션/NNG;우려/NNG;제기되/VVX,0,0.1638659617989755,15,8,7,24,0.46650198303272233,0.33469463708184194
수출/NNG;영향/NNG;받/VV,0,0.1638659617989755,15,8,7,18,0.46650198303272233,0.33469463708184194
완화적/VAX;통화정책/NNG;유지될/VVX,0,0.1638659617989755,15,8,7,15,0.46650198303272233,0.33469463708184194
인플레이션우려/NNG;부각되/VVX,0,0.1638659617989755,15,8,7,7,0.46650198303272233,0.33469463708184194
경기/NNG;침체/NNG;빠질/VV,0,0.1638659617989755,15,8,7,20,0.46650198303272233,0.33469463708184194
물가상승/NNG;주도했/VVX,0,0.1638659617989755,15,8,7,12,0.46650198303272233,0.33469463708184194
경기둔화/NNG;반영해/VVX,0,0.1638659617989755,15,8,7,11,0.46650198303272233,0.33469463708184194
금리인하기대감/NNG;확대되/VVX,0,0.1638659617989755,15,8,7,8,0.46650198303272233,0.33469463708184194
유가상승/NNG;제한됐/VVX,0,0.1638659617989755,15,8,7,17,0.46650198303272233,0.33469463708184194
연방기금금리/NNG;선물시장/NNG;반영된/VVX,0,0.1638659617989755,15,8,7,12,0.46650198303272233,0.33469463708184194
견조한/VAX;성장세/NNG;지속할/VVX,0,0.1638659617989755,15,8,7,14,0.46650198303272233,0.33469463708184194
금리하락/NNG;두드러졌/VV,0,0.1638659617989755,15,8,7,23,0.46650198303272233,0.33469463708184194
경기둔화우려/NNG;완화되/VVX,0,0.1638659617989755,15,8,7,26,0.46650198303272233,0.33469463708184194
기준금리동결/NNG;지속될/VVX,0,0.1638659617989755,15,8,7,29,0.46650198303272233,0.33469463708184194
물가상승률/NNG;끌어올리/VV,0,0.1638659617989755,15,8,7,9,0.46650198303272233,0.33469463708184194
투자심리/NNG;회복됐/VVX,0,0.1638659617989755,15,8,7,14,0.46650198303272233,0.33469463708184194
금리인상/NNG;가능성/NNG;불거지/VV,0,0.1638659617989755,15,8,7,14,0.46650198303272233,0.33469463708184194
물가/NNG;크/VA;오르/VV,0,0.1638659617989755,15,8,7,14,0.46650198303272233,0.33469463708184194
장단기금리차/NNG;확대되/VVX,1,0.15974518924930292,54,28,26,82,0.6099863398888534,0.44135386443203495
기준금리/NNG;유지해/VVX,1,0.15974518924930292,54,28,26,85,0.6099863398888534,0.44135386443203495
금리인상/NNG;단행된/VVX,1,0.1585147881982092,56,29,27,54,0.6151757402368496,0.44623263457589846
성장/NNG;둔화될/VVX,1,0.1562791705426556,60,31,29,66,0.6251491385427786,0.455548678992669
성장/NNG;지속할/VVX,1,0.1562791705426556,60,31,29,58,0.6251491385427786,0.455548678992669
성장세/NNG;유지할/VVX,1,0.1562791705426556,60,31,29,53,0.6251491385427786,0.455548678992669
설비투자/NNG;개선되/VVX,0,0.15623124324163662,17,9,8,20,0.4732645461299301,0.3449036186318949
경제/NNG;미치/VV;긍정적/VAX,0,0.15623124324163662,17,9,8,6,0.4732645461299301,0.3449036186318949
성장세/NNG;기록할/VVX,0,0.15623124324163662,17,9,8,17,0.4732645461299301,0.3449036186318949
성장률전망/NNG;상향했/VVX,0,0.15623124324163662,17,9,8,10,0.4732645461299301,0.3449036186318949
신용위험/NNG;나타내/VV,0,0.15623124324163662,17,9,8,4,0.4732645461299301,0.3449036186318949
안전자산선호심리/NNG;완화되/VVX,0,0.15623124324163662,17,9,8,26,0.4732645461299301,0.3449036186318949
물가/NNG;상승한/VVX,0,0.15623124324163662,17,9,8,29,0.4732645461299301,0.3449036186318949
유동성/NNG;과도하/VVX,0,0.15623124324163662,17,9,8,23,0.4732645461299301,0.3449036186318949
마이너스/NNG;수준이/VVX,0,0.15623124324163662,17,9,8,27,0.4732645461299301,0.3449036186318949
완전고용/NNG;근접했/VVX,0,0.15623124324163662,17,9,8,10,0.4732645461299301,0.3449036186318949
기준금리/NNG;낮춰야/VV,0,0.15623124324163662,17,9,8,22,0.4732645461299301,0.3449036186318949
금리인상/NNG;예상한/VVX,0,0.15623124324163662,17,9,8,26,0.4732645461299301,0.3449036186318949
성장/NNG;주도하/VVX,0,0.15623124324163662,17,9,8,37,0.4732645461299301,0.3449036186318949
변동성/NNG;크/VA;확대됐/VVX,0,0.15623124324163662,17,9,8,14,0.4732645461299301,0.3449036186318949
금리인상/NNG;계속할/VVX,0,0.15623124324163662,17,9,8,17,0.4732645461299301,0.3449036186318949
불확실성/NNG;커지/VV,0,0.1559740311719846,185,95,90,274,0.7572469845226856,0.5521538159972829
기준금리/NNG;동결하/VVX,0,0.15578750612664738,574,295,279,955,0.7618058558759236,0.5556901543531788
경기개선/NNG;따른/VV,1,0.15525656351660677,62,32,30,70,0.6299326382641948,0.4599965770937888
금리/NNG;인상할/VVX;전망/NNG,1,0.15428782389928308,64,33,31,108,0.6345809341934342,0.46431067577074214
금리/NNG;낮/VA;유지하/VVX,1,0.15428782389928308,64,33,31,74,0.6345809341934342,0.46431067577074214
투자심리/NNG;위축됐/VVX,1,0.15336696303919473,66,34,32,86,0.6390946063866968,0.468495210512813
동결/NNG;예상된/VVX,0,0.1504772899295943,19,10,9,15,0.48022444659667524,0.3541202291382239
경기회복/NNG;맞물려/VV,0,0.1504772899295943,19,10,9,26,0.48022444659667524,0.3541202291382239
마이너스/NNG;떨어졌/VV,0,0.1504772899295943,19,10,9,20,0.48022444659667524,0.3541202291382239
자산매입/NNG;연장하/VVX,0,0.1504772899295943,19,10,9,13,0.48022444659667524,0.3541202291382239
신용등급/NNG;강등할/VVX,0,0.1504772899295943,19,10,9,57,0.48022444659667524,0.3541202291382239
고용/NNG;호조/NNG;보이/VV,0,0.1504772899295943,19,10,9,13,0.48022444659667524,0.3541202291382239
장단기금리차/NNG;축소될/VVX,0,0.1504772899295943,19,10,9,20,0.48022444659667524,0.3541202291382239
금리동결/NNG;전망했/VVX,0,0.1504772899295943,19,10,9,15,0.48022444659667524,0.3541202291382239
금리하락/NNG;예상된/VVX,0,0.1504772899295943,19,10,9,26,0.48022444659667524,0.3541202291382239
불확실성/NNG;키울/VV,0,0.1504772899295943,19,10,9,27,0.48022444659667524,0.3541202291382239
소비자물가/NNG;안정세/NNG;보이/VV,0,0.1504772899295943,19,10,9,20,0.48022444659667524,0.3541202291382239
불확실성/NNG;해소/NNG;따른/VV,0,0.1504772899295943,19,10,9,35,0.48022444659667524,0.3541202291382239
수출증가율/NNG;기록하/VVX,0,0.1504772899295943,19,10,9,17,0.48022444659667524,0.3541202291382239
수출/NNG;품목인/VVX,0,0.1504772899295943,19,10,9,30,0.48022444659667524,0.3541202291382239
수출/NNG;크/VA;증가하/VVX,0,0.1504772899295943,19,10,9,9,0.48022444659667524,0.3541202291382239
물가오름세/NNG;확대되/VVX,0,0.1504772899295943,19,10,9,13,0.48022444659667524,0.3541202291382239
경제지표/NNG;혼조세/NNG;나타내/VV,0,0.1504772899295943,19,10,9,18,0.48022444659667524,0.3541202291382239
수출/NNG;높/VA;신장세/NNG;유지하/VVX,0,0.1504772899295943,19,10,9,7,0.48022444659667524,0.3541202291382239
수출증가율/NNG;둔화되/VVX,0,0.1504772899295943,19,10,9,29,0.48022444659667524,0.3541202291382239
기준금리인하/NNG;나설/VV,0,0.1504772899295943,19,10,9,37,0.48022444659667524,0.3541202291382239
수출/NNG;둔화될/VVX,0,0.1504772899295943,19,10,9,29,0.48022444659667524,0.3541202291382239
금리/NNG;인상할/VVX,0,0.14921180398087763,859,440,419,1163,0.7582080694410667,0.5605548234195378
불안/NNG;고조되/VVX,0,0.14603026829455446,21,11,10,27,0.4872960792840164,0.3626139955729591
큰/VA;변동성/NNG;보였/VV,0,0.14603026829455446,21,11,10,16,0.4872960792840164,0.3626139955729591
금리하락/NNG;견인할/VVX,0,0.14603026829455446,21,11,10,57,0.4872960792840164,0.3626139955729591
취업자수/NNG;증가했/VVX,0,0.14603026829455446,21,11,10,40,0.4872960792840164,0.3626139955729591
채권시장/NNG;부담/NNG;되/VV,0,0.14603026829455446,21,11,10,26,0.4872960792840164,0.3626139955729591
기준금리인상/NNG;가능성/NNG;시사하/VVX,0,0.14603026829455446,21,11,10,12,0.4872960792840164,0.3626139955729591
금리/NNG;낮/VA;유지되/VVX,0,0.14603026829455446,21,11,10,34,0.4872960792840164,0.3626139955729591
금융시장변동성/NNG;확대되/VVX,0,0.14603026829455446,21,11,10,35,0.4872960792840164,0.3626139955729591
재정긴축/NNG;따른/VV,0,0.14603026829455446,21,11,10,40,0.4872960792840164,0.3626139955729591
경기둔화/NNG;대응하/VVX,0,0.14603026829455446,21,11,10,23,0.4872960792840164,0.3626139955729591
성장/NNG;제약하/VVX,0,0.14603026829455446,21,11,10,21,0.4872960792840164,0.3626139955729591
성장률/NNG;될/VV,0,0.14603026829455446,21,11,10,38,0.4872960792840164,0.3626139955729591
경기회복세/NNG;둔화되/VVX,0,0.14603026829455446,21,11,10,39,0.4872960792840164,0.3626139955729591
듀레이션/NNG;줄이/VV,0,0.14603026829455446,21,11,10,55,0.4872960792840164,0.3626139955729591
금리상승/NNG;동조화되/VVX,0,0.14603026829455446,21,11,10,18,0.4872960792840164,0.3626139955729591
금리인상/NNG;이어질/VV,0,0.14591659567043047,86,44,42,98,0.6771088215108197,0.5039772032075807
금리/NNG;인상했/VVX,0,0.1453943391621484,268,137,131,258,0.7559627894839087,0.5632689286977427
소비자물가/NNG;상승하/VVX,0,0.14467679637851538,90,46,44,129,0.683251521074305,0.5098376858481135
불확실성/NNG;인해/VV,0,0.14291544294001302,96,49,47,230,0.6916349663042082,0.5179511067595205
경제/NNG;타격/NNG;줄/VV,0,0.14252495497596196,23,12,11,29,0.494419104733522,0.3705552043078284
성장/NNG;기대되/VVX,0,0.14252495497596196,23,12,11,36,0.494419104733522,0.3705552043078284
시장금리/NNG;상승했/VVX,0,0.14252495497596196,23,12,11,41,0.494419104733522,0.3705552043078284
경기/NNG;낙관하/VVX,0,0.14252495497596196,23,12,11,28,0.494419104733522,0.3705552043078284
금융시장/NNG;불안하/VVX,1,0.13971784004795573,25,13,12,33,0.5015496199858009,0.378056443148193
성장/NNG;뒷받침하/VVX,1,0.13971784004795573,25,13,12,23,0.5015496199858009,0.378056443148193
투자심리/NNG;부정적/VAX;영향/NNG;미쳤/VV,1,0.13971784004795573,25,13,12,33,0.5015496199858009,0.378056443148193
경기회복/NNG;이어지/VV,1,0.13971784004795573,25,13,12,32,0.5015496199858009,0.378056443148193
소비/NNG;이어지/VV,1,0.13971784004795573,25,13,12,30,0.5015496199858009,0.378056443148193
가계부채증가/NNG;따른/VV,1,0.13971784004795573,25,13,12,24,0.5015496199858009,0.378056443148193
금리상승/NNG;이어질/VV,1,0.13971784004795573,25,13,12,48,0.5015496199858009,0.378056443148193
금리하락/NNG;작용했/VVX,1,0.13971784004795573,25,13,12,31,0.5015496199858009,0.378056443148193
불확실성/NNG;상존하/VVX,0,0.13966861689243326,108,55,53,176,0.7056526797563675,0.5319579350970628
불확실성/NNG;확대되/VVX,0,0.13766519816606437,116,59,57,171,0.7131760746614378,0.5398279770068078
침체/NNG;벗어나/VV;못하/VX,1,0.1374403699610065,27,14,13,30,0.5086548152331007,0.3851949770077916
금리인상/NNG;나선/VV,1,0.1374403699610065,27,14,13,32,0.5086548152331007,0.3851949770077916
경기후퇴/NNG;막/VV,1,0.1374403699610065,27,14,13,13,0.5086548152331007,0.3851949770077916
인플레이션우려/NNG;커지/VV,1,0.1374403699610065,27,14,13,41,0.5086548152331007,0.3851949770077916
신용경색/NNG;우려/NNG;완화되/VVX,1,0.1374403699610065,27,14,13,18,0.5086548152331007,0.3851949770077916
기준금리인하/NNG;예상하/VVX,1,0.1374403699610065,27,14,13,40,0.5086548152331007,0.3851949770077916
금리인상/NNG;점치/VV,1,0.1374403699610065,27,14,13,30,0.5086548152331007,0.3851949770077916
재정정책/NNG;통한/VV,1,0.1374403699610065,27,14,13,39,0.5086548152331007,0.3851949770077916
기준금리/NNG;유지될/VVX,1,0.13557222961961868,29,15,14,46,0.5157096191614923,0.39202551554784065
경기선행지수/NNG;하락했/VVX,1,0.13557222961961868,29,15,14,31,0.5157096191614923,0.39202551554784065
금융안정/NNG;위해/VV,1,0.13557222961961868,29,15,14,31,0.5157096191614923,0.39202551554784065
금리/NNG;유지하/VVX,0,0.13441317267410158,130,66,64,194,0.723367296224252,0.5511785138394191
경기/NNG;개선된/VVX,1,0.13402530371180288,31,16,15,65,0.5226945224024306,0.39858785451153234
유가상승/NNG;부추겼/VV,1,0.13402530371180288,31,16,15,31,0.5226945224024306,0.39858785451153234
통화완화정책/NNG;따른/VV,1,0.13402530371180288,31,16,15,25,0.5226945224024306,0.39858785451153234
금리인상/NNG;더불/VV,1,0.13402530371180288,31,16,15,43,0.5226945224024306,0.39858785451153234
안전자산선호심리/NNG;강화되/VVX,1,0.13402530371180288,31,16,15,81,0.5226945224024306,0.39858785451153234
유가하락/NNG;인해/VV,1,0.13402530371180288,31,16,15,33,0.5226945224024306,0.39858785451153234
유가하락/NNG;힘입/VV,1,0.13402530371180288,31,16,15,29,0.5226945224024306,0.39858785451153234
성장/NNG;이/VV;가/VX,1,0.13402530371180288,31,16,15,44,0.5226945224024306,0.39858785451153234
금리인상/NNG;나설/VV,0,0.1336336203547348,429,218,211,540,0.7495406426532303,0.5720280626687924
금리인상/NNG;늦추/VV,1,0.13273364398067677,33,17,16,51,0.5295941230205224,0.4049116359835495
금리동결/NNG;따른/VV,1,0.13273364398067677,33,17,16,55,0.5295941230205224,0.4049116359835495
성장/NNG;하/VV,0,0.1322714010338919,140,71,69,111,0.7286995691508866,0.5576655776638947
기준금리/NNG;인하하/VVX;않/VX,1,0.13164697028556893,35,18,17,54,0.5363961281797696,0.41101941657072516
경기둔화우려/NNG;따른/VV,1,0.13164697028556893,35,18,17,62,0.5363961281797696,0.41101941657072516
불확실성/NNG;확대된/VVX,1,0.13164697028556893,35,18,17,37,0.5363961281797696,0.41101941657072516
추경/NNG;편성하/VVX,1,0.13164697028556893,35,18,17,53,0.5363961281797696,0.41101941657072516
금리/NNG;올렸/VV,0,0.13134254843392545,205,104,101,215,0.746018530196896,0.5719987674916108
불확실성/NNG;고조되/VVX,1,0.13072633243930665,37,19,18,82,0.5430906519682173,0.416928703593997
경제성장/NNG;따른/VV,1,0.13072633243930665,37,19,18,43,0.5430906519682173,0.416928703593997
인플레이션/NNG;따른/VV,1,0.13072633243930665,37,19,18,50,0.5430906519682173,0.416928703593997
기준금리인상/NNG;단행하/VVX,1,0.12926706782459818,41,21,20,54,0.5561268495179567,0.42820447331948247
물가안정/NNG;유지될/VVX,1,0.12926706782459818,41,21,20,33,0.5561268495179567,0.42820447331948247
금리인상/NNG;계속될/VVX,1,0.12926706782459818,41,21,20,36,0.5561268495179567,0.42820447331948247
경제/NNG;위협하/VVX,1,0.12868458693045493,43,22,21,55,0.562456868748643,0.4335912298558545
금리인상/NNG;결정하/VVX,1,0.12817785727203557,45,23,22,63,0.5686556069834089,0.4388212173369471
수출/NNG;둔화되/VVX,1,0.12817785727203557,45,23,22,63,0.5686556069834089,0.4388212173369471
정책금리/NNG;동결될/VVX,1,0.12817785727203557,45,23,22,72,0.5686556069834089,0.4388212173369471
금리/NNG;상승세/NNG;보이/VV,1,0.12773393474501682,47,24,23,65,0.5747197781960247,0.44390088095536206
유가급등/NNG;따른/VV,1,0.12773393474501682,47,24,23,58,0.5747197781960247,0.44390088095536206
자산/NNG;매각하/VVX,1,0.12773393474501682,47,24,23,49,0.5747197781960247,0.44390088095536206
기준금리인하/NNG;단행될/VVX,1,0.1273421653308604,49,25,24,66,0.5806468407106995,0.4488357717704926
불확실성/NNG;높이/VV,1,0.12590308727263144,59,30,29,86,0.6081769159669861,0.4714919238211233
정책금리/NNG;올리/VV,1,0.12547469120569366,63,32,31,89,0.6181991719495358,0.47967866183571173
불안요인/NNG;작용하/VVX,1,0.12547469120569366,63,32,31,80,0.6181991719495358,0.47967866183571173
불확실성/NNG;커졌/VV,1,0.12547469120569366,63,32,31,101,0.6181991719495358,0.47967866183571173
성장세/NNG;보일/VV,1,0.12473318695234359,71,36,35,103,0.6365721740476524,0.4946786990048892
성장/NNG;이끌/VV,0,0.12405619250519462,79,40,39,95,0.6527912884916608,0.507979890065427
금리/NNG;인상한/VVX,0,0.12388911812625514,81,41,40,99,0.6565231164617504,0.5110570842222761
정책금리/NNG;인상할/VVX,0,0.12286324575599417,93,47,46,138,0.6763689982314129,0.5276025850894296
금리인상/NNG;예상되/VVX,0,0.12058649475914773,117,59,58,158,0.7046353524149374,0.5521953229836203
금리하락/NNG;따른/VV,0,0.1201808531104871,121,61,60,198,0.7080983254563564,0.5553656084491625
금리/NNG;올릴/VV,0,0.11656112064214508,947,477,470,1209,0.7398104854915666,0.584508842312335
기준금리/NNG;인상할/VVX,0,0.11323227409124903,885,445,440,1280,0.7378852887858601,0.586929934221977
성장/NNG;할/VV,0,0.10341910743028149,110,55,55,89,0.6877235707105558,0.5579900939226368
금리인상/NNG;단행되/VVX,0,0.10285743675721193,102,51,51,140,0.6779282613662796,0.5506667656299462
금리인상/NNG;가능성/NNG;시사했/VVX,0,0.09934383554858073,76,38,38,89,0.6339146947045259,0.5185800918508692
기준금리/NNG;동결될/VVX,0,0.09815511706904845,445,222,223,708,0.7290523313346491,0.5978403350993733
경제/NNG;부정적/VAX;영향/NNG;미칠/VV,1,0.0965584767432035,64,32,32,68,0.6062455969464959,0.4987393165411075
금리인하/NNG;예상하/VVX,1,0.09542359728148586,60,30,30,70,0.5958707285604281,0.4913272315974129
경기/NNG;개선될/VVX,1,0.09542359728148586,60,30,30,101,0.5958707285604281,0.4913272315974129
대외불확실성/NNG;따른/VV,1,0.09481357508477917,58,29,29,135,0.5904600853212493,0.48746497183930515
경기선행지수/NNG;하락하/VVX,1,0.09481357508477917,58,29,29,61,0.5904600853212493,0.48746497183930515
물가/NNG;안정될/VVX,1,0.09417396079418205,56,28,28,66,0.5848989782546334,0.48349685960738176
기준금리/NNG;동결했/VVX,0,0.09229559280640198,376,187,189,707,0.7255696283552419,0.6020545490094203
채권시장/NNG;국채가격/NNG;올랐/VV,1,0.09130091386248895,48,24,24,93,0.5611324144100456,0.4665437909807466
성장세/NNG;보이/VV,0,0.09002374026369386,139,69,70,195,0.703701944413053,0.5865878407699697
기준금리/NNG;인상하/VVX,0,0.08997512379831352,612,304,308,825,0.7241830863925433,0.6037195037789889
금리/NNG;올려/VV,0,0.08958042827552082,135,67,68,168,0.7009978828680364,0.584855733469884
불확실성/NNG;커질/VV,1,0.0887888123833167,42,21,21,54,0.5416984393090268,0.4526702301578617
시장금리/NNG;상승하/VVX,0,0.08855167443601086,127,63,64,192,0.6947937030347515,0.5808815628279392
침체/NNG;빠질/VV,1,0.08787810328687984,40,20,20,53,0.5349148874911326,0.44782194254183416
불확실성/NNG;이어질/VV,1,0.08787810328687984,40,20,20,46,0.5349148874911326,0.44782194254183416
성장/NNG;있/VV,1,0.08787810328687984,40,20,20,53,0.5349148874911326,0.44782194254183416
금리/NNG;동결된/VVX,1,0.08594059992537573,36,18,18,57,0.5208947517295182,0.4377885641445065
불확실성/NNG;제거되/VVX,1,0.08594059992537573,36,18,18,48,0.5208947517295182,0.4377885641445065
성장/NNG;이/VV,1,0.08594059992537573,36,18,18,33,0.5208947517295182,0.4377885641445065
물가/NNG;치솟/VV,1,0.08491176396295286,34,17,17,26,0.5136610581812426,0.4326037085095566
유동성/NNG;회수하/VVX,1,0.08491176396295286,34,17,17,38,0.5136610581812426,0.4326037085095566
금리인하/NNG;주장하/VVX,1,0.08491176396295286,34,17,17,54,0.5136610581812426,0.4326037085095566
경기후퇴/NNG;따른/VV,1,0.08491176396295286,34,17,17,27,0.5136610581812426,0.4326037085095566
기준금리인상/NNG;단행될/VVX,1,0.08491176396295286,34,17,17,65,0.5136610581812426,0.4326037085095566
실업률/NNG;치솟/VV,1,0.08384150767216236,32,16,16,36,0.5062807841889198,0.4273072247242158
경기회복/NNG;발목/NNG;잡/VV,1,0.08384150767216236,32,16,16,26,0.5062807841889198,0.4273072247242158
유동성확보/NNG;위한/VV,1,0.08384150767216236,32,16,16,20,0.5062807841889198,0.4273072247242158
산업생산/NNG;증가했/VVX,1,0.08384150767216236,32,16,16,71,0.5062807841889198,0.4273072247242158
설비투자/NNG;증가하/VVX,0,0.08272880912564906,30,15,15,45,0.49875626252374583,0.42189973714401435
실업률/NNG;떨어지/VV,0,0.08272880912564906,30,15,15,49,0.49875626252374583,0.42189973714401435
금융시장/NNG;변동성/NNG;확대될/VVX,0,0.08272880912564906,30,15,15,56,0.49875626252374583,0.42189973714401435
금리변동성/NNG;확대되/VVX,0,0.08272880912564906,30,15,15,58,0.49875626252374583,0.42189973714401435
마이너스/NNG;유지하/VVX,0,0.08272880912564906,30,15,15,25,0.49875626252374583,0.42189973714401435
금리/NNG;크/VA;상승했/VVX,0,0.08157265034324501,28,14,14,23,0.4910902076093838,0.4163820940541736
수출/NNG;타격/NNG;받/VV,0,0.08157265034324501,28,14,14,47,0.4910902076093838,0.4163820940541736
금리/NNG;인상할/VVX;예상했/VVX,0,0.08157265034324501,28,14,14,30,0.4910902076093838,0.4163820940541736
유동성/NNG;늘어나/VV,0,0.08157265034324501,28,14,14,31,0.4910902076093838,0.4163820940541736
경제/NNG;성장했/VVX,0,0.08157265034324501,28,14,14,31,0.4910902076093838,0.4163820940541736
글로벌/NNG;경기둔화/NNG;따른/VV,0,0.08157265034324501,28,14,14,47,0.4910902076093838,0.4163820940541736
콜금리/NNG;동결되/VVX,0,0.08157265034324501,28,14,14,23,0.4910902076093838,0.4163820940541736
변동성/NNG;높이/VV,0,0.08037202000750887,26,13,13,39,0.4832857290296081,0.41075537928819467
변동성/NNG;확대하/VVX,0,0.08037202000750887,26,13,13,37,0.4832857290296081,0.41075537928819467
리스크/NNG;부각될/VVX,0,0.08037202000750887,26,13,13,48,0.4832857290296081,0.41075537928819467
잠재성장률/NNG;높이/VV,0,0.08037202000750887,26,13,13,29,0.4832857290296081,0.41075537928819467
성장/NNG;유지할/VVX,0,0.07912591635589239,24,12,12,42,0.47534634393952274,0.40502092359971137
수입/NNG;줄어들/VV,0,0.07912591635589239,24,12,12,24,0.47534634393952274,0.40502092359971137
인플레이션압력/NNG;높일/VV,0,0.07912591635589239,24,12,12,20,0.47534634393952274,0.40502092359971137
인플레이션우려/NNG;따른/VV,0,0.07912591635589239,24,12,12,38,0.47534634393952274,0.40502092359971137
성장/NNG;견인할/VVX,0,0.07912591635589239,24,12,12,40,0.47534634393952274,0.40502092359971137
소비심리/NNG;살아나/VV,0,0.07912591635589239,24,12,12,17,0.47534634393952274,0.40502092359971137
유동성/NNG;억제하/VVX,0,0.07912591635589239,24,12,12,24,0.47534634393952274,0.40502092359971137
불안/NNG;심화되/VVX,0,0.07912591635589239,24,12,12,18,0.47534634393952274,0.40502092359971137
리스크/NNG;작용하/VVX,0,0.07912591635589239,24,12,12,29,0.47534634393952274,0.40502092359971137
적자/NNG;기록할/VVX,0,0.07912591635589239,24,12,12,39,0.47534634393952274,0.40502092359971137
완화적/VAX;통화정책/NNG;유지할/VVX,0,0.07912591635589239,24,12,12,34,0.47534634393952274,0.40502092359971137
마이너스/NNG;보이/VV,0,0.07912591635589239,24,12,12,45,0.47534634393952274,0.40502092359971137
물가/NNG;올라가/VV,0,0.07912591635589239,24,12,12,34,0.47534634393952274,0.40502092359971137
금리인하/NNG;기대하/VVX,0,0.07903337462823101,87,43,44,101,0.6427918917752267,0.5477955299578077
실물경제/NNG;영향/NNG;주/VV,0,0.07783335024277416,22,11,11,21,0.4672759881775395,0.39918031567904705
경기/NNG;반등하/VVX,0,0.07783335024277416,22,11,11,44,0.4672759881775395,0.39918031567904705
시장금리/NNG;상승압력/NNG;받/VV,0,0.07783335024277416,22,11,11,21,0.4672759881775395,0.39918031567904705
자산/NNG;팔/VV,0,0.07783335024277416,22,11,11,29,0.4672759881775395,0.39918031567904705
투자심리/NNG;줬/VV,0,0.07783335024277416,22,11,11,36,0.4672759881775395,0.39918031567904705
경기/NNG;선행하/VVX,0,0.07783335024277416,22,11,11,19,0.4672759881775395,0.39918031567904705
기준금리인상/NNG;나서/VV,0,0.07783335024277416,22,11,11,58,0.4672759881775395,0.39918031567904705
경기회복/NNG;둔화되/VVX,0,0.07783335024277416,22,11,11,53,0.4672759881775395,0.39918031567904705
성장률/NNG;하향조정하/VVX,0,0.07783335024277416,22,11,11,45,0.4672759881775395,0.39918031567904705
수출/NNG;감소할/VVX,0,0.07783335024277416,22,11,11,28,0.4672759881775395,0.39918031567904705
추경/NNG;편성할/VVX,0,0.07783335024277416,22,11,11,42,0.4672759881775395,0.39918031567904705
불확실성/NNG;걷히/VV,0,0.07783335024277416,22,11,11,25,0.4672759881775395,0.39918031567904705
출구전략/NNG;나서/VV,0,0.07783335024277416,22,11,11,26,0.4672759881775395,0.39918031567904705
금리/NNG;상승세/NNG;이어졌/VV,0,0.07783335024277416,22,11,11,34,0.4672759881775395,0.39918031567904705
경기/NNG;호조/NNG;보이/VV,0,0.07783335024277416,22,11,11,27,0.4672759881775395,0.39918031567904705
금리/NNG;상승세/NNG;보임/VV,0,0.07783335024277416,22,11,11,43,0.4672759881775395,0.39918031567904705
금리인하/NNG;나서/VV;않/VX,0,0.07783335024277416,22,11,11,41,0.4672759881775395,0.39918031567904705
금리/NNG;하락세/NNG;출발했/VVX,0,0.07783335024277416,22,11,11,51,0.4672759881775395,0.39918031567904705
소비/NNG;증가하/VVX,0,0.07666656329988197,81,40,41,65,0.6311702502680543,0.5404562291993394
기준금리/NNG;역전된/VVX,0,0.07649334836209509,20,10,10,32,0.45907902586817245,0.3932354126976641
경기둔화/NNG;이어지/VV,0,0.07649334836209509,20,10,10,21,0.45907902586817245,0.3932354126976641
경기부양/NNG;하/VV,0,0.07649334836209509,20,10,10,29,0.45907902586817245,0.3932354126976641
글로벌/NNG;경기회복/NNG;의심/NNG;걷히/VV,0,0.07649334836209509,20,10,10,24,0.45907902586817245,0.3932354126976641
경기둔화/NNG;우려/NNG;커지/VV,0,0.07649334836209509,20,10,10,34,0.45907902586817245,0.3932354126976641
금리/NNG;인상하/VVX;어려울/VA,0,0.07649334836209509,20,10,10,45,0.45907902586817245,0.3932354126976641
경기/NNG;후퇴하/VVX,0,0.07649334836209509,20,10,10,20,0.45907902586817245,0.3932354126976641
수입/NNG;늘리/VV,0,0.07649334836209509,20,10,10,12,0.45907902586817245,0.3932354126976641
금리인상/NNG;기대하/VVX,0,0.07649334836209509,20,10,10,31,0.45907902586817245,0.3932354126976641
경제성장세/NNG;둔화되/VVX,0,0.07649334836209509,20,10,10,44,0.45907902586817245,0.3932354126976641
내수회복/NNG;따른/VV,0,0.07649334836209509,20,10,10,29,0.45907902586817245,0.3932354126976641
신용경색/NNG;나타나/VV,0,0.07649334836209509,20,10,10,8,0.45907902586817245,0.3932354126976641
신용경색/NNG;인해/VV,0,0.07649334836209509,20,10,10,23,0.45907902586817245,0.3932354126976641
금리인상/NNG;지연시/VVX,0,0.07649334836209509,20,10,10,30,0.45907902586817245,0.3932354126976641
인플레이션/NNG;억제되/VVX,0,0.07649334836209509,20,10,10,28,0.45907902586817245,0.3932354126976641
투자심리/NNG;개선됐/VVX,0,0.07649334836209509,20,10,10,41,0.45907902586817245,0.3932354126976641
경제지표/NNG;호조/NNG;보였/VV,0,0.07649334836209509,20,10,10,54,0.45907902586817245,0.3932354126976641
경제성장률/NNG;하향조정할/VVX,0,0.07510495661864924,18,9,9,21,0.4507602573007514,0.3871883502559728
환율급락/NNG;따른/VV,0,0.07510495661864924,18,9,9,16,0.4507602573007514,0.3871883502559728
물가/NNG;올라갈/VV,0,0.07510495661864924,18,9,9,17,0.4507602573007514,0.3871883502559728
금리하락/NNG;지지하/VVX,0,0.07510495661864924,18,9,9,50,0.4507602573007514,0.3871883502559728
경기회복/NNG;위해서/VV,0,0.07510495661864924,18,9,9,28,0.4507602573007514,0.3871883502559728
통화긴축/NNG;단행할/VVX,0,0.07510495661864924,18,9,9,16,0.4507602573007514,0.3871883502559728
경기/NNG;둔화할/VVX,0,0.07510495661864924,18,9,9,18,0.4507602573007514,0.3871883502559728
금리인하기대/NNG;소멸되/VVX,0,0.07510495661864924,18,9,9,32,0.4507602573007514,0.3871883502559728
통화긴축/NNG;중단할/VVX,0,0.07510495661864924,18,9,9,18,0.4507602573007514,0.3871883502559728
물가상승압력/NNG;완화시/VVX,0,0.07510495661864924,18,9,9,17,0.4507602573007514,0.3871883502559728
소비자물가상승률/NNG;둔화되/VVX,0,0.07510495661864924,18,9,9,13,0.4507602573007514,0.3871883502559728
금리인하/NNG;대응할/VVX,0,0.07510495661864924,18,9,9,27,0.4507602573007514,0.3871883502559728
경기/NNG;두/VV,0,0.07510495661864924,18,9,9,14,0.4507602573007514,0.3871883502559728
더블딥/NNG;빠지/VV,0,0.07510495661864924,18,9,9,22,0.4507602573007514,0.3871883502559728
자산/NNG;매각할/VVX,0,0.07510495661864924,18,9,9,11,0.4507602573007514,0.3871883502559728
경기/NNG;수출/NNG;호조/NNG;보이/VV,0,0.07510495661864924,18,9,9,12,0.4507602573007514,0.3871883502559728
불확실성/NNG;작용하/VVX,0,0.07510495661864924,18,9,9,39,0.4507602573007514,0.3871883502559728
마이너스/NNG;하락하/VVX,0,0.07510495661864924,18,9,9,13,0.4507602573007514,0.3871883502559728
수출/NNG;통한/VV,0,0.07510495661864924,18,9,9,24,0.4507602573007514,0.3871883502559728
하방위험/NNG;커지/VV,0,0.07510495661864924,18,9,9,36,0.4507602573007514,0.3871883502559728
글로벌/NNG;신용경색/NNG;따른/VV,0,0.07510495661864924,18,9,9,13,0.4507602573007514,0.3871883502559728
마이너스/NNG;축소되/VVX,0,0.07510495661864924,18,9,9,25,0.4507602573007514,0.3871883502559728
금리/NNG;고점/NNG;확인하/VVX,0,0.07366724363325505,16,8,8,10,0.44232492486674474,0.38104155160296416
경제/NNG;부정적/VAX;영향/NNG;줄/VV,0,0.07366724363325505,16,8,8,31,0.44232492486674474,0.38104155160296416
경기회복/NNG;이어질/VV,0,0.07366724363325505,16,8,8,14,0.44232492486674474,0.38104155160296416
실업률/NNG;높/VA;유지하/VVX,0,0.07366724363325505,16,8,8,20,0.44232492486674474,0.38104155160296416
인플레이션압력/NNG;줄어들/VV,0,0.07366724363325505,16,8,8,16,0.44232492486674474,0.38104155160296416
공공요금/NNG;인상되/VVX,0,0.07366724363325505,16,8,8,5,0.44232492486674474,0.38104155160296416
출구전략/NNG;있/VV,0,0.07366724363325505,16,8,8,12,0.44232492486674474,0.38104155160296416
흑자/NNG;이/VV,0,0.07366724363325505,16,8,8,19,0.44232492486674474,0.38104155160296416
지준율/NNG;인상할/VVX,0,0.07366724363325505,16,8,8,24,0.44232492486674474,0.38104155160296416
인플레이션/NNG;유발하/VVX,0,0.07366724363325505,16,8,8,22,0.44232492486674474,0.38104155160296416
불안/NNG;남/VV,0,0.07366724363325505,16,8,8,24,0.44232492486674474,0.38104155160296416
변동성확대/NNG;예상되/VVX,0,0.07366724363325505,16,8,8,13,0.44232492486674474,0.38104155160296416
경기회복세/NNG;뒷받침하/VVX,0,0.07366724363325505,16,8,8,13,0.44232492486674474,0.38104155160296416
금리역전/NNG;해소되/VVX,0,0.07366724363325505,16,8,8,12,0.44232492486674474,0.38104155160296416
기준금리인상/NNG;시작하/VVX,0,0.07366724363325505,16,8,8,15,0.44232492486674474,0.38104155160296416
물가상승압력/NNG;확대되/VVX,0,0.07366724363325505,16,8,8,17,0.44232492486674474,0.38104155160296416
경제/NNG;긍정적/VAX;작용할/VVX,0,0.07366724363325505,16,8,8,20,0.44232492486674474,0.38104155160296416
경제회복/NNG;따른/VV,0,0.07366724363325505,16,8,8,26,0.44232492486674474,0.38104155160296416
경기진작/NNG;위해/VV,0,0.07366724363325505,16,8,8,23,0.44232492486674474,0.38104155160296416
금리상승/NNG;견인하/VVX,0,0.07366724363325505,16,8,8,26,0.44232492486674474,0.38104155160296416
금융위기/NNG;터지/VV,0,0.07366724363325505,16,8,8,13,0.44232492486674474,0.38104155160296416
물가상승/NNG;이어지/VV,0,0.07366724363325505,16,8,8,29,0.44232492486674474,0.38104155160296416
가계부채/NNG;문제/NNG;해결하/VVX,0,0.07366724363325505,16,8,8,13,0.44232492486674474,0.38104155160296416
유동성확보/NNG;위해/VV,0,0.07366724363325505,16,8,8,16,0.44232492486674474,0.38104155160296416
금리하락/NNG;되돌리/VV,0,0.07366724363325505,16,8,8,22,0.44232492486674474,0.38104155160296416
경제상황/NNG;악화될/VVX,0,0.07366724363325505,16,8,8,16,0.44232492486674474,0.38104155160296416
수출/NNG;부정적/VAX;영향/NNG;미칠/VV,0,0.07366724363325505,16,8,8,25,0.44232492486674474,0.38104155160296416
경기회복/NNG;걸림돌/NNG;될/VV,0,0.07366724363325505,16,8,8,24,0.44232492486674474,0.38104155160296416
추경/NNG;편성되/VVX,0,0.07366724363325505,16,8,8,18,0.44232492486674474,0.38104155160296416
양적완화/NNG;확대할/VVX,0,0.07366724363325505,16,8,8,25,0.44232492486674474,0.38104155160296416
양적완화/NNG;끝나/VV,0,0.07366724363325505,16,8,8,13,0.44232492486674474,0.38104155160296416
마이너스/NNG;떨어지/VV,0,0.07366724363325505,16,8,8,18,0.44232492486674474,0.38104155160296416
수출부진/NNG;지속되/VVX,0,0.06718039955958566,63,31,32,51,0.5888065553609501,0.5138772717036585
리스크/NNG;완화되/VVX,0,0.06584805261991322,61,30,31,95,0.5833510185265458,0.5104788646577466
기준금리인상/NNG;나설/VV,0,0.06444701639280148,59,29,30,100,0.5777370092549932,0.506989144410352
투자심리/NNG;위축된/VVX,0,0.06444701639280148,59,29,30,96,0.5777370092549932,0.506989144410352
실업률/NNG;하락하/VVX,0,0.06175354223188689,96,47,49,155,0.6465197221836724,0.5704220958497344
금리/NNG;올라갈/VV,1,0.06141951924949063,55,27,28,83,0.5660242280994757,0.4997358096363506
수출/NNG;미치/VV,1,0.06141951924949063,55,27,28,87,0.5660242280994757,0.4997358096363506
금리인상/NNG;가능성/NNG;제기되/VVX,1,0.05805302255367062,51,25,26,76,0.5536493081104238,0.4921203163137905
신용스프레드/NNG;확대되/VVX,0,0.056296028782996554,86,42,44,128,0.6283721112427166,0.5605091638655366
물가/NNG;미치/VV,0,0.05597143336067201,123,60,63,131,0.672194182777402,0.5999886825333641
금리/NNG;인상하/VVX,0,0.05346294112478267,739,360,379,869,0.7018040713834127,0.629574265903631
기준금리/NNG;낮췄/VV,1,0.052236810317054294,45,22,23,66,0.5338011154750768,0.4800398223250928
양적완화/NNG;나설/VV,1,0.052236810317054294,45,22,23,75,0.5338011154750768,0.4800398223250928
금리상승/NNG;이끌/VV,1,0.052236810317054294,45,22,23,88,0.5338011154750768,0.4800398223250928
성장률/NNG;끌어올리/VV,1,0.052236810317054294,45,22,23,57,0.5338011154750768,0.4800398223250928
금리인상/NNG;시사하/VVX,0,0.051152078153201774,148,72,76,184,0.684812078551131,0.6171813251795107
소비/NNG;줄이/VV,1,0.050054128993787916,43,21,22,49,0.5268305791641049,0.4758469654834567
인플레이션압력/NNG;커지/VV,1,0.050054128993787916,43,21,22,65,0.5268305791641049,0.4758469654834567
마이너스/NNG;기록할/VVX,1,0.050054128993787916,43,21,22,60,0.5268305791641049,0.4758469654834567
정책금리/NNG;인상되/VVX,1,0.050054128993787916,43,21,22,49,0.5268305791641049,0.4758469654834567
자산/NNG;투자하/VVX,1,0.047727959792702945,41,20,21,55,0.5196769613266576,0.47157706724600884
금리인상/NNG;지속되/VVX,1,0.047727959792702945,41,20,21,47,0.5196769613266576,0.47157706724600884
금리인하/NNG;필요하/VVX,1,0.047727959792702945,41,20,21,60,0.5196769613266576,0.47157706724600884
성장/NNG;보이/VV,1,0.047727959792702945,41,20,21,75,0.5196769613266576,0.47157706724600884
성장세/NNG;이어지/VV,1,0.047727959792702945,41,20,21,73,0.5196769613266576,0.47157706724600884
금리인상/NNG;단행할/VVX,0,0.0460416833665096,439,213,226,597,0.6971299511691742,0.6347447081036364
변동성/NNG;커질/VV,0,0.04541107020731627,200,97,103,264,0.6940329485233557,0.6327230590887324
경제/NNG;악영향/NNG;미칠/VV,1,0.045241752132013424,39,19,20,53,0.5123358725745814,0.467235175510915
소비/NNG;미치/VV,1,0.045241752132013424,39,19,20,38,0.5123358725745814,0.467235175510915
물가/NNG;안정된/VVX,0,0.04294089065817719,68,33,35,103,0.5871476144860875,0.5379328097128162
금리인하기대감/NNG;약화되/VVX,1,0.042575615775204634,37,18,19,63,0.5048020079092631,0.46282762741173866
물가/NNG;안정세/NNG;보이/VV,1,0.042575615775204634,37,18,19,58,0.5048020079092631,0.46282762741173866
금리인하기대/NNG;약화되/VVX,0,0.03970537044732669,35,17,18,90,0.49706879275642907,0.45836236397534663
성장세/NNG;둔화되/VVX,0,0.03939266129992802,93,45,48,114,0.6293045334305191,0.580664161687222
경기/NNG;개선되/VVX,0,0.0392642225698101,151,73,78,229,0.6787104902417291,0.6264123634091032
경제/NNG;둔화되/VVX,0,0.038375336653630576,149,72,77,145,0.6772866857193963,0.6262108596005973
정책금리/NNG;올릴/VV,0,0.036601248679454246,33,16,17,53,0.4891278873894329,0.4538493481438388
잠재성장률/NNG;상회하/VVX,0,0.036601248679454246,33,16,17,34,0.4891278873894329,0.4538493481438388
금리인상/NNG;반대하/VVX,0,0.036601248679454246,33,16,17,43,0.4891278873894329,0.4538493481438388
변동성/NNG;커졌/VV,0,0.036601248679454246,33,16,17,53,0.4891278873894329,0.4538493481438388
경제/NNG;미치/VV;부정적/VAX,0,0.03496386958982822,60,29,31,84,0.5648265827329436,0.5258074157123125
경제/NNG;회복되/VVX,0,0.03351592203424314,139,67,72,217,0.6692340668825947,0.6248089191935567
경제/NNG;둔화하/VVX,0,0.03322609443433433,31,15,16,48,0.48096848244309093,0.4493011294518892
불안심리/NNG;해소되/VVX,0,0.03322609443433433,31,15,16,22,0.48096848244309093,0.4493011294518892
금융위기/NNG;거치/VV,0,0.03322609443433433,31,15,16,64,0.48096848244309093,0.4493011294518892
금리인상/NNG;나섰/VV,0,0.03322609443433433,31,15,16,44,0.48096848244309093,0.4493011294518892
물가상승압력/NNG;완화되/VVX,0,0.03322609443433433,31,15,16,26,0.48096848244309093,0.4493011294518892
성장세/NNG;나타내/VV,0,0.030328845343747357,56,27,29,68,0.5526455009447574,0.5192583531739162
리스크/NNG;있/VV,0,0.030328845343747357,56,27,29,52,0.5526455009447574,0.5192583531739162
완화적/VAX;통화정책/NNG;유지하/VVX,0,0.030328845343747357,56,27,29,61,0.5526455009447574,0.5192583531739162
불확실성/NNG;해소될/VVX,0,0.030328845343747357,56,27,29,83,0.5526455009447574,0.5192583531739162
소비/NNG;제약하/VVX,0,0.029532812428344934,29,14,15,46,0.4725762791335815,0.4447336207091089
경기하강/NNG;막/VV,0,0.029532812428344934,29,14,15,22,0.4725762791335815,0.4447336207091089
경기/NNG;호전될/VVX,0,0.029532812428344934,29,14,15,46,0.4725762791335815,0.4447336207091089
금리/NNG;하락세/NNG;보임/VV,0,0.029532812428344934,29,14,15,42,0.4725762791335815,0.4447336207091089
금리인하/NNG;결정하/VVX,0,0.029532812428344934,29,14,15,33,0.4725762791335815,0.4447336207091089
금리/NNG;오른/VV,0,0.026181536605264233,200,96,104,298,0.6817475211468049,0.6458938496872801
가계대출/NNG;크/VA;상회하/VVX,0,0.025460676202983423,27,13,14,16,0.46393198117943485,0.44016718752085776
경제성장률/NNG;낮췄/VV,0,0.025460676202983423,27,13,14,36,0.46393198117943485,0.44016718752085776
금리상승/NNG;이어지/VV,0,0.025460676202983423,27,13,14,40,0.46393198117943485,0.44016718752085776
큰/VA;금리/NNG;상승세/NNG;보였/VV,0,0.025460676202983423,27,13,14,26,0.46393198117943485,0.44016718752085776
디플레이션/NNG;우려/NNG;커지/VV,0,0.025460676202983423,27,13,14,28,0.46393198117943485,0.44016718752085776
경제지표/NNG;호조/NNG;나타내/VV,0,0.025460676202983423,27,13,14,45,0.46393198117943485,0.44016718752085776
침체/NNG;겪/VV,0,0.025165934404327128,52,25,27,60,0.5397427564876648,0.5123963544150987
시장금리/NNG;상승할/VVX,0,0.0214958785117787,73,35,38,124,0.5854936120507191,0.5599211954188381
시장금리/NNG;급등하/VVX,0,0.0214958785117787,73,35,38,60,0.5854936120507191,0.5599211954188381
기준금리/NNG;동결된/VVX,0,0.021265678121962228,96,46,50,152,0.6227014347608437,0.5957779204558191
물가안정/NNG;하/VV,0,0.020929848611183743,25,12,13,51,0.4550090079271394,0.4356282100607213
물가/NNG;올라/VV,0,0.020929848611183743,25,12,13,50,0.4550090079271394,0.4356282100607213
근원인플레이션율/NNG;상승하/VVX,0,0.020929848611183743,25,12,13,17,0.4550090079271394,0.4356282100607213
소비심리/NNG;회복되/VVX,0,0.020929848611183743,25,12,13,28,0.4550090079271394,0.4356282100607213
불확실성/NNG;상존해/VVX,0,0.020929848611183743,25,12,13,48,0.4550090079271394,0.4356282100607213
금리인상/NNG;점쳤/VV,0,0.020929848611183743,25,12,13,22,0.4550090079271394,0.4356282100607213
물가/NNG;상승했/VVX,0,0.020929848611183743,25,12,13,35,0.4550090079271394,0.4356282100607213
금리/NNG;크/VA;하락하/VVX,0,0.019375460417301538,48,23,25,100,0.5260804931973775,0.5052393692134662
금리/NNG;인상될/VVX,0,0.01864958181015508,318,152,166,434,0.6795182461229958,0.6535458130608061
정책금리/NNG;내리/VV,0,0.015833010745597287,23,11,12,15,0.4457699227737962,0.4311513760374263
채권시장/NNG;강세/NNG;보였/VV,0,0.015833010745597287,23,11,12,47,0.4457699227737962,0.4311513760374263
수입/NNG;의존하/VVX,0,0.015833010745597287,23,11,12,19,0.4457699227737962,0.4311513760374263
통화정책/NNG;불확실성/NNG;해소되/VVX,0,0.015833010745597287,23,11,12,22,0.4457699227737962,0.4311513760374263
추경/NNG;하/VV,0,0.015833010745597287,23,11,12,38,0.4457699227737962,0.4311513760374263
불확실성/NNG;완화됐/VVX,0,0.015833010745597287,23,11,12,24,0.4457699227737962,0.4311513760374263
불확실성/NNG;커질/VV;있/VV,0,0.015833010745597287,23,11,12,38,0.4457699227737962,0.4311513760374263
대외불확실성/NNG;인해/VV,0,0.015833010745597287,23,11,12,37,0.4457699227737962,0.4311513760374263
금리인상/NNG;결정할/VVX,0,0.015833010745597287,23,11,12,41,0.4457699227737962,0.4311513760374263
금리인상/NNG;가능성/NNG;언급하/VVX,0,0.015833010745597287,23,11,12,25,0.4457699227737962,0.4311513760374263
견조한/VAX;성장세/NNG;지속하/VVX,0,0.015833010745597287,23,11,12,18,0.4457699227737962,0.4311513760374263
금리인상/NNG;가능성/NNG;열려/VV,0,0.015833010745597287,23,11,12,46,0.4457699227737962,0.4311513760374263
투자심리/NNG;위축시/VVX,0,0.013374543472077116,193,92,101,301,0.6726328857026542,0.6537779594577982
유동성/NNG;흡수하/VVX,0,0.013353205237647714,130,62,68,178,0.6509722905741917,0.6327515176470844
변동성/NNG;확대되/VVX,0,0.013032068201136449,298,142,156,405,0.6758235222670688,0.6573287518455107
자금이탈/NNG;지속되/VVX,0,0.010022135221502637,21,10,11,37,0.43616065801871806,0.4267831383984877
경제/NNG;회복시/VVX,0,0.010022135221502637,21,10,11,31,0.43616065801871806,0.4267831383984877
수출/NNG;증가할/VVX,0,0.010022135221502637,21,10,11,36,0.43616065801871806,0.4267831383984877
경기침체/NNG;우려/NNG;커지/VV,0,0.010022135221502637,21,10,11,20,0.43616065801871806,0.4267831383984877
경기둔화/NNG;지속될/VVX,0,0.010022135221502637,21,10,11,30,0.43616065801871806,0.4267831383984877
성장률/NNG;둔화하/VVX,0,0.010022135221502637,21,10,11,24,0.43616065801871806,0.4267831383984877
물가/NNG;상승해/VVX,0,0.010022135221502637,21,10,11,29,0.43616065801871806,0.4267831383984877
물가/NNG;상승시/VVX,0,0.010022135221502637,21,10,11,22,0.43616065801871806,0.4267831383984877
기준금리/NNG;낮/VA;유지하/VVX,0,0.010022135221502637,21,10,11,18,0.43616065801871806,0.4267831383984877
고용지표/NNG;호조/NNG;보인/VV,0,0.010022135221502637,21,10,11,33,0.43616065801871806,0.4267831383984877
실물경제/NNG;부정적/VAX;영향/NNG;미칠/VV,0,0.010022135221502637,21,10,11,19,0.43616065801871806,0.4267831383984877
금융위기/NNG;발생했/VVX,0,0.010022135221502637,21,10,11,15,0.43616065801871806,0.4267831383984877
경제/NNG;성장세/NNG;이/VV;갈/VX,0,0.010022135221502637,21,10,11,19,0.43616065801871806,0.4267831383984877
gdp/NNG;감소할/VVX,0,0.010022135221502637,21,10,11,20,0.43616065801871806,0.4267831383984877
경제성장률/NNG;웃돌/VV,0,0.010022135221502637,21,10,11,11,0.43616065801871806,0.4267831383984877
수출/NNG;감소해/VVX,0,0.010022135221502637,21,10,11,12,0.43616065801871806,0.4267831383984877
리스크/NNG;해소되/VVX;않/VX,0,0.010022135221502637,21,10,11,35,0.43616065801871806,0.4267831383984877
금리인하/NNG;단행되/VVX;않/VX,0,0.010022135221502637,21,10,11,28,0.43616065801871806,0.4267831383984877
금리인상/NNG;유지하/VVX,0,0.010022135221502637,21,10,11,29,0.43616065801871806,0.4267831383984877
흑자/NNG;전환되/VVX,0,0.010022135221502637,21,10,11,20,0.43616065801871806,0.4267831383984877
듀레이션/NNG;확대하/VVX,1,0.009209066873721694,42,20,22,48,0.5040537934708157,0.494018307211507
경기상승/NNG;따른/VV,1,0.009209066873721694,42,20,22,41,0.5040537934708157,0.494018307211507
환율급등/NNG;따른/VV,1,0.009209066873721694,42,20,22,35,0.5040537934708157,0.494018307211507
불안/NNG;인해/VV,1,0.009209066873721694,42,20,22,68,0.5040537934708157,0.494018307211507
채권시장/NNG;국채가격/NNG;오른/VV,0,0.007273944930258791,181,86,95,212,0.6668082635693455,0.6560635878138183
경제성장률/NNG;둔화되/VVX,0,0.005329695839791926,40,19,21,57,0.4962686705620229,0.4901719907349753
유동성/NNG;공급하/VVX,0,0.0033979663504866142,365,173,192,403,0.6694943647635564,0.6638261062113401
출구전략/NNG;시행하/VVX,0,0.0033012091829924817,59,28,31,67,0.545529355104822,0.5410151948978078
침체/NNG;따른/VV,0,0.0033012091829924817,59,28,31,55,0.545529355104822,0.5410151948978078
경기회복세/NNG;이어지/VV,0,0.0033012091829924817,59,28,31,75,0.545529355104822,0.5410151948978078
금리/NNG;상승세/NNG;제한될/VVX,0,0.0032867381523897787,19,9,10,48,0.426100783456544,0.42258708870180983
단기금리/NNG;오르/VV,0,0.0032867381523897787,19,9,10,21,0.426100783456544,0.42258708870180983
연방기금금리/NNG;동결하/VVX,0,0.0032867381523897787,19,9,10,26,0.426100783456544,0.42258708870180983
인플레이션/NNG;걱정하/VVX,0,0.0032867381523897787,19,9,10,19,0.426100783456544,0.42258708870180983
경기/NNG;회복세/NNG;보일/VV,0,0.0032867381523897787,19,9,10,23,0.426100783456544,0.42258708870180983
gdp/NNG;증가할/VVX,0,0.0032867381523897787,19,9,10,36,0.426100783456544,0.42258708870180983
리스크/NNG;해소되/VVX,0,0.0032867381523897787,19,9,10,44,0.426100783456544,0.42258708870180983
금리인상/NNG;멈추/VV,0,0.0032867381523897787,19,9,10,35,0.426100783456544,0.42258708870180983
물가안정/NNG;강조하/VVX,0,0.0032867381523897787,19,9,10,37,0.426100783456544,0.42258708870180983
디플레이션/NNG;벗어나/VV,0,0.0032867381523897787,19,9,10,38,0.426100783456544,0.42258708870180983
금리인상/NNG;가능성/NNG;시사함/VVX,0,0.0032867381523897787,19,9,10,17,0.426100783456544,0.42258708870180983
자산매입/NNG;유지하/VVX,0,0.0032867381523897787,19,9,10,57,0.426100783456544,0.42258708870180983
변동성/NNG;크/VA;확대될/VVX,0,0.0032867381523897787,19,9,10,26,0.426100783456544,0.42258708870180983
수출/NNG;잘/MAG;되/VV,0,0.0032867381523897787,19,9,10,24,0.426100783456544,0.42258708870180983
금리상승/NNG;이어졌/VV,0,0.0032867381523897787,19,9,10,16,0.426100783456544,0.42258708870180983
경제/NNG;성장할/VVX,0,0.0021051078834133374,116,55,61,133,0.6329475167681874,0.6292114792559914
기준금리/NNG;동결할/VVX,0,0.0015452525614396695,528,250,278,641,0.6682653412670925,0.6650641492094641
변동성/NNG;줄이/VV,0,0.0011510034321944307,38,18,20,63,0.488242621106468,0.4862865867668334
안전자산선호현상/NNG;강화됐/VVX,0,0.0011510034321944307,38,18,20,21,0.488242621106468,0.4862865867668334
경기부진/NNG;따른/VV,0,0.0011510034321944307,38,18,20,79,0.488242621106468,0.4862865867668334
변동성/NNG;높일/VV,0,0.0011510034321944307,38,18,20,36,0.488242621106468,0.4862865867668334
금리인상/NNG;하/VV;않/VX,0,0.0001456848879375361,57,27,30,66,0.5390985691536869,0.5380180800022708
금리인하/NNG;가능하/VVX,0,-0.0033699989752983273,36,17,19,42,0.47995972821425403,0.48237329493671316
성장/NNG;그칠/VV,0,-0.0033699989752983273,36,17,19,68,0.47995972821425403,0.48237329493671316
경제지표/NNG;부진한/VAX;모습/NNG;보이/VV,0,-0.0033699989752983273,36,17,19,61,0.47995972821425403,0.48237329493671316
금융시장불안/NNG;따른/VV,0,-0.0033699989752983273,36,17,19,20,0.47995972821425403,0.48237329493671316
부양책/NNG;나올/VV,0,-0.0033699989752983273,36,17,19,64,0.47995972821425403,0.48237329493671316
정책금리/NNG;동결했/VVX,0,-0.0033699989752983273,36,17,19,39,0.47995972821425403,0.48237329493671316
성장률/NNG;웃돌/VV,0,-0.004683633629442352,17,8,9,21,0.41546627640361233,0.4186525972960426
마이너스/NNG;보일/VV,0,-0.004683633629442352,17,8,9,27,0.41546627640361233,0.4186525972960426
금리인상/NNG;대비하/VVX,0,-0.004683633629442352,17,8,9,25,0.41546627640361233,0.4186525972960426
경제/NNG;나아지/VV,0,-0.004683633629442352,17,8,9,32,0.41546627640361233,0.4186525972960426
물가/NNG;밑돌/VV,0,-0.004683633629442352,17,8,9,14,0.41546627640361233,0.4186525972960426
금리변동성/NNG;커지/VV,0,-0.004683633629442352,17,8,9,26,0.41546627640361233,0.4186525972960426
기준금리/NNG;인상하/VVX;어려울/VA,0,-0.004683633629442352,17,8,9,31,0.41546627640361233,0.4186525972960426
금리인상/NNG;가능성/NNG;남/VV,0,-0.004683633629442352,17,8,9,29,0.41546627640361233,0.4186525972960426
성장률전망/NNG;낮추/VV,0,-0.004683633629442352,17,8,9,16,0.41546627640361233,0.4186525972960426
투자심리/NNG;지지했/VVX,0,-0.004683633629442352,17,8,9,5,0.41546627640361233,0.4186525972960426
성장모멘텀/NNG;불확실성/NNG;해소되/VVX;않/VX,0,-0.004683633629442352,17,8,9,4,0.41546627640361233,0.4186525972960426
강한/VA;성장세/NNG;보이/VV,0,-0.004683633629442352,17,8,9,11,0.41546627640361233,0.4186525972960426
불확실성/NNG;반영하/VVX,0,-0.004683633629442352,17,8,9,27,0.41546627640361233,0.4186525972960426
금리인상시기/NNG;앞당겨질/VV,0,-0.004683633629442352,17,8,9,35,0.41546627640361233,0.4186525972960426
실업률/NNG;웃돌/VV,0,-0.004683633629442352,17,8,9,32,0.41546627640361233,0.4186525972960426
성장세/NNG;나타냈/VV,0,-0.004683633629442352,17,8,9,30,0.41546627640361233,0.4186525972960426
경기/NNG;회복세/NNG;이/VV,0,-0.004683633629442352,17,8,9,17,0.41546627640361233,0.4186525972960426
양적완화정책/NNG;펴/VV,0,-0.004683633629442352,17,8,9,20,0.41546627640361233,0.4186525972960426
기준금리/NNG;인하된/VVX,0,-0.006947386621951934,89,42,47,128,0.5960160677436975,0.603308958564669
기준금리/NNG;유지할/VVX,0,-0.007931674142585776,123,58,65,146,0.6323797301534583,0.6413773624340577
금리/NNG;올릴/VV;없/VA,0,-0.008286313518604649,34,16,18,34,0.47139986934776934,0.47844585952367186
금리인상/NNG;전망하/VVX,0,-0.008286313518604649,34,16,18,40,0.47139986934776934,0.47844585952367186
물가/NNG;안정되/VVX,0,-0.008514252759720287,70,33,37,137,0.5626320586705774,0.5713017569810436
인플레이션/NNG;잡/VV,0,-0.008514252759720287,70,33,37,89,0.5626320586705774,0.5713017569810436
기준금리/NNG;올릴/VV,0,-0.012679766831110606,347,163,184,513,0.6587487701553754,0.6744887675630888
금리인상/NNG;지속하/VVX,0,-0.01366417595114311,32,15,17,25,0.46253717753515894,0.4745212087142324
기준금리인상/NNG;단행했/VVX,0,-0.01366417595114311,32,15,17,33,0.46253717753515894,0.4745212087142324
인플레이션기대심리/NNG;낮추/VV,0,-0.01366417595114311,32,15,17,62,0.46253717753515894,0.4745212087142324
경제/NNG;회복세/NNG;보일/VV,0,-0.014368022629005606,15,7,8,35,0.404057118588393,0.4151092568392031
소비자물가지수/NNG;상승할/VVX,0,-0.014368022629005606,15,7,8,12,0.404057118588393,0.4151092568392031
변동성/NNG;지속되/VVX,0,-0.014368022629005606,15,7,8,15,0.404057118588393,0.4151092568392031
금리/NNG;횡보하/VVX,0,-0.014368022629005606,15,7,8,18,0.404057118588393,0.4151092568392031
부양책/NNG;나오/VV;않/VX,0,-0.014368022629005606,15,7,8,17,0.404057118588393,0.4151092568392031
불안심리/NNG;자극하/VVX,0,-0.014368022629005606,15,7,8,31,0.404057118588393,0.4151092568392031
금융시장변동성/NNG;확대될/VVX,0,-0.014368022629005606,15,7,8,24,0.404057118588393,0.4151092568392031
세계경제/NNG;위험요인/NNG;작용할/VVX,0,-0.014368022629005606,15,7,8,17,0.404057118588393,0.4151092568392031
수출액/NNG;줄/VV,0,-0.014368022629005606,15,7,8,7,0.404057118588393,0.4151092568392031
금리/NNG;크/VA;올랐/VV,0,-0.014368022629005606,15,7,8,23,0.404057118588393,0.4151092568392031
연방기금금리/NNG;유지했/VVX,0,-0.014368022629005606,15,7,8,14,0.404057118588393,0.4151092568392031
금리차축소/NNG;따른/VV,0,-0.014368022629005606,15,7,8,13,0.404057118588393,0.4151092568392031
근원소비자물가/NNG;상승하/VVX,0,-0.014368022629005606,15,7,8,17,0.404057118588393,0.4151092568392031
인플레이션우려/NNG;완화됐/VVX,0,-0.014368022629005606,15,7,8,18,0.404057118588393,0.4151092568392031
국제금융시장/NNG;변동성/NNG;커지/VV,0,-0.014368022629005606,15,7,8,9,0.404057118588393,0.4151092568392031
인플레이션우려/NNG;고조되/VVX,0,-0.014368022629005606,15,7,8,11,0.404057118588393,0.4151092568392031
경기회복/NNG;있/VV,0,-0.014368022629005606,15,7,8,23,0.404057118588393,0.4151092568392031
안전자산선호현상/NNG;약화됐/VVX,0,-0.014368022629005606,15,7,8,20,0.404057118588393,0.4151092568392031
인플레이션압력/NNG;억제하/VVX,0,-0.014368022629005606,15,7,8,26,0.404057118588393,0.4151092568392031
금리하락/NNG;인해/VV,0,-0.014368022629005606,15,7,8,27,0.404057118588393,0.4151092568392031
금리인상/NNG;가능성/NNG;반영되/VVX,0,-0.014368022629005606,15,7,8,21,0.404057118588393,0.4151092568392031
인플레이션압력/NNG;가중되/VVX,0,-0.014368022629005606,15,7,8,23,0.404057118588393,0.4151092568392031
경제/NNG;성장세/NNG;유지하/VVX,0,-0.014368022629005606,15,7,8,9,0.404057118588393,0.4151092568392031
금융안정리스크/NNG;있/VV,0,-0.014368022629005606,15,7,8,8,0.404057118588393,0.4151092568392031
인플레이션압력/NNG;가중시/VVX,0,-0.014368022629005606,15,7,8,27,0.404057118588393,0.4151092568392031
금리인하/NNG;검토할/VVX,0,-0.014368022629005606,15,7,8,24,0.404057118588393,0.4151092568392031
투자심리/NNG;부정적/VAX;영향/NNG;미칠/VV,0,-0.014368022629005606,15,7,8,20,0.404057118588393,0.4151092568392031
성장/NNG;예상했/VVX,0,-0.014368022629005606,15,7,8,22,0.404057118588393,0.4151092568392031
경기안정/NNG;위한/VV,0,-0.014368022629005606,15,7,8,28,0.404057118588393,0.4151092568392031
동결/NNG;예상한/VVX,0,-0.014368022629005606,15,7,8,24,0.404057118588393,0.4151092568392031
정책금리인상/NNG;반영하/VVX,0,-0.014368022629005606,15,7,8,12,0.404057118588393,0.4151092568392031
가계부채/NNG;급증하/VVX,0,-0.014368022629005606,15,7,8,25,0.404057118588393,0.4151092568392031
금리인상/NNG;나설/VV;가능성/NNG;낮/VA,0,-0.014368022629005606,15,7,8,9,0.404057118588393,0.4151092568392031
금리인상/NNG;가능성/NNG;인해/VV,0,-0.014368022629005606,15,7,8,6,0.404057118588393,0.4151092568392031
투자심리/NNG;부담/NNG;주/VV,0,-0.014368022629005606,15,7,8,12,0.404057118588393,0.4151092568392031
경기불확실성/NNG;따른/VV,0,-0.014368022629005606,15,7,8,37,0.404057118588393,0.4151092568392031
금리상승/NNG;크/VA;나타났/VV,0,-0.014368022629005606,15,7,8,5,0.404057118588393,0.4151092568392031
주택가격/NNG;하/VV,0,-0.014368022629005606,15,7,8,11,0.404057118588393,0.4151092568392031
단기금리/NNG;오를/VV,0,-0.014368022629005606,15,7,8,13,0.404057118588393,0.4151092568392031
수출/NNG;감소세/NNG;지속하/VVX,0,-0.018601223882117046,47,22,25,42,0.5038539824780454,0.5220323781022891
금리상승/NNG;따른/VV,0,-0.018966363178693935,220,103,117,396,0.6533280564475119,0.6773933105910245
경제성장/NNG;위한/VV,0,-0.01958762044636153,30,14,16,30,0.4533378231967134,0.4706202997492391
금리인하/NNG;카드/NNG;꺼내/VV,0,-0.01958762044636153,30,14,16,34,0.4533378231967134,0.4706202997492391
경제/NNG;확산되/VVX,0,-0.01958762044636153,30,14,16,39,0.4533378231967134,0.4706202997492391
재정/NNG;통한/VV,0,-0.01958762044636153,30,14,16,25,0.4533378231967134,0.4706202997492391
성장세/NNG;보였/VV,0,-0.021614436118847724,62,29,33,78,0.5386067412904926,0.5614090105947075
투자심리/NNG;악화시/VVX,-1,-0.023095131540742497,45,21,24,63,0.49612518754157814,0.518661397901132
금리/NNG;유지할/VVX,0,-0.0234211302760019,77,36,41,131,0.5670009226898051,0.5931429223184993
금리/NNG;하락세/NNG;보이/VV,0,-0.026165100778340444,28,13,15,59,0.4437567456516924,0.4667692505527231
금리인하/NNG;지지하/VVX,0,-0.026165100778340444,28,13,15,20,0.4437567456516924,0.4667692505527231
신용등급/NNG;강등될/VVX,0,-0.026165100778340444,28,13,15,53,0.4437567456516924,0.4667692505527231
금리인상/NNG;단행한/VVX,0,-0.026165100778340444,28,13,15,29,0.4437567456516924,0.4667692505527231
금리인상/NNG;그칠/VV,0,-0.026581813420383904,75,35,40,95,0.5616017413529119,0.5912177141534992
기준금리/NNG;낮춘/VV,0,-0.029881158456686707,73,34,39,66,0.5560294023417068,0.58922475742268
경기/NNG;부양하/VVX,0,-0.03011422042213585,202,94,108,284,0.6445429262666096,0.6833409102508541
경제성장/NNG;둔화하/VVX,0,-0.03353935013146869,26,12,14,36,0.4337327141657269,0.4630008746879131
인플레이션압력/NNG;증가하/VVX,0,-0.03353935013146869,26,12,14,32,0.4337327141657269,0.4630008746879131
지정학적리스크/NNG;부각되/VVX,0,-0.03353935013146869,26,12,14,39,0.4337327141657269,0.4630008746879131
기준금리인상/NNG;시사하/VVX,0,-0.03353935013146869,26,12,14,22,0.4337327141657269,0.4630008746879131
유동성/NNG;따른/VV,0,-0.03353935013146869,26,12,14,22,0.4337327141657269,0.4630008746879131
경기과열/NNG;억제하/VVX,0,-0.03353935013146869,26,12,14,32,0.4337327141657269,0.4630008746879131
경기둔화/NNG;우려하/VVX,0,-0.03353935013146869,26,12,14,28,0.4337327141657269,0.4630008746879131
금리상승/NNG;나타날/VV,0,-0.03353935013146869,26,12,14,50,0.4337327141657269,0.4630008746879131
금리인상/NNG;뒷받침하/VVX,0,-0.03353935013146869,26,12,14,16,0.4337327141657269,0.4630008746879131
소비/NNG;회복되/VVX,0,-0.037649843354678025,54,25,29,48,0.511402043593094,0.5504173754695252
금리/NNG;오르/VV,0,-0.03843440206435378,432,200,232,650,0.6411973713601746,0.6911987321553336
경기부양책/NNG;따른/VV,-1,-0.03864722859853886,39,18,21,60,0.47133976916335496,0.5083117718884476
가계부채/NNG;늘어나/VV,-1,-0.03864722859853886,39,18,21,48,0.47133976916335496,0.5083117718884476
금리/NNG;올라가/VV,0,-0.039163411099454426,110,51,59,182,0.6011453504410947,0.648969067635188
수출/NNG;늘어나/VV,0,-0.040708555639828004,67,31,36,87,0.5382199696799994,0.5828364827116606
기준금리/NNG;낮추/VV,0,-0.04088334448346698,95,44,51,118,0.5833906932460448,0.6319726506149618
성장세/NNG;유지될/VVX,0,-0.04190251741985518,24,11,13,30,0.4231806452614554,0.45935679020945747
침체/NNG;빠져/VV,0,-0.04190251741985518,24,11,13,41,0.4231806452614554,0.45935679020945747
물가상승/NNG;막/VV,0,-0.04190251741985518,24,11,13,27,0.4231806452614554,0.45935679020945747
소비자물가/NNG;올랐/VV,0,-0.04190251741985518,24,11,13,42,0.4231806452614554,0.45935679020945747
양적완화정책/NNG;시행하/VVX,0,-0.04190251741985518,24,11,13,15,0.4231806452614554,0.45935679020945747
유가상승/NNG;견인했/VVX,0,-0.04190251741985518,24,11,13,48,0.4231806452614554,0.45935679020945747
경제/NNG;회복할/VVX,0,-0.04190251741985518,24,11,13,29,0.4231806452614554,0.45935679020945747
불안심리/NNG;진정되/VVX,0,-0.04190251741985518,24,11,13,33,0.4231806452614554,0.45935679020945747
경기/NNG;둔화되/VVX,0,-0.04419403120158982,234,108,126,297,0.636579054061469,0.6941735340805312
금리인하기대/NNG;선반영하/VVX,-1,-0.0446873137450331,37,17,20,75,0.46247470960527404,0.5048151933080468
채권시장/NNG;부담/NNG;작용할/VVX,-1,-0.0446873137450331,37,17,20,84,0.46247470960527404,0.5048151933080468
경제성장률/NNG;상향조정했/VVX,-1,-0.0446873137450331,37,17,20,57,0.46247470960527404,0.5048151933080468
수익성/NNG;개선되/VVX,-1,-0.0446873137450331,37,17,20,39,0.46247470960527404,0.5048151933080468
리스크/NNG;남/VV,0,-0.04618099824443811,78,36,42,100,0.5551882418470938,0.6078312065581609
물가/NNG;안정돼/VVX,-1,-0.04712522922092288,50,23,27,54,0.4964451075524063,0.5445462614878455
금리/NNG;동결할/VVX,0,-0.04783570745078114,367,169,198,476,0.6346910771677371,0.6971778785348718
콜금리/NNG;동결될/VVX,0,-0.04981823746774994,76,35,41,59,0.5496072957110625,0.6061183651740447
경제/NNG;견조하/VVX,-1,-0.05126751784310124,35,16,19,20,0.4532592396607984,0.5013164265677543
금리인하/NNG;요구하/VVX,-1,-0.05126751784310124,35,16,19,43,0.4532592396607984,0.5013164265677543
금리인상전망/NNG;따른/VV,0,-0.051520246458174324,22,10,12,30,0.41197924407056025,0.45589035161937563
변동성/NNG;확대시/VVX;있/VV,0,-0.051520246458174324,22,10,12,31,0.41197924407056025,0.45589035161937563
변동성/NNG;장세/NNG;이어질/VV,0,-0.051520246458174324,22,10,12,26,0.41197924407056025,0.45589035161937563
실업률/NNG;기록하/VVX,0,-0.051520246458174324,22,10,12,38,0.41197924407056025,0.45589035161937563
물가/NNG;자극할/VVX,0,-0.051520246458174324,22,10,12,20,0.41197924407056025,0.45589035161937563
성장잠재력/NNG;확충하/VVX,0,-0.051520246458174324,22,10,12,32,0.41197924407056025,0.45589035161937563
경제성장률/NNG;하락하/VVX,0,-0.051520246458174324,22,10,12,37,0.41197924407056025,0.45589035161937563
물가/NNG;하락했/VVX,0,-0.051520246458174324,22,10,12,21,0.41197924407056025,0.45589035161937563
듀레이션/NNG;축소하/VVX,0,-0.051520246458174324,22,10,12,41,0.41197924407056025,0.45589035161937563
물가/NNG;상승세/NNG;지속될/VVX,0,-0.051520246458174324,22,10,12,20,0.41197924407056025,0.45589035161937563
금리/NNG;인상돼/VVX,0,-0.051520246458174324,22,10,12,20,0.41197924407056025,0.45589035161937563
금리/NNG;유지한/VVX,0,-0.051520246458174324,22,10,12,36,0.41197924407056025,0.45589035161937563
경기/NNG;둔화된/VVX,0,-0.051520246458174324,22,10,12,33,0.41197924407056025,0.45589035161937563
인플레이션/NNG;자극할/VVX,0,-0.051520246458174324,22,10,12,22,0.41197924407056025,0.45589035161937563
인플레이션/NNG;하락하/VVX,0,-0.051520246458174324,22,10,12,22,0.41197924407056025,0.45589035161937563
유동성/NNG;조절하/VVX,0,-0.051520246458174324,22,10,12,37,0.41197924407056025,0.45589035161937563
물가상승/NNG;따른/VV,-1,-0.05231772256646405,48,22,26,103,0.4885878636403038,0.5415285181361812
기준금리/NNG;동결됐/VVX,-1,-0.05231772256646405,48,22,26,117,0.4885878636403038,0.5415285181361812
성장/NNG;가능하/VVX,0,-0.05757533167225548,72,33,39,86,0.5378987920799915,0.6024949620796474
금리하락/NNG;확대되/VVX,0,-0.057779925837809776,59,27,32,67,0.5116863693678015,0.5733697178045557
물가/NNG;상승하/VVX,0,-0.05836354630005203,133,61,72,144,0.6060314994171542,0.6798827705098367
경기침체/NNG;막/VV,0,-0.05844042688423001,109,50,59,96,0.587748712957842,0.6594736344072655
통화정책/NNG;완화/NNG;유지하/VVX,0,-0.058480523244987315,33,15,18,23,0.4436518060567832,0.49783210687241203
동결/NNG;예상했/VVX,0,-0.058480523244987315,33,15,18,47,0.4436518060567832,0.49783210687241203
신용등급/NNG;하향조정하/VVX,0,-0.058480523244987315,33,15,18,52,0.4436518060567832,0.49783210687241203
외화유동성/NNG;공급하/VVX,0,-0.058480523244987315,33,15,18,7,0.4436518060567832,0.49783210687241203
부양책/NNG;힘입/VV,0,-0.06277163284298315,20,9,11,18,0.3999503300012338,0.45267076462265826
경제성장세/NNG;둔화될/VVX,0,-0.06277163284298315,20,9,11,34,0.3999503300012338,0.45267076462265826
소비/NNG;하/VV,0,-0.06277163284298315,20,9,11,24,0.3999503300012338,0.45267076462265826
금리인하/NNG;나올/VV,0,-0.06277163284298315,20,9,11,15,0.3999503300012338,0.45267076462265826
소매판매/NNG;증가했/VVX,0,-0.06277163284298315,20,9,11,79,0.3999503300012338,0.45267076462265826
정책금리/NNG;동결되/VVX,0,-0.06277163284298315,20,9,11,62,0.3999503300012338,0.45267076462265826
불안/NNG;확산될/VVX,0,-0.06277163284298315,20,9,11,33,0.3999503300012338,0.45267076462265826
마이너스/NNG;나타낼/VV,0,-0.06277163284298315,20,9,11,11,0.3999503300012338,0.45267076462265826
디플레이션/NNG;막/VV,0,-0.06277163284298315,20,9,11,27,0.3999503300012338,0.45267076462265826
경기/NNG;나타내/VV,0,-0.06277163284298315,20,9,11,54,0.3999503300012338,0.45267076462265826
금융시장/NNG;흔들/VV,0,-0.06277163284298315,20,9,11,24,0.3999503300012338,0.45267076462265826
내수/NNG;부양/NNG;위해/VV,0,-0.06277163284298315,20,9,11,35,0.3999503300012338,0.45267076462265826
성장/NNG;이어질/VV,0,-0.06277163284298315,20,9,11,19,0.3999503300012338,0.45267076462265826
동결/NNG;이/VV;갈/VX,0,-0.06277163284298315,20,9,11,20,0.3999503300012338,0.45267076462265826
출구전략/NNG;나설/VV,0,-0.06277163284298315,20,9,11,20,0.3999503300012338,0.45267076462265826
인플레이션/NNG;통제하/VVX,0,-0.06277163284298315,20,9,11,25,0.3999503300012338,0.45267076462265826
경기둔화/NNG;따른/VV,0,-0.06351430866025098,129,59,70,249,0.6001533713643732,0.6802763791094777
인플레이션압력/NNG;완화되/VVX,-1,-0.06379451139314507,44,20,24,39,0.4720345862933949,0.5353539241134977
금리인상/NNG;가능성/NNG;배제하/VVX,-1,-0.06379451139314507,44,20,24,74,0.4720345862933949,0.5353539241134977
경제지표/NNG;부진했/VVX,0,-0.06644426008052151,31,14,17,70,0.4335983685447766,0.49438228802114625
높/VA;변동성/NNG;보일/VV,0,-0.06644426008052151,31,14,17,23,0.4335983685447766,0.49438228802114625
성장/NNG;지속될/VVX,0,-0.06644426008052151,31,14,17,48,0.4335983685447766,0.49438228802114625
성장/NNG;힘입/VV,0,-0.06644426008052151,31,14,17,25,0.4335983685447766,0.49438228802114625
금융완화/NNG;유지될/VVX,0,-0.06644426008052151,31,14,17,21,0.4335983685447766,0.49438228802114625
경기침체/NNG;겪/VV,0,-0.06644426008052151,31,14,17,59,0.4335983685447766,0.49438228802114625
금리인상/NNG;기정사실화하/VVX,0,-0.06644426008052151,31,14,17,23,0.4335983685447766,0.49438228802114625
성장/NNG;보일/VV,-1,-0.06774774343913492,55,25,30,56,0.4970779066993229,0.5682447493891304
금리/NNG;하회하/VVX,-1,-0.06774774343913492,55,25,30,89,0.4970779066993229,0.5682447493891304
금리인상/NNG;시작되/VVX,-1,-0.07017309594950183,42,19,23,61,0.46329597964499825,0.53221021952142
금리인하/NNG;주장했/VVX,-1,-0.07017309594950183,42,19,23,62,0.46329597964499825,0.53221021952142
고용/NNG;늘리/VV,-1,-0.07017309594950183,42,19,23,42,0.46329597964499825,0.53221021952142
동결/NNG;유지하/VVX,-1,-0.07017309594950183,42,19,23,77,0.46329597964499825,0.53221021952142
경제/NNG;둔화될/VVX,0,-0.07059382141252302,66,30,36,95,0.5188743403778348,0.596559283703326
금리인상/NNG;지속할/VVX,0,-0.07059382141252302,66,30,36,90,0.5188743403778348,0.596559283703326
인플레이션/NNG;억제하/VVX,0,-0.07411566504404865,143,65,78,180,0.6005059725605881,0.695311656883095
물가상승률/NNG;둔화되/VVX,0,-0.0753114550695223,29,13,16,46,0.4230274341024504,0.49099119356703336
투자심리/NNG;냉각시/VVX,0,-0.0753114550695223,29,13,16,57,0.4230274341024504,0.49099119356703336
성장/NNG;위한/VV,0,-0.07535892109009057,64,29,35,115,0.5121136426414818,0.5944466989646339
변동성/NNG;확대될/VVX,0,-0.07569265137547332,331,150,181,476,0.6151258163831361,0.7144990399493469
경기둔화/NNG;진행되/VVX,0,-0.0762189770970062,18,8,10,16,0.386822621425875,0.44978888091717223
고용/NNG;줄어들/VV,0,-0.0762189770970062,18,8,10,11,0.386822621425875,0.44978888091717223
자산/NNG;보유하/VVX,0,-0.0762189770970062,18,8,10,36,0.386822621425875,0.44978888091717223
경기회복세/NNG;이/VV,0,-0.0762189770970062,18,8,10,14,0.386822621425875,0.44978888091717223
인플레이션/NNG;발생하/VVX,0,-0.0762189770970062,18,8,10,26,0.386822621425875,0.44978888091717223
유동성/NNG;부족/NNG;따른/VV,0,-0.0762189770970062,18,8,10,11,0.386822621425875,0.44978888091717223
침체/NNG;진입했/VVX,0,-0.0762189770970062,18,8,10,4,0.386822621425875,0.44978888091717223
금리인상/NNG;재개될/VVX,0,-0.0762189770970062,18,8,10,27,0.386822621425875,0.44978888091717223
금융위기/NNG;촉발된/VVX,0,-0.0762189770970062,18,8,10,11,0.386822621425875,0.44978888091717223
투자심리/NNG;위축돼/VVX,0,-0.0762189770970062,18,8,10,23,0.386822621425875,0.44978888091717223
고용/NNG;줄/VV,0,-0.0762189770970062,18,8,10,13,0.386822621425875,0.44978888091717223
수출/NNG;악영향/NNG;미칠/VV,0,-0.0762189770970062,18,8,10,11,0.386822621425875,0.44978888091717223
수출/NNG;하/VV,0,-0.0762189770970062,18,8,10,19,0.386822621425875,0.44978888091717223
변동성/NNG;작용할/VVX,0,-0.0762189770970062,18,8,10,18,0.386822621425875,0.44978888091717223
회복속도/NNG;둔화되/VVX,0,-0.0762189770970062,18,8,10,20,0.386822621425875,0.44978888091717223
금리인상/NNG;유지되/VVX,0,-0.0762189770970062,18,8,10,11,0.386822621425875,0.44978888091717223
경제지표/NNG;부진할/VVX,0,-0.0762189770970062,18,8,10,31,0.386822621425875,0.44978888091717223
스태그플레이션/NNG;빠질/VV,0,-0.0762189770970062,18,8,10,18,0.386822621425875,0.44978888091717223
유동성/NNG;인해/VV,0,-0.0762189770970062,18,8,10,27,0.386822621425875,0.44978888091717223
주택시장/NNG;안정되/VVX,0,-0.0762189770970062,18,8,10,14,0.386822621425875,0.44978888091717223
유동성/NNG;증가/NNG;따른/VV,0,-0.0762189770970062,18,8,10,15,0.386822621425875,0.44978888091717223
경제지표/NNG;상회하/VVX,0,-0.0762189770970062,18,8,10,26,0.386822621425875,0.44978888091717223
물가/NNG;잡/VV;위해/VV,-1,-0.07705775597003695,40,18,22,69,0.45421307532328015,0.529039736501811
유동성/NNG;풀/VV,-1,-0.07705775597003695,40,18,22,53,0.45421307532328015,0.529039736501811
재할인율/NNG;인하했/VVX,-1,-0.07705775597003695,40,18,22,22,0.45421307532328015,0.529039736501811
금리/NNG;인하해/VVX,0,-0.07768232373585793,86,39,47,101,0.5483055417443631,0.6394348095157387
경제/NNG;개선되/VVX,0,-0.07768232373585793,86,39,47,125,0.5483055417443631,0.6394348095157387
소비/NNG;늘어나/VV,-1,-0.07892623243940122,51,23,28,87,0.481454645635465,0.562878386511832
국제유가하락/NNG;따른/VV,-1,-0.07892623243940122,51,23,28,59,0.481454645635465,0.562878386511832
물가상승/NNG;억제하/VVX,-1,-0.07892623243940122,51,23,28,73,0.481454645635465,0.562878386511832
금리/NNG;크/VA;오르/VV,-1,-0.08452454475474724,38,17,21,36,0.4447504666246231,0.5258524326604234
금리인상/NNG;신중할/VVX,-1,-0.08505186804817177,49,22,27,54,0.47322397075836775,0.5601120111788727
경기/NNG;악화되/VVX,-1,-0.08505186804817177,49,22,27,67,0.47322397075836775,0.5601120111788727
변동성/NNG;확대된/VVX,0,-0.08590135629456452,82,37,45,97,0.5373335703273348,0.6370805318394264
물가/NNG;오르/VV,0,-0.08645842372025603,144,65,79,263,0.5924672774203608,0.7032366623431033
투자심리/NNG;얼어붙/VV,-1,-0.09266770158258364,36,16,20,60,0.43486366931476905,0.5226600070121459
침체/NNG;이어지/VV,-1,-0.09266770158258364,36,16,20,22,0.43486366931476905,0.5226600070121459
금리/NNG;인하할/VVX;없/VA,0,-0.09273732808787338,16,7,9,15,0.37216473112483706,0.44736527387778274
임금인상/NNG;요구하/VVX,0,-0.09273732808787338,16,7,9,16,0.37216473112483706,0.44736527387778274
재정/NNG;투입하/VVX,0,-0.09273732808787338,16,7,9,30,0.37216473112483706,0.44736527387778274
경기/NNG;둔화시/VVX,0,-0.09273732808787338,16,7,9,19,0.37216473112483706,0.44736527387778274
적자/NNG;전환했/VVX,0,-0.09273732808787338,16,7,9,18,0.37216473112483706,0.44736527387778274
부양책/NNG;쓸/VV,0,-0.09273732808787338,16,7,9,22,0.37216473112483706,0.44736527387778274
불안/NNG;가중되/VVX,0,-0.09273732808787338,16,7,9,33,0.37216473112483706,0.44736527387778274
경기선행지수/NNG;반등하/VVX,0,-0.09273732808787338,16,7,9,27,0.37216473112483706,0.44736527387778274
수익성/NNG;악화될/VVX,0,-0.09273732808787338,16,7,9,32,0.37216473112483706,0.44736527387778274
소비/NNG;투자심리/NNG;위축되/VVX,0,-0.09273732808787338,16,7,9,10,0.37216473112483706,0.44736527387778274
통화완화/NNG;지속될/VVX,0,-0.09273732808787338,16,7,9,22,0.37216473112483706,0.44736527387778274
소비자물가/NNG;이/VV,0,-0.09273732808787338,16,7,9,17,0.37216473112483706,0.44736527387778274
금리메리트/NNG;남/VV,0,-0.09273732808787338,16,7,9,52,0.37216473112483706,0.44736527387778274
경기확장/NNG;밑돌/VV,0,-0.09273732808787338,16,7,9,12,0.37216473112483706,0.44736527387778274
소비/NNG;회복세/NNG;이/VV,0,-0.09273732808787338,16,7,9,7,0.37216473112483706,0.44736527387778274
글로벌/NNG;금융시장/NNG;안정되/VVX,0,-0.09273732808787338,16,7,9,25,0.37216473112483706,0.44736527387778274
지정학적리스크/NNG;확대되/VVX,0,-0.09273732808787338,16,7,9,23,0.37216473112483706,0.44736527387778274
성장률/NNG;부진했/VVX,0,-0.09273732808787338,16,7,9,11,0.37216473112483706,0.44736527387778274
금리인상우려/NNG;완화된/VVX,0,-0.09273732808787338,16,7,9,12,0.37216473112483706,0.44736527387778274
물가상승압력/NNG;가중시/VVX,0,-0.09273732808787338,16,7,9,4,0.37216473112483706,0.44736527387778274
출구전략/NNG;시행해/VVX,0,-0.09273732808787338,16,7,9,13,0.37216473112483706,0.44736527387778274
금리/NNG;하락세/NNG;지속될/VVX;예상되/VVX,0,-0.09273732808787338,16,7,9,33,0.37216473112483706,0.44736527387778274
금리인상/NNG;걸릴/VV,0,-0.09273732808787338,16,7,9,19,0.37216473112483706,0.44736527387778274
금리인상시기/NNG;늦춰질/VV,0,-0.09273732808787338,16,7,9,43,0.37216473112483706,0.44736527387778274
경기/NNG;부정적/VAX;영향/NNG;미칠/VV,0,-0.09273732808787338,16,7,9,25,0.37216473112483706,0.44736527387778274
경기부양책/NNG;발표하/VVX,0,-0.09273732808787338,16,7,9,17,0.37216473112483706,0.44736527387778274
불확실성/NNG;사라지/VV,0,-0.09273732808787338,16,7,9,25,0.37216473112483706,0.44736527387778274
내수회복/NNG;힘입/VV,0,-0.09273732808787338,16,7,9,16,0.37216473112483706,0.44736527387778274
경제성장/NNG;저해하/VVX,0,-0.09273732808787338,16,7,9,20,0.37216473112483706,0.44736527387778274
물가상승/NNG;작용할/VVX,0,-0.09273732808787338,16,7,9,18,0.37216473112483706,0.44736527387778274
금리하락/NNG;여지/NNG;남/VV,0,-0.09273732808787338,16,7,9,50,0.37216473112483706,0.44736527387778274
경제/NNG;악영향/NNG;줄/VV,0,-0.09273732808787338,16,7,9,26,0.37216473112483706,0.44736527387778274
경제지표/NNG;개선되/VVX,0,-0.0939922586605223,129,58,71,215,0.5795602995299128,0.698431268563538
경기회복/NNG;위한/VV,0,-0.09480014115197255,78,35,43,123,0.5256364618561856,0.6344793847098863
양적완화/NNG;내놓/VV,0,-0.09663478253955193,25,11,14,77,0.399911232917755,0.4845086683205606
잠재성장률/NNG;부합하/VVX,0,-0.09663478253955193,25,11,14,26,0.399911232917755,0.4845086683205606
불확실성/NNG;완화하/VVX,0,-0.09663478253955193,25,11,14,18,0.399911232917755,0.4845086683205606
불안/NNG;계속되/VVX,0,-0.09663478253955193,25,11,14,31,0.399911232917755,0.4845086683205606
경기/NNG;침체될/VVX,0,-0.09663478253955193,25,11,14,18,0.399911232917755,0.4845086683205606
안전자산선호심리/NNG;약화되/VVX,0,-0.09663478253955193,25,11,14,58,0.399911232917755,0.4845086683205606
성장/NNG;촉진하/VVX,0,-0.09663478253955193,25,11,14,30,0.399911232917755,0.4845086683205606
실업률/NNG;낮추/VV,0,-0.09663478253955193,25,11,14,48,0.399911232917755,0.4845086683205606
금리상승압력/NNG;가중시/VVX,0,-0.09663478253955193,25,11,14,39,0.399911232917755,0.4845086683205606
신용스프레드/NNG;축소된/VVX,0,-0.09663478253955193,25,11,14,47,0.399911232917755,0.4845086683205606
신용등급/NNG;강등했/VVX,0,-0.09663478253955193,25,11,14,78,0.399911232917755,0.4845086683205606
장단기금리차/NNG;확대될/VVX,0,-0.09663478253955193,25,11,14,39,0.399911232917755,0.4845086683205606
성장/NNG;위해서/VV,0,-0.09663478253955193,25,11,14,69,0.399911232917755,0.4845086683205606
단기금리/NNG;상승하/VVX,-1,-0.09705943944922879,56,25,31,93,0.4827207378169507,0.5853366266947333
자금이탈/NNG;따른/VV,-1,-0.09859431390227891,45,20,25,36,0.45582195842362544,0.554432978528486
소비심리/NNG;개선되/VVX,-1,-0.09859431390227891,45,20,25,55,0.45582195842362544,0.554432978528486
수출/NNG;호조/NNG;보이/VV,-1,-0.1012706773103963,65,29,36,89,0.49885564344135647,0.6100610976793845
자산/NNG;축소하/VVX,-1,-0.10160565589042247,34,15,19,44,0.42449602719600066,0.5194761571790478
금리인상/NNG;중단될/VVX,-1,-0.10160565589042247,34,15,19,58,0.42449602719600066,0.5194761571790478
인플레이션/NNG;막/VV,-1,-0.10160565589042247,34,15,19,55,0.42449602719600066,0.5194761571790478
인플레이션/NNG;상승할/VVX,-1,-0.10160565589042247,34,15,19,46,0.42449602719600066,0.5194761571790478
금리상승/NNG;인해/VV,-1,-0.10160565589042247,34,15,19,50,0.42449602719600066,0.5194761571790478
경기부양/NNG;위해/VV,0,-0.10276613896266218,547,244,303,750,0.5957537268218147,0.7307618406809326
금리하락/NNG;제한되/VVX,0,-0.10446881144275,74,33,41,142,0.5131628804954121,0.631621744280588
금리인상/NNG;중단할/VVX,0,-0.10568928229096408,103,46,57,142,0.550960987061904,0.679818545886456
금리/NNG;내려야/VV,0,-0.10684355511176347,83,37,46,80,0.5257479095793537,0.6502228640816061
금리/NNG;상승압력/NNG;받/VV,0,-0.10684355511176347,83,37,46,174,0.5257479095793537,0.6502228640816061
불확실성/NNG;따른/VV,0,-0.10746964826770478,157,70,87,203,0.582542857924762,0.7213763070194594
금리상승/NNG;제한되/VVX,0,-0.10854835331333246,92,41,51,178,0.5367350254633589,0.6661016612193367
콜금리/NNG;동결할/VVX,0,-0.10971037737045608,101,45,56,50,0.5462571628006622,0.6795128521957836
물가상승압력/NNG;높일/VV,0,-0.1097437048869413,23,10,13,10,0.3870461363608221,0.4814958227640819
성장률/NNG;하향조정했/VVX,0,-0.1097437048869413,23,10,13,42,0.3870461363608221,0.4814958227640819
경제지표/NNG;호전되/VVX,0,-0.1097437048869413,23,10,13,53,0.3870461363608221,0.4814958227640819
수입/NNG;늘어난/VV,0,-0.1097437048869413,23,10,13,26,0.3870461363608221,0.4814958227640819
금리인상/NNG;준비하/VVX,0,-0.1097437048869413,23,10,13,28,0.3870461363608221,0.4814958227640819
고용/NNG;상황/NNG;개선되/VVX,0,-0.1097437048869413,23,10,13,31,0.3870461363608221,0.4814958227640819
기대인플레이션/NNG;상승하/VVX,0,-0.1097437048869413,23,10,13,33,0.3870461363608221,0.4814958227640819
성장률/NNG;둔화할/VVX,0,-0.1097437048869413,23,10,13,18,0.3870461363608221,0.4814958227640819
금리인하/NNG;가능성/NNG;열려/VV,-1,-0.10986790467117868,52,23,29,77,0.4664328333244074,0.580400705776675
성장세/NNG;둔화하/VVX,-1,-0.1114896094468838,32,14,18,34,0.41357432539515443,0.5163168551661342
원자재가격/NNG;하락/NNG;따른/VV,-1,-0.1114896094468838,32,14,18,56,0.41357432539515443,0.5163168551661342
심리지표/NNG;개선되/VVX,-1,-0.1114896094468838,32,14,18,36,0.41357432539515443,0.5163168551661342
기준금리/NNG;낮출/VV,0,-0.11161539695369804,81,36,45,90,0.5198219907134191,0.649124271623241
금리인하/NNG;단행할/VVX,0,-0.11220036885977636,275,122,153,329,0.588828998330825,0.7361666802993305
금리급등/NNG;따른/VV,-1,-0.11281028982418784,61,27,34,116,0.4841415973260646,0.6060313865515728
소비/NNG;위축될/VVX,-1,-0.11425620359079869,41,18,23,46,0.4369768143260386,0.5485945527746608
시장금리/NNG;큰/VA;상승하/VVX,-1,-0.11425620359079869,41,18,23,40,0.4369768143260386,0.5485945527746608
환율하락/NNG;따른/VV,0,-0.11449292960681323,117,52,65,169,0.5574640479694524,0.7001933600719361
금리/NNG;오를/VV,0,-0.11540870499709954,271,120,151,421,0.5864788399529007,0.7380033481872478
기준금리/NNG;인하될/VVX,0,-0.11965698552047821,437,193,244,685,0.5835050855076325,0.7406049882318152
금리/NNG;동결되/VVX,-1,-0.1206634354137347,68,30,38,99,0.49286245331999323,0.6268351809593768
리스크/NNG;꼽/VV,-1,-0.12251609126522844,30,13,17,48,0.40200245454371586,0.5132006212226292
금리급락/NNG;따른/VV,-1,-0.12251609126522844,30,13,17,49,0.40200245454371586,0.5132006212226292
수입/NNG;늘/VV,-1,-0.12251609126522844,30,13,17,50,0.40200245454371586,0.5132006212226292
유가하락/NNG;부추겼/VV,-1,-0.12251609126522844,30,13,17,44,0.40200245454371586,0.5132006212226292
금융안정/NNG;유의해/VVX,-1,-0.12251609126522844,30,13,17,12,0.40200245454371586,0.5132006212226292
금리/NNG;기준금리/NNG;하회하/VVX,-1,-0.12251609126522844,30,13,17,88,0.40200245454371586,0.5132006212226292
기준금리인상/NNG;반영하/VVX,-1,-0.12251609126522844,30,13,17,22,0.40200245454371586,0.5132006212226292
투자심리/NNG;개선될/VVX,-1,-0.12308141200297085,39,17,22,33,0.42691732835795876,0.5456322540326223
양적완화/NNG;하/VV,-1,-0.12308141200297085,39,17,22,37,0.42691732835795876,0.5456322540326223
마이너스/NNG;나타내/VV,-1,-0.12308141200297085,39,17,22,55,0.42691732835795876,0.5456322540326223
안전자산선호현상/NNG;강화되/VVX,-1,-0.12308141200297085,39,17,22,51,0.42691732835795876,0.5456322540326223
경기회복/NNG;지연될/VVX,-1,-0.12308141200297085,39,17,22,43,0.42691732835795876,0.5456322540326223
불확실성/NNG;키우/VV,-1,-0.12308141200297085,39,17,22,56,0.42691732835795876,0.5456322540326223
gdp/NNG;증가했/VVX,-1,-0.12437947364715662,48,21,27,69,0.4488924977337131,0.5752304253829323
소비/NNG;둔화되/VVX,0,-0.12515629527134664,21,9,12,36,0.3729760810804301,0.47870155188383634
금리인상/NNG;멈출/VV,0,-0.12515629527134664,21,9,12,39,0.3729760810804301,0.47870155188383634
성장둔화/NNG;따른/VV,0,-0.12515629527134664,21,9,12,33,0.3729760810804301,0.47870155188383634
금리/NNG;상승세/NNG;진정되/VVX,0,-0.12515629527134664,21,9,12,31,0.3729760810804301,0.47870155188383634
유동성/NNG;떨어지/VV,0,-0.12515629527134664,21,9,12,56,0.3729760810804301,0.47870155188383634
대외불확실성/NNG;커지/VV,0,-0.12515629527134664,21,9,12,34,0.3729760810804301,0.47870155188383634
경기/NNG;살아날/VV,0,-0.12515629527134664,21,9,12,43,0.3729760810804301,0.47870155188383634
금리/NNG;올린다/VV,0,-0.12515629527134664,21,9,12,16,0.3729760810804301,0.47870155188383634
신용경색/NNG;지속되/VVX,0,-0.12515629527134664,21,9,12,10,0.3729760810804301,0.47870155188383634
정책금리/NNG;결정하/VVX,0,-0.12515629527134664,21,9,12,19,0.3729760810804301,0.47870155188383634
금리/NNG;인하될/VVX,0,-0.1307801244430563,166,73,93,164,0.5683160355555956,0.7377890519612312
물가/NNG;오를/VV,0,-0.13128508625536595,100,44,56,126,0.5310206215601814,0.6900797043737795
투자심리/NNG;위축될/VVX,-1,-0.1324065150261533,46,20,26,82,0.43958876684537557,0.5725642155418034
채권시장/NNG;국채가격/NNG;떨어진/VV,-1,-0.1324065150261533,46,20,26,36,0.43958876684537557,0.5725642155418034
금리인하/NNG;단행해/VVX,-1,-0.13260708366594676,55,24,31,43,0.46006570859650997,0.5994797647086739
투자심리/NNG;회복되/VVX,-1,-0.13260708366594676,55,24,31,123,0.46006570859650997,0.5994797647086739
변동성/NNG;보이/VV,-1,-0.1327143116671533,37,16,21,56,0.4163630361332983,0.5426521006848133
경기회복/NNG;기대하/VVX,-1,-0.1327143116671533,37,16,21,41,0.4163630361332983,0.5426521006848133
경기선행지수/NNG;상승하/VVX,-1,-0.1327143116671533,37,16,21,57,0.4163630361332983,0.5426521006848133
금리/NNG;낮춰/VV,-1,-0.1327997984151501,64,28,36,89,0.4781586107957945,0.6232994876044801
금리인하/NNG;나서/VV,0,-0.13411050122673962,132,58,74,175,0.5536189820500641,0.7235908328638813
시장금리/NNG;하/VV,-1,-0.13494580938979317,28,12,16,45,0.38965207011745057,0.5101487503375061
신용경색/NNG;심화되/VVX,-1,-0.13494580938979317,28,12,16,18,0.38965207011745057,0.5101487503375061
물가/NNG;올랐/VV,-1,-0.13494580938979317,28,12,16,40,0.38965207011745057,0.5101487503375061
금리/NNG;상승세/NNG;재개될/VVX,-1,-0.13494580938979317,28,12,16,65,0.38965207011745057,0.5101487503375061
금리인상/NNG;신중해/VVX,-1,-0.13494580938979317,28,12,16,35,0.38965207011745057,0.5101487503375061
내수/NNG;살리/VV,-1,-0.13494580938979317,28,12,16,33,0.38965207011745057,0.5101487503375061
기준금리동결/NNG;예상했/VVX,-1,-0.13494580938979317,28,12,16,43,0.38965207011745057,0.5101487503375061
임금상승/NNG;따른/VV,-1,-0.13494580938979317,28,12,16,23,0.38965207011745057,0.5101487503375061
금리상승/NNG;작용했/VVX,-1,-0.13494580938979317,28,12,16,41,0.38965207011745057,0.5101487503375061
금리/NNG;인하할/VVX,0,-0.13845640448616658,735,321,414,773,0.5697471303753019,0.7512845185135714
경기침체/NNG;따른/VV,0,-0.13908310443421934,105,46,59,78,0.5307730243879955,0.7007858010082386
성장률/NNG;둔화될/VVX,-1,-0.14000773497230456,53,23,30,116,0.45143810971791937,0.5971623950375888
유동성/NNG;공급할/VVX,0,-0.14064675609159372,96,42,54,127,0.5205689388274036,0.6895055798358622
경제성장/NNG;위해/VV,-1,-0.14103975720107242,44,19,25,56,0.4298848470823828,0.569848468044828
소비자물가/NNG;상승해/VVX,-1,-0.14103975720107242,44,19,25,36,0.4298848470823828,0.569848468044828
수입/NNG;줄/VV,-1,-0.14329875149984217,35,15,20,40,0.40524381673496945,0.5396635511274294
자산/NNG;매입하/VVX,-1,-0.14329875149984217,35,15,20,71,0.40524381673496945,0.5396635511274294
금리인하/NNG;가능성/NNG;반영하/VVX,-1,-0.14329875149984217,35,15,20,40,0.40524381673496945,0.5396635511274294
고용지표호조/NNG;따른/VV,-1,-0.14329875149984217,35,15,20,55,0.40524381673496945,0.5396635511274294
인플레이션기대/NNG;억제하/VVX,0,-0.14368781166296551,19,8,11,17,0.357295120344275,0.47618780004099304
경기/NNG;위축시/VVX,0,-0.14368781166296551,19,8,11,27,0.357295120344275,0.47618780004099304
경기부진/NNG;이어지/VV,0,-0.14368781166296551,19,8,11,21,0.357295120344275,0.47618780004099304
지정학적리스크/NNG;인해/VV,0,-0.14368781166296551,19,8,11,21,0.357295120344275,0.47618780004099304
금리/NNG;안정될/VVX,0,-0.14368781166296551,19,8,11,32,0.357295120344275,0.47618780004099304
재정정책/NNG;필요하/VVX,0,-0.14368781166296551,19,8,11,21,0.357295120344275,0.47618780004099304
콜금리/NNG;인하할/VVX,0,-0.14368781166296551,19,8,11,40,0.357295120344275,0.47618780004099304
경기둔화우려/NNG;지속되/VVX,0,-0.14368781166296551,19,8,11,27,0.357295120344275,0.47618780004099304
원자재가격/NNG;급락하/VVX,0,-0.14368781166296551,19,8,11,19,0.357295120344275,0.47618780004099304
소비/NNG;증가할/VVX,0,-0.14368781166296551,19,8,11,26,0.357295120344275,0.47618780004099304
경기부양책/NNG;필요하/VVX,0,-0.14368781166296551,19,8,11,8,0.357295120344275,0.47618780004099304
불안요인/NNG;되/VV,0,-0.14368781166296551,19,8,11,23,0.357295120344275,0.47618780004099304
시장금리/NNG;반등하/VVX,0,-0.14368781166296551,19,8,11,25,0.357295120344275,0.47618780004099304
금리/NNG;내려왔/VV,0,-0.14368781166296551,19,8,11,13,0.357295120344275,0.47618780004099304
경기회복/NNG;확인하/VVX,0,-0.14368781166296551,19,8,11,22,0.357295120344275,0.47618780004099304
성장/NNG;미치/VV,0,-0.14368781166296551,19,8,11,37,0.357295120344275,0.47618780004099304
경기회복/NNG;위해/VV,0,-0.14388085730267997,119,52,67,166,0.5388970177307456,0.7185018732699001
채권시장/NNG;부담/NNG;될/VV,-1,-0.14623075607774816,60,26,34,71,0.4624063998270417,0.6194804544489363
금리/NNG;안정되/VVX,-1,-0.14623075607774816,60,26,34,93,0.4624063998270417,0.6194804544489363
소비/NNG;위축되/VVX,-1,-0.14623075607774816,60,26,34,80,0.4624063998270417,0.6194804544489363
경제성장률/NNG;상향조정하/VVX,-1,-0.14913280213613822,26,11,15,45,0.3763485095950794,0.5071853968853641
불안/NNG;확대되/VVX,-1,-0.14913280213613822,26,11,15,29,0.3763485095950794,0.5071853968853641
성장세/NNG;확대될/VVX,-1,-0.14913280213613822,26,11,15,22,0.3763485095950794,0.5071853968853641
경제/NNG;타격/NNG;받/VV,-1,-0.14913280213613822,26,11,15,37,0.3763485095950794,0.5071853968853641
경제/NNG;나아질/VV,-1,-0.14913280213613822,26,11,15,16,0.3763485095950794,0.5071853968853641
금리/NNG;상승세/NNG;예상된/VVX,-1,-0.14913280213613822,26,11,15,26,0.3763485095950794,0.5071853968853641
투자심리/NNG;악화되/VVX,-1,-0.14913280213613822,26,11,15,31,0.3763485095950794,0.5071853968853641
금리인상/NNG;시작될/VVX,-1,-0.15036669064312225,42,18,24,62,0.4197383655275602,0.5670871093309052
소비/NNG;늘리/VV,-1,-0.15036669064312225,42,18,24,54,0.4197383655275602,0.5670871093309052
성장세/NNG;지속하/VVX,-1,-0.15132044835321645,67,29,38,87,0.47248243920074406,0.6395921568142646
내수/NNG;살아나/VV,-1,-0.15501878526825064,33,14,19,53,0.3934697806151348,0.5366770782591148
소비자물가/NNG;상승할/VVX,-1,-0.15501878526825064,33,14,19,66,0.3934697806151348,0.5366770782591148
경기회복/NNG;나타나/VV,-1,-0.15501878526825064,33,14,19,43,0.3934697806151348,0.5366770782591148
소비/NNG;살아나/VV,-1,-0.15501878526825064,33,14,19,44,0.3934697806151348,0.5366770782591148
재할인율/NNG;인하하/VVX,-1,-0.15501878526825064,33,14,19,44,0.3934697806151348,0.5366770782591148
금리/NNG;큰/VA;하락하/VVX,0,-0.1583333206455907,97,42,55,145,0.5099946761901956,0.7003480722715036
경제지표/NNG;둔화되/VVX,-1,-0.16049476562366582,40,17,23,77,0.4090972622580614,0.5642844596042553
재정적자/NNG;줄이/VV,-1,-0.16049476562366582,40,17,23,98,0.4090972622580614,0.5642844596042553
경기둔화/NNG;지속되/VVX,-1,-0.16049476562366582,40,17,23,57,0.4090972622580614,0.5642844596042553
기준금리/NNG;올리/VV;않/VX,-1,-0.16121282623045086,56,24,32,82,0.44547925555558054,0.6153726941584627
경기회복/NNG;진행되/VVX,-1,-0.16121282623045086,56,24,32,44,0.44547925555558054,0.6153726941584627
성장세회복/NNG;이어지/VV,-1,-0.1618383141774733,72,31,41,47,0.4745120567529874,0.6563189165643182
변동성/NNG;커지/VV,0,-0.16442984425147755,167,72,95,213,0.5442077601958477,0.7567303021967289
환율상승/NNG;따른/VV,-1,-0.1648258461419222,79,34,45,94,0.48336530216381063,0.6726742912956829
금리인상/NNG;지지하/VVX,-1,-0.16524777037537985,63,27,36,76,0.4567831088699628,0.6362320079480147
금리인하/NNG;예상되/VVX,-1,-0.16524777037537985,63,27,36,50,0.4567831088699628,0.6362320079480147
금리/NNG;낮췄/VV,-1,-0.16530366754378423,47,20,27,50,0.423414155186435,0.589821614923284
기준금리/NNG;내려야/VV,-1,-0.16530366754378423,47,20,27,54,0.423414155186435,0.589821614923284
금리/NNG;인하되/VVX,-1,-0.16530366754378423,47,20,27,58,0.423414155186435,0.589821614923284
성장/NNG;달성하/VVX,-1,-0.16530366754378423,47,20,27,68,0.423414155186435,0.589821614923284
경기회복세/NNG;보이/VV,-1,-0.16557103761322423,24,10,14,32,0.361849039431999,0.5043373261764251
경제지표개선/NNG;따른/VV,-1,-0.16557103761322423,24,10,14,26,0.361849039431999,0.5043373261764251
금리/NNG;낮/VA;수준이/VVX,-1,-0.16557103761322423,24,10,14,42,0.361849039431999,0.5043373261764251
금리인상/NNG;가능성/NNG;낮추/VV,-1,-0.16557103761322423,24,10,14,27,0.361849039431999,0.5043373261764251
소비자물가상승률/NNG;기록하/VVX,-1,-0.16557103761322423,24,10,14,46,0.361849039431999,0.5043373261764251
생산/NNG;늘리/VV,-1,-0.16557103761322423,24,10,14,22,0.361849039431999,0.5043373261764251
금리인상/NNG;전망했/VVX,-1,-0.16557103761322423,24,10,14,44,0.361849039431999,0.5043373261764251
금리인하기대감/NNG;형성되/VVX,-1,-0.16557103761322423,24,10,14,25,0.361849039431999,0.5043373261764251
견실한/VAX;경제성장/NNG;지속되/VVX,0,-0.1666160551210698,17,7,10,38,0.33937270106590545,0.47402636269646314
금리/NNG;상승세/NNG;돌아섰/VV,0,-0.1666160551210698,17,7,10,15,0.33937270106590545,0.47402636269646314
내수부진/NNG;이어지/VV,0,-0.1666160551210698,17,7,10,28,0.33937270106590545,0.47402636269646314
불안/NNG;해소되/VVX,0,-0.1666160551210698,17,7,10,40,0.33937270106590545,0.47402636269646314
불안/NNG;키우/VV,0,-0.1666160551210698,17,7,10,12,0.33937270106590545,0.47402636269646314
금리인상/NNG;반영해/VVX,0,-0.1666160551210698,17,7,10,18,0.33937270106590545,0.47402636269646314
리스크/NNG;존재한/VVX,0,-0.1666160551210698,17,7,10,24,0.33937270106590545,0.47402636269646314
물가상승압력/NNG;확대될/VVX,0,-0.1666160551210698,17,7,10,25,0.33937270106590545,0.47402636269646314
고용지표개선/NNG;따른/VV,0,-0.1666160551210698,17,7,10,26,0.33937270106590545,0.47402636269646314
경제/NNG;침체되/VVX,0,-0.1666160551210698,17,7,10,31,0.33937270106590545,0.47402636269646314
완화적/VAX;통화정책/NNG;지속하/VVX,0,-0.1666160551210698,17,7,10,14,0.33937270106590545,0.47402636269646314
채권시장/NNG;약세/NNG;보일/VV,0,-0.1666160551210698,17,7,10,13,0.33937270106590545,0.47402636269646314
경제/NNG;회복된/VVX,0,-0.1666160551210698,17,7,10,16,0.33937270106590545,0.47402636269646314
금융시장/NNG;충격/NNG;받/VV,0,-0.1666160551210698,17,7,10,12,0.33937270106590545,0.47402636269646314
금리인상/NNG;이뤄진/VV,0,-0.1666160551210698,17,7,10,7,0.33937270106590545,0.47402636269646314
인플레이션우려/NNG;완화된/VVX,0,-0.1666160551210698,17,7,10,19,0.33937270106590545,0.47402636269646314
기준금리인상/NNG;예상된/VVX,0,-0.1666160551210698,17,7,10,28,0.33937270106590545,0.47402636269646314
하방압력/NNG;완화되/VVX,0,-0.1666160551210698,17,7,10,7,0.33937270106590545,0.47402636269646314
금리하락/NNG;주도했/VVX,0,-0.1666160551210698,17,7,10,16,0.33937270106590545,0.47402636269646314
고용/NNG;감소해/VVX,0,-0.1666160551210698,17,7,10,12,0.33937270106590545,0.47402636269646314
안전자산선호현상/NNG;강화돼/VVX,-1,-0.16811407441997672,31,13,18,26,0.38092408395273897,0.533704016538853
수출/NNG;늘리/VV,-1,-0.16811407441997672,31,13,18,45,0.38092408395273897,0.533704016538853
물가/NNG;자극하/VVX,-1,-0.16811407441997672,31,13,18,30,0.38092408395273897,0.533704016538853
불확실성/NNG;증대되/VVX,-1,-0.16811407441997672,31,13,18,57,0.38092408395273897,0.533704016538853
고용/NNG;증가해/VVX,-1,-0.16811407441997672,31,13,18,31,0.38092408395273897,0.533704016538853
성장세/NNG;이어질/VV,-1,-0.1685098438716287,70,30,40,64,0.4670978097454233,0.6549725033799703
경제/NNG;회복세/NNG;보이/VV,0,-0.17034712484385284,100,43,57,119,0.5050724613053638,0.7109011383777872
정책금리/NNG;동결하/VVX,-1,-0.171099660054004,77,33,44,94,0.4764730650879408,0.6716855784234009
경기/NNG;바닥/NNG;찍/VV,-1,-0.1715575896164494,38,16,22,29,0.3978969054805635,0.5614451438477619
금리/NNG;하락세/NNG;이어질/VV,-1,-0.1715575896164494,38,16,22,78,0.3978969054805635,0.5614451438477619
안전자산선호/NNG;약화되/VVX,-1,-0.1715575896164494,38,16,22,71,0.3978969054805635,0.5614451438477619
금융시장/NNG;안정/NNG;되찾/VV,-1,-0.1715575896164494,38,16,22,42,0.3978969054805635,0.5614451438477619
불안/NNG;커지/VV,-1,-0.17499675462711917,45,19,26,66,0.41324816615917487,0.5872489599869569
소비/NNG;늘/VV,-1,-0.18071329157286165,59,25,34,61,0.43992238396740924,0.6325666507758632
경기/NNG;살리/VV,0,-0.18166988827517028,103,44,59,131,0.5003193171583467,0.7208338022558914
장단기금리차/NNG;축소되/VVX,-1,-0.18284023322417087,66,28,38,86,0.4514871579228411,0.6520531071464236
콜금리/NNG;동결했/VVX,-1,-0.18290290226726202,29,12,17,30,0.36745256973908336,0.5307562015960269
기준금리인하/NNG;단행했/VVX,-1,-0.18290290226726202,29,12,17,26,0.36745256973908336,0.5307562015960269
산업생산/NNG;감소하/VVX,-1,-0.18290290226726202,29,12,17,26,0.36745256973908336,0.5307562015960269
침체/NNG;빠진/VV,-1,-0.18372357103934067,36,15,21,47,0.38605618271156705,0.5585739257725093
불안요인/NNG;상존하/VVX,-1,-0.18372357103934067,36,15,21,71,0.38605618271156705,0.5585739257725093
하방리스크/NNG;작용할/VVX,-1,-0.18372357103934067,36,15,21,29,0.38605618271156705,0.5585739257725093
성장/NNG;둔화하/VVX,-1,-0.18497175045489556,22,9,13,41,0.3458083855762923,0.5016329483966647
양적완화/NNG;통한/VV,-1,-0.18497175045489556,22,9,13,39,0.3458083855762923,0.5016329483966647
리스크/NNG;감수하/VVX,-1,-0.18497175045489556,22,9,13,22,0.3458083855762923,0.5016329483966647
금리상승/NNG;억제하/VVX,-1,-0.18497175045489556,22,9,13,27,0.3458083855762923,0.5016329483966647
gdp/NNG;증가해/VVX,-1,-0.18497175045489556,22,9,13,31,0.3458083855762923,0.5016329483966647
경기/NNG;바닥/NNG;다지/VV,-1,-0.18497175045489556,22,9,13,24,0.3458083855762923,0.5016329483966647
불안요인/NNG;작용할/VVX,-1,-0.1856908231279636,80,34,46,113,0.47150204585718924,0.6849830237146031
금리상승/NNG;작용할/VVX,-1,-0.1873798885357847,50,21,29,68,0.4175039876450875,0.608659287610562
소비자물가지수/NNG;상승해/VVX,-1,-0.1873798885357847,50,21,29,58,0.4175039876450875,0.608659287610562
정책금리/NNG;동결할/VVX,-1,-0.1873798885357847,50,21,29,35,0.4175039876450875,0.608659287610562
불확실성/NNG;부각되/VVX,-1,-0.18912008893086674,57,24,33,78,0.4310092465993656,0.6306154158401065
금리인하/NNG;단행될/VVX,0,-0.1902250227217389,153,65,88,213,0.5220671930028561,0.7655935031258566
금리/NNG;인하하/VVX;않/VX,-1,-0.19237906332992571,78,33,45,84,0.4644379014573721,0.6841293110644573
기준금리/NNG;인하할/VVX,0,-0.19343019936471706,651,275,376,870,0.528925778541605,0.7808218087995815
변동성/NNG;장세/NNG;예상되/VVX,0,-0.19606488790020915,15,6,9,17,0.31818631861849517,0.47229490837543425
금리하락/NNG;기대하/VVX,0,-0.19606488790020915,15,6,9,32,0.31818631861849517,0.47229490837543425
원자재가격/NNG;급등하/VVX,0,-0.19606488790020915,15,6,9,27,0.31818631861849517,0.47229490837543425
불확실성/NNG;자리/NNG;잡/VV,0,-0.19606488790020915,15,6,9,13,0.31818631861849517,0.47229490837543425
기준금리/NNG;인하할/VVX;가능성/NNG;낮/VA,0,-0.19606488790020915,15,6,9,18,0.31818631861849517,0.47229490837543425
금리인상/NNG;중단해/VVX,0,-0.19606488790020915,15,6,9,6,0.31818631861849517,0.47229490837543425
기준금리/NNG;올려도/VV,0,-0.19606488790020915,15,6,9,21,0.31818631861849517,0.47229490837543425
기준금리/NNG;인하한/VAX;이/VV,0,-0.19606488790020915,15,6,9,17,0.31818631861849517,0.47229490837543425
물가/NNG;오른/VV,0,-0.19606488790020915,15,6,9,22,0.31818631861849517,0.47229490837543425
디레버리징/NNG;진행되/VVX,0,-0.19606488790020915,15,6,9,25,0.31818631861849517,0.47229490837543425
높/VA;변동성/NNG;보였/VV,0,-0.19606488790020915,15,6,9,10,0.31818631861849517,0.47229490837543425
성장세/NNG;보인/VV,0,-0.19606488790020915,15,6,9,28,0.31818631861849517,0.47229490837543425
디플레이션/NNG;겪/VV,0,-0.19606488790020915,15,6,9,9,0.31818631861849517,0.47229490837543425
고용/NNG;늘릴/VV,0,-0.19606488790020915,15,6,9,12,0.31818631861849517,0.47229490837543425
글로벌/NNG;금리/NNG;상승하/VVX,0,-0.19606488790020915,15,6,9,25,0.31818631861849517,0.47229490837543425
기준금리/NNG;하/VV,0,-0.19606488790020915,15,6,9,19,0.31818631861849517,0.47229490837543425
금리인상/NNG;시사해/VVX,0,-0.19606488790020915,15,6,9,16,0.31818631861849517,0.47229490837543425
자산/NNG;증가하/VVX,0,-0.19606488790020915,15,6,9,30,0.31818631861849517,0.47229490837543425
금리상승/NNG;키웠/VV,0,-0.19606488790020915,15,6,9,11,0.31818631861849517,0.47229490837543425
수출/NNG;위축되/VVX,0,-0.19606488790020915,15,6,9,20,0.31818631861849517,0.47229490837543425
수입/NNG;감소했/VVX,0,-0.19606488790020915,15,6,9,18,0.31818631861849517,0.47229490837543425
인플레이션우려/NNG;부각돼/VVX,0,-0.19606488790020915,15,6,9,10,0.31818631861849517,0.47229490837543425
경기회복세/NNG;지속하/VVX,0,-0.19606488790020915,15,6,9,20,0.31818631861849517,0.47229490837543425
리스크관리/NNG;강화할/VVX,0,-0.19606488790020915,15,6,9,10,0.31818631861849517,0.47229490837543425
금리/NNG;안정세/NNG;보이/VV,0,-0.19606488790020915,15,6,9,13,0.31818631861849517,0.47229490837543425
흑자/NNG;유지할/VVX,0,-0.19606488790020915,15,6,9,7,0.31818631861849517,0.47229490837543425
임금/NNG;오르/VV;않/VX,0,-0.19606488790020915,15,6,9,13,0.31818631861849517,0.47229490837543425
성장률/NNG;높일/VV,0,-0.19606488790020915,15,6,9,17,0.31818631861849517,0.47229490837543425
경제/NNG;호전되/VVX,0,-0.19606488790020915,15,6,9,23,0.31818631861849517,0.47229490837543425
금리인상/NNG;중단하/VVX,-1,-0.19685207448618336,41,17,24,48,0.3914022844965414,0.58192239873914
소비자물가/NNG;오르/VV,-1,-0.19720818984475263,34,14,20,28,0.3734721463257168,0.5556754205832829
변동성/NNG;키우/VV,-1,-0.19733494896696324,48,20,28,62,0.4073708895287949,0.6062717348256513
마이너스/NNG;돌아섰/VV,-1,-0.19733494896696324,48,20,28,31,0.4073708895287949,0.6062717348256513
경제지표/NNG;호조/NNG;보인/VV,-1,-0.19733494896696324,48,20,28,77,0.4073708895287949,0.6062717348256513
경기/NNG;둔화될/VVX,-1,-0.197865376076807,104,44,60,149,0.49026270949179673,0.7304404249296707
기준금리/NNG;인하해/VVX,0,-0.19830748302216228,180,76,104,223,0.5214826492301956,0.7776690214583168
실물경제/NNG;미치/VV;영향/NNG,-1,-0.19868593805741608,62,26,36,78,0.4347357660304338,0.6488165453797329
테이퍼링/NNG;따른/VV,-1,-0.1998174680036352,27,11,16,42,0.35284859080417147,0.5278452456264354
금리동결/NNG;지속될/VVX,-1,-0.1998174680036352,27,11,16,47,0.35284859080417147,0.5278452456264354
성장률/NNG;개선될/VVX,-1,-0.1998174680036352,27,11,16,41,0.35284859080417147,0.5278452456264354
불안요인/NNG;될/VV,-1,-0.1998174680036352,27,11,16,39,0.35284859080417147,0.5278452456264354
재정지출/NNG;늘리/VV,-1,-0.1998174680036352,27,11,16,46,0.35284859080417147,0.5278452456264354
경기/NNG;상승기조/NNG;이/VV,-1,-0.1998174680036352,27,11,16,19,0.35284859080417147,0.5278452456264354
금리인상/NNG;단행했/VVX,0,-0.20100249459120445,154,65,89,147,0.5145183003487263,0.771595259396825
금리/NNG;큰/VA;상승하/VVX,-1,-0.20700990056753832,67,28,39,129,0.438339638611942,0.6656324309134911
변동성/NNG;확대됐/VVX,-1,-0.20804592832519786,46,19,27,50,0.39676766117314743,0.6038077929586437
실업률/NNG;상승하/VVX,-1,-0.20804592832519786,46,19,27,74,0.39676766117314743,0.6038077929586437
유동성/NNG;관리하/VVX,0,-0.2083973068535806,20,8,12,23,0.32772270366858036,0.49909985748094504
기준금리인상/NNG;가능성/NNG;커지/VV,0,-0.2083973068535806,20,8,12,12,0.32772270366858036,0.49909985748094504
고용/NNG;감소하/VVX,0,-0.2083973068535806,20,8,12,15,0.32772270366858036,0.49909985748094504
기준금리인하/NNG;기대하/VVX,0,-0.2083973068535806,20,8,12,51,0.32772270366858036,0.49909985748094504
성장률/NNG;상회하/VVX,0,-0.2083973068535806,20,8,12,33,0.32772270366858036,0.49909985748094504
연방기금금리/NNG;인상하/VVX,0,-0.2083973068535806,20,8,12,32,0.32772270366858036,0.49909985748094504
긴축정책/NNG;펴/VV,0,-0.2083973068535806,20,8,12,42,0.32772270366858036,0.49909985748094504
주택가격/NNG;상승하/VVX,0,-0.2083973068535806,20,8,12,37,0.32772270366858036,0.49909985748094504
투자심리/NNG;살아나/VV,0,-0.2083973068535806,20,8,12,33,0.32772270366858036,0.49909985748094504
양적완화/NNG;종료되/VVX,0,-0.2083973068535806,20,8,12,50,0.32772270366858036,0.49909985748094504
기준금리인하/NNG;나서/VV,0,-0.2083973068535806,20,8,12,36,0.32772270366858036,0.49909985748094504
성장세/NNG;둔화된/VVX,0,-0.2083973068535806,20,8,12,14,0.32772270366858036,0.49909985748094504
금리/NNG;상승세/NNG;지속될/VVX,-1,-0.20928832537558817,39,16,23,72,0.37959251790254694,0.5791703868728818
금리/NNG;크/VA;상승하/VVX,-1,-0.21229175034442815,32,13,19,51,0.3600126006166193,0.5527536171605514
금리인하/NNG;기대하/VVX;어렵/VA,-1,-0.21229175034442815,32,13,19,37,0.3600126006166193,0.5527536171605514
금리인상/NNG;고려하/VVX,-1,-0.21229175034442815,32,13,19,44,0.3600126006166193,0.5527536171605514
변동성/NNG;줄여/VV,-1,-0.21229175034442815,32,13,19,86,0.3600126006166193,0.5527536171605514
안전자산선호현상/NNG;약화되/VVX,-1,-0.21229175034442815,32,13,19,43,0.3600126006166193,0.5527536171605514
금리/NNG;하락세/NNG;보였/VV,-1,-0.21635000667086013,58,24,34,89,0.4166977465182194,0.6452426958868236
소비/NNG;위축시/VVX,-1,-0.21767015992260608,51,21,30,52,0.40203661353463055,0.6242646251320747
금융위기/NNG;벗어나/VV,-1,-0.2194595676083817,25,10,15,27,0.33683043305448657,0.524981174797855
지준율/NNG;인하하/VVX,-1,-0.2194595676083817,25,10,15,20,0.33683043305448657,0.524981174797855
인플레이션/NNG;달성하/VVX,-1,-0.2194595676083817,25,10,15,30,0.33683043305448657,0.524981174797855
변동성/NNG;지속될/VVX,-1,-0.2194595676083817,25,10,15,36,0.33683043305448657,0.524981174797855
가계부채/NNG;증가세/NNG;점검해/VVX,-1,-0.2194595676083817,25,10,15,17,0.33683043305448657,0.524981174797855
금리상승압력/NNG;가중될/VVX,-1,-0.2194595676083817,25,10,15,14,0.33683043305448657,0.524981174797855
투자심리/NNG;안정시/VVX,-1,-0.21962340269169645,44,18,26,55,0.38564263443050467,0.6012660590609389
유동성/NNG;공급해/VVX,-1,-0.22060259898518086,77,32,45,81,0.4450629460128539,0.6953369263049326
시장금리/NNG;오르/VV,-1,-0.22297204403076298,37,15,22,75,0.36707859148633376,0.5763595996741987
지준율/NNG;인상하/VVX,-1,-0.22297204403076298,37,15,22,56,0.36707859148633376,0.5763595996741987
경기/NNG;부진하/VVX,-1,-0.22297204403076298,37,15,22,46,0.36707859148633376,0.5763595996741987
침체/NNG;빠졌/VV,-1,-0.22297204403076298,37,15,22,32,0.36707859148633376,0.5763595996741987
경기/NNG;부양할/VVX,-1,-0.22297204403076298,37,15,22,36,0.36707859148633376,0.5763595996741987
금융위기/NNG;따른/VV,-1,-0.22398951726205996,89,37,52,71,0.4578925978086907,0.7204877955150254
경제성장/NNG;둔화될/VVX,-1,-0.22853108249615162,49,20,29,78,0.39152488458293905,0.6219742052936815
수출/NNG;부진했/VVX,-1,-0.2293455890016196,30,12,18,27,0.3455057418403217,0.549811099484362
물가/NNG;영향/NNG;미칠/VV,-1,-0.2293455890016196,30,12,18,21,0.3455057418403217,0.549811099484362
통화완화/NNG;나서/VV,-1,-0.2293455890016196,30,12,18,28,0.3455057418403217,0.549811099484362
임금/NNG;오르/VV,-1,-0.2293455890016196,30,12,18,32,0.3455057418403217,0.549811099484362
더블딥/NNG;빠질/VV,-1,-0.2322029789615384,42,17,25,38,0.3739332735003143,0.5986445352043197
주택시장침체/NNG;따른/VV,-1,-0.2322029789615384,42,17,25,51,0.3739332735003143,0.5986445352043197
투자심리/NNG;개선되/VVX,-1,-0.23318845383326436,61,25,36,113,0.4120319766525043,0.661011677786909
경기부양/NNG;나서/VV,-1,-0.2336029370630256,80,33,47,114,0.4407684287595351,0.707731850328302
가계부채/NNG;따른/VV,0,-0.23750393031217287,18,7,11,14,0.3068364779565684,0.49675928090140814
금리인상/NNG;나타날/VV,0,-0.23750393031217287,18,7,11,20,0.3068364779565684,0.49675928090140814
수출/NNG;영향/NNG;미치/VV,0,-0.23750393031217287,18,7,11,21,0.3068364779565684,0.49675928090140814
기준금리/NNG;내려도/VV,0,-0.23750393031217287,18,7,11,8,0.3068364779565684,0.49675928090140814
금리상승/NNG;견인할/VVX,0,-0.23750393031217287,18,7,11,23,0.3068364779565684,0.49675928090140814
경제성장률/NNG;유지하/VVX,0,-0.23750393031217287,18,7,11,27,0.3068364779565684,0.49675928090140814
금리인하기대/NNG;지속되/VVX,0,-0.23750393031217287,18,7,11,29,0.3068364779565684,0.49675928090140814
경제성장/NNG;하/VV,0,-0.23750393031217287,18,7,11,21,0.3068364779565684,0.49675928090140814
원자재가격/NNG;오르/VV,0,-0.23750393031217287,18,7,11,22,0.3068364779565684,0.49675928090140814
수출부진/NNG;지속될/VVX,0,-0.23750393031217287,18,7,11,12,0.3068364779565684,0.49675928090140814
흑자/NNG;유지하/VVX,0,-0.23750393031217287,18,7,11,35,0.3068364779565684,0.49675928090140814
유동성/NNG;풀리/VV,0,-0.23750393031217287,18,7,11,14,0.3068364779565684,0.49675928090140814
채권시장/NNG;부담/NNG;작용하/VVX,0,-0.23750393031217287,18,7,11,29,0.3068364779565684,0.49675928090140814
동결/NNG;주장하/VVX,0,-0.23750393031217287,18,7,11,12,0.3068364779565684,0.49675928090140814
경제성장률/NNG;머물/VV,0,-0.23750393031217287,18,7,11,31,0.3068364779565684,0.49675928090140814
소비/NNG;진작시/VVX,0,-0.23750393031217287,18,7,11,25,0.3068364779565684,0.49675928090140814
시장금리/NNG;오를/VV,-1,-0.23814717001546126,35,14,21,37,0.35374883436876414,0.5734890347109448
고용/NNG;늘/VV,-1,-0.23814717001546126,35,14,21,53,0.35374883436876414,0.5734890347109448
금리인상/NNG;시작할/VVX,-1,-0.23814717001546126,35,14,21,68,0.35374883436876414,0.5734890347109448
신용스프레드/NNG;축소되/VVX,-1,-0.23923474107845166,143,59,84,134,0.4834774830429449,0.7856085527535719
물가/NNG;하회하/VVX,-1,-0.2426911342013386,23,9,14,24,0.3190073275316964,0.5221699444171872
리스크/NNG;불거지/VV,-1,-0.2426911342013386,23,9,14,30,0.3190073275316964,0.5221699444171872
수출증가/NNG;힘입/VV,-1,-0.2426911342013386,23,9,14,36,0.3190073275316964,0.5221699444171872
경기/NNG;회복시/VVX,-1,-0.2426911342013386,23,9,14,40,0.3190073275316964,0.5221699444171872
취업자수/NNG;감소하/VVX,-1,-0.2426911342013386,23,9,14,12,0.3190073275316964,0.5221699444171872
기준금리/NNG;내려갈/VV,-1,-0.2426911342013386,23,9,14,38,0.3190073275316964,0.5221699444171872
금융위기/NNG;확산되/VVX,-1,-0.2426911342013386,23,9,14,14,0.3190073275316964,0.5221699444171872
기준금리/NNG;올려야/VV,-1,-0.2429167884265131,59,24,35,70,0.40258278689536303,0.6592866788267723
통화정책/NNG;완화할/VVX,-1,-0.24595278696580836,40,16,24,58,0.3615633296753756,0.5959403347317761
금리인하/NNG;할/VV,-1,-0.24870269000044687,64,26,38,75,0.40770839917313456,0.6759388238011943
금리/NNG;인하해/VVX;한다는/VX,-1,-0.24887158732804415,28,11,17,23,0.3297255831776417,0.546847790616649
물가/NNG;떨어지/VV,-1,-0.24887158732804415,28,11,17,34,0.3297255831776417,0.546847790616649
소비심리/NNG;위축시/VVX,-1,-0.24887158732804415,28,11,17,28,0.3297255831776417,0.546847790616649
금리인상/NNG;가능성/NNG;따른/VV,-1,-0.24887158732804415,28,11,17,40,0.3297255831776417,0.546847790616649
기준금리동결/NNG;예상되/VVX,-1,-0.24887158732804415,28,11,17,63,0.3297255831776417,0.546847790616649
양적완화정책/NNG;따른/VV,-1,-0.24887158732804415,28,11,17,21,0.3297255831776417,0.546847790616649
금리인상/NNG;유지할/VVX,-1,-0.24887158732804415,28,11,17,56,0.3297255831776417,0.546847790616649
경제/NNG;회복될/VVX,-1,-0.25323582291283653,57,23,34,69,0.392752700966901,0.6574624923428817
불확실성/NNG;해소됐/VVX,-1,-0.25323582291283653,57,23,34,80,0.392752700966901,0.6574624923428817
소비자물가지수/NNG;상승하/VVX,-1,-0.25512974174843184,33,13,20,57,0.3394619493654399,0.5705558716973469
불안/NNG;이어질/VV,-1,-0.25512974174843184,33,13,20,49,0.3394619493654399,0.5705558716973469
금리인상/NNG;가능성/NNG;높이/VV,-1,-0.25512974174843184,33,13,20,33,0.3394619493654399,0.5705558716973469
기준금리인상/NNG;위한/VV,-1,-0.25512974174843184,33,13,20,63,0.3394619493654399,0.5705558716973469
금융시장/NNG;안정되/VVX,-1,-0.25848405494103976,62,25,37,80,0.39838530767562225,0.6744093658937758
소비자물가지수/NNG;상승했/VVX,-1,-0.2589086181924207,50,20,30,59,0.3759349088222533,0.6369823348949134
리스크/NNG;확대되/VVX,-1,-0.2589086181924207,50,20,30,86,0.3759349088222533,0.6369823348949134
금리인하/NNG;가능성/NNG;배제할/VVX,-1,-0.2610837192679678,38,15,23,91,0.34843917034024824,0.5931492694450787
금리인하/NNG;통한/VV,-1,-0.26466176147664056,101,41,60,105,0.4423516942655852,0.7588164633194255
금리인하/NNG;단행하/VVX,-1,-0.2679117169971904,168,68,100,178,0.46826118668207145,0.8088901557699585
양적완화/NNG;줄이/VV,-1,-0.2707860921302482,21,8,13,60,0.29882809907812347,0.5194089632327504
성장/NNG;견인했/VVX,-1,-0.2707860921302482,21,8,13,17,0.29882809907812347,0.5194089632327504
물가/NNG;낮추/VV,-1,-0.2707860921302482,21,8,13,26,0.29882809907812347,0.5194089632327504
동결/NNG;유지될/VVX,-1,-0.2707860921302482,21,8,13,39,0.29882809907812347,0.5194089632327504
경제활성화/NNG;위해/VV,-1,-0.2707860921302482,21,8,13,37,0.29882809907812347,0.5194089632327504
경기불확실성/NNG;지속되/VVX,-1,-0.2707860921302482,21,8,13,42,0.29882809907812347,0.5194089632327504
금리상승/NNG;예상된/VVX,-1,-0.2707860921302482,21,8,13,41,0.29882809907812347,0.5194089632327504
경기둔화/NNG;반영하/VVX,-1,-0.2707860921302482,21,8,13,27,0.29882809907812347,0.5194089632327504
내수/NNG;회복세/NNG;약화되/VVX,-1,-0.2707860921302482,21,8,13,0,0.29882809907812347,0.5194089632327504
통화완화/NNG;유지할/VVX,-1,-0.2707860921302482,21,8,13,20,0.29882809907812347,0.5194089632327504
물가상승/NNG;이어질/VV,-1,-0.2707860921302482,21,8,13,25,0.29882809907812347,0.5194089632327504
경기둔화/NNG;가능성/NNG;시사하/VVX,-1,-0.2707860921302482,21,8,13,8,0.29882809907812347,0.5194089632327504
유동성/NNG;늘리/VV,-1,-0.2707860921302482,21,8,13,19,0.29882809907812347,0.5194089632327504
금리/NNG;상승세/NNG;이/VV,-1,-0.2707860921302482,21,8,13,54,0.29882809907812347,0.5194089632327504
불확실성/NNG;영향/NNG;받/VV,-1,-0.2707860921302482,21,8,13,16,0.29882809907812347,0.5194089632327504
기준금리/NNG;상향조정할/VVX,-1,-0.2707860921302482,21,8,13,34,0.29882809907812347,0.5194089632327504
정책금리/NNG;인하되/VVX,-1,-0.2707860921302482,21,8,13,30,0.29882809907812347,0.5194089632327504
침체/NNG;심화되/VVX,-1,-0.2707860921302482,21,8,13,11,0.29882809907812347,0.5194089632327504
시장금리상승/NNG;따른/VV,-1,-0.27156302016042977,26,10,16,24,0.3123714346766465,0.5438589329628224
기준금리/NNG;오르/VV,-1,-0.27156302016042977,26,10,16,53,0.3123714346766465,0.5438589329628224
큰/VA;금리/NNG;하락세/NNG;보였/VV,-1,-0.27156302016042977,26,10,16,24,0.3123714346766465,0.5438589329628224
경제/NNG;회복세/NNG;지속하/VVX,-1,-0.27156302016042977,26,10,16,42,0.3123714346766465,0.5438589329628224
경기활성화/NNG;위해/VV,-1,-0.27433582650755606,31,12,19,42,0.3240376342522263,0.5675544379929668
과잉유동성/NNG;따른/VV,-1,-0.27433582650755606,31,12,19,32,0.3240376342522263,0.5675544379929668
경기부진/NNG;지속되/VVX,-1,-0.27433582650755606,31,12,19,46,0.3240376342522263,0.5675544379929668
금융위기/NNG;극복/NNG;위해/VV,-1,-0.27433582650755606,31,12,19,28,0.3240376342522263,0.5675544379929668
소비심리/NNG;위축되/VVX,-1,-0.27433582650755606,31,12,19,35,0.3240376342522263,0.5675544379929668
유동성/NNG;넘치/VV,0,-0.27500384280181867,16,6,10,14,0.2819863635756371,0.49461410943202266
실업률/NNG;하/VV,0,-0.27500384280181867,16,6,10,39,0.2819863635756371,0.49461410943202266
금리/NNG;내릴/VV;없/VA,0,-0.27500384280181867,16,6,10,29,0.2819863635756371,0.49461410943202266
경제/NNG;과열되/VVX,0,-0.27500384280181867,16,6,10,20,0.2819863635756371,0.49461410943202266
시장금리/NNG;미치/VV;영향/NNG,0,-0.27500384280181867,16,6,10,15,0.2819863635756371,0.49461410943202266
경제지표/NNG;호조/NNG;보임/VV,0,-0.27500384280181867,16,6,10,21,0.2819863635756371,0.49461410943202266
금융위기/NNG;발생하/VVX,0,-0.27500384280181867,16,6,10,42,0.2819863635756371,0.49461410943202266
고용지표/NNG;악화되/VVX,0,-0.27500384280181867,16,6,10,4,0.2819863635756371,0.49461410943202266
금융시장/NNG;큰/VA;충격/NNG;주/VV,0,-0.27500384280181867,16,6,10,8,0.2819863635756371,0.49461410943202266
유가하락/NNG;의한/VV,0,-0.27500384280181867,16,6,10,11,0.2819863635756371,0.49461410943202266
수출/NNG;큰/VA;감소하/VVX,0,-0.27500384280181867,16,6,10,4,0.2819863635756371,0.49461410943202266
금리/NNG;올리/VV;어렵/VA,0,-0.27500384280181867,16,6,10,31,0.2819863635756371,0.49461410943202266
동결/NNG;지속될/VVX,0,-0.27500384280181867,16,6,10,23,0.2819863635756371,0.49461410943202266
경기회복/NNG;될/VV,0,-0.27500384280181867,16,6,10,16,0.2819863635756371,0.49461410943202266
불확실성/NNG;가중시/VVX,0,-0.27500384280181867,16,6,10,17,0.2819863635756371,0.49461410943202266
취업자수/NNG;늘어나/VV,0,-0.27500384280181867,16,6,10,21,0.2819863635756371,0.49461410943202266
경기침체/NNG;빠져/VV,0,-0.27500384280181867,16,6,10,10,0.2819863635756371,0.49461410943202266
성장잠재력/NNG;높이/VV,0,-0.27500384280181867,16,6,10,46,0.2819863635756371,0.49461410943202266
금리인상/NNG;단행함/VVX,0,-0.27500384280181867,16,6,10,14,0.2819863635756371,0.49461410943202266
불안/NNG;요소/NNG;남/VV,0,-0.27500384280181867,16,6,10,19,0.2819863635756371,0.49461410943202266
침체/NNG;가/VV,0,-0.27500384280181867,16,6,10,14,0.2819863635756371,0.49461410943202266
채권시장/NNG;우호적/VAX;지속될/VVX,0,-0.27500384280181867,16,6,10,24,0.2819863635756371,0.49461410943202266
금리/NNG;상승하/VVX;모습/NNG;보였/VV,0,-0.27500384280181867,16,6,10,18,0.2819863635756371,0.49461410943202266
불확실성/NNG;제거하/VVX,0,-0.27500384280181867,16,6,10,19,0.2819863635756371,0.49461410943202266
대외불확실성/NNG;해소되/VVX;않/VX,0,-0.27500384280181867,16,6,10,12,0.2819863635756371,0.49461410943202266
소비위축/NNG;이어질/VV,0,-0.27500384280181867,16,6,10,5,0.2819863635756371,0.49461410943202266
경기회복/NNG;둔화될/VVX,0,-0.27500384280181867,16,6,10,42,0.2819863635756371,0.49461410943202266
금리/NNG;폭등하/VVX,0,-0.27500384280181867,16,6,10,21,0.2819863635756371,0.49461410943202266
소비/NNG;감소하/VVX,0,-0.27500384280181867,16,6,10,25,0.2819863635756371,0.49461410943202266
금리인상/NNG;중단되/VVX,0,-0.27500384280181867,16,6,10,16,0.2819863635756371,0.49461410943202266
마이너스/NNG;돌아선/VV,0,-0.27500384280181867,16,6,10,24,0.2819863635756371,0.49461410943202266
출구전략/NNG;실행하/VVX,0,-0.27500384280181867,16,6,10,7,0.2819863635756371,0.49461410943202266
리스크/NNG;될/VV,-1,-0.27786358744177264,36,14,22,80,0.33444505055023577,0.5902652689519965
기준금리인상/NNG;예상되/VVX,-1,-0.27786358744177264,36,14,22,55,0.33444505055023577,0.5902652689519965
동결/NNG;예상하/VVX,-1,-0.27786358744177264,36,14,22,43,0.33444505055023577,0.5902652689519965
경제/NNG;침체/NNG;빠질/VV,-1,-0.27786358744177264,36,14,22,51,0.33444505055023577,0.5902652689519965
성장세/NNG;지속될/VVX,-1,-0.2797988541522939,58,23,35,72,0.3786209920636175,0.6710364766973533
금리인하/NNG;있/VV,-1,-0.2797988541522939,58,23,35,77,0.3786209920636175,0.6710364766973533
금리인상/NNG;가능성/NNG;반영하/VVX,-1,-0.28156512595456606,41,16,25,90,0.34390811812920924,0.611851266258471
적자/NNG;기록하/VVX,-1,-0.2851506220475303,46,18,28,62,0.3526063685231394,0.6322268142849101
금리인하/NNG;단행되/VVX,-1,-0.29457795208266324,93,37,56,121,0.4151891244928585,0.7598887316876599
경기침체/NNG;이어지/VV,-1,-0.29632254452175855,29,11,18,40,0.30724414605791656,0.5644746661327019
물가상승률/NNG;하락하/VVX,-1,-0.29632254452175855,29,11,18,40,0.30724414605791656,0.5644746661327019
신용경색/NNG;해소하/VVX,-1,-0.29632254452175855,29,11,18,15,0.30724414605791656,0.5644746661327019
하방압력/NNG;받/VV,-1,-0.29632254452175855,29,11,18,41,0.30724414605791656,0.5644746661327019
금리인상/NNG;의미하/VVX,-1,-0.29632254452175855,29,11,18,26,0.30724414605791656,0.5644746661327019
경제회복/NNG;위해/VV,-1,-0.29632254452175855,29,11,18,41,0.30724414605791656,0.5644746661327019
경기/NNG;하강하/VVX,-1,-0.29632254452175855,29,11,18,26,0.30724414605791656,0.5644746661327019
금리/NNG;크/VA;하락했/VVX,-1,-0.29632254452175855,29,11,18,48,0.30724414605791656,0.5644746661327019
금리인하/NNG;힘입/VV,-1,-0.29632254452175855,29,11,18,22,0.30724414605791656,0.5644746661327019
경기/NNG;회복하/VVX,-1,-0.29663690175642465,34,13,21,53,0.31943706902660607,0.5872795622279379
정책금리/NNG;인상했/VVX,-1,-0.29663690175642465,34,13,21,60,0.31943706902660607,0.5872795622279379
물가목표/NNG;달성하/VVX,-1,-0.29663690175642465,34,13,21,47,0.31943706902660607,0.5872795622279379
경기회복/NNG;지원하/VVX,-1,-0.29663690175642465,34,13,21,52,0.31943706902660607,0.5872795622279379
금리하락/NNG;요인이/VVX,-1,-0.2984001173402897,24,9,15,32,0.29303935245332885,0.540831836620964
물가상승압력/NNG;완화될/VVX,-1,-0.2984001173402897,24,9,15,30,0.29303935245332885,0.540831836620964
경기부양책/NNG;나올/VV,-1,-0.2984001173402897,24,9,15,40,0.29303935245332885,0.540831836620964
시장금리/NNG;급락하/VVX,-1,-0.2984001173402897,24,9,15,28,0.29303935245332885,0.540831836620964
견조한/VAX;성장세/NNG;이/VV,-1,-0.2984001173402897,24,9,15,47,0.29303935245332885,0.540831836620964
금리인하기대/NNG;커지/VV,-1,-0.2984001173402897,24,9,15,41,0.29303935245332885,0.540831836620964
성장/NNG;이루/VV,-1,-0.2984001173402897,24,9,15,41,0.29303935245332885,0.540831836620964
변동성확대/NNG;따른/VV,-1,-0.2984001173402897,24,9,15,35,0.29303935245332885,0.540831836620964
금리인상/NNG;우려/NNG;완화되/VVX,-1,-0.2984001173402897,24,9,15,31,0.29303935245332885,0.540831836620964
리스크/NNG;줄이/VV,-1,-0.2984001173402897,24,9,15,67,0.29303935245332885,0.540831836620964
내수/NNG;부양/NNG;위한/VV,-1,-0.2984001173402897,24,9,15,36,0.29303935245332885,0.540831836620964
기준금리/NNG;인하한/VVX,-1,-0.29995193285907973,44,17,27,73,0.34001674224760603,0.6296712943910574
불안/NNG;진정되/VVX,-1,-0.29995193285907973,44,17,27,77,0.34001674224760603,0.6296712943910574
기준금리/NNG;올렸/VV,-1,-0.30271229640845443,121,48,73,140,0.42912464239293,0.7995185898995074
경제지표/NNG;호조/NNG;보이/VV,-1,-0.3027446451516509,91,36,55,153,0.40788055475593954,0.7599919290097169
경기회복/NNG;뒷받침하/VVX,-1,-0.3027446451516509,91,36,55,61,0.40788055475593954,0.7599919290097169
양적완화/NNG;따른/VV,-1,-0.3032007549538308,96,38,58,226,0.4121092703537237,0.7686411908579908
금융시장/NNG;안정시/VVX,-1,-0.3056775463145146,59,23,36,67,0.36477547249844205,0.6840737864431584
경제/NNG;침체/NNG;빠지/VV;않/VX,-1,-0.3056924144862879,19,7,12,21,0.2755048924994911,0.5166790481151629
금리인하/NNG;이어지/VV,-1,-0.3056924144862879,19,7,12,22,0.2755048924994911,0.5166790481151629
투자심리/NNG;회복시/VVX,-1,-0.3056924144862879,19,7,12,32,0.2755048924994911,0.5166790481151629
재정정책/NNG;펴/VV,-1,-0.3056924144862879,19,7,12,20,0.2755048924994911,0.5166790481151629
경기/NNG;모니터링하/VVX,-1,-0.3056924144862879,19,7,12,4,0.2755048924994911,0.5166790481151629
추경/NNG;집행/NNG;따른/VV,-1,-0.3056924144862879,19,7,12,16,0.2755048924994911,0.5166790481151629
유동성/NNG;확대되/VVX,-1,-0.3056924144862879,19,7,12,27,0.2755048924994911,0.5166790481151629
성장/NNG;위해/VV,-1,-0.3103467728066731,79,31,48,99,0.39015567102283927,0.7392416493615076
금리/NNG;내릴/VV,-1,-0.31328638645914186,378,148,230,414,0.43865971354882605,0.8365626830561541
금리하락/NNG;작용하/VVX,-1,-0.3163443008396437,37,14,23,64,0.31568270860394987,0.6061267182731734
유동성/NNG;의한/VV,-1,-0.3163443008396437,37,14,23,47,0.31568270860394987,0.6061267182731734
경제지표/NNG;부진하/VVX,-1,-0.317224760855366,52,20,32,89,0.34572179753745513,0.6651010210826966
신용스프레드/NNG;확대될/VVX,-1,-0.3178527481676834,32,12,20,34,0.3032355852558821,0.5841795207631502
경제/NNG;위축될/VVX,-1,-0.3178527481676834,32,12,20,27,0.3032355852558821,0.5841795207631502
금리인하/NNG;하/VV,-1,-0.319305399430752,67,26,41,52,0.368852722920723,0.7128864794978906
투자심리/NNG;호전시/VVX,-1,-0.32184899941226763,27,10,17,42,0.2887822358635321,0.561299786405437
금리인하/NNG;될/VV,-1,-0.32184899941226763,27,10,17,24,0.2887822358635321,0.561299786405437
수익성/NNG;악화되/VVX,-1,-0.32184899941226763,27,10,17,42,0.2887822358635321,0.561299786405437
경제지표부진/NNG;따른/VV,-1,-0.32184899941226763,27,10,17,39,0.2887822358635321,0.561299786405437
소비/NNG;줄어들/VV,-1,-0.32184899941226763,27,10,17,45,0.2887822358635321,0.561299786405437
경기/NNG;반등할/VVX,-1,-0.33080230798834465,22,8,14,31,0.2711839850843721,0.5377406255972862
기준금리인하/NNG;단행하/VVX,-1,-0.33080230798834465,22,8,14,44,0.2711839850843721,0.5377406255972862
하방리스크/NNG;상존하/VVX,-1,-0.33080230798834465,22,8,14,19,0.2711839850843721,0.5377406255972862
금리인하효과/NNG;지켜볼/VV,-1,-0.33080230798834465,22,8,14,40,0.2711839850843721,0.5377406255972862
금리/NNG;하락세/NNG;이끌/VV,-1,-0.33080230798834465,22,8,14,49,0.2711839850843721,0.5377406255972862
금리/NNG;높일/VV,-1,-0.33080230798834465,22,8,14,26,0.2711839850843721,0.5377406255972862
수출부진/NNG;심화되/VVX,-1,-0.33080230798834465,22,8,14,5,0.2711839850843721,0.5377406255972862
금리/NNG;인하함/VVX,-1,-0.33080230798834465,22,8,14,20,0.2711839850843721,0.5377406255972862
채권시장/NNG;강세/NNG;보이/VV,-1,-0.33080230798834465,22,8,14,41,0.2711839850843721,0.5377406255972862
경제/NNG;부양하/VVX,-1,-0.3311166273700653,55,21,34,41,0.3428646063175755,0.680357814502767
불안/NNG;완화되/VVX,-1,-0.3311166273700653,55,21,34,73,0.3428646063175755,0.680357814502767
기준금리/NNG;하회하/VVX,-1,-0.33153520370256695,50,19,31,107,0.3337327564110724,0.662858833758566
인플레이션/NNG;상승하/VVX,-1,-0.3323400947479779,45,17,28,67,0.3237103132397399,0.6441139113136342
성장률/NNG;유지하/VVX,-1,-0.3323400947479779,45,17,28,64,0.3237103132397399,0.6441139113136342
기준금리/NNG;내려가/VV,-1,-0.3367769391218145,35,13,22,18,0.3000728495005387,0.6030628900562105
소매판매/NNG;증가하/VVX,-1,-0.3367769391218145,35,13,22,73,0.3000728495005387,0.6030628900562105
고용지표/NNG;호조/NNG;보일/VV,-1,-0.3367769391218145,35,13,22,16,0.3000728495005387,0.6030628900562105
기준금리인하/NNG;따른/VV,-1,-0.340707594068287,73,28,45,122,0.3635790243530031,0.7371954367544609
금리/NNG;낮출/VV,-1,-0.34216006855464287,101,39,62,161,0.3898347744802609,0.793029278627058
경제성장/NNG;둔화되/VVX,-1,-0.34958876275330064,43,16,27,94,0.31003971415167403,0.6414139883048094
금리/NNG;상승세/NNG;보였/VV,-1,-0.34958876275330064,43,16,27,97,0.31003971415167403,0.6414139883048094
성장률/NNG;끌어올릴/VV,-1,-0.35049238546442396,17,6,11,35,0.24790792127806507,0.513929917960893
신용등급/NNG;하향조정되/VVX,-1,-0.35049238546442396,17,6,11,25,0.24790792127806507,0.513929917960893
금리/NNG;큰/VA;오르/VV,-1,-0.35049238546442396,17,6,11,21,0.24790792127806507,0.513929917960893
금리인하/NNG;대응하/VVX,-1,-0.35049238546442396,17,6,11,23,0.24790792127806507,0.513929917960893
경제/NNG;둔화할/VVX,-1,-0.35049238546442396,17,6,11,17,0.24790792127806507,0.513929917960893
금리인하/NNG;전망하/VVX,-1,-0.35049238546442396,17,6,11,24,0.24790792127806507,0.513929917960893
금리상승/NNG;확대시/VVX,-1,-0.35049238546442396,17,6,11,19,0.24790792127806507,0.513929917960893
신용등급/NNG;떨어지/VV,-1,-0.35049238546442396,17,6,11,4,0.24790792127806507,0.513929917960893
금리차확대/NNG;따른/VV,-1,-0.35049238546442396,17,6,11,13,0.24790792127806507,0.513929917960893
불안/NNG;가중시/VVX,-1,-0.35049238546442396,17,6,11,30,0.24790792127806507,0.513929917960893
적자/NNG;확대되/VVX,-1,-0.35049238546442396,17,6,11,15,0.24790792127806507,0.513929917960893
주택가격/NNG;하락했/VVX,-1,-0.35049238546442396,17,6,11,23,0.24790792127806507,0.513929917960893
금리인하/NNG;기대할/VVX,-1,-0.35049238546442396,17,6,11,21,0.24790792127806507,0.513929917960893
경제지표/NNG;개선될/VVX,-1,-0.35049238546442396,17,6,11,35,0.24790792127806507,0.513929917960893
충분한/VAX;유동성/NNG;공급하/VVX,-1,-0.35049238546442396,17,6,11,7,0.24790792127806507,0.513929917960893
소비자물가/NNG;상승/NNG;영향/NNG;미칠/VV,-1,-0.35049238546442396,17,6,11,15,0.24790792127806507,0.513929917960893
금리/NNG;상승세/NNG;보일/VV,-1,-0.35049238546442396,17,6,11,41,0.24790792127806507,0.513929917960893
불확실성/NNG;확대/NNG;따른/VV,-1,-0.35049238546442396,17,6,11,24,0.24790792127806507,0.513929917960893
소비/NNG;감소할/VVX,-1,-0.35049238546442396,17,6,11,10,0.24790792127806507,0.513929917960893
듀레이션확대/NNG;지속하/VVX,-1,-0.35049238546442396,17,6,11,34,0.24790792127806507,0.513929917960893
불안심리/NNG;커지/VV,-1,-0.35049238546442396,17,6,11,13,0.24790792127806507,0.513929917960893
금융시장/NNG;안정세/NNG;보이/VV,-1,-0.35049238546442396,17,6,11,3,0.24790792127806507,0.513929917960893
통화완화/NNG;따른/VV,-1,-0.35049238546442396,17,6,11,42,0.24790792127806507,0.513929917960893
소비위축/NNG;따른/VV,-1,-0.35049238546442396,17,6,11,9,0.24790792127806507,0.513929917960893
재정정책/NNG;따른/VV,-1,-0.3519671380869097,25,9,16,19,0.2682656831037179,0.5580028631648134
기준금리인상/NNG;가능성/NNG;열/VV,-1,-0.3519671380869097,25,9,16,33,0.2682656831037179,0.5580028631648134
성장/NNG;기대하/VVX,-1,-0.3519671380869097,25,9,16,41,0.2682656831037179,0.5580028631648134
금리상승/NNG;작용하/VVX,-1,-0.35355140000788077,38,14,24,70,0.29756037725363427,0.6211755923400607
수출/NNG;개선될/VVX,-1,-0.35355140000788077,38,14,24,34,0.29756037725363427,0.6211755923400607
외환위기/NNG;겪/VV,-1,-0.3598275519255575,33,12,21,61,0.2832475122086006,0.5998418707961668
경기침체/NNG;벗어나/VV,-1,-0.3598275519255575,33,12,21,38,0.2832475122086006,0.5998418707961668
금리/NNG;인하하/VVX,-1,-0.362586299297154,417,158,259,452,0.40176757810090835,0.8562385440723
금리/NNG;상승세/NNG;지속되/VVX,-1,-0.3697636029278265,77,29,48,118,0.3499923491643426,0.7583342215005223
하방위험/NNG;상존하/VVX,-1,-0.3701842678050554,28,10,18,32,0.2662991419224352,0.5775561017329987
금리/NNG;상승세/NNG;이어질/VV,-1,-0.3701842678050554,28,10,18,33,0.2662991419224352,0.5775561017329987
리스크/NNG;완화하/VVX,-1,-0.3701842678050554,28,10,18,25,0.2662991419224352,0.5775561017329987
성장률/NNG;개선되/VVX,-1,-0.37087080017386775,20,7,13,29,0.2460732533043609,0.5345377182092113
듀레이션확대/NNG;유지하/VVX,-1,-0.37087080017386775,20,7,13,18,0.2460732533043609,0.5345377182092113
저성장/NNG;지속되/VVX,-1,-0.37087080017386775,20,7,13,33,0.2460732533043609,0.5345377182092113
하방리스크/NNG;확대되/VVX,-1,-0.37087080017386775,20,7,13,18,0.2460732533043609,0.5345377182092113
콜금리/NNG;유지할/VVX,-1,-0.37087080017386775,20,7,13,13,0.2460732533043609,0.5345377182092113
경제/NNG;성장세/NNG;둔화되/VVX,-1,-0.37087080017386775,20,7,13,7,0.2460732533043609,0.5345377182092113
경기회복세/NNG;지원하/VVX,-1,-0.37087080017386775,20,7,13,30,0.2460732533043609,0.5345377182092113
경제/NNG;회복세/NNG;나타낼/VV,-1,-0.37087080017386775,20,7,13,24,0.2460732533043609,0.5345377182092113
양적완화/NNG;단행하/VVX,-1,-0.37087080017386775,20,7,13,23,0.2460732533043609,0.5345377182092113
정책금리/NNG;인하했/VVX,-1,-0.37087080017386775,20,7,13,24,0.2460732533043609,0.5345377182092113
금리상승/NNG;나타나/VV,-1,-0.37087080017386775,20,7,13,42,0.2460732533043609,0.5345377182092113
기준금리동결/NNG;따른/VV,-1,-0.37087080017386775,20,7,13,45,0.2460732533043609,0.5345377182092113
금리인하기대/NNG;형성되/VVX,-1,-0.37087080017386775,20,7,13,40,0.2460732533043609,0.5345377182092113
금융안정/NNG;유의하/VVX,-1,-0.3715867922106858,90,34,56,85,0.3615777550688291,0.786747195008706
경기/NNG;위축되/VVX,-1,-0.375727864029758,67,25,42,65,0.33416244980069154,0.7341106613658452
동결/NNG;유지할/VVX,-1,-0.3764700551855905,49,18,31,63,0.3061329640403244,0.6736945108255457
불안/NNG;따른/VV,-1,-0.37783114429468767,186,70,116,273,0.3887823103770153,0.8582904800154313
수출/NNG;증가하/VVX,-1,-0.3805456660513419,138,52,86,171,0.38028878692390194,0.844866845150962
성장률/NNG;떨어질/VV,-1,-0.38195027436234363,44,16,28,59,0.29394988459427784,0.6551971753287973
시장금리/NNG;하락하/VVX,-1,-0.3878775043552021,120,45,75,172,0.3691478664915628,0.8343106088402067
물가안정/NNG;유지하/VVX,-1,-0.3880261389884855,52,19,33,32,0.3046384954243713,0.6887534355244146
기준금리인하/NNG;단행할/VVX,-1,-0.3881556101306489,23,8,15,38,0.24520146389402395,0.5545415856476896
수입/NNG;증가하/VVX,-1,-0.3881556101306489,23,8,15,42,0.24520146389402395,0.5545415856476896
금리차/NNG;확대되/VVX,-1,-0.3881556101306489,23,8,15,43,0.24520146389402395,0.5545415856476896
경제/NNG;악화되/VVX,-1,-0.3881556101306489,23,8,15,26,0.24520146389402395,0.5545415856476896
내수/NNG;부양하/VVX,-1,-0.3881556101306489,23,8,15,26,0.24520146389402395,0.5545415856476896
재정위기/NNG;부각되/VVX,-1,-0.3881556101306489,23,8,15,37,0.24520146389402395,0.5545415856476896
듀레이션/NNG;유지하/VVX,-1,-0.3894348513560719,39,14,25,61,0.2801541083916009,0.635497376470136
고용/NNG;증가했/VVX,-1,-0.3894348513560719,39,14,25,47,0.2801541083916009,0.635497376470136
기준금리/NNG;내릴/VV,-1,-0.39030390623053723,231,86,145,257,0.3808559004798014,0.8656958933717146
실물경제/NNG;미칠/VV,-1,-0.39405191207306467,47,17,30,38,0.29266394203284407,0.6711371939772387
경기/NNG;미치/VV;영향/NNG,-1,-0.3973349325059844,68,25,43,56,0.3222467119879958,0.7447369421286381
실물경제/NNG;파급되/VVX,-1,-0.4001697647245347,34,12,22,24,0.26418327669326735,0.6146671761112439
경기부양책/NNG;내놓/VV,-1,-0.40022609531380826,105,39,66,132,0.3532758796079039,0.8220662034077385
수출/NNG;늘어난/VV,-1,-0.4031622077857797,26,9,17,27,0.2449418929040121,0.5739696780226357
금리/NNG;상승세/NNG;나타나/VV,-1,-0.4031622077857797,26,9,17,26,0.2449418929040121,0.5739696780226357
가계부채/NNG;증가하/VVX,-1,-0.4031622077857797,26,9,17,24,0.2449418929040121,0.5739696780226357
금리/NNG;하락세/NNG;제한되/VVX,-1,-0.4031622077857797,26,9,17,42,0.2449418929040121,0.5739696780226357
시장금리/NNG;큰/VA;하락하/VVX,-1,-0.40499526558879195,50,18,32,41,0.29163469684035614,0.6863774143855986
경기/NNG;하/VV,-1,-0.41019625659866954,15,5,10,27,0.21445670891316773,0.5110539857791505
인플레이션/NNG;억제할/VVX,-1,-0.41019625659866954,15,5,10,16,0.21445670891316773,0.5110539857791505
설비투자/NNG;부진하/VVX,-1,-0.41019625659866954,15,5,10,18,0.21445670891316773,0.5110539857791505
경기침체/NNG;심화될/VVX,-1,-0.41019625659866954,15,5,10,7,0.21445670891316773,0.5110539857791505
불안/NNG;증폭되/VVX,-1,-0.41019625659866954,15,5,10,12,0.21445670891316773,0.5110539857791505
경제성장/NNG;힘입/VV,-1,-0.41019625659866954,15,5,10,15,0.21445670891316773,0.5110539857791505
인플레이션/NNG;높/VA;질/VX;있/VV,-1,-0.41019625659866954,15,5,10,9,0.21445670891316773,0.5110539857791505
재정지출/NNG;따른/VV,-1,-0.41019625659866954,15,5,10,12,0.21445670891316773,0.5110539857791505
유동성/NNG;있/VV,-1,-0.41019625659866954,15,5,10,25,0.21445670891316773,0.5110539857791505
gdp갭/NNG;마이너스/NNG;지속될/VVX,-1,-0.41019625659866954,15,5,10,22,0.21445670891316773,0.5110539857791505
성장률/NNG;하향조정되/VVX,-1,-0.41019625659866954,15,5,10,33,0.21445670891316773,0.5110539857791505
금리인하/NNG;진행될/VVX,-1,-0.41019625659866954,15,5,10,16,0.21445670891316773,0.5110539857791505
실물경제/NNG;확산되/VVX,-1,-0.41019625659866954,15,5,10,12,0.21445670891316773,0.5110539857791505
자본확충/NNG;필요하/VVX,-1,-0.41019625659866954,15,5,10,13,0.21445670891316773,0.5110539857791505
적자/NNG;줄어들/VV,-1,-0.41019625659866954,15,5,10,8,0.21445670891316773,0.5110539857791505
실물경제/NNG;미치/VV;영향/NNG;제한적/VAX,-1,-0.41019625659866954,15,5,10,18,0.21445670891316773,0.5110539857791505
변동성/NNG;키웠/VV,-1,-0.41019625659866954,15,5,10,15,0.21445670891316773,0.5110539857791505
금리인하/NNG;나설/VV,-1,-0.41050057073228874,248,91,157,352,0.3661642519445281,0.8732127915319868
실물경제/NNG;전이되/VVX,-1,-0.4127034772709163,37,13,24,25,0.2637193816026864,0.6322426536874899
성장/NNG;견인하/VVX,-1,-0.4127034772709163,37,13,24,56,0.2637193816026864,0.6322426536874899
금리/NNG;낮춘/VV,-1,-0.4127034772709163,37,13,24,24,0.2637193816026864,0.6322426536874899
불안요인/NNG;잠재해/VVX,-1,-0.4127034772709163,37,13,24,24,0.2637193816026864,0.6322426536874899
경제/NNG;회복하/VVX,-1,-0.4127034772709163,37,13,24,90,0.2637193816026864,0.6322426536874899
금리/NNG;내린/VV,-1,-0.4148467789806469,235,86,149,263,0.36288741902405386,0.8744880784847672
금리/NNG;낮추/VV,-1,-0.4151981124685864,213,78,135,317,0.36234262155669705,0.8739147764979569
경제/NNG;개선될/VVX,-1,-0.41639580833527945,29,10,19,40,0.24508729015289268,0.5928227177022075
하방압력/NNG;작용할/VVX,-1,-0.41639580833527945,29,10,19,39,0.24508729015289268,0.5928227177022075
기준금리/NNG;인하됐/VVX,-1,-0.41639580833527945,29,10,19,27,0.24508729015289268,0.5928227177022075
성장세/NNG;유지되/VVX,-1,-0.41639580833527945,29,10,19,43,0.24508729015289268,0.5928227177022075
물가상승압력/NNG;작용하/VVX,-1,-0.41639580833527945,29,10,19,33,0.24508729015289268,0.5928227177022075
경기회복/NNG;도모하/VVX,-1,-0.4217606387669707,18,6,12,23,0.21675424856425812,0.5311400171236625
금리/NNG;인상할/VVX;없/VA,-1,-0.4217606387669707,18,6,12,25,0.21675424856425812,0.5311400171236625
재정위기/NNG;확산되/VVX,-1,-0.4217606387669707,18,6,12,45,0.21675424856425812,0.5311400171236625
경제성장/NNG;유지하/VVX,-1,-0.4217606387669707,18,6,12,16,0.21675424856425812,0.5311400171236625
장단기/NNG;금리/NNG;역전되/VVX,-1,-0.4217606387669707,18,6,12,38,0.21675424856425812,0.5311400171236625
소비자물가상승률/NNG;하락하/VVX,-1,-0.4217606387669707,18,6,12,20,0.21675424856425812,0.5311400171236625
기준금리인상/NNG;지지하/VVX,-1,-0.4217606387669707,18,6,12,18,0.21675424856425812,0.5311400171236625
기준금리/NNG;인상한/VAX;있/VV,-1,-0.4217606387669707,18,6,12,30,0.21675424856425812,0.5311400171236625
금리인상/NNG;시점/NNG;앞당겨질/VV,-1,-0.4217606387669707,18,6,12,21,0.21675424856425812,0.5311400171236625
경제전망/NNG;악화되/VVX,-1,-0.4217606387669707,18,6,12,10,0.21675424856425812,0.5311400171236625
마이너스/NNG;확대되/VVX,-1,-0.4217606387669707,18,6,12,24,0.21675424856425812,0.5311400171236625
인플레이션/NNG;미치/VV,-1,-0.4217606387669707,18,6,12,30,0.21675424856425812,0.5311400171236625
개인소비지출/NNG;가격지수/NNG;상승해/VVX,-1,-0.4217606387669707,18,6,12,20,0.21675424856425812,0.5311400171236625
고용률/NNG;상승하/VVX,-1,-0.4217606387669707,18,6,12,24,0.21675424856425812,0.5311400171236625
불안/NNG;이어지/VV,-1,-0.42394208101478703,40,14,26,59,0.26351895584912005,0.6491638475632033
금리인하/NNG;이어질/VV,-1,-0.42394208101478703,40,14,26,23,0.26351895584912005,0.6491638475632033
유동성/NNG;공급되/VVX,-1,-0.42394208101478703,40,14,26,61,0.26351895584912005,0.6491638475632033
양적완화/NNG;종료하/VVX,-1,-0.42394208101478703,40,14,26,41,0.26351895584912005,0.6491638475632033
경상수지흑자/NNG;지속되/VVX,-1,-0.4281919246135535,32,11,21,45,0.24550766856151782,0.6110901457183203
기준금리인상/NNG;그칠/VV,-1,-0.4325070566520861,21,7,14,12,0.21898088761748732,0.5508504566164065
투자심리/NNG;부담/NNG;줬/VV,-1,-0.4325070566520861,21,7,14,14,0.21898088761748732,0.5508504566164065
금리인상/NNG;지지할/VVX,-1,-0.4325070566520861,21,7,14,24,0.21898088761748732,0.5508504566164065
금리인하/NNG;위한/VV,-1,-0.4325070566520861,21,7,14,41,0.21898088761748732,0.5508504566164065
금리인하/NNG;가능성/NNG;시사하/VVX,-1,-0.4325070566520861,21,7,14,34,0.21898088761748732,0.5508504566164065
투자심리/NNG;긍정적/VAX;영향/NNG;미쳤/VV,-1,-0.4325070566520861,21,7,14,29,0.21898088761748732,0.5508504566164065
재정확대/NNG;따른/VV,-1,-0.4325070566520861,21,7,14,19,0.21898088761748732,0.5508504566164065
변동성/NNG;완화하/VVX,-1,-0.4325070566520861,21,7,14,36,0.21898088761748732,0.5508504566164065
자산매입/NNG;유지했/VVX,-1,-0.4325070566520861,21,7,14,33,0.21898088761748732,0.5508504566164065
경기/NNG;영향/NNG;주/VV,-1,-0.4325070566520861,21,7,14,30,0.21898088761748732,0.5508504566164065
금리/NNG;하락세/NNG;지속되/VVX,-1,-0.4387066299356831,70,25,45,117,0.29943474654379976,0.7648162467073824
금리/NNG;내려가/VV,-1,-0.4387066299356831,70,25,45,90,0.29943474654379976,0.7648162467073824
경기/NNG;악화될/VVX,-1,-0.4408964741240411,54,19,35,64,0.2774944238429487,0.7126244428740164
추경/NNG;편성해/VVX,-1,-0.4424838885437371,24,8,16,19,0.22113780251106008,0.5701348352672592
경기/NNG;과도한/VAX;위축/NNG;방지하/VVX,-1,-0.4424838885437371,24,8,16,0,0.22113780251106008,0.5701348352672592
정책금리/NNG;낮추/VV,-1,-0.4424838885437371,24,8,16,20,0.22113780251106008,0.5701348352672592
마이너스/NNG;떨어질/VV,-1,-0.4424838885437371,24,8,16,11,0.22113780251106008,0.5701348352672592
금리상승/NNG;제한됨/VVX,-1,-0.4424838885437371,24,8,16,28,0.22113780251106008,0.5701348352672592
금리하락/NNG;이어질/VV,-1,-0.4424838885437371,24,8,16,45,0.22113780251106008,0.5701348352672592
금리/NNG;유지해/VVX,-1,-0.4424838885437371,24,8,16,29,0.22113780251106008,0.5701348352672592
불확실성/NNG;완화되/VVX,-1,-0.44366323995862356,122,44,78,227,0.33149047956889777,0.8571495602079429
금융위기/NNG;겪/VV,-1,-0.4515298680055905,49,17,32,111,0.26392809381104915,0.6959714141028667
투자심리/NNG;약화시/VVX,-1,-0.4517376534629829,27,9,18,23,0.2232262493461535,0.5889482150973181
경기/NNG;침체되/VVX,-1,-0.4517376534629829,27,9,18,49,0.2232262493461535,0.5889482150973181
변동성/NNG;크/VA;확대된/VVX,-1,-0.4517376534629829,27,9,18,11,0.2232262493461535,0.5889482150973181
금리상승압력/NNG;지속될/VVX,-1,-0.4517376534629829,27,9,18,43,0.2232262493461535,0.5889482150973181
기준금리/NNG;인하되/VVX,-1,-0.45272383387203763,87,31,56,224,0.3067114854052462,0.811214222951085
경제/NNG;살리/VV,-1,-0.4530495947171086,182,65,117,238,0.3340982991485506,0.8843714338143127
원자재가격/NNG;상승/NNG;따른/VV,-1,-0.45543780977795634,60,21,39,86,0.2774268931301117,0.7387798293493686
단기금리/NNG;하락하/VVX,-1,-0.4570249399207661,41,14,27,42,0.24769098179791207,0.6622355359322138
금리변동성/NNG;확대될/VVX,-1,-0.4570249399207661,41,14,27,68,0.24769098179791207,0.6622355359322138
기준금리/NNG;인하했/VVX,-1,-0.4591164368193459,288,102,186,341,0.33102871792682237,0.8897340902115951
양적완화/NNG;지속하/VVX,-1,-0.46031286586338516,30,10,20,28,0.225247551851826,0.6072512425556367
금리/NNG;상승압력/NNG;작용할/VVX,-1,-0.46031286586338516,30,10,20,28,0.225247551851826,0.6072512425556367
양적완화축소/NNG;따른/VV,-1,-0.4649076912625203,44,15,29,136,0.24858417007234196,0.678022872564633
기준금리인하/NNG;단행되/VVX,-1,-0.46825194501816236,33,11,22,75,0.22720309019378332,0.6250101071463295
소비자물가/NNG;올라/VV,-1,-0.46825194501816236,33,11,22,32,0.22720309019378332,0.6250101071463295
경기회복/NNG;이끌/VV,-1,-0.46825194501816236,33,11,22,35,0.22720309019378332,0.6250101071463295
경기부양/NNG;위한/VV,-1,-0.4683343940600724,455,160,295,703,0.32447778207049877,0.8927898092260196
금리/NNG;내리/VV,-1,-0.46904052240642846,478,168,310,476,0.32397287229953026,0.89301040097565
수출/NNG;감소했/VVX,-1,-0.4820323380970529,75,26,49,69,0.27824682426575387,0.7930777940491736
리스크/NNG;커졌/VV,-1,-0.4823806705411956,39,13,26,32,0.2309226159386551,0.6587870166279566
수출/NNG;감소하/VVX,-1,-0.4860732173429668,123,43,80,154,0.3030113334252066,0.8727984099646435
마이너스/NNG;기록하/VVX,-1,-0.4860732173429668,123,43,80,206,0.3030113334252066,0.8727984099646435
저성장/NNG;따른/VV,-1,-0.48794864489019374,19,6,13,27,0.18891566186362618,0.5468292485177877
생산/NNG;늘어나/VV,-1,-0.48794864489019374,19,6,13,16,0.18891566186362618,0.5468292485177877
가계부채/NNG;늘/VV,-1,-0.48794864489019374,19,6,13,28,0.18891566186362618,0.5468292485177877
성장률/NNG;하회하/VVX,-1,-0.48794864489019374,19,6,13,20,0.18891566186362618,0.5468292485177877
금리상승/NNG;대비하/VVX,-1,-0.48794864489019374,19,6,13,33,0.18891566186362618,0.5468292485177877
금리상승압력/NNG;우세할/VVX,-1,-0.48794864489019374,19,6,13,17,0.18891566186362618,0.5468292485177877
경기부양/NNG;위해서/VV,-1,-0.48794864489019374,19,6,13,28,0.18891566186362618,0.5468292485177877
수입/NNG;증가했/VVX,-1,-0.48794864489019374,19,6,13,20,0.18891566186362618,0.5468292485177877
기준금리/NNG;인하/VV,-1,-0.48794864489019374,19,6,13,28,0.18891566186362618,0.5468292485177877
금리인하/NNG;점치/VV,-1,-0.48794864489019374,19,6,13,15,0.18891566186362618,0.5468292485177877
경제/NNG;활력/NNG;불어넣/VV,-1,-0.48794864489019374,19,6,13,12,0.18891566186362618,0.5468292485177877
금리/NNG;상승세/NNG;나타났/VV,-1,-0.48816550829881244,16,5,11,14,0.18210232561272988,0.5274068198018587
기준금리인하/NNG;예상되/VVX,-1,-0.48816550829881244,16,5,11,23,0.18210232561272988,0.5274068198018587
금융위기/NNG;직전인/VVX,-1,-0.48816550829881244,16,5,11,17,0.18210232561272988,0.5274068198018587
금리/NNG;스프레드/NNG;확대되/VVX,-1,-0.48816550829881244,16,5,11,15,0.18210232561272988,0.5274068198018587
적자/NNG;국채발행/NNG;따른/VV,-1,-0.48816550829881244,16,5,11,8,0.18210232561272988,0.5274068198018587
금리인하/NNG;하/VV;않/VX,-1,-0.48816550829881244,16,5,11,17,0.18210232561272988,0.5274068198018587
금리인하/NNG;가능성/NNG;높이/VV,-1,-0.48816550829881244,16,5,11,29,0.18210232561272988,0.5274068198018587
인플레이션기대심리/NNG;자극하/VVX,-1,-0.48816550829881244,16,5,11,15,0.18210232561272988,0.5274068198018587
수익성/NNG;악화시/VVX,-1,-0.48816550829881244,16,5,11,25,0.18210232561272988,0.5274068198018587
성장률/NNG;달성/NNG;가능할/VVX,-1,-0.48816550829881244,16,5,11,16,0.18210232561272988,0.5274068198018587
금리동결/NNG;주장하/VVX,-1,-0.48816550829881244,16,5,11,16,0.18210232561272988,0.5274068198018587
불안/NNG;있/VV,-1,-0.48816550829881244,16,5,11,28,0.18210232561272988,0.5274068198018587
경제성장률/NNG;마이너스/NNG;기록할/VVX,-1,-0.48816550829881244,16,5,11,12,0.18210232561272988,0.5274068198018587
실업률/NNG;상승할/VVX,-1,-0.48816550829881244,16,5,11,21,0.18210232561272988,0.5274068198018587
자산매입/NNG;축소하/VVX,-1,-0.48816550829881244,16,5,11,47,0.18210232561272988,0.5274068198018587
리스크/NNG;요인이/VVX,-1,-0.48864445074876883,42,14,28,46,0.23268955677763517,0.6747637261942038
물가상승률/NNG;접근하/VVX,-1,-0.49007958822568665,22,7,15,22,0.19444178290825512,0.5659763235322077
동결/NNG;예상되/VVX,-1,-0.49007958822568665,22,7,15,34,0.19444178290825512,0.5659763235322077
성장률/NNG;하향조정될/VVX,-1,-0.49007958822568665,22,7,15,32,0.19444178290825512,0.5659763235322077
기준금리인상/NNG;가능할/VVX,-1,-0.49007958822568665,22,7,15,45,0.19444178290825512,0.5659763235322077
불확실성/NNG;줄/VV,-1,-0.49007958822568665,22,7,15,22,0.19444178290825512,0.5659763235322077
적자/NNG;냈/VV,-1,-0.49007958822568665,22,7,15,22,0.19444178290825512,0.5659763235322077
기준금리/NNG;유지키/VVX,-1,-0.49007958822568665,22,7,15,18,0.19444178290825512,0.5659763235322077
신용스프레드/NNG;축소될/VVX,-1,-0.4934576693613827,25,8,17,33,0.1991173107660136,0.5847569315562018
흑자/NNG;기록할/VVX,-1,-0.4934576693613827,25,8,17,32,0.1991173107660136,0.5847569315562018
경제/NNG;회복세/NNG;나타내/VV,-1,-0.4934576693613827,25,8,17,27,0.1991173107660136,0.5847569315562018
금리인하/NNG;결정했/VVX,-1,-0.4934576693613827,25,8,17,20,0.1991173107660136,0.5847569315562018
금리인상시기/NNG;지연될/VVX,-1,-0.4934576693613827,25,8,17,31,0.1991173107660136,0.5847569315562018
금리인하/NNG;가능성/NNG;제기되/VVX,-1,-0.4934576693613827,25,8,17,34,0.1991173107660136,0.5847569315562018
경기회복세/NNG;유지되/VVX,-1,-0.4934576693613827,25,8,17,23,0.1991173107660136,0.5847569315562018
금리인상/NNG;대응하/VVX,-1,-0.4934576693613827,25,8,17,20,0.1991173107660136,0.5847569315562018
성장률/NNG;떨어지/VV,-1,-0.49442043223616094,45,15,30,54,0.23439662364720215,0.6901130724474833
성장모멘텀/NNG;약화되/VVX,-1,-0.49747937342050863,28,9,19,36,0.20319366631759778,0.6031027675148486
침체/NNG;인해/VV,-1,-0.49747937342050863,28,9,19,16,0.20319366631759778,0.6031027675148486
고용/NNG;개선되/VVX,-1,-0.49747937342050863,28,9,19,41,0.20319366631759778,0.6031027675148486
금융위기/NNG;인해/VV,-1,-0.49974051834566724,48,16,32,62,0.23604533972531497,0.704825966104988
경기침체/NNG;심화되/VVX,-1,-0.5017937533793958,31,10,21,27,0.20682596474181997,0.6209605957665372
정책금리/NNG;인하하/VVX,-1,-0.5037670441668932,96,33,63,90,0.28017315875903925,0.8456132492528528
금리인하/NNG;이뤄질/VV,-1,-0.5061886549813587,34,11,23,51,0.21011526827265908,0.6382882495770202
금리/NNG;내렸/VV,-1,-0.512954906362721,149,51,98,143,0.2897261920350755,0.89631126558227
불안/NNG;확산되/VVX,-1,-0.5147447173134811,40,13,27,62,0.21592008017551256,0.6712268559356273
수출/NNG;급감하/VVX,-1,-0.5147447173134811,40,13,27,19,0.21592008017551256,0.6712268559356273
수출/NNG;줄/VV,-1,-0.5170338630620288,60,20,40,67,0.24208725762276026,0.7572658954116606
성장세/NNG;지속할/VVX,-1,-0.5225897981027066,46,15,31,40,0.22095618549301746,0.701733912467614
기준금리/NNG;인하하/VVX,-1,-0.5242520147895621,552,186,366,688,0.28503060118167356,0.9093675866880628
기준금리/NNG;내리/VV,-1,-0.5342691333368481,254,85,169,265,0.27796947442553926,0.9117779302027902
기준금리/NNG;내렸/VV,-1,-0.5380976698261307,143,48,95,109,0.27195218080452443,0.9016436903954714
금리/NNG;내리/VV;않/VX,-1,-0.5381599477146172,61,20,41,68,0.23127551789178086,0.7669162366379081
리스크/NNG;부각되/VVX,-1,-0.5381599477146172,61,20,41,98,0.23127551789178086,0.7669162366379081
경기/NNG;영향/NNG;받/VV,-1,-0.5402351516230607,29,9,20,16,0.1848522011232826,0.6165595575755048
물가상승률/NNG;달성하/VVX,-1,-0.5402351516230607,29,9,20,28,0.1848522011232826,0.6165595575755048
경기침체/NNG;지속되/VVX,-1,-0.5402351516230607,29,9,20,39,0.1848522011232826,0.6165595575755048
금리인하기대/NNG;반영하/VVX,-1,-0.5407406066063507,32,10,22,50,0.1898241998663549,0.6340447939392547
경기/NNG;살아나/VV;않/VX,-1,-0.5407406066063507,32,10,22,37,0.1898241998663549,0.6340447939392547
양적완화/NNG;시행하/VVX,-1,-0.5408374281583792,26,8,18,50,0.17915866349597728,0.5985833085636385
고용지표/NNG;개선되/VVX,-1,-0.5408374281583792,26,8,18,55,0.17915866349597728,0.5985833085636385
소매판매/NNG;감소했/VVX,-1,-0.5408374281583792,26,8,18,34,0.17915866349597728,0.5985833085636385
잠재성장률/NNG;하회하/VVX,-1,-0.5408374281583792,26,8,18,39,0.17915866349597728,0.5985833085636385
양적완화/NNG;실시하/VVX,-1,-0.5408374281583792,26,8,18,46,0.17915866349597728,0.5985833085636385
기준금리/NNG;위한/VV,-1,-0.5408374281583792,26,8,18,53,0.17915866349597728,0.5985833085636385
고용사정/NNG;개선되/VVX,-1,-0.5408374281583792,26,8,18,19,0.17915866349597728,0.5985833085636385
물가안정/NNG;달성하/VVX,-1,-0.5419392087522583,35,11,24,49,0.19424199202822756,0.6509966625547858
금리인상/NNG;유지될/VVX,-1,-0.543202132222032,23,7,16,36,0.17249264544669696,0.5801698297395348
신용등급/NNG;하향조정했/VVX,-1,-0.543202132222032,23,7,16,37,0.17249264544669696,0.5801698297395348
물가/NNG;영향/NNG;주/VV,-1,-0.543202132222032,23,7,16,38,0.17249264544669696,0.5801698297395348
금리/NNG;인하할/VVX;가능성/NNG;낮/VA,-1,-0.543202132222032,23,7,16,9,0.17249264544669696,0.5801698297395348
유동성/NNG;위기/NNG;겪/VV,-1,-0.543202132222032,23,7,16,32,0.17249264544669696,0.5801698297395348
디플레이션/NNG;빠질/VV,-1,-0.543202132222032,23,7,16,29,0.17249264544669696,0.5801698297395348
금리인하/NNG;가능성/NNG;열/VV,-1,-0.5445126977017267,171,57,114,186,0.26981431213620555,0.910877680379171
금리/NNG;인하했/VVX,-1,-0.5445126977017267,171,57,114,177,0.26981431213620555,0.910877680379171
높/VA;변동성/NNG;보이/VV,-1,-0.5454210651315987,41,13,28,35,0.2018454516527909,0.6831753997817775
성장세/NNG;유지하/VVX,-1,-0.5466158527567858,73,24,49,117,0.2378866419245112,0.8078978379361063
금리인하/NNG;주장하/VVX;소수의견/NNG,-1,-0.5484082635458352,20,6,14,21,0.1644604530924972,0.5613878186547977
변동성/NNG;확대할/VVX,-1,-0.5484082635458352,20,6,14,16,0.1644604530924972,0.5613878186547977
금리상승/NNG;될/VV,-1,-0.5484082635458352,20,6,14,14,0.1644604530924972,0.5613878186547977
흑자/NNG;전환했/VVX,-1,-0.5484082635458352,20,6,14,13,0.1644604530924972,0.5613878186547977
금리인하/NNG;가능성/NNG;낮추/VV,-1,-0.5484082635458352,20,6,14,16,0.1644604530924972,0.5613878186547977
금리인하기대/NNG;지속될/VVX,-1,-0.5484082635458352,20,6,14,39,0.1644604530924972,0.5613878186547977
금융위기/NNG;직후인/VVX,-1,-0.5494097255160847,47,15,32,65,0.2082556979689761,0.7129165958112117
침체/NNG;지속되/VVX,-1,-0.5513938082524903,50,16,34,47,0.21112314512382777,0.7268432342101979
금리인하/NNG;단행했/VVX,-1,-0.5519948917381564,169,56,113,145,0.2646470225749202,0.9126823031621281
금리인상/NNG;가능성/NNG;부각되/VVX,-1,-0.553311407377655,53,17,36,69,0.2138049441190998,0.7401342628024389
금리인하/NNG;따른/VV,-1,-0.556926556832273,225,74,151,249,0.262304225124443,0.9175285298495613
경제/NNG;미칠/VV;악영향/NNG,-1,-0.558337519884225,17,5,12,9,0.15440979289132672,0.542326659087089
수출/NNG;부진할/VVX,-1,-0.558337519884225,17,5,12,37,0.15440979289132672,0.542326659087089
자금이탈/NNG;나타나/VV,-1,-0.558337519884225,17,5,12,37,0.15440979289132672,0.542326659087089
마이너스/NNG;전환되/VVX,-1,-0.558337519884225,17,5,12,41,0.15440979289132672,0.542326659087089
통화완화/NNG;지속되/VVX,-1,-0.558337519884225,17,5,12,23,0.15440979289132672,0.542326659087089
유동성/NNG;부족하/VVX,-1,-0.558337519884225,17,5,12,21,0.15440979289132672,0.542326659087089
경기부진/NNG;지속될/VVX,-1,-0.558337519884225,17,5,12,17,0.15440979289132672,0.542326659087089
경제성장/NNG;지속하/VVX,-1,-0.558337519884225,17,5,12,15,0.15440979289132672,0.542326659087089
정책금리인상/NNG;단행되/VVX,-1,-0.558337519884225,17,5,12,18,0.15440979289132672,0.542326659087089
물가상승률/NNG;웃돌/VV,-1,-0.558337519884225,17,5,12,15,0.15440979289132672,0.542326659087089
경기부양/NNG;나선/VV,-1,-0.558337519884225,17,5,12,24,0.15440979289132672,0.542326659087089
변동성/NNG;축소된/VVX,-1,-0.558337519884225,17,5,12,46,0.15440979289132672,0.542326659087089
불안요인/NNG;있/VV,-1,-0.5744039818739477,42,13,29,39,0.18868006956073033,0.6946712101656966
인플레이션압력/NNG;완화될/VVX,-1,-0.5744039818739477,42,13,29,23,0.18868006956073033,0.6946712101656966
금리/NNG;인하한/VVX,-1,-0.5744039818739477,42,13,29,75,0.18868006956073033,0.6946712101656966
소비/NNG;늘어날/VV,-1,-0.5746613272287773,39,12,27,38,0.18434564695831407,0.6792325491244778
금융시장/NNG;안정/NNG;찾/VV,-1,-0.5746613272287773,39,12,27,47,0.18434564695831407,0.6792325491244778
리스크/NNG;작용할/VVX,-1,-0.5753997729727964,51,16,35,95,0.19965237703326008,0.7372495381730069
신용경색/NNG;따른/VV,-1,-0.5753997729727964,51,16,35,63,0.19965237703326008,0.7372495381730069
금융안정/NNG;위한/VV,-1,-0.5754753873616673,36,11,25,31,0.17955720495376826,0.6631941060667136
경제지표/NNG;혼조세/NNG;보이/VV,-1,-0.5771049885709132,33,10,23,49,0.17420990087315988,0.6465787322853542
경기부양책/NNG;힘입/VV,-1,-0.5771049885709132,33,10,23,54,0.17420990087315988,0.6465787322853542
금리인하/NNG;가능성/NNG;시사했/VVX,-1,-0.5772686926924832,60,19,41,40,0.20847453532702342,0.7741301146398324
금융시장안정/NNG;위한/VV,-1,-0.5772686926924832,60,19,41,63,0.20847453532702342,0.7741301146398324
물가/NNG;하락하/VVX,-1,-0.5789454469517685,69,22,47,90,0.21582107813471985,0.8054404505417522
불확실성/NNG;계속되/VVX,-1,-0.5799257763590403,30,9,21,42,0.16815966313241984,0.6294164540546568
금리인하/NNG;배경/NNG;설명했/VVX,-1,-0.584496277070359,27,8,19,14,0.16120315662670442,0.6117455951696603
금리/NNG;상승세/NNG;제한되/VVX,-1,-0.584496277070359,27,8,19,44,0.16120315662670442,0.6117455951696603
금리인하/NNG;지속될/VVX,-1,-0.5916724030923188,24,7,17,15,0.15304461109461887,0.5936141944297335
마이너스/NNG;되/VV,-1,-0.5916724030923188,24,7,17,34,0.15304461109461887,0.5936141944297335
금리/NNG;하락세/NNG;이어지/VV,-1,-0.5916724030923188,24,7,17,34,0.15304461109461887,0.5936141944297335
단기금리/NNG;급등하/VVX,-1,-0.5916724030923188,24,7,17,19,0.15304461109461887,0.5936141944297335
자산매입/NNG;줄이/VV,-1,-0.5916724030923188,24,7,17,67,0.15304461109461887,0.5936141944297335
기준금리인하/NNG;가능성/NNG;열/VV,-1,-0.5916724030923188,24,7,17,34,0.15304461109461887,0.5936141944297335
금리인하/NNG;인해/VV,-1,-0.5971488838553417,58,18,40,61,0.19565540433760503,0.7717963344227126
금리/NNG;큰/VA;상승했/VVX,-1,-0.5990288150815932,49,15,34,85,0.18501078878311306,0.7340730713062246
금리인하/NNG;가능성/NNG;남/VV,-1,-0.6028157036175414,21,6,15,25,0.1432389990931697,0.5750817737670714
불안/NNG;진정시/VVX,-1,-0.6028157036175414,21,6,15,21,0.1432389990931697,0.5750817737670714
수출/NNG;증가세/NNG;보이/VV,-1,-0.6028157036175414,21,6,15,10,0.1432389990931697,0.5750817737670714
기준금리인상/NNG;단행할/VVX,-1,-0.6038466707801686,40,12,28,59,0.17146822385374713,0.6906433707983922
금리인하/NNG;나섰/VV,-1,-0.6038466707801686,40,12,28,50,0.17146822385374713,0.6906433707983922
금리상승/NNG;영향/NNG;받/VV,-1,-0.606802739667909,37,11,26,20,0.1660171688789475,0.674928783824336
리스크/NNG;확대될/VVX,-1,-0.610886995592404,34,10,24,41,0.1599261184888374,0.6586225090855956
마이너스성장/NNG;할/VV,-1,-0.6165441727149452,31,9,22,16,0.15303872000020638,0.6417499962716009
물가안정/NNG;안정되/VVX,-1,-0.6165441727149452,31,9,22,62,0.15303872000020638,0.6417499962716009
마이너스/NNG;돌아서/VV,-1,-0.6165441727149452,31,9,22,28,0.15303872000020638,0.6417499962716009
금리인하/NNG;예상했/VVX,-1,-0.6165441727149452,31,9,22,39,0.15303872000020638,0.6417499962716009
경제성장률/NNG;떨어지/VV,-1,-0.6201926683642971,18,5,13,35,0.1310917695641294,0.5562212751063271
신용경색/NNG;발생하/VVX,-1,-0.6201926683642971,18,5,13,22,0.1310917695641294,0.5562212751063271
금리인하/NNG;예상된/VVX,-1,-0.6201926683642971,18,5,13,21,0.1310917695641294,0.5562212751063271
채권시장/NNG;강세/NNG;나타냈/VV,-1,-0.6201926683642971,18,5,13,13,0.1310917695641294,0.5562212751063271
금리스프레드/NNG;확대되/VVX,-1,-0.6201926683642971,18,5,13,39,0.1310917695641294,0.5562212751063271
변동성/NNG;제한된/VVX,-1,-0.6201926683642971,18,5,13,35,0.1310917695641294,0.5562212751063271
유동성함정/NNG;빠지/VV;않/VX,-1,-0.6201926683642971,18,5,13,10,0.1310917695641294,0.5562212751063271
금리인상/NNG;시작해/VVX,-1,-0.6201926683642971,18,5,13,17,0.1310917695641294,0.5562212751063271
재정위기/NNG;지속되/VVX,-1,-0.6201926683642971,18,5,13,19,0.1310917695641294,0.5562212751063271
금융안정/NNG;유의할/VVX,-1,-0.6201926683642971,18,5,13,9,0.1310917695641294,0.5562212751063271
금리인하/NNG;반대하/VVX,-1,-0.6201926683642971,18,5,13,23,0.1310917695641294,0.5562212751063271
금리/NNG;재할인율/NNG;인하했/VVX,-1,-0.6201926683642971,18,5,13,10,0.1310917695641294,0.5562212751063271
기준금리/NNG;역전되/VVX,-1,-0.6244191231330114,28,8,20,55,0.1451402742090645,0.6243436102288946
시장금리/NNG;급등했/VVX,-1,-0.6244191231330114,28,8,20,20,0.1451402742090645,0.6243436102288946
불안심리/NNG;확산되/VVX,-1,-0.6244191231330114,28,8,20,51,0.1451402742090645,0.6243436102288946
추경/NNG;따른/VV,-1,-0.6265526616908876,135,42,93,158,0.21303347730454258,0.9228125410433131
고용지표/NNG;호조/NNG;보이/VV,-1,-0.627353264348995,44,13,31,57,0.16495613501009343,0.7164311780878361
경기/NNG;부진할/VVX,-1,-0.627353264348995,44,13,31,38,0.16495613501009343,0.7164311780878361
성장률/NNG;나타내/VV,-1,-0.6354707363673275,25,7,18,37,0.1359296321395421,0.6064431557054936
시장금리/NNG;반영되/VVX,-1,-0.6354707363673275,25,7,18,38,0.1359296321395421,0.6064431557054936
수출부진/NNG;따른/VV,-1,-0.6359572811265632,38,11,27,29,0.15356582613600875,0.6862404902580934
지정학적리스크/NNG;따른/VV,-1,-0.6421301825970251,35,10,25,55,0.1468994136544958,0.6702246868643251
경기둔화/NNG;막/VV,-1,-0.6470617108203738,48,14,34,43,0.15961678098601448,0.7405783280076209
마이너스/NNG;진입하/VVX,-1,-0.647780715071367,15,4,11,11,0.11548057760428615,0.53711982631649
안전자산선호현상/NNG;약화시/VVX,-1,-0.647780715071367,15,4,11,11,0.11548057760428615,0.53711982631649
금융위기/NNG;해결하/VVX,-1,-0.647780715071367,15,4,11,15,0.11548057760428615,0.53711982631649
마이너스/NNG;돌아설/VV,-1,-0.647780715071367,15,4,11,18,0.11548057760428615,0.53711982631649
채권시장/NNG;우호적/VAX;작용하/VVX,-1,-0.647780715071367,15,4,11,31,0.11548057760428615,0.53711982631649
경제지표/NNG;개선된/VVX,-1,-0.647780715071367,15,4,11,30,0.11548057760428615,0.53711982631649
물가안정/NNG;하회하/VVX,-1,-0.647780715071367,15,4,11,22,0.11548057760428615,0.53711982631649
금리/NNG;인하하/VVX;인상할/VVX,-1,-0.647780715071367,15,4,11,7,0.11548057760428615,0.53711982631649
투자심리/NNG;부정적/VAX;작용했/VVX,-1,-0.647780715071367,15,4,11,10,0.11548057760428615,0.53711982631649
금리/NNG;급락한/VAX;따른/VV,-1,-0.647780715071367,15,4,11,12,0.11548057760428615,0.53711982631649
기준금리동결/NNG;결정했/VVX,-1,-0.647780715071367,15,4,11,24,0.11548057760428615,0.53711982631649
콜금리/NNG;인상하/VVX;않/VX,-1,-0.647780715071367,15,4,11,10,0.11548057760428615,0.53711982631649
성장/NNG;하방위험/NNG;작용할/VVX,-1,-0.647780715071367,15,4,11,9,0.11548057760428615,0.53711982631649
추경편성/NNG;따른/VV,-1,-0.6499541421238488,83,25,58,72,0.18436900424280436,0.8639613665437029
소비/NNG;회복될/VVX,-1,-0.6511661754080837,22,6,16,19,0.12497576730448903,0.5880959858666231
인플레이션리스크/NNG;남/VV,-1,-0.6511661754080837,22,6,16,12,0.12497576730448903,0.5880959858666231
통화완화정책/NNG;펴/VV,-1,-0.6511661754080837,22,6,16,15,0.12497576730448903,0.5880959858666231
수출/NNG;이/VV,-1,-0.6511661754080837,22,6,16,20,0.12497576730448903,0.5880959858666231
금리인하/NNG;더불/VV,-1,-0.6511661754080837,22,6,16,18,0.12497576730448903,0.5880959858666231
경기침체/NNG;대응하/VVX,-1,-0.6511661754080837,22,6,16,16,0.12497576730448903,0.5880959858666231
금리인하/NNG;가능성/NNG;있/VV,-1,-0.6513894470937635,45,13,32,34,0.15432139387346486,0.726747601368541
침체/NNG;지속될/VVX,-1,-0.6606878327373256,29,8,21,16,0.1308287550839769,0.6364537851422469
내수부진/NNG;따른/VV,-1,-0.6606878327373256,29,8,21,35,0.1308287550839769,0.6364537851422469
유동성/NNG;조이/VV,-1,-0.6606878327373256,29,8,21,12,0.1308287550839769,0.6364537851422469
리스크/NNG;따른/VV,-1,-0.6630007957094438,39,11,28,89,0.14213927207915084,0.6971622838827747
수출/NNG;증가했/VVX,-1,-0.6684174201044053,49,14,35,58,0.1500287153407926,0.7502368408523317
경제지표/NNG;악화되/VVX,-1,-0.6709142056263236,36,10,26,36,0.13504647680775406,0.6814247725734592
금리인하/NNG;단행하/VVX;않/VX,-1,-0.6709142056263236,36,10,26,50,0.13504647680775406,0.6814247725734592
물가/NNG;안정세/NNG;유지할/VVX,-1,-0.6738184610062334,19,5,14,7,0.11165298692576046,0.5693557793238809
경기회복/NNG;무게/NNG;두/VV,-1,-0.6738184610062334,19,5,14,5,0.11165298692576046,0.5693557793238809
경기회복/NNG;걸림돌/NNG;작용할/VVX,-1,-0.6738184610062334,19,5,14,12,0.11165298692576046,0.5693557793238809
금리인하/NNG;예상됨/VVX,-1,-0.6738184610062334,19,5,14,18,0.11165298692576046,0.5693557793238809
금리/NNG;계속/MAG;오를/VV,-1,-0.6738184610062334,19,5,14,7,0.11165298692576046,0.5693557793238809
만장일치/NNG;기준금리/NNG;동결했/VVX,-1,-0.6738184610062334,19,5,14,33,0.11165298692576046,0.5693557793238809
수출/NNG;감소세/NNG;지속되/VVX,-1,-0.674730856863092,26,7,19,10,0.12093737810840799,0.6187555373062605
변동성/NNG;보였/VV,-1,-0.674730856863092,26,7,19,21,0.12093737810840799,0.6187555373062605
금리/NNG;내려/VV,-1,-0.6774761364067652,82,24,58,104,0.16817456203321163,0.8691341161982951
경제성장/NNG;촉진하/VVX,-1,-0.6778409911870753,69,20,49,40,0.16087482203444237,0.8325250719290761
금리인하/NNG;단행된/VVX,-1,-0.6880155526321792,40,11,29,78,0.13166934761479648,0.7077218003079696
금리/NNG;하락세/NNG;예상된/VVX,-1,-0.6880155526321792,40,11,29,31,0.13166934761479648,0.7077218003079696
금리인하/NNG;가능성/NNG;배제하/VVX,-1,-0.693459889368449,30,8,22,33,0.11811270167578304,0.6481351600630639
설비투자/NNG;감소하/VVX,-1,-0.6937088781279974,23,6,17,30,0.10933869779128177,0.6005610426219287
투자심리/NNG;크/VA;위축되/VVX,-1,-0.6937088781279974,23,6,17,24,0.10933869779128177,0.6005610426219287
수출/NNG;위축될/VVX,-1,-0.6937088781279974,23,6,17,12,0.10933869779128177,0.6005610426219287
금리상승압력/NNG;작용할/VVX,-1,-0.6961973741690765,67,19,48,106,0.1497872788644223,0.8306418346165161
금융위기/NNG;대처하/VVX,-1,-0.6973466209320296,37,10,27,14,0.12427929840697934,0.6922551196381563
성장경로/NNG;불확실성/NNG;높/VA;진/VX;판단된/VVX,-1,-0.7071625835901483,16,4,12,12,0.09505915054387463,0.550277247630864
경기/NNG;상승세/NNG;둔화되/VVX,-1,-0.7071625835901483,16,4,12,7,0.09505915054387463,0.550277247630864
금리인하/NNG;지속되/VVX,-1,-0.7071625835901483,16,4,12,12,0.09505915054387463,0.550277247630864
기준금리/NNG;인하돼/VVX,-1,-0.7071625835901483,16,4,12,9,0.09505915054387463,0.550277247630864
인플레이션/NNG;웃돌/VV,-1,-0.7071625835901483,16,4,12,14,0.09505915054387463,0.550277247630864
경제/NNG;부양할/VVX,-1,-0.7071625835901483,16,4,12,20,0.09505915054387463,0.550277247630864
신용경색/NNG;완화하/VVX,-1,-0.7087783677600565,34,9,25,28,0.11605457439990406,0.676154676353075
물가안정/NNG;유지되/VVX,-1,-0.7087783677600565,34,9,25,54,0.11605457439990406,0.676154676353075
주택가격하락/NNG;따른/VV,-1,-0.7096995001357224,27,7,20,34,0.1078419510465068,0.6306251557589896
경기침체/NNG;진행되/VVX,-1,-0.7197426662232839,20,5,15,5,0.09553224842555297,0.5819065800529679
잠재성장률/NNG;밑돌/VV,-1,-0.7197426662232839,20,5,15,37,0.09553224842555297,0.5819065800529679
고용지표/NNG;밑돌/VV,-1,-0.7197426662232839,20,5,15,16,0.09553224842555297,0.5819065800529679
불안/NNG;반영하/VVX,-1,-0.7197426662232839,20,5,15,14,0.09553224842555297,0.5819065800529679
수출경쟁력/NNG;높이/VV,-1,-0.7197426662232839,20,5,15,21,0.09553224842555297,0.5819065800529679
금리/NNG;하향안정화되/VVX,-1,-0.7197426662232839,20,5,15,21,0.09553224842555297,0.5819065800529679
실물경제/NNG;영향/NNG;미치/VV,-1,-0.734126022399451,35,9,26,43,0.10613614983108491,0.6868875359996226
경기침체/NNG;인해/VV,-1,-0.740695825446325,28,7,21,35,0.09641962784599965,0.6421076757006344
금리상승/NNG;예상되/VVX,-1,-0.740695825446325,28,7,21,46,0.09641962784599965,0.6421076757006344
물가/NNG;영향/NNG;미치/VV,-1,-0.740695825446325,28,7,21,33,0.09641962784599965,0.6421076757006344
실업률/NNG;상승했/VVX,-1,-0.740695825446325,28,7,21,33,0.09641962784599965,0.6421076757006344
경기회복/NNG;지속되/VVX,-1,-0.7436788550980614,39,10,29,61,0.10564878011730545,0.7129087415822913
소비/NNG;촉진하/VVX,-1,-0.7559336263816856,17,4,13,21,0.07889775612816108,0.5628212932359338
경기회복/NNG;찬물/NNG;끼얹/VV,-1,-0.7559336263816856,17,4,13,29,0.07889775612816108,0.5628212932359338
캐리트레이드/NNG;청산/NNG;매물/NNG;나와/VV,-1,-0.7559336263816856,17,4,13,8,0.07889775612816108,0.5628212932359338
인플레이션압력/NNG;높이/VV,-1,-0.7559336263816856,17,4,13,27,0.07889775612816108,0.5628212932359338
금리/NNG;하락세/NNG;지속될/VVX,-1,-0.7570729921301109,36,9,27,54,0.0972338561343144,0.6972996051922699
금리상승/NNG;제한될/VVX,-1,-0.7573087394877034,79,21,58,134,0.12294371320578679,0.8826417341033652
신용등급/NNG;강등/NNG;따른/VV,-1,-0.7587446573547592,21,5,16,38,0.08218532174978231,0.5939933487219519
유동성함정/NNG;빠질/VV,-1,-0.7587446573547592,21,5,16,7,0.08218532174978231,0.5939933487219519
성장세/NNG;둔화됐/VVX,-1,-0.7680765268356421,29,7,22,25,0.08645957117524289,0.6532454299548
금리인하/NNG;압박하/VVX,-1,-0.7680765268356421,29,7,22,37,0.08645957117524289,0.6532454299548
금리/NNG;낮/VA;유지할/VVX,-1,-0.7680765268356421,29,7,22,44,0.08645957117524289,0.6532454299548
내수/NNG;위축되/VVX,-1,-0.77304574784732,33,8,25,36,0.0879747643807588,0.6810190474132242
유동성/NNG;확보하/VVX,-1,-0.7822612860220427,41,10,31,67,0.09033079552001827,0.7323496667366146
하방위험/NNG;커졌/VV,-1,-0.7910979153736569,26,6,20,12,0.07486090880460976,0.6354756363356668
금리인하/NNG;여력/NNG;있/VV,-1,-0.7910979153736569,26,6,20,14,0.07486090880460976,0.6354756363356668
유동성함정/NNG;빠지/VV,-1,-0.7910979153736569,26,6,20,4,0.07486090880460976,0.6354756363356668
가계대출/NNG;상회하/VVX,-1,-0.7917014296169085,22,5,17,25,0.07112507900075976,0.6056985649242619
물가상승률/NNG;둔화될/VVX,-1,-0.7917014296169085,22,5,17,15,0.07112507900075976,0.6056985649242619
기준금리인하/NNG;인해/VV,-1,-0.7956655488830646,18,4,14,27,0.06609122121841912,0.5749048463452638
gdp/NNG;감소하/VVX,-1,-0.7956655488830646,18,4,14,38,0.06609122121841912,0.5749048463452638
주택가격/NNG;떨어지/VV,-1,-0.7956655488830646,18,4,14,11,0.06609122121841912,0.5749048463452638
실물경제/NNG;개선되/VVX,-1,-0.7956655488830646,18,4,14,7,0.06609122121841912,0.5749048463452638
침체/NNG;이어질/VV,-1,-0.7965348285192864,38,9,29,38,0.082067213072363,0.7172396032399126
유동성/NNG;지원하/VVX,-1,-0.7990129283860289,42,10,32,44,0.08372238416068176,0.7416530118752526
금융시장안정/NNG;위해/VV,-1,-0.8013287774642325,65,16,49,78,0.09476902073978742,0.8502836877548999
신용경색/NNG;완화되/VVX,-1,-0.8014590532497771,46,11,35,30,0.08515287307018844,0.7645572178205119
가계부채/NNG;늘어날/VV,-1,-0.8152621890510259,27,6,21,10,0.06653767146475163,0.6464576641026226
변동성/NNG;나타내/VV,-1,-0.8153173603442773,47,11,36,36,0.0795437349906611,0.7730719164125197
근원인플레이션율/NNG;하락하/VVX,-1,-0.8194835375434055,23,5,18,19,0.061935247789424386,0.6170798059546887
기준금리/NNG;통화정책방향/NNG;유지해/VVX,-1,-0.8279303551567198,19,4,15,21,0.05589652291807179,0.5866263591921839
금리상승압력/NNG;확대될/VVX,-1,-0.8279303551567198,19,4,15,10,0.05589652291807179,0.5866263591921839
통화완화정책/NNG;지속될/VVX,-1,-0.8279303551567198,19,4,15,19,0.05589652291807179,0.5866263591921839
소비자물가상승률/NNG;머물/VV,-1,-0.8279303551567198,19,4,15,11,0.05589652291807179,0.5866263591921839
기준금리/NNG;밑돌/VV,-1,-0.8279303551567198,19,4,15,36,0.05589652291807179,0.5866263591921839
통화정책/NNG;완화하/VVX,-1,-0.8286628476850042,40,9,31,51,0.06981612330448449,0.736099165965772
인플레이션압력/NNG;커질/VV,-1,-0.8321435593279283,32,7,25,33,0.06353390757385938,0.6848792894684456
성장세/NNG;약화되/VVX,-1,-0.8361413282948285,28,6,22,43,0.05939980033625111,0.6571654930158135
금리인하/NNG;이/VV,-1,-0.8380825187772668,61,14,47,54,0.07534310214937791,0.8443071700392404
경기후퇴/NNG;제한하/VVX,-1,-0.8440270244652122,15,3,12,15,0.047602553932861134,0.5552866405915604
저성장/NNG;벗어나/VV,-1,-0.8440270244652122,15,3,12,18,0.047602553932861134,0.5552866405915604
적자/NNG;내/VV,-1,-0.8440270244652122,15,3,12,13,0.047602553932861134,0.5552866405915604
고용지표/NNG;개선될/VVX,-1,-0.8440270244652122,15,3,12,19,0.047602553932861134,0.5552866405915604
물가/NNG;높이/VV,-1,-0.8440270244652122,15,3,12,16,0.047602553932861134,0.5552866405915604
경제지표/NNG;약화된/VVX,-1,-0.8440270244652122,15,3,12,11,0.047602553932861134,0.5552866405915604
채권시장/NNG;유입될/VVX,-1,-0.8440270244652122,15,3,12,31,0.047602553932861134,0.5552866405915604
금리/NNG;하향안정될/VVX,-1,-0.8440270244652122,15,3,12,24,0.047602553932861134,0.5552866405915604
성장률/NNG;유지할/VVX,-1,-0.8440270244652122,15,3,12,39,0.047602553932861134,0.5552866405915604
안전자산선호심리/NNG;강해/VV,-1,-0.8440270244652122,15,3,12,19,0.047602553932861134,0.5552866405915604
글로벌/NNG;금리/NNG;하락하/VVX,-1,-0.8440270244652122,15,3,12,23,0.047602553932861134,0.5552866405915604
성장세/NNG;꺾이/VV,-1,-0.8541411988652419,20,4,16,13,0.04772735878865268,0.5980503397208163
경제성장률/NNG;낮춘/VV,-1,-0.8698170792933185,30,6,24,26,0.04795974263573155,0.6778351405458131
흑자/NNG;돌아섰/VV,-1,-0.8728404864786995,16,3,13,30,0.03913423716123468,0.5669482600784215
경제성장률/NNG;낮춰/VV,-1,-0.8728404864786995,16,3,13,14,0.03913423716123468,0.5669482600784215
불안/NNG;진정될/VVX,-1,-0.8728404864786995,16,3,13,14,0.03913423716123468,0.5669482600784215
기준금리/NNG;내린/VV;이/VV,-1,-0.8728404864786995,16,3,13,14,0.03913423716123468,0.5669482600784215
재고조정/NNG;진행되/VVX,-1,-0.875494722115831,21,4,17,9,0.04113058010039755,0.6092195770367705
경기활성화/NNG;위한/VV,-1,-0.875494722115831,21,4,17,37,0.04113058010039755,0.6092195770367705
기준금리/NNG;내려/VV,-1,-0.8761414029776866,44,9,35,51,0.051762618688323526,0.7709001820704636
성장세회복/NNG;지원하/VVX,-1,-0.8788032528070164,62,13,49,46,0.056400124283478695,0.859311096871641
성장/NNG;머물/VV,-1,-0.8950816194897119,17,3,14,16,0.032667157511736836,0.5783579002319879
고용지표/NNG;양호하/VVX,-1,-0.8950816194897119,17,3,14,28,0.032667157511736836,0.5783579002319879
경기부양책/NNG;고려하/VVX,-1,-0.8950816194897119,17,3,14,3,0.032667157511736836,0.5783579002319879
gdp갭/NNG;축소되/VVX,-1,-0.8950816194897119,17,3,14,13,0.032667157511736836,0.5783579002319879
인플레이션/NNG;잘/MAG;제어되/VVX,-1,-0.8950816194897119,17,3,14,13,0.032667157511736836,0.5783579002319879
정책금리/NNG;인하할/VVX,-1,-0.904572797431898,76,15,61,53,0.046792886852162124,0.913585543653197
금리인하/NNG;시사했/VVX,-1,-0.9055864214342053,28,5,23,27,0.03395235978785854,0.6702018370251104
내수부진/NNG;심화되/VVX,-1,-0.9073488148944935,23,4,19,6,0.0313489204975317,0.6308987057608597
수출/NNG;증가세/NNG;둔화되/VVX,-1,-0.9073488148944935,23,4,19,44,0.0313489204975317,0.6308987057608597
기준금리/NNG;내린/VV,-1,-0.9077332977871337,176,35,141,149,0.04883123566264165,0.9869321827330186
마이너스성장/NNG;하/VV,-1,-0.9124168382596787,18,3,15,20,0.027654996264810505,0.5895558373772267
투자심리/NNG;개선된/VVX,-1,-0.9124168382596787,18,3,15,24,0.027654996264810505,0.5895558373772267
마이너스성장/NNG;했/VV,-1,-0.9124168382596787,18,3,15,13,0.027654996264810505,0.5895558373772267
신용경색/NNG;해소되/VVX,-1,-0.9124168382596787,18,3,15,17,0.027654996264810505,0.5895558373772267
물가안정/NNG;하회할/VVX,-1,-0.9192540274213379,24,4,20,8,0.027697072929432694,0.6414404541603358
금리인하/NNG;단행함/VVX,-1,-0.9192540274213379,24,4,20,23,0.027697072929432694,0.6414404541603358
경기둔화우려/NNG;반영하/VVX,-1,-0.9260745447328452,19,3,16,17,0.02371412975945652,0.6005666620578313
성장/NNG;도모하/VVX,-1,-0.9260745447328452,19,3,16,21,0.02371412975945652,0.6005666620578313
소비/NNG;회복세/NNG;이어지/VV,-1,-0.9260745447328452,19,3,16,8,0.02371412975945652,0.6005666620578313
경기하강/NNG;위험/NNG;남/VV,-1,-0.9260745447328452,19,3,16,13,0.02371412975945652,0.6005666620578313
기준금리/NNG;내린/VV;뒤/NNG,-1,-0.9260745447328452,19,3,16,24,0.02371412975945652,0.6005666620578313
신용등급/NNG;하향조정할/VVX,-1,-0.9260745447328452,19,3,16,13,0.02371412975945652,0.6005666620578313
가계부채/NNG;자본유출입/NNG;점검해/VVX,-1,-0.9260745447328452,19,3,16,11,0.02371412975945652,0.6005666620578313
기준금리/NNG;인하함/VVX,-1,-0.9271692420255874,41,7,34,49,0.029832457775367312,0.7669815756322317
경기침체/NNG;지속될/VVX,-1,-0.9291741582314895,25,4,21,17,0.02464864002436787,0.6517962604807624
금리인하/NNG;나선/VV,-1,-0.9291741582314895,25,4,21,41,0.02464864002436787,0.6517962604807624
경기침체/NNG;이어질/VV,-1,-0.9352939800656583,37,6,31,25,0.02567248613693734,0.7433672271399262
기대인플레이션/NNG;낮추/VV,-1,-0.9369549341985615,20,3,17,11,0.020572853829533905,0.6114052259642982
유동성함정/NNG;빠진/VV,-1,-0.9369549341985615,20,3,17,8,0.020572853829533905,0.6114052259642982
금리/NNG;내려도/VV,-1,-0.9374941314194086,26,4,22,22,0.022083949874736324,0.6619714703445816
재정지출확대/NNG;따른/VV,-1,-0.9445172126357211,27,4,23,24,0.01991009762218072,0.6719693471653149
기준금리/NNG;만장일치/NNG;동결되/VVX,-1,-0.9457184407983434,21,3,18,31,0.018036562540200883,0.6220802054908033
물가/NNG;고려하/VVX,-1,-0.9457184407983434,21,3,18,18,0.018036562540200883,0.6220802054908033
기준금리인하/NNG;내린/VV,-1,-0.9505368044366475,15,2,13,6,0.015055181432423922,0.5691378782908243
인플레이션/NNG;완화됐/VVX,-1,-0.9505368044366475,15,2,13,5,0.015055181432423922,0.5691378782908243
물가/NNG;억제하/VVX,-1,-0.9505368044366475,15,2,13,21,0.015055181432423922,0.5691378782908243
기준금리/NNG;인상된/VVX;하/VV,-1,-0.9505368044366475,15,2,13,26,0.015055181432423922,0.5691378782908243
부양책/NNG;쏟/VV,-1,-0.9505368044366475,15,2,13,7,0.015055181432423922,0.5691378782908243
불확실성/NNG;증폭시/VVX,-1,-0.9505368044366475,15,2,13,20,0.015055181432423922,0.5691378782908243
수출/NNG;감소세/NNG;확대되/VVX,-1,-0.9541560242403359,35,5,30,5,0.018071448427761892,0.7360488336437065
불안요인/NNG;작용했/VVX,-1,-0.9587180557093479,23,3,20,20,0.014251893250694217,0.6429556299507991
경기/NNG;부추기/VV,-1,-0.9588752731136023,16,2,14,4,0.012813216043304515,0.5801984480235365
불안요인/NNG;부각되/VVX,-1,-0.9588752731136023,16,2,14,32,0.012813216043304515,0.5801984480235365
불안/NNG;계속될/VVX,-1,-0.9588752731136023,16,2,14,7,0.012813216043304515,0.5801984480235365
경기후퇴/NNG;겪/VV,-1,-0.9653012821632735,17,2,15,5,0.011079492702908299,0.5911275758907117
경제지표/NNG;악화된/VVX,-1,-0.9653012821632735,17,2,15,12,0.011079492702908299,0.5911275758907117
불확실성/NNG;증대/NNG;따른/VV,-1,-0.9703439650067436,18,2,16,24,0.009712875206973845,0.6019275294630602
소매판매/NNG;감소하/VVX,-1,-0.9703439650067436,18,2,16,38,0.009712875206973845,0.6019275294630602
경기/NNG;과도하/VVX,-1,-0.9743662334886614,19,2,17,6,0.008617179536617918,0.6125979153311356
금리동결/NNG;주장했/VVX,-1,-0.9743662334886614,19,2,17,47,0.008617179536617918,0.6125979153311356
금리인하/NNG;했/VV,-1,-0.9743662334886614,19,2,17,22,0.008617179536617918,0.6125979153311356
기준금리/NNG;하향조정하/VVX,-1,-0.9790787266682072,69,8,61,20,0.010742981921060416,0.9219475221308594
성장률/NNG;하향조정된/VVX,-1,-0.9893330986520581,15,1,14,5,0.003740926383990137,0.5809916221675222
신용경색/NNG;풀리/VV,-1,-0.9906943548496356,16,1,15,8,0.0034034429774262116,0.5918208248833767
소비자물가/NNG;큰/VA;영향/NNG;미치/VV,-1,-0.9927125723982287,18,1,17,2,0.002901660409703122,0.613148457341592
성장경로/NNG;하회할/VVX,-1,-0.9927125723982287,18,1,17,7,0.002901660409703122,0.613148457341592
하방리스크/NNG;커졌/VV,-1,-0.9929517289726684,32,2,30,32,0.0034041515040929295,0.73813123542097
경기위축/NNG;의미한/VVX,-1,-0.9934764566552841,19,1,18,13,0.0027112365453529834,0.623635245999606
수출/NNG;가/VV,-1,-0.9934764566552841,19,1,18,2,0.0027112365453529834,0.623635245999606
기준금리/NNG;인하하/VVX;했/VV,-1,-0.9996333366727473,15,0,15,6,0.0007434697015679957,0.5920560317026168
경상수지/NNG;줄어들/VV,-1,-0.9997204382065952,17,0,17,5,0.0007434697015679957,0.613353049027147
침체/NNG;막/VV,-1,-1.0,25,0,25,23,0.0007434697015679957,0.6933932120947746
