word,label,polarity,count,pos_count,neg_count,neu_count,pos_score,neg_score
성장능력/NNG;괜찮/VA;경로이/VVX,1,1.0,34,34,0,0,0.7906512836302811,0.00018278087251644
금리/NNG;너무/MAG;낮/VA;아니/VCN;올리/VV,1,0.9999905129487976,32,32,0,0,0.7747676186691467,0.00018278087251644
금리인상/NNG;부동산가격/NNG;영향/NNG;주/VV;아니/VCN,1,0.999985447426361,31,31,0,0,0.7665451985969294,0.00018278087251644
흑자/NNG;정부/NNG;가/VV,1,0.9999688371698185,28,28,0,0,0.7407661935210782,0.00018278087251644
경상수지/NNG;흑자/NNG;기조다/VVX,1,0.9999498572472336,25,25,0,0,0.7133530570834838,0.00018278087251644
가계부채/NNG;문제/NNG;있/VA;정상/NNG;돌아가/VV,1,0.9999357080060707,23,23,0,0,0.6942012884225345,0.00018278087251644
수출/NNG;높/VA;증가세/NNG;지속하/VVX,1,0.9998746505134535,16,16,0,1,0.6221232553626186,0.00018278087251644
수요압력/NNG;증대될/VVX,1,0.9998746505134535,16,16,0,14,0.6221232553626186,0.00018278087251644
물가안정기조/NNG;유지될/VVX,1,0.9992432054327063,30,29,1,27,0.7495046872044561,0.00045673945870335596
환율하락/NNG;예상하/VVX,1,0.9990670791365754,27,26,1,3,0.7226268432413095,0.0005039954938206077
인플레이션기대심리/NNG;확산될/VVX,1,0.9976099428757519,17,16,1,13,0.6220549167861283,0.0008874190015134616
통화정책/NNG;방향/NNG;조정/NNG;검토해/VVX;할/VX,1,0.9968596422414193,15,14,1,5,0.6001765248775734,0.001081790502525203
콜금리/NNG;올렸/VV,1,0.9964995622266579,26,24,2,13,0.7037121276858931,0.0013954155798336762
금리인상/NNG;이뤄지지/VV,1,0.9929313192841966,20,18,2,29,0.6432289807585672,0.0024281584574609356
경제위기/NNG;겪/VV,1,0.9918100773307954,19,17,2,16,0.6326038397287761,0.0027451072132349853
금리/NNG;낮/VA;있/VV,1,0.9905168695092479,26,23,3,3,0.6938031981281703,0.0034628824238864815
경기회복세/NNG;되/VV,1,0.989272701089299,25,22,3,36,0.6839399649002607,0.0038430749910496657
경제성장/NNG;가능할/VVX,1,0.989272701089299,25,22,3,5,0.6839399649002607,0.0038430749910496657
금리/NNG;상승세/NNG;쉬/VV,1,0.9885881027366674,17,15,2,21,0.6109270109495539,0.003644080818690658
견실한/VAX;성장세/NNG;이/VV,1,0.9877740883366835,24,21,3,26,0.6739069913749639,0.0042970566510328444
인플레이션억제/NNG;위한/VV,1,0.9862438459540477,30,26,4,38,0.722011802092313,0.005162967435616513
금융위기/NNG;극복/NNG;위한/VV,1,0.98622270872885,16,14,2,13,0.599883736778896,0.004296075579567958
성장경로/NNG;크/VA;벗어나/VV;않/VX,1,0.9809115291421819,21,18,3,28,0.6428171385351856,0.006337464274246628
콜금리/NNG;올린/VV,1,0.980188033623554,27,23,4,17,0.6933570204090824,0.007091274225603879
경기회복세/NNG;진행되/VVX,1,0.97738380854692,20,17,3,24,0.6321312644708913,0.007369706708720116
금융완화/NNG;줄여/VV,1,0.97738380854692,20,17,3,36,0.6321312644708913,0.007369706708720116
잠재성장률/NNG;웃돌/VV,1,0.9773260298745325,26,22,4,14,0.6834433384084171,0.007988109825095647
금리/NNG;상승세/NNG;지속하/VVX,1,0.9728664276418157,19,16,3,19,0.6212860684525656,0.008680839007670431
불확실성/NNG;상존한/VVX,1,0.9714776389735995,46,38,8,20,0.8181363107279171,0.012015031457020792
금융완화/NNG;유지하/VVX,1,0.9699833422653796,113,92,21,117,0.9863159027009175,0.015243183718881045
성장/NNG;될/VV,1,0.9689521298720054,45,37,8,16,0.8109088316394971,0.012963109624903924
물가안정기조/NNG;하/VV,1,0.9669902463384572,18,15,3,24,0.6102803490200874,0.010373616062900552
통화정책/NNG;완화/NNG;유지해/VVX,1,0.9631678299515665,28,23,5,31,0.6925994898623906,0.01314280644123154
물가상승압력/NNG;크/VA;않/VX;전망되/VVX,1,0.9631678299515665,28,23,5,20,0.6925994898623906,0.01314280644123154
견조한/VAX;성장/NNG;지속할/VVX,1,0.9523515612170703,31,25,6,15,0.7110754672205689,0.017503078911218498
기준금리/NNG;동결한/VAX;배경/NNG;설명했/VVX,1,0.9508295931572313,26,21,5,21,0.6723918999896586,0.017087767017873408
변동성/NNG;과도하/VVX,1,0.9494535791689716,21,17,4,15,0.6311734456882605,0.016496582717618787
금리동결/NNG;내리/VV,1,0.9487428818261952,16,13,3,4,0.5877648358764126,0.015581748092454883
소비지출/NNG;증가하/VVX,1,0.9487428818261952,16,13,3,23,0.5877648358764126,0.015581748092454883
경기/NNG;상승세/NNG;이어질/VV,1,0.9487428818261952,16,13,3,7,0.5877648358764126,0.015581748092454883
흑자/NNG;줄어들/VV,1,0.9487428818261952,16,13,3,30,0.5877648358764126,0.015581748092454883
기준금리/NNG;상향조정하/VVX,1,0.9456837369914084,30,24,6,25,0.7013504332457151,0.01972358741743077
기준금리/NNG;유지한/VVX,1,0.9446081168331748,61,48,13,57,0.8761088998930516,0.025135862833983086
경기/NNG;위험요인/NNG;상존하/VVX,1,0.9389812102707826,38,30,8,33,0.7545795296657447,0.023899193218539675
금리상승/NNG;축소되/VVX,1,0.9388441984315994,20,16,4,45,0.6201597043408874,0.019686983053819718
물가/NNG;올리/VV,1,0.9388441984315994,20,16,4,25,0.6201597043408874,0.019686983053819718
채권시장/NNG;강세/NNG;작용할/VVX,1,0.9388441984315994,20,16,4,20,0.6201597043408874,0.019686983053819718
부동산가격/NNG;잡/VV,1,0.9364995228403015,59,46,13,22,0.8647523448793938,0.02853061567350676
gdp/NNG;상회하/VVX,1,0.9343652088852288,15,12,3,29,0.5762272351978379,0.01966737797765445
콜금리/NNG;조정하/VVX,1,0.9343652088852288,15,12,3,11,0.5762272351978379,0.01966737797765445
신용등급/NNG;강등당/VVX,1,0.9343652088852288,15,12,3,12,0.5762272351978379,0.01966737797765445
높/VA;변동성/NNG;지속될/VVX,1,0.9343652088852288,15,12,3,12,0.5762272351978379,0.01966737797765445
출구전략/NNG;지연될/VVX,1,0.9343652088852288,15,12,3,16,0.5762272351978379,0.01966737797765445
금리하락/NNG;이어졌/VV,1,0.9343652088852288,15,12,3,12,0.5762272351978379,0.01966737797765445
생산/NNG;증가했/VVX,1,0.9343652088852288,15,12,3,22,0.5762272351978379,0.01966737797765445
금리인상/NNG;대비해/VVX,1,0.9324128603646009,24,19,5,33,0.6513780237126835,0.022912155008888834
물가상승압력/NNG;이어질/VV,1,0.9198256530000932,23,18,5,14,0.6405499368560994,0.026873736608058727
재정위기/NNG;인해/VV,1,0.9198256530000932,23,18,5,37,0.6405499368560994,0.026873736608058727
물가안정/NNG;있/VV,1,0.907262581785562,18,14,4,23,0.5974878503459834,0.029163113600053508
국제원자재가격/NNG;상승하/VVX,1,0.907262581785562,18,14,4,17,0.5974878503459834,0.029163113600053508
금리/NNG;인상되/VVX;않/VX,1,0.907262581785562,18,14,4,30,0.5974878503459834,0.029163113600053508
경기/NNG;상승세/NNG;따른/VV,1,0.907262581785562,18,14,4,20,0.5974878503459834,0.029163113600053508
콜금리/NNG;인상된/VVX,1,0.9041252554296473,22,17,5,21,0.6294895052195931,0.031811642085441016
경제성장률/NNG;낮추/VV,1,0.895367211085516,41,31,10,59,0.7599244742414236,0.042087850321824584
경기상승/NNG;이어지/VV,1,0.8931846448903238,37,28,9,21,0.734651396547337,0.04158093317428374
경기/NNG;찬물/NNG;끼얹/VV,1,0.8862514889904101,25,19,6,15,0.6494105782200776,0.039275489499750134
물가/NNG;낮/VA;유지하/VVX,1,0.8844267114339233,21,16,5,15,0.6181744202481535,0.03802043584845146
콜금리/NNG;경기회복/NNG;뒷받침하/VVX,1,0.8844267114339233,21,16,5,8,0.6181744202481535,0.03802043584845146
기준금리인상/NNG;시작될/VVX,1,0.8837036066992092,17,13,4,24,0.585772514794971,0.036265990371006446
금리상승/NNG;기다리/VV,1,0.8837036066992092,17,13,4,34,0.585772514794971,0.036265990371006446
성장/NNG;이/VV;갈/VX,1,0.8803676455282972,36,27,9,66,0.7251072884276117,0.046256856210754524
콜금리/NNG;올릴/VV,1,0.8678100512513465,53,39,14,22,0.8162618363188903,0.057902954175403844
듀레이션/NNG;늘리/VV,1,0.8658637480091325,24,18,6,41,0.6382768935526087,0.0459894635743146
경기회복세/NNG;둔화될/VVX,1,0.8658637480091325,24,18,6,32,0.6382768935526087,0.0459894635743146
기준금리인상/NNG;단행되/VVX,1,0.8658637480091325,24,18,6,37,0.6382768935526087,0.0459894635743146
확장/NNG;유지하/VVX,1,0.8658637480091325,24,18,6,10,0.6382768935526087,0.0459894635743146
경기둔화/NNG;나타나/VV,1,0.859601138874488,20,15,5,24,0.6065714208110502,0.04589235635016878
금리/NNG;동결함/VVX,1,0.859601138874488,20,15,5,32,0.6065714208110502,0.04589235635016878
대외불확실성/NNG;완화되/VVX,1,0.8589998102878702,31,23,8,55,0.6872934050879701,0.052238525164515624
침체/NNG;벗어나/VV,1,0.8567376975522107,38,28,10,77,0.7322153413447738,0.05661161040575974
안전자산선호심리/NNG;약화될/VVX,1,0.8524399937064746,16,12,4,24,0.5737354559166638,0.04579094291244741
동결/NNG;가/VV,1,0.8524399937064746,16,12,4,9,0.5737354559166638,0.04579094291244741
수출/NNG;타격/NNG;입/VV,1,0.8524399937064746,16,12,4,38,0.5737354559166638,0.04579094291244741
자산/NNG;늘리/VV,1,0.8524399937064746,16,12,4,16,0.5737354559166638,0.04579094291244741
금리상승/NNG;예상하/VVX,1,0.8524399937064746,16,12,4,61,0.5737354559166638,0.04579094291244741
내수/NNG;개선되/VVX,1,0.8509553063449418,27,20,7,47,0.6577726621771224,0.05306715981504321
금리인상/NNG;나타나/VV,1,0.8473939527736714,58,42,16,12,0.8330234532870017,0.06893924422698854
내수/NNG;회복세/NNG;보이/VV,1,0.8282416790522542,19,14,5,33,0.5946307577682585,0.055946989915651044
경기둔화우려/NNG;부각되/VVX,1,0.8282416790522542,19,14,5,32,0.5946307577682585,0.055946989915651044
출구전략/NNG;시행되/VVX,1,0.8282416790522542,19,14,5,33,0.5946307577682585,0.055946989915651044
리스크/NNG;완화될/VVX,1,0.8282416790522542,19,14,5,36,0.5946307577682585,0.055946989915651044
성장속도/NNG;둔화되/VVX,1,0.8282416790522542,19,14,5,13,0.5946307577682585,0.055946989915651044
금리/NNG;상승세/NNG;재개되/VVX,1,0.8282416790522542,19,14,5,80,0.5946307577682585,0.055946989915651044
인플레이션/NNG;유발하/VVX;않/VX,1,0.8282416790522542,19,14,5,18,0.5946307577682585,0.055946989915651044
인플레이션기대심리/NNG;확산되/VVX,1,0.8267125369191584,26,19,7,25,0.6465516019433649,0.06142350057246746
신흥시장/NNG;경제/NNG;호조/NNG;지속하/VVX,1,0.8267125369191584,26,19,7,18,0.6465516019433649,0.06142350057246746
국제원자재가격/NNG;오르/VV,1,0.821574686489984,36,26,10,8,0.712362984872771,0.06987317452089202
경기/NNG;상승세/NNG;지속되/VVX,1,0.821574686489984,36,26,10,12,0.712362984872771,0.06987317452089202
경기회복/NNG;고유가/NNG;따른/VV,1,0.8108196648312869,15,11,4,8,0.5612838733439677,0.058710528318813376
금리메리트/NNG;인해/VV,1,0.8108196648312869,15,11,4,21,0.5612838733439677,0.058710528318813376
금리인상/NNG;검토하/VVX,1,0.8108196648312869,15,11,4,18,0.5612838733439677,0.058710528318813376
금리인상/NNG;나올/VV,1,0.8108196648312869,15,11,4,28,0.5612838733439677,0.058710528318813376
물가안정/NNG;웃돌/VV,1,0.8108196648312869,15,11,4,6,0.5612838733439677,0.058710528318813376
경제/NNG;활력/NNG;회복하/VVX,1,0.8108196648312869,15,11,4,5,0.5612838733439677,0.058710528318813376
금리/NNG;올리/VV;쉽/VA;않/VX,1,0.8108196648312869,15,11,4,33,0.5612838733439677,0.058710528318813376
금리정상화/NNG;나서/VV,1,0.8108196648312869,15,11,4,30,0.5612838733439677,0.058710528318813376
인플레이션/NNG;억제될/VVX,1,0.8106999592519368,22,16,6,22,0.6150635124891478,0.0643807616344062
인플레이션/NNG;완화될/VVX,1,0.8106999592519368,22,16,6,24,0.6150635124891478,0.0643807616344062
금리인상/NNG;했/VV,1,0.8106999592519368,22,16,6,17,0.6150635124891478,0.0643807616344062
양적완화/NNG;지속되/VVX,1,0.8106999592519368,22,16,6,29,0.6150635124891478,0.0643807616344062
물가상승률/NNG;낮추/VV,1,0.8106999592519368,22,16,6,35,0.6150635124891478,0.0643807616344062
금리하락압력/NNG;지속될/VVX,1,0.8106999592519368,22,16,6,53,0.6150635124891478,0.0643807616344062
견조한/VAX;성장/NNG;지속하/VVX,1,0.8077143076282285,116,81,35,96,0.9522199598021374,0.10140726386092787
불확실성/NNG;해소하/VVX,1,0.8071094227982711,32,23,9,42,0.6841500866469419,0.0731120750526013
콜금리/NNG;인상하/VVX,1,0.8012042265551393,128,89,39,104,0.9589435339574572,0.10595361203310247
금리인상/NNG;인해/VV,1,0.7900966573715813,63,44,19,81,0.8379831480993082,0.09835580924677782
금리/NNG;올린/VV,1,0.7896971439240501,139,96,43,172,0.9613732503774053,0.11307786058369407
금리/NNG;올릴/VV;필요/NNG;있/VA,1,0.7886643024610436,18,13,5,9,0.5822774573772069,0.06886347786247601
정책금리/NNG;인하될/VVX,1,0.7886643024610436,18,13,5,26,0.5822774573772069,0.06886347786247601
금리인상/NNG;배제하/VVX,1,0.7886643024610436,18,13,5,18,0.5822774573772069,0.06886347786247601
물가목표/NNG;달성/NNG;위해/VV,1,0.7886643024610436,18,13,5,21,0.5822774573772069,0.06886347786247601
성장/NNG;기대된/VVX,1,0.7886643024610436,18,13,5,18,0.5822774573772069,0.06886347786247601
경제지표/NNG;하회하/VVX,1,0.7886643024610436,18,13,5,52,0.5822774573772069,0.06886347786247601
잠재성장률/NNG;웃도/VV,1,0.7885368508008848,28,20,8,25,0.6543531501560964,0.077439643269915
하방위험/NNG;있/VV,1,0.7815970844546607,31,22,9,48,0.6731220944227474,0.08258951260264186
기준금리/NNG;올라갈/VV,1,0.7738365281673338,21,15,6,11,0.6028816467965442,0.07692884001022826
경제/NNG;둔화시/VVX,1,0.7738365281673338,21,15,6,12,0.6028816467965442,0.07692884001022826
하방위험/NNG;작용할/VVX,1,0.7674807278780371,43,30,13,39,0.74161540566358,0.09763489800713453
경기/NNG;상승세/NNG;지속하/VVX,1,0.7638196906546975,24,17,7,11,0.6230289582692304,0.08348439451975623
마이너스/NNG;보였/VV,1,0.7638196906546975,24,17,7,19,0.6230289582692304,0.08348439451975623
경제지표/NNG;양호하/VVX,1,0.7524381154397277,30,21,9,50,0.6617230222201106,0.09353676038319152
물가/NNG;있/VV,1,0.7524381154397277,30,21,9,31,0.6617230222201106,0.09353676038319152
금리/NNG;인상된/VVX,1,0.7493795515661661,33,23,10,67,0.6801771291075736,0.09750090033012461
채권시장/NNG;우호적/VAX;작용할/VVX,1,0.7473955318172782,36,25,11,126,0.6979880942101936,0.10095900399064006
금리인상/NNG;통한/VV,1,0.7461706773093042,39,27,12,83,0.7151294050230792,0.10401183392911427
고용지표부진/NNG;따른/VV,1,0.7389884862098168,17,12,5,31,0.569397208215249,0.08550613870084234
불안/NNG;야기하/VVX,1,0.7389884862098168,17,12,5,30,0.569397208215249,0.08550613870084234
성장률전망/NNG;낮췄/VV,1,0.7389884862098168,17,12,5,10,0.569397208215249,0.08550613870084234
금리인상/NNG;자제해/VVX,1,0.7389884862098168,17,12,5,11,0.569397208215249,0.08550613870084234
단기금리/NNG;상승/NNG;따른/VV,1,0.7389884862098168,17,12,5,18,0.569397208215249,0.08550613870084234
금리/NNG;동결됐/VVX,1,0.7389884862098168,17,12,5,35,0.569397208215249,0.08550613870084234
주택시장/NNG;지원하/VVX,1,0.7389884862098168,17,12,5,9,0.569397208215249,0.08550613870084234
물가상승/NNG;인해/VV,1,0.7389884862098168,17,12,5,27,0.569397208215249,0.08550613870084234
물가안정/NNG;상단인/VVX,1,0.7389884862098168,17,12,5,14,0.569397208215249,0.08550613870084234
경기/NNG;부양할/VVX;있/VV,1,0.7389884862098168,17,12,5,22,0.569397208215249,0.08550613870084234
콜금리/NNG;인상했/VVX,1,0.7294112195549058,59,40,19,40,0.8072848288586486,0.12636507182104822
금리인상/NNG;결정했/VVX,1,0.7292497452004358,20,14,6,17,0.5902101759822521,0.09244982579860063
경기둔화/NNG;심화될/VVX,1,0.7292497452004358,20,14,6,23,0.5902101759822521,0.09244982579860063
콜금리/NNG;인하하/VVX,1,0.7292497452004358,20,14,6,10,0.5902101759822521,0.09244982579860063
수출호조/NNG;힘입/VV,1,0.7240035116768859,47,32,15,79,0.7527357434921849,0.12055366751705486
인플레이션기대심리/NNG;높/VA;물가상승률/NNG;이어질/VV,1,0.7236415879081883,23,16,7,1,0.610612889028413,0.09794067685719966
금리인상/NNG;신중하/VVX,1,0.7236415879081883,23,16,7,32,0.610612889028413,0.09794067685719966
기준금리/NNG;인상한/VVX,1,0.7219929153696363,76,51,25,67,0.8624049065962696,0.13928434085995844
내수/NNG;증가하/VVX,1,0.7213304304076278,41,28,13,37,0.7211904504038577,0.1167992110651855
물가안정/NNG;위한/VV,1,0.7098020689165196,78,52,26,164,0.8645951869196087,0.14678902019817378
금융위기/NNG;극복하/VVX,1,0.7011117532989335,46,31,15,70,0.7427503034286577,0.13053535282632403
금리동결/NNG;예상되/VVX,1,0.6915782765965719,37,25,12,67,0.6932071236990681,0.12641577393386583
물가안정/NNG;두/VV,1,0.6915782765965719,37,25,12,70,0.6932071236990681,0.12641577393386583
침체/NNG;빠지/VV;않/VX,1,0.684853605901262,31,21,10,22,0.656785888504914,0.1228692564041009
양적완화/NNG;축소할/VVX,1,0.6816505130830326,28,19,9,100,0.6376332861030409,0.12072609319811012
잠재성장률/NNG;밑도/VV,1,0.6788094204417885,25,17,8,29,0.6179036466783855,0.11823263702497475
금리하락/NNG;동조화되/VVX,1,0.6788094204417885,25,17,8,27,0.6179036466783855,0.11823263702497475
gdp/NNG;증가하/VVX,1,0.6788094204417885,25,17,8,56,0.6179036466783855,0.11823263702497475
경제/NNG;반등하/VVX,1,0.6773638644283271,16,11,5,24,0.5558129572028874,0.10692181355883071
기준금리/NNG;만장일치/NNG;동결했/VVX,1,0.6773638644283271,16,11,5,33,0.5558129572028874,0.10692181355883071
재고조정/NNG;마무리되/VVX,1,0.6773638644283271,16,11,5,31,0.5558129572028874,0.10692181355883071
경기둔화우려/NNG;확대되/VVX,1,0.6773638644283271,16,11,5,8,0.5558129572028874,0.10692181355883071
자본확충/NNG;위한/VV,1,0.6773638644283271,16,11,5,49,0.5558129572028874,0.10692181355883071
경기침체/NNG;우려하/VVX,1,0.6773638644283271,16,11,5,15,0.5558129572028874,0.10692181355883071
기준금리인상/NNG;시사했/VVX,1,0.6773638644283271,16,11,5,26,0.5558129572028874,0.10692181355883071
기준금리/NNG;상승할/VVX,1,0.6773638644283271,16,11,5,16,0.5558129572028874,0.10692181355883071
대외여건/NNG;개선되/VVX,1,0.6773638644283271,16,11,5,39,0.5558129572028874,0.10692181355883071
gdp/NNG;감소했/VVX,1,0.6773638644283271,16,11,5,15,0.5558129572028874,0.10692181355883071
경제성장/NNG;미치/VV,1,0.6773638644283271,16,11,5,28,0.5558129572028874,0.10692181355883071
내수/NNG;부진해/VVX,1,0.6773638644283271,16,11,5,9,0.5558129572028874,0.10692181355883071
금리하락/NNG;나타날/VV,1,0.6773638644283271,16,11,5,14,0.5558129572028874,0.10692181355883071
금리/NNG;끌어올렸/VV,1,0.6758432733193729,19,13,6,15,0.5769239855825374,0.11160630292727475
금융시장/NNG;변동성/NNG;확대되/VVX,1,0.6758432733193729,19,13,6,16,0.5769239855825374,0.11160630292727475
인플레이션/NNG;인해/VV,1,0.6758432733193729,19,13,6,24,0.5769239855825374,0.11160630292727475
금리인상/NNG;미룰/VV,1,0.6758432733193729,19,13,6,26,0.5769239855825374,0.11160630292727475
금리/NNG;유지될/VVX,1,0.6758432733193729,19,13,6,29,0.5769239855825374,0.11160630292727475
수출호조/NNG;지속되/VVX,1,0.6758432733193729,19,13,6,31,0.5769239855825374,0.11160630292727475
경기/NNG;회복된/VVX,1,0.6601646130717773,36,24,12,22,0.6816159484728102,0.13953132505579666
금리인상/NNG;남/VV,1,0.6601646130717773,36,24,12,48,0.6816159484728102,0.13953132505579666
소비/NNG;개선되/VVX,1,0.6601646130717773,36,24,12,41,0.6816159484728102,0.13953132505579666
기준금리/NNG;인상한/VAX;이/VV,1,0.6468875856368868,30,20,10,19,0.6443793587613602,0.138158726599046
동결/NNG;이어질/VV,1,0.6468875856368868,30,20,10,53,0.6443793587613602,0.138158726599046
금리/NNG;내려갈/VV,1,0.6442726913047323,71,46,25,52,0.8269815313978298,0.1789046964465324
경제성장률/NNG;떨어질/VV,1,0.6393813083493809,27,18,9,26,0.624819530288282,0.1374345825002931
견조한/VAX;성장세/NNG;보이/VV,1,0.6393813083493809,27,18,9,37,0.624819530288282,0.1374345825002931
리스크/NNG;지속되/VVX,1,0.6393813083493809,27,18,9,22,0.624819530288282,0.1374345825002931
경기/NNG;위축될/VVX,1,0.6346403764436099,38,25,13,31,0.6876114949495221,0.15367588334691176
금리인상/NNG;되/VV,1,0.6312338101607946,24,16,8,24,0.6046793929770856,0.1366841047845919
신용등급/NNG;유지하/VVX,1,0.6223934407561094,21,14,7,25,0.584002482832998,0.13590644807326563
물가안정/NNG;지키/VV,1,0.6223934407561094,21,14,7,5,0.584002482832998,0.13590644807326563
경기/NNG;나아질/VV,1,0.6223934407561094,21,14,7,38,0.584002482832998,0.13590644807326563
경기둔화우려/NNG;지속될/VVX,1,0.6223934407561094,21,14,7,22,0.584002482832998,0.13590644807326563
불안요인/NNG;남/VV,1,0.6209719214745006,43,28,15,72,0.7104410445408359,0.16609763385840723
금리인상/NNG;필요하/VVX,1,0.6204788492056676,83,53,30,102,0.8523976942452529,0.19960596965219868
성장/NNG;기록하/VVX,1,0.6159980592951337,32,21,11,57,0.6508112811820186,0.15462456436705296
흑자/NNG;기록하/VVX,1,0.6159980592951337,32,21,11,42,0.6508112811820186,0.15462456436705296
금리인상/NNG;단행된/VVX;하/VV,1,0.6128046435612475,18,12,6,17,0.5628388310754175,0.13510075480577552
큰/VA;변동성/NNG;보이/VV,1,0.6048989618876457,29,19,10,24,0.6314127053929026,0.1554124624260358
원자재가격/NNG;하락하/VVX,1,0.6031650962703863,53,34,19,60,0.7515805011959568,0.18600143915184295
경제/NNG;불확실성/NNG;커지/VV,1,0.6024078115687759,15,10,5,21,0.5412449154770929,0.13426615712583884
금리인상/NNG;재개되/VVX,1,0.6024078115687759,15,10,5,8,0.5412449154770929,0.13426615712583884
기준금리/NNG;낮/VA;수준이/VVX,1,0.6024078115687759,15,10,5,29,0.5412449154770929,0.13426615712583884
기준금리인상/NNG;예상했/VVX,1,0.6024078115687759,15,10,5,26,0.5412449154770929,0.13426615712583884
기준금리인상/NNG;필요하/VVX,1,0.6024078115687759,15,10,5,14,0.5412449154770929,0.13426615712583884
수출/NNG;급감했/VVX,1,0.6024078115687759,15,10,5,9,0.5412449154770929,0.13426615712583884
콜금리/NNG;위한/VV,1,0.6024078115687759,15,10,5,12,0.5412449154770929,0.13426615712583884
인플레이션/NNG;잘/MAG;제어될/VVX,1,0.6024078115687759,15,10,5,26,0.5412449154770929,0.13426615712583884
gdp/NNG;하락하/VVX,1,0.6024078115687759,15,10,5,5,0.5412449154770929,0.13426615712583884
수출/NNG;부정적/VAX;영향/NNG;줄/VV,1,0.6024078115687759,15,10,5,16,0.5412449154770929,0.13426615712583884
세계경제/NNG;회복세/NNG;이/VV,1,0.6006764028200584,37,24,13,10,0.6755009732899163,0.16848161450194554
기준금리/NNG;올려/VV,1,0.5935617960456481,50,32,18,47,0.736477569943391,0.18779272905305752
성장동력/NNG;약화되/VVX,1,0.5922664440836862,26,17,9,6,0.611379075857427,0.15651748467655016
경제과열/NNG;막/VV,1,0.5922664440836862,26,17,9,10,0.611379075857427,0.15651748467655016
금리인상/NNG;필요할/VVX,1,0.5902379044405801,42,27,15,55,0.6987930983516552,0.18001415687329891
유가급락/NNG;따른/VV,1,0.5885505384672793,34,22,12,40,0.6569615595638881,0.1701144262841883
금리인상/NNG;가능하/VVX,1,0.5877742407783539,55,35,20,91,0.7557931550810993,0.19617056348778505
성장률/NNG;나타낼/VV,1,0.5776964854647602,23,15,8,33,0.5907345467653842,0.15807480163968585
금융시장안정/NNG;도모하/VVX,1,0.5776964854647602,23,15,8,5,0.5907345467653842,0.15807480163968585
기준금리/NNG;유지했/VVX,1,0.5776964854647602,23,15,8,33,0.5907345467653842,0.15807480163968585
인플레이션/NNG;대응하/VVX,1,0.5747399531894875,31,20,11,26,0.6377238026792882,0.172164243152049
생산/NNG;증가하/VVX,1,0.5747399531894875,31,20,11,39,0.6377238026792882,0.172164243152049
경제/NNG;악영향/NNG;미치/VV,1,0.5747399531894875,31,20,11,32,0.6377238026792882,0.172164243152049
금리/NNG;올려서/VV,1,0.5747399531894875,31,20,11,47,0.6377238026792882,0.172164243152049
유동성/NNG;줄이/VV,1,0.5747399531894875,31,20,11,58,0.6377238026792882,0.172164243152049
금리인상/NNG;있/VV,1,0.5679996393919053,222,138,84,247,0.920921818792388,0.25363870618721585
금리인상/NNG;할/VV,1,0.5643157271647814,134,83,51,151,0.9036237999769535,0.25158478996954536
글로벌/NNG;경기회복/NNG;따른/VV,1,0.5605729088823854,20,13,7,39,0.5694991856806716,0.16030229081317082
경기/NNG;나아지/VV,1,0.5605729088823854,20,13,7,40,0.5694991856806716,0.16030229081317082
금융완화/NNG;유지할/VVX,1,0.5605729088823854,20,13,7,26,0.5694991856806716,0.16030229081317082
경제/NNG;안정시/VVX,1,0.5605729088823854,20,13,7,22,0.5694991856806716,0.16030229081317082
경제성장률/NNG;밑돌/VV,1,0.5605729088823854,20,13,7,28,0.5694991856806716,0.16030229081317082
경기/NNG;부양해/VVX,1,0.5588453387213168,28,18,10,24,0.6177985357294602,0.17477371033753208
정책금리/NNG;인상해/VVX,1,0.5588453387213168,28,18,10,39,0.6177985357294602,0.17477371033753208
기준금리인상/NNG;이뤄질/VV,1,0.5574486882303684,41,26,15,49,0.6866472937665088,0.19503969038447694
성장/NNG;예상된/VVX,1,0.5574486882303684,41,26,15,47,0.6866472937665088,0.19503969038447694
성장률/NNG;달성할/VVX,1,0.5531799264352246,46,29,17,51,0.7090118831476504,0.20389087931079455
금리하락/NNG;이끌/VV,1,0.5484484705578181,56,35,21,117,0.7492980169900222,0.21841976247800343
금리인상/NNG;시사할/VVX,1,0.5422464475761795,38,24,14,45,0.6685165351806094,0.19833911722099573
기준금리인상/NNG;지연될/VVX,1,0.5403012050656868,25,16,9,35,0.5971919336880208,0.17815469868015713
채권시장/NNG;강세/NNG;이/VV,1,0.5398882829752054,17,11,6,29,0.5476787674227039,0.16357429689982259
경제성장률/NNG;하락할/VVX,1,0.5398882829752054,17,11,6,20,0.5476787674227039,0.16357429689982259
금리인하/NNG;기정사실화하/VVX,1,0.5398882829752054,17,11,6,35,0.5476787674227039,0.16357429689982259
성장률/NNG;그친/VV,1,0.5398882829752054,17,11,6,6,0.5476787674227039,0.16357429689982259
수출호조/NNG;이어지/VV,1,0.5398882829752054,17,11,6,14,0.5476787674227039,0.16357429689982259
성장률/NNG;낮추/VV,1,0.5398882829752054,17,11,6,74,0.5476787674227039,0.16357429689982259
투자심리/NNG;개선시/VVX,1,0.5398882829752054,17,11,6,49,0.5476787674227039,0.16357429689982259
금리/NNG;하향안정되/VVX,1,0.5398882829752054,17,11,6,32,0.5476787674227039,0.16357429689982259
경기회복/NNG;확인되/VVX,1,0.5398882829752054,17,11,6,27,0.5476787674227039,0.16357429689982259
인플레이션기대심리/NNG;억제하/VVX,1,0.5398882829752054,17,11,6,25,0.5476787674227039,0.16357429689982259
동결/NNG;전망하/VVX,1,0.5398882829752054,17,11,6,11,0.5476787674227039,0.16357429689982259
금리인상/NNG;나/VV,1,0.5398882829752054,17,11,6,31,0.5476787674227039,0.16357429689982259
불확실성/NNG;완화될/VVX,1,0.5388134155271282,43,27,16,96,0.6918779060357497,0.2072687328001149
콜금리/NNG;올리/VV,1,0.53533251611894,58,36,22,68,0.7531714617048693,0.22784665019590586
콜금리/NNG;동결하/VVX,1,0.5348892052633776,68,42,26,63,0.7866424311142706,0.2382676716285581
콜금리/NNG;인상할/VVX,1,0.5303099679076448,113,69,44,111,0.8752363183287194,0.2685094394392468
불확실성/NNG;줄어들/VV,1,0.530052602838234,30,19,11,50,0.6239765202063582,0.19156364230199657
콜금리/NNG;인상되/VVX,1,0.530052602838234,30,19,11,27,0.6239765202063582,0.19156364230199657
생산/NNG;늘/VV,1,0.530052602838234,30,19,11,22,0.6239765202063582,0.19156364230199657
변동성/NNG;축소되/VVX,1,0.530052602838234,30,19,11,80,0.6239765202063582,0.19156364230199657
정책금리/NNG;유지하/VVX,1,0.530052602838234,30,19,11,36,0.6239765202063582,0.19156364230199657
성장률/NNG;하/VV,1,0.530052602838234,30,19,11,47,0.6239765202063582,0.19156364230199657
금리상승/NNG;되돌리/VV,1,0.5249433568026332,35,22,13,62,0.6496179749657501,0.20227628918507748
금리인상/NNG;가능성/NNG;반영해/VVX,1,0.5182714998060467,22,14,8,20,0.575897212297443,0.18263521804697122
성장세/NNG;확대되/VVX,1,0.5182714998060467,22,14,8,35,0.575897212297443,0.18263521804697122
금리역전/NNG;따른/VV,1,0.5182714998060467,22,14,8,38,0.575897212297443,0.18263521804697122
불확실성/NNG;고려하/VVX,1,0.5182714998060467,22,14,8,25,0.575897212297443,0.18263521804697122
경제/NNG;위축되/VVX,1,0.5182714998060467,22,14,8,37,0.575897212297443,0.18263521804697122
금리인상/NNG;시사하/VVX;않/VX,1,0.5182714998060467,22,14,8,19,0.575897212297443,0.18263521804697122
경제둔화/NNG;따른/VV,1,0.5182714998060467,22,14,8,21,0.575897212297443,0.18263521804697122
금리인하기대/NNG;강화되/VVX,1,0.5182714998060467,22,14,8,32,0.575897212297443,0.18263521804697122
불확실성/NNG;있/VV,1,0.514919882815573,132,80,52,162,0.8872259894457449,0.28394906244709894
기준금리/NNG;인상된/VVX,1,0.5114515580596808,62,38,24,121,0.7603706185753283,0.24564996959573593
경기부양/NNG;따른/VV,1,0.5088130644813542,27,17,10,28,0.6034240856373974,0.19633995411654323
인플레이션압력/NNG;대응하/VVX,1,0.5088130644813542,27,17,10,15,0.6034240856373974,0.19633995411654323
수출/NNG;늘어날/VV,1,0.5088130644813542,27,17,10,26,0.6034240856373974,0.19633995411654323
고용/NNG;늘어나/VV,1,0.5088130644813542,27,17,10,46,0.6034240856373974,0.19633995411654323
물가상승압력/NNG;커질/VV,1,0.5088130644813542,27,17,10,41,0.6034240856373974,0.19633995411654323
기준금리/NNG;인상됐/VVX,1,0.5088130644813542,27,17,10,39,0.6034240856373974,0.19633995411654323
금리인상/NNG;예상된/VVX,1,0.5079984009359708,52,32,20,60,0.7227631987419466,0.23568683158074416
금리인상/NNG;위한/VV,1,0.5063619026323902,79,48,31,157,0.8080712860402726,0.264667510524674
수출/NNG;호조/NNG;지속하/VVX,1,0.5050843816587809,32,20,12,19,0.6299412990228623,0.2070333998340754
기준금리/NNG;유지해/VVX,1,0.5050843816587809,32,20,12,50,0.6299412990228623,0.2070333998340754
콜금리/NNG;인상해/VVX,1,0.5049067299238972,42,26,16,29,0.6791979187796297,0.22332821075073686
변동성/NNG;줄어들/VV,1,0.5049067299238972,42,26,16,60,0.6791979187796297,0.22332821075073686
기준금리/NNG;인상하/VVX;않/VX,1,0.5047387917981869,74,45,29,134,0.7946563595327473,0.261409972861604
기준금리/NNG;인상해/VVX,1,0.5023264786215877,146,88,58,199,0.8909524541014361,0.29498596149460576
내수/NNG;회복세/NNG;이/VV,1,0.49202843876711433,49,30,19,16,0.7063516494989395,0.24034621827084338
물가안정기조/NNG;유지되/VVX,1,0.49175082729557174,125,75,50,104,0.8743830828666179,0.297739075675546
유동성/NNG;넘쳐나/VV,1,0.491454662259458,19,12,7,25,0.553876988271794,0.18874970515764258
리스크/NNG;반영하/VVX,1,0.491454662259458,19,12,7,43,0.553876988271794,0.18874970515764258
금리하락/NNG;견인했/VVX,1,0.491454662259458,19,12,7,30,0.553876988271794,0.18874970515764258
금융완화/NNG;크/VA;축소될/VVX,1,0.491454662259458,19,12,7,16,0.553876988271794,0.18874970515764258
물가상승률/NNG;안정될/VVX,1,0.491454662259458,19,12,7,17,0.553876988271794,0.18874970515764258
기준금리인상/NNG;가능성/NNG;시사했/VVX,1,0.491454662259458,19,12,7,26,0.553876988271794,0.18874970515764258
채권시장/NNG;호재/NNG;작용할/VVX,1,0.491454662259458,19,12,7,20,0.553876988271794,0.18874970515764258
기준금리인상/NNG;하/VV,1,0.491454662259458,19,12,7,26,0.553876988271794,0.18874970515764258
불안/NNG;심화될/VVX,1,0.491454662259458,19,12,7,22,0.553876988271794,0.18874970515764258
금리/NNG;큰/VA;하락했/VVX,1,0.4868996800351222,61,37,24,97,0.7496801168189615,0.25854996206130565
기준금리/NNG;인상함/VVX,1,0.48368007550632175,24,15,9,53,0.5820982379316657,0.20245053852819792
금리인상우려/NNG;따른/VV,1,0.48368007550632175,24,15,9,27,0.5820982379316657,0.20245053852819792
침체/NNG;보이/VV,1,0.48368007550632175,24,15,9,8,0.5820982379316657,0.20245053852819792
금리/NNG;오르/VV;않/VX,1,0.48327172865802637,34,21,13,50,0.6357134653006358,0.2213331483290961
금리인상/NNG;선반영하/VVX,1,0.48327172865802637,34,21,13,60,0.6357134653006358,0.2213331483290961
성장/NNG;따른/VV,1,0.48311043242896345,56,34,22,83,0.7309920325550134,0.25461282518754047
선진국/NNG;경제/NNG;회복세/NNG;이/VV,1,0.48205972155592125,29,18,11,20,0.6094646315911364,0.21286516668806546
인플레이션/NNG;유발할/VVX,1,0.48205972155592125,29,18,11,48,0.6094646315911364,0.21286516668806546
금리인상/NNG;가능성/NNG;열/VV,1,0.47070855553709956,143,85,58,246,0.8791836144424103,0.3162107670132981
경기/NNG;둔화하/VVX,1,0.466695089804007,53,32,21,68,0.7150786492757798,0.25984462227131594
불확실성/NNG;지속될/VVX,1,0.4614092855403189,60,36,24,138,0.7385393305692782,0.27200616710852527
불확실성/NNG;해소된/VVX,1,0.4614092855403189,60,36,24,110,0.7385393305692782,0.27200616710852527
성장/NNG;예상되/VVX,1,0.4592721629848522,91,54,37,78,0.8181956072579628,0.30298090900416086
불확실성/NNG;확대될/VVX,1,0.45910497306456133,31,19,12,53,0.6153362270988826,0.22795778900045333
수출/NNG;증가해/VVX,1,0.45910497306456133,31,19,12,31,0.6153362270988826,0.22795778900045333
금리동결/NNG;점쳤/VV,1,0.4576928141281682,16,10,6,17,0.531022029884934,0.19742665333528917
금리인상/NNG;우려하/VVX,1,0.4576928141281682,16,10,6,10,0.531022029884934,0.19742665333528917
콜금리/NNG;하/VV,1,0.4576928141281682,16,10,6,4,0.531022029884934,0.19742665333528917
기준금리/NNG;유지되/VVX,1,0.4576928141281682,16,10,6,22,0.531022029884934,0.19742665333528917
금리인상/NNG;힘/NNG;실/VV,1,0.4576928141281682,16,10,6,16,0.531022029884934,0.19742665333528917
경기/NNG;호전되/VVX,1,0.4576928141281682,16,10,6,38,0.531022029884934,0.19742665333528917
기준금리인상/NNG;가능성/NNG;부각되/VVX,1,0.4576928141281682,16,10,6,12,0.531022029884934,0.19742665333528917
금리인상/NNG;가능성/NNG;확대되/VVX,1,0.4576928141281682,16,10,6,6,0.531022029884934,0.19742665333528917
유동성/NNG;늘/VV,1,0.4576928141281682,16,10,6,10,0.531022029884934,0.19742665333528917
금리인상/NNG;그치/VV,1,0.4576928141281682,16,10,6,17,0.531022029884934,0.19742665333528917
금융위기/NNG;진정되/VVX,1,0.4576928141281682,16,10,6,12,0.531022029884934,0.19742665333528917
금리상승압력/NNG;지속되/VVX,1,0.4576928141281682,16,10,6,18,0.531022029884934,0.19742665333528917
물가상승압력/NNG;나타날/VV,1,0.4576928141281682,16,10,6,9,0.531022029884934,0.19742665333528917
불확실성/NNG;대비해/VVX,1,0.4576928141281682,16,10,6,16,0.531022029884934,0.19742665333528917
유동성/NNG;지속되/VVX,1,0.4576928141281682,16,10,6,17,0.531022029884934,0.19742665333528917
경제/NNG;확산될/VVX,1,0.4576928141281682,16,10,6,12,0.531022029884934,0.19742665333528917
불안/NNG;확대될/VVX,1,0.4576928141281682,16,10,6,10,0.531022029884934,0.19742665333528917
금리인하기대감/NNG;확산되/VVX,1,0.4576928141281682,16,10,6,17,0.531022029884934,0.19742665333528917
금리정상화/NNG;나설/VV,1,0.4576928141281682,16,10,6,18,0.531022029884934,0.19742665333528917
투자심리/NNG;고무시/VVX,1,0.4576928141281682,16,10,6,29,0.531022029884934,0.19742665333528917
지준율/NNG;인상했/VVX,1,0.455030603745338,26,16,10,40,0.5881425936047661,0.2201372353596838
물가/NNG;하/VV,1,0.455030603745338,26,16,10,35,0.5881425936047661,0.2201372353596838
고용지표/NNG;상회하/VVX,1,0.455030603745338,26,16,10,20,0.5881425936047661,0.2201372353596838
양적완화/NNG;확대하/VVX,1,0.45335284151025124,21,13,8,39,0.5599290711164715,0.21046410965726398
실업률/NNG;나타내/VV,1,0.45335284151025124,21,13,8,17,0.5599290711164715,0.21046410965726398
불안/NNG;해소하/VVX,1,0.45335284151025124,21,13,8,28,0.5599290711164715,0.21046410965726398
경제회복/NNG;위한/VV,1,0.45335284151025124,21,13,8,21,0.5599290711164715,0.21046410965726398
기준금리/NNG;묶/VV,1,0.45335284151025124,21,13,8,35,0.5599290711164715,0.21046410965726398
고용지표/NNG;개선된/VVX,1,0.45335284151025124,21,13,8,20,0.5599290711164715,0.21046410965726398
경기회복세/NNG;강화되/VVX,1,0.45335284151025124,21,13,8,25,0.5599290711164715,0.21046410965726398
경제체질/NNG;개선하/VVX,1,0.45335284151025124,21,13,8,24,0.5599290711164715,0.21046410965726398
기준금리동결/NNG;예상하/VVX,1,0.45335284151025124,21,13,8,39,0.5599290711164715,0.21046410965726398
기준금리/NNG;올린/VV,1,0.4504604676385777,129,76,53,124,0.8633753428066994,0.3268875934122928
경기회복/NNG;따른/VV,1,0.45010018456048373,200,118,82,365,0.8854840009187824,0.33556111949792244
경제/NNG;살아나/VV,1,0.44704166487838815,38,23,15,50,0.6467360537602643,0.24696782711270135
불확실성/NNG;완화된/VVX,1,0.44704166487838815,38,23,15,73,0.6467360537602643,0.24696782711270135
금리인상/NNG;단행하/VVX;않/VX,1,0.44704166487838815,38,23,15,67,0.6467360537602643,0.24696782711270135
금리/NNG;동결한/VVX,1,0.44704166487838815,38,23,15,44,0.6467360537602643,0.24696782711270135
금리/NNG;동결해/VVX,1,0.4422712635049717,64,38,26,63,0.745453174656122,0.2880667165077019
금리인상/NNG;지연될/VVX,1,0.4415993746116593,90,53,37,88,0.8100108699924765,0.3135364652875146
기준금리/NNG;동결한/VVX,1,0.4406925419825154,45,27,18,71,0.6759142962859461,0.26222001275108875
성장/NNG;둔화되/VVX,1,0.4402431604992796,71,42,29,97,0.7653240775568383,0.2972373412768662
성장세/NNG;이/VV,1,0.43528937636148224,135,79,56,186,0.8622055840671654,0.33898952875503796
금리/NNG;올리/VV;않/VX,1,0.4331731738736351,193,113,80,258,0.8792390607825711,0.3474924328121015
물가안정/NNG;위해/VV,1,0.43268635750502593,118,69,49,184,0.8471427226276074,0.3352083343734295
정책금리인상/NNG;따른/VV,1,0.431832089517572,40,24,16,34,0.6520056261333195,0.2585360710303758
금리인상/NNG;이어지/VV,1,0.431832089517572,40,24,16,53,0.6520056261333195,0.2585360710303758
경기회복/NNG;기대/NNG;커지/VV,1,0.4309837458110026,28,17,11,47,0.5940544883440594,0.23604810659764316
마이너스/NNG;될/VV,1,0.4309837458110026,28,17,11,32,0.5940544883440594,0.23604810659764316
리스크관리/NNG;강화하/VVX,1,0.42830577007131243,47,28,19,38,0.6806651796711758,0.27224349654984265
성장세/NNG;나타낼/VV,1,0.42830577007131243,47,28,19,65,0.6806651796711758,0.27224349654984265
실업률/NNG;하락했/VVX,1,0.4266099495089417,54,32,22,79,0.7068685619811179,0.2838984996739871
경기/NNG;회복세/NNG;보이/VV,1,0.4266099495089417,54,32,22,97,0.7068685619811179,0.2838984996739871
금리인상/NNG;이/VV,1,0.4241798062225821,82,48,34,67,0.7871078426361873,0.3180044604331647
금리인상/NNG;이뤄질/VV,1,0.4235104935728198,146,85,61,197,0.8641580875209011,0.34970361006334905
경기/NNG;회복세/NNG;지속하/VVX,1,0.4228085913438937,23,14,9,38,0.5658826970526565,0.2293903912638666
성장세/NNG;둔화할/VVX,1,0.4228085913438937,23,14,9,27,0.5658826970526565,0.2293903912638666
금리/NNG;높이/VV,1,0.4228085913438937,23,14,9,41,0.5658826970526565,0.2293903912638666
금리인상/NNG;미루/VV,1,0.4218202305934693,35,21,14,31,0.6266279115460645,0.25462573979393427
유동성/NNG;줄어들/VV,1,0.4218202305934693,35,21,14,45,0.6266279115460645,0.25462573979393427
경기회복세/NNG;지속되/VVX,1,0.42047416596606046,129,75,54,173,0.8524892516565826,0.34753719758844576
금리상승/NNG;제한할/VVX,1,0.41681117568636816,56,33,23,73,0.7109140909171162,0.29240402442903546
경기회복/NNG;저해하/VVX,1,0.41581500210487987,18,11,7,17,0.536756608123439,0.2213039837184861
불확실성/NNG;큰/VA;상황이/VVX,1,0.41581500210487987,18,11,7,21,0.536756608123439,0.2213039837184861
경상수지흑자/NNG;따른/VV,1,0.41581500210487987,18,11,7,40,0.536756608123439,0.2213039837184861
금리인상/NNG;이루어지/VV,1,0.41581500210487987,18,11,7,14,0.536756608123439,0.2213039837184861
소비/NNG;증가했/VVX,1,0.41581500210487987,18,11,7,24,0.536756608123439,0.2213039837184861
수출증가율/NNG;둔화될/VVX,1,0.41581500210487987,18,11,7,30,0.536756608123439,0.2213039837184861
성장/NNG;제약하/VVX,1,0.41581500210487987,18,11,7,19,0.536756608123439,0.2213039837184861
경기선행지수/NNG;상승했/VVX,1,0.41581500210487987,18,11,7,22,0.536756608123439,0.2213039837184861
경기회복/NNG;저해할/VVX,1,0.41581500210487987,18,11,7,30,0.536756608123439,0.2213039837184861
금리인상시기/NNG;앞당길/VV,1,0.41581500210487987,18,11,7,6,0.536756608123439,0.2213039837184861
성장세/NNG;회복할/VVX,1,0.41581500210487987,18,11,7,39,0.536756608123439,0.2213039837184861
변동성/NNG;키울/VV;있/VV,1,0.41581500210487987,18,11,7,33,0.536756608123439,0.2213039837184861
양적완화/NNG;가능성/NNG;열/VV,1,0.41581500210487987,18,11,7,21,0.536756608123439,0.2213039837184861
고용지표/NNG;하회하/VVX,1,0.41581500210487987,18,11,7,24,0.536756608123439,0.2213039837184861
수입/NNG;늘어나/VV,1,0.41581500210487987,18,11,7,25,0.536756608123439,0.2213039837184861
금리/NNG;높여/VV,1,0.41581500210487987,18,11,7,25,0.536756608123439,0.2213039837184861
금리인상지연/NNG;따른/VV,1,0.41581500210487987,18,11,7,16,0.536756608123439,0.2213039837184861
금리인하기대감/NNG;유지되/VVX,1,0.41053899741322275,30,18,12,61,0.5998478508297311,0.2504802140172552
침체/NNG;빠지/VV,1,0.41053899741322275,30,18,12,38,0.5998478508297311,0.2504802140172552
금리인상/NNG;시작하/VVX,1,0.4057837093952983,44,26,18,48,0.6620923278089527,0.27964169143400713
물가상승압력/NNG;작용할/VVX,1,0.4057837093952983,44,26,18,66,0.6620923278089527,0.27964169143400713
기준금리/NNG;인상했/VVX,1,0.40221173339917415,325,188,137,363,0.871371338304755,0.37118517706676085
경제/NNG;성장하/VVX,1,0.39929053075964105,125,72,53,190,0.8411843770410643,0.36082638514278764
유럽재정위기/NNG;따른/VV,1,0.3978613452675632,25,15,10,54,0.5717612617241851,0.2460912396377583
금리인상/NNG;검토할/VVX,1,0.3978613452675632,25,15,10,14,0.5717612617241851,0.2460912396377583
장단기금리스프레드/NNG;축소되/VVX,1,0.3978613452675632,25,15,10,23,0.5717612617241851,0.2460912396377583
경기회복/NNG;되/VV,1,0.3978613452675632,25,15,10,22,0.5717612617241851,0.2460912396377583
성장률/NNG;달성하/VVX,1,0.39680945963171954,53,31,22,80,0.6940031772008346,0.29945166374647736
금리인상/NNG;가능성/NNG;있/VV,1,0.39294807664222864,32,19,13,62,0.6055301128690286,0.2636759733136654
경기/NNG;회복될/VVX,1,0.38953403256248054,78,45,33,124,0.7652229876457626,0.33590822747474924
금리인상/NNG;진행될/VVX,1,0.3878228040859266,55,32,23,88,0.6981567179199671,0.30770506491738253
경제성장률/NNG;하향조정하/VVX,1,0.38422553786565694,48,28,20,101,0.6716017764602171,0.29851182526121833
물가상승압력/NNG;완화하/VVX,1,0.3836516012626472,20,12,8,8,0.5424950406549357,0.24145132420297918
인플레이션/NNG;위험/NNG;상존해/VVX,1,0.3836516012626472,20,12,8,23,0.5424950406549357,0.24145132420297918
수출부진/NNG;이어지/VV,1,0.3836516012626472,20,12,8,40,0.5424950406549357,0.24145132420297918
경제/NNG;회복세/NNG;이/VV,1,0.3836516012626472,20,12,8,17,0.5424950406549357,0.24145132420297918
내수/NNG;부진하/VVX,1,0.3836516012626472,20,12,8,34,0.5424950406549357,0.24145132420297918
부동산가격/NNG;상승하/VVX,1,0.3836516012626472,20,12,8,23,0.5424950406549357,0.24145132420297918
소비자물가/NNG;급등하/VVX,1,0.3836516012626472,20,12,8,19,0.5424950406549357,0.24145132420297918
유동성/NNG;축소되/VVX,1,0.3836516012626472,20,12,8,24,0.5424950406549357,0.24145132420297918
추경/NNG;통한/VV,1,0.3836516012626472,20,12,8,33,0.5424950406549357,0.24145132420297918
금리/NNG;올리/VV;어려울/VA,1,0.3776468646128679,34,20,14,13,0.6111046500462171,0.2758307639455827
정책금리/NNG;인상될/VVX,1,0.3776468646128679,34,20,14,56,0.6111046500462171,0.2758307639455827
경제성장/NNG;뒷받침하/VVX,1,0.3776468646128679,34,20,14,21,0.6111046500462171,0.2758307639455827
성장/NNG;기록할/VVX,1,0.3771316000588789,27,16,11,35,0.5775742633901717,0.26100949164046594
노동시장/NNG;개선되/VVX,1,0.3771316000588789,27,16,11,82,0.5775742633901717,0.26100949164046594
수출/NNG;줄어들/VV,1,0.37475733035276226,50,29,21,47,0.6761470287178531,0.30724788219733806
금리인상우려/NNG;완화되/VVX,1,0.3678812857899638,77,44,33,81,0.7547064040848636,0.3484548175863806
경기부양/NNG;나섰/VV,1,0.3677664052340732,15,9,6,30,0.5122082086184204,0.2365539760827002
마이너스/NNG;머물/VV,1,0.3677664052340732,15,9,6,21,0.5122082086184204,0.2365539760827002
경기/NNG;악영향/NNG;미칠/VV,1,0.3677664052340732,15,9,6,19,0.5122082086184204,0.2365539760827002
경제성장/NNG;이루/VV,1,0.3677664052340732,15,9,6,14,0.5122082086184204,0.2365539760827002
성장/NNG;하방리스크/NNG;작용할/VVX,1,0.3677664052340732,15,9,6,13,0.5122082086184204,0.2365539760827002
기준금리/NNG;낮/VA;유지할/VVX,1,0.3677664052340732,15,9,6,17,0.5122082086184204,0.2365539760827002
실물경제/NNG;제약하/VVX,1,0.3677664052340732,15,9,6,4,0.5122082086184204,0.2365539760827002
디레버리징/NNG;따른/VV,1,0.3677664052340732,15,9,6,16,0.5122082086184204,0.2365539760827002
리스크/NNG;줄/VV,1,0.3677664052340732,15,9,6,23,0.5122082086184204,0.2365539760827002
변동성/NNG;확대할/VVX;있/VV,1,0.3677664052340732,15,9,6,11,0.5122082086184204,0.2365539760827002
인플레이션/NNG;잘/MAG;통제되/VVX,1,0.3677664052340732,15,9,6,13,0.5122082086184204,0.2365539760827002
성장/NNG;둔화할/VVX,1,0.3677664052340732,15,9,6,13,0.5122082086184204,0.2365539760827002
통화정책완화/NNG;조정/NNG;필요할/VVX,1,0.3677664052340732,15,9,6,42,0.5122082086184204,0.2365539760827002
정책금리인상/NNG;단행될/VVX,1,0.3677664052340732,15,9,6,12,0.5122082086184204,0.2365539760827002
금리메리트/NNG;부각되/VVX,1,0.3677664052340732,15,9,6,36,0.5122082086184204,0.2365539760827002
성장/NNG;했/VV,1,0.3677664052340732,15,9,6,27,0.5122082086184204,0.2365539760827002
양적완화/NNG;단행할/VVX,1,0.3677664052340732,15,9,6,22,0.5122082086184204,0.2365539760827002
유동성흡수/NNG;위한/VV,1,0.3677664052340732,15,9,6,21,0.5122082086184204,0.2365539760827002
금리상승/NNG;보였/VV,1,0.3677664052340732,15,9,6,12,0.5122082086184204,0.2365539760827002
소비자물가/NNG;선행하/VVX,1,0.3677664052340732,15,9,6,8,0.5122082086184204,0.2365539760827002
경상수지/NNG;개선되/VVX,1,0.3677664052340732,15,9,6,11,0.5122082086184204,0.2365539760827002
자금이탈/NNG;이어지/VV,1,0.3677664052340732,15,9,6,9,0.5122082086184204,0.2365539760827002
물가/NNG;잡/VV;위해/VV,1,0.3660139021304778,52,30,22,78,0.6805555169902703,0.3155763731862217
투자심리/NNG;위축되/VVX,1,0.36489315856587146,111,63,48,161,0.8130697565380501,0.37799940256836323
금리인상/NNG;늦춰질/VV,1,0.3642054207474483,36,21,15,55,0.6165723573161749,0.287101576330282
성장/NNG;달성할/VVX,1,0.3642054207474483,36,21,15,58,0.6165723573161749,0.287101576330282
금융시장/NNG;불안해/VVX,1,0.35963842825552894,29,17,12,29,0.583323388462772,0.2744865634780708
금리동결/NNG;예상된/VVX,1,0.35963842825552894,29,17,12,24,0.583323388462772,0.2744865634780708
리스크/NNG;존재하/VVX,1,0.35963842825552894,29,17,12,27,0.583323388462772,0.2744865634780708
불확실성/NNG;높/VA;상황이/VVX,1,0.35963842825552894,29,17,12,48,0.583323388462772,0.2744865634780708
불확실성/NNG;이어지/VV,1,0.35963842825552894,29,17,12,56,0.583323388462772,0.2744865634780708
금리상승/NNG;요인이/VVX,1,0.35963842825552894,29,17,12,45,0.583323388462772,0.2744865634780708
기준금리/NNG;오를/VV,1,0.3595344550686064,45,26,19,71,0.6525004197189654,0.3071115232599095
경기회복/NNG;기대감/NNG;커지/VV,1,0.3582714758268697,22,13,9,42,0.548251934264688,0.25879353844575886
인플레이션우려/NNG;완화되/VVX,1,0.3582714758268697,22,13,9,44,0.548251934264688,0.25879353844575886
불확실성/NNG;줄이/VV,1,0.3582714758268697,22,13,9,31,0.548251934264688,0.25879353844575886
낮/VA;금리/NNG;유지하/VVX,1,0.3582714758268697,22,13,9,24,0.548251934264688,0.25879353844575886
경제/NNG;경착륙할/VVX,1,0.3582714758268697,22,13,9,26,0.548251934264688,0.25879353844575886
소비/NNG;이어지/VV,1,0.3582714758268697,22,13,9,27,0.548251934264688,0.25879353844575886
부양책/NNG;내놓/VV;않/VX,1,0.3582714758268697,22,13,9,54,0.548251934264688,0.25879353844575886
금리동결/NNG;예상하/VVX,1,0.3582714758268697,22,13,9,53,0.548251934264688,0.25879353844575886
금리인상/NNG;단행되/VVX;않/VX,1,0.3582714758268697,22,13,9,31,0.548251934264688,0.25879353844575886
콜금리/NNG;인상될/VVX,1,0.3579060921540258,54,31,23,45,0.6848291246478347,0.32353342836139787
금리/NNG;인상해/VVX,1,0.35684703810153495,226,128,98,337,0.8537010399856624,0.40429302987100413
금리/NNG;올라/VV,1,0.3566032410579978,81,46,35,110,0.7594966071445496,0.35988079576767845
성장률/NNG;하락하/VVX,1,0.3522921271631505,38,22,16,50,0.6219326679552355,0.29761479410818936
수출/NNG;회복되/VVX,1,0.3522921271631505,38,22,16,51,0.6219326679552355,0.29761479410818936
리스크/NNG;커지/VV,1,0.3512225181418762,74,42,32,100,0.7410520130631778,0.3554831369456517
경기회복/NNG;지연되/VVX,1,0.35038819873379223,47,27,20,69,0.6572889498764994,0.3159018630803771
불안심리/NNG;완화되/VVX,1,0.344673068959759,31,18,13,52,0.5890060750778352,0.28678468851249933
불확실성/NNG;해소되/VVX;않/VX,1,0.3446582325904666,67,38,29,81,0.7202132677737912,0.3506807391140621
변동성/NNG;보일/VV,1,0.3377657537051999,24,14,10,39,0.5540242787426239,0.27399861462689173
경제지표/NNG;부진하/VVX;나오/VV,1,0.3377657537051999,24,14,10,51,0.5540242787426239,0.27399861462689173
금리/NNG;인상할/VVX;필요/NNG;있/VA,1,0.3377657537051999,24,14,10,20,0.5540242787426239,0.27399861462689173
재정지출/NNG;확대하/VVX,1,0.3377657537051999,24,14,10,29,0.5540242787426239,0.27399861462689173
기준금리/NNG;유지하/VVX,1,0.33553646440636986,424,238,186,687,0.8463522685479629,0.42068048160623406
금리/NNG;최저치/NNG;경신했/VVX,1,0.33490217775948405,17,10,7,13,0.5175735684245116,0.257628166365723
불확실성/NNG;언급하/VVX,1,0.33490217775948405,17,10,7,20,0.5175735684245116,0.257628166365723
부동산가격/NNG;오르/VV,1,0.33490217775948405,17,10,7,20,0.5175735684245116,0.257628166365723
경기회복/NNG;뒷받침할/VVX,1,0.33490217775948405,17,10,7,43,0.5175735684245116,0.257628166365723
유동성/NNG;흡수할/VVX,1,0.33490217775948405,17,10,7,39,0.5175735684245116,0.257628166365723
물가상승률/NNG;상승할/VVX,1,0.33490217775948405,17,10,7,21,0.5175735684245116,0.257628166365723
내수회복/NNG;따른/VV,1,0.33490217775948405,17,10,7,29,0.5175735684245116,0.257628166365723
gdp/NNG;성장했/VVX,1,0.33490217775948405,17,10,7,31,0.5175735684245116,0.257628166365723
경제/NNG;타격/NNG;입/VV,1,0.33490217775948405,17,10,7,23,0.5175735684245116,0.257628166365723
장단기금리스프레드/NNG;확대되/VVX,1,0.33490217775948405,17,10,7,25,0.5175735684245116,0.257628166365723
기준금리/NNG;인상되/VVX;않/VX,1,0.33490217775948405,17,10,7,31,0.5175735684245116,0.257628166365723
경기불확실성/NNG;인해/VV,1,0.33490217775948405,17,10,7,37,0.5175735684245116,0.257628166365723
금리인상시기/NNG;늦추/VV,1,0.33490217775948405,17,10,7,22,0.5175735684245116,0.257628166365723
인플레이션압력/NNG;선제적/VAX;대응하/VVX,1,0.33490217775948405,17,10,7,8,0.5175735684245116,0.257628166365723
기준금리/NNG;인상되/VVX,1,0.3320608410574082,161,90,71,245,0.8346499923295662,0.4181187020057461
경제성장률/NNG;높이/VV,1,0.33171434797260546,33,19,14,32,0.5946176034972261,0.2981060798024956
출구전략/NNG;시행할/VVX,1,0.33171434797260546,33,19,14,37,0.5946176034972261,0.2981060798024956
금리인상/NNG;하/VV,1,0.3302294833588022,154,86,68,154,0.8312575533751082,0.41813411871213374
금리인상/NNG;단행해/VVX,1,0.32463175331653105,64,36,28,67,0.7042347742766732,0.3587054406647657
금리/NNG;상승세/NNG;이어지/VV,1,0.3208594413979253,26,15,11,29,0.5598011726742865,0.28754655840357995
신용등급/NNG;강등하/VVX,1,0.3208594413979253,26,15,11,83,0.5598011726742865,0.28754655840357995
경제/NNG;호조/NNG;보이/VV,1,0.3208594413979253,26,15,11,21,0.5598011726742865,0.28754655840357995
낮/VA;금리/NNG;유지할/VVX,1,0.3208594413979253,26,15,11,61,0.5598011726742865,0.28754655840357995
대외불확실성/NNG;지속되/VVX,1,0.3208594413979253,26,15,11,42,0.5598011726742865,0.28754655840357995
경제성장/NNG;이끌/VV,1,0.3203723080304677,35,20,15,47,0.6001523212018048,0.3086078559492889
통화완화/NNG;유지하/VVX,1,0.3203723080304677,35,20,15,21,0.6001523212018048,0.3086078559492889
경기과열/NNG;막/VV,1,0.31548285761130357,46,26,20,58,0.6422684468330097,0.33387334430053967
재정위기/NNG;따른/VV,1,0.31548285761130357,46,26,20,96,0.6422684468330097,0.33387334430053967
금리인상/NNG;주장하/VVX,1,0.31548285761130357,46,26,20,73,0.6422684468330097,0.33387334430053967
금리하락/NNG;제한하/VVX,1,0.31420342868049533,57,32,25,95,0.679335993811887,0.35414581111342064
내수/NNG;회복되/VVX,1,0.31420342868049533,57,32,25,55,0.679335993811887,0.35414581111342064
기준금리/NNG;동결해/VVX,1,0.3103503188025232,37,21,16,60,0.60560435550962,0.31841323032870783
금리인상/NNG;나서/VV;않/VX,1,0.3103503188025232,37,21,16,57,0.60560435550962,0.31841323032870783
인플레이션/NNG;나타나/VV,1,0.31009421069589727,19,11,8,15,0.5231165575298682,0.2751987589941253
소비자물가/NNG;미치/VV,1,0.31009421069589727,19,11,8,24,0.5231165575298682,0.2751987589941253
경기선행지수/NNG;비/VV,1,0.31009421069589727,19,11,8,17,0.5231165575298682,0.2751987589941253
경제상황/NNG;악화되/VVX,1,0.31009421069589727,19,11,8,12,0.5231165575298682,0.2751987589941253
경제지표/NNG;개선되/VVX;모습/NNG,1,0.31009421069589727,19,11,8,42,0.5231165575298682,0.2751987589941253
금융시장/NNG;변동성/NNG;커질/VV,1,0.31009421069589727,19,11,8,28,0.5231165575298682,0.2751987589941253
금리/NNG;고시됐/VVX,1,0.31009421069589727,19,11,8,11,0.5231165575298682,0.2751987589941253
불확실성/NNG;확대됐/VVX,1,0.31009421069589727,19,11,8,19,0.5231165575298682,0.2751987589941253
콜금리/NNG;유지될/VVX,1,0.31009421069589727,19,11,8,15,0.5231165575298682,0.2751987589941253
금리상승/NNG;확대되/VVX,1,0.3083791618077023,59,33,26,103,0.6833697508941745,0.36086874256263957
수출/NNG;부진하/VVX,1,0.30823686410617057,48,27,21,52,0.6470672237930981,0.3418057455346102
금리인상시기/NNG;될/VV,1,0.3066769473872224,28,16,12,31,0.5655687199097683,0.2997852023105446
성장경로/NNG;불확실성/NNG;높/VA;판단된/VVX,1,0.3066769473872224,28,16,12,43,0.5655687199097683,0.2997852023105446
금리인상/NNG;단행될/VVX,1,0.3050948421470252,235,130,105,367,0.8330799993423676,0.44312476470178813
불확실성/NNG;존재하/VVX,1,0.3015646955798954,50,28,22,72,0.6517488760080248,0.349376040277618
경기둔화우려/NNG;커지/VV,1,0.3014192560173523,39,22,17,56,0.6109680202705803,0.327619786012173
수출/NNG;의존하/VVX,1,0.3014192560173523,39,22,17,57,0.6109680202705803,0.327619786012173
금리/NNG;동결될/VVX,1,0.30131081831377227,147,81,66,193,0.8155417127567229,0.4374226962598887
성장률/NNG;둔화되/VVX,1,0.2953930650313188,52,29,23,90,0.6563122979517932,0.3566171884920025
금리/NNG;올려도/VV,1,0.29529954439283745,76,42,34,89,0.7234407712616591,0.3931729338696236
유동성/NNG;증가하/VVX,1,0.29460067034561566,30,17,13,35,0.5713124706605569,0.3109700267261792
금리인하/NNG;시사하/VVX,1,0.29460067034561566,30,17,13,68,0.5713124706605569,0.3109700267261792
금리인하기대/NNG;유지될/VVX,1,0.29460067034561566,30,17,13,60,0.5713124706605569,0.3109700267261792
양적완화/NNG;나서/VV,1,0.29460067034561566,30,17,13,58,0.5713124706605569,0.3109700267261792
성장/NNG;지속되/VVX,1,0.29339962642104034,41,23,18,47,0.6162380388780819,0.33630558236118774
원자재가격/NNG;상승하/VVX,1,0.29339962642104034,41,23,18,59,0.6162380388780819,0.33630558236118774
금리인상/NNG;가능성/NNG;시사하/VVX,1,0.2911707674535444,78,43,35,82,0.7262362812550851,0.39827050819468174
물가/NNG;상승세/NNG;둔화되/VVX,1,0.29073769649821024,21,12,9,24,0.5288010602882239,0.2902706007264302
기준금리/NNG;동결키/VVX,1,0.29073769649821024,21,12,9,20,0.5288010602882239,0.2902706007264302
금리/NNG;변동성/NNG;확대될/VVX,1,0.29073769649821024,21,12,9,17,0.5288010602882239,0.2902706007264302
경제/NNG;연착륙할/VVX,1,0.29073769649821024,21,12,9,21,0.5288010602882239,0.2902706007264302
물가상승률/NNG;밑돌/VV,1,0.29073769649821024,21,12,9,30,0.5288010602882239,0.2902706007264302
수출호조/NNG;따른/VV,1,0.29073769649821024,21,12,9,27,0.5288010602882239,0.2902706007264302
불확실성/NNG;증폭되/VVX,1,0.29073769649821024,21,12,9,33,0.5288010602882239,0.2902706007264302
금리/NNG;올린다고/VV,1,0.2896607118855872,54,30,24,66,0.6607566648508089,0.363557175349444
금리인상/NNG;예상하/VVX,1,0.28938670496560626,91,50,41,133,0.7513318489574894,0.41363994832275347
금리인상/NNG;될/VV,1,0.2882740570490516,67,37,30,71,0.6982796557718248,0.38536598434109537
금리/NNG;치솟/VV,1,0.2882740570490516,67,37,30,149,0.6982796557718248,0.38536598434109537
성장세/NNG;지속되/VVX,1,0.28614899178098585,43,24,19,71,0.6214096567481242,0.3445336776370601
성장률/NNG;그칠/VV,1,0.28614899178098585,43,24,19,58,0.6214096567481242,0.3445336776370601
변동성/NNG;확대시/VVX,1,0.2843160558499884,56,31,25,93,0.6650814332915644,0.3702199270878823
성장/NNG;유지하/VVX,1,0.2841841547821313,32,18,14,58,0.5770186014240427,0.321291540484595
채권시장/NNG;약세/NNG;보임/VV,1,0.28341753610109777,82,45,37,88,0.73149896897513,0.4079873114973212
기준금리인상/NNG;따른/VV,1,0.2822358622152439,130,71,59,118,0.7960504629937205,0.44513118250722233
취업자수/NNG;증가하/VVX,1,0.2795529797709029,45,25,20,79,0.62647868748445,0.35235550033724605
성장률/NNG;높이/VV,1,0.2795529797709029,45,25,20,69,0.62647868748445,0.35235550033724605
금리인상/NNG;빨라질/VA;있/VV,1,0.2795529797709029,45,25,20,44,0.62647868748445,0.35235550033724605
금리/NNG;인상함/VVX,1,0.2795529797709029,45,25,20,20,0.62647868748445,0.35235550033724605
시장금리/NNG;하락했/VVX,1,0.2752235226304307,23,13,10,31,0.5345887008624082,0.30350393380496893
동결/NNG;전망했/VVX,1,0.2752235226304307,23,13,10,21,0.5345887008624082,0.30350393380496893
경기침체/NNG;빠질/VV,1,0.2752235226304307,23,13,10,42,0.5345887008624082,0.30350393380496893
경기/NNG;바닥/NNG;쳤/VV,1,0.2752235226304307,23,13,10,10,0.5345887008624082,0.30350393380496893
불안/NNG;잠재우/VV,1,0.2752235226304307,23,13,10,31,0.5345887008624082,0.30350393380496893
연착륙/NNG;유도하/VVX,1,0.2752235226304307,23,13,10,21,0.5345887008624082,0.30350393380496893
금리/NNG;올려야/VV,1,0.2736950763604469,180,98,82,280,0.8142630627697025,0.4638136695665324
물가/NNG;잡/VV,1,0.27210495971899373,149,81,68,215,0.803319013134835,0.45915319333201576
인플레이션/NNG;우려하/VVX,1,0.2683543676288114,77,42,35,90,0.714258366735823,0.41156233558105276
금리/NNG;상승세/NNG;출발했/VVX,1,0.26797024475782827,49,27,22,60,0.6362951009073626,0.36694247880424197
고용/NNG;감소했/VVX,1,0.26797024475782827,49,27,22,20,0.6362951009073626,0.36694247880424197
금리인상/NNG;예상했/VVX,1,0.2670918321948912,36,20,16,78,0.5882686714369774,0.3398881924289704
물가/NNG;상승할/VVX,1,0.2660297943073253,64,35,29,96,0.6811829594707756,0.3944719589920764
유가하락/NNG;따른/VV,1,0.265756808701368,177,96,81,191,0.809987391316005,0.4693377714946072
금리상승/NNG;제한하/VVX,1,0.26342131047491635,94,51,43,151,0.7448243992073782,0.43375068679672185
금리동결/NNG;예상했/VVX,1,0.26284450018525574,51,28,23,60,0.6410369089924824,0.37377223553782885
경제성장/NNG;발목/NNG;잡/VV,1,0.2625116651986521,25,14,11,25,0.5404439191549877,0.3153441925696942
경기회복/NNG;힘입/VV,1,0.2625116651986521,25,14,11,38,0.5404439191549877,0.3153441925696942
안전자산선호/NNG;강화되/VVX,1,0.2625116651986521,25,14,11,71,0.5404439191549877,0.3153441925696942
금리/NNG;내려간/VV,1,0.25997648805930584,38,21,17,56,0.5937913297856154,0.3483605111524599
금리인상/NNG;지연되/VVX,1,0.25997648805930584,38,21,17,39,0.5937913297856154,0.3483605111524599
유가상승/NNG;따른/VV,1,0.25901710969772407,124,67,57,154,0.7801886268276355,0.4586561519618324
금리인상/NNG;늦출/VV,1,0.2580890453416078,53,29,24,41,0.6456649169386243,0.38032752096897265
금리인하/NNG;가능할/VVX,1,0.2580890453416078,53,29,24,76,0.6456649169386243,0.38032752096897265
세계경제/NNG;회복되/VVX,1,0.25190287755336005,27,15,12,35,0.5463354978032766,0.3261000999248409
마이너스/NNG;벗어나/VV,1,0.25190287755336005,27,15,12,28,0.5463354978032766,0.3261000999248409
기준금리동결/NNG;전망했/VVX,1,0.25190287755336005,27,15,12,21,0.5463354978032766,0.3261000999248409
금리하락/NNG;견인하/VVX,1,0.25190287755336005,27,15,12,59,0.5463354978032766,0.3261000999248409
안전자산선호/NNG;따른/VV,1,0.25190287755336005,27,15,12,70,0.5463354978032766,0.3261000999248409
경기/NNG;하강할/VVX,1,0.25190287755336005,27,15,12,13,0.5463354978032766,0.3261000999248409
출구전략/NNG;따른/VV,1,0.25190287755336005,27,15,12,61,0.5463354978032766,0.3261000999248409
신용스프레드/NNG;확대된/VVX,0,0.2501280824860592,16,9,7,39,0.4954694171583337,0.29686013276987916
대외불확실성/NNG;상존하/VVX,0,0.2501280824860592,16,9,7,25,0.4954694171583337,0.29686013276987916
금리변동성/NNG;확대시/VVX,0,0.2501280824860592,16,9,7,27,0.4954694171583337,0.29686013276987916
물가상승/NNG;유발하/VVX;않/VX,0,0.2501280824860592,16,9,7,5,0.4954694171583337,0.29686013276987916
경제/NNG;미치/VV;긍정적/VAX,0,0.2501280824860592,16,9,7,6,0.4954694171583337,0.29686013276987916
양적완화/NNG;축소될/VVX,0,0.2501280824860592,16,9,7,30,0.4954694171583337,0.29686013276987916
소비자물가지수/NNG;올라/VV,0,0.2501280824860592,16,9,7,15,0.4954694171583337,0.29686013276987916
금리상승/NNG;대비해/VVX,0,0.2501280824860592,16,9,7,38,0.4954694171583337,0.29686013276987916
물가/NNG;두/VV,0,0.2501280824860592,16,9,7,26,0.4954694171583337,0.29686013276987916
불안/NNG;보이/VV,0,0.2501280824860592,16,9,7,15,0.4954694171583337,0.29686013276987916
대외불확실성/NNG;남/VV,0,0.2501280824860592,16,9,7,23,0.4954694171583337,0.29686013276987916
물가/NNG;상회하/VVX,0,0.2501280824860592,16,9,7,22,0.4954694171583337,0.29686013276987916
경기/NNG;두/VV,0,0.2501280824860592,16,9,7,14,0.4954694171583337,0.29686013276987916
고용/NNG;상황/NNG;개선되/VVX,0,0.2501280824860592,16,9,7,26,0.4954694171583337,0.29686013276987916
금리/NNG;유지키/VVX,0,0.2501280824860592,16,9,7,6,0.4954694171583337,0.29686013276987916
산업생산/NNG;감소해/VVX,0,0.2501280824860592,16,9,7,17,0.4954694171583337,0.29686013276987916
금리/NNG;올리/VV;못할/VX,0,0.2501280824860592,16,9,7,25,0.4954694171583337,0.29686013276987916
변동성/NNG;따른/VV,0,0.2501280824860592,16,9,7,17,0.4954694171583337,0.29686013276987916
금리인상/NNG;막/VV,0,0.2501280824860592,16,9,7,24,0.4954694171583337,0.29686013276987916
물가/NNG;시차/NNG;두/VV,0,0.2501280824860592,16,9,7,21,0.4954694171583337,0.29686013276987916
고용지표/NNG;부진할/VVX,0,0.2501280824860592,16,9,7,9,0.4954694171583337,0.29686013276987916
금융시장/NNG;안정/NNG;위해/VV,0,0.2501280824860592,16,9,7,20,0.4954694171583337,0.29686013276987916
내수/NNG;성장기여/VVX,0,0.2501280824860592,16,9,7,10,0.4954694171583337,0.29686013276987916
불확실성/NNG;우려하/VVX,0,0.2501280824860592,16,9,7,19,0.4954694171583337,0.29686013276987916
기준금리인상/NNG;가능성/NNG;열려/VV,0,0.2501280824860592,16,9,7,13,0.4954694171583337,0.29686013276987916
적자/NNG;지속되/VVX,0,0.2501280824860592,16,9,7,20,0.4954694171583337,0.29686013276987916
적자/NNG;줄이/VV,0,0.2501280824860592,16,9,7,43,0.4954694171583337,0.29686013276987916
물가/NNG;달성하/VVX,0,0.2501280824860592,16,9,7,15,0.4954694171583337,0.29686013276987916
금리인상/NNG;가능성/NNG;반영했/VVX,0,0.2501280824860592,16,9,7,19,0.4954694171583337,0.29686013276987916
금리인상/NNG;반영하/VVX,1,0.24951938769605864,57,31,26,57,0.6545736736452886,0.3926963536406647
채권시장/NNG;강세/NNG;보임/VV,1,0.24785290303660057,42,23,19,68,0.6045885273831766,0.3639984486428938
불확실성/NNG;지속되/VVX,1,0.2464990571337553,121,65,56,189,0.7714317663849258,0.4657879971934114
금리인상/NNG;따른/VV,1,0.244118244060876,543,292,251,737,0.8066292708833627,0.48951139203667576
경기회복세/NNG;이어질/VV,1,0.2429108151194308,29,16,13,29,0.5522366915595656,0.3359911083774003
금리/NNG;올린다는/VV,1,0.2429108151194308,29,16,13,29,0.5522366915595656,0.3359911083774003
금리인상/NNG;진행되/VVX,1,0.2429108151194308,29,16,13,63,0.5522366915595656,0.3359911083774003
변동성/NNG;키울/VV,1,0.2429108151194308,29,16,13,36,0.5522366915595656,0.3359911083774003
금리/NNG;올리/VV,1,0.24247555397569331,1018,547,471,1254,0.8058547890677104,0.4907503519473927
정책금리/NNG;인상하/VVX,1,0.2398623680673433,127,68,59,147,0.7735972510428009,0.4737248508877301
채권시장강세/NNG;지지하/VVX,1,0.2385355995957028,63,34,29,94,0.6670569368811393,0.40963327088456325
수출/NNG;개선되/VVX,1,0.23518722087414923,31,17,14,67,0.5581248463496364,0.3451768516299448
마이너스/NNG;이/VV,1,0.23358289493977336,18,10,8,25,0.5010986364789798,0.3109613943494075
금리인상/NNG;미뤄질/VV,1,0.23358289493977336,18,10,8,28,0.5010986364789798,0.3109613943494075
신흥시장/NNG;성장세약화/NNG;영향/NNG;받/VV,1,0.23358289493977336,18,10,8,24,0.5010986364789798,0.3109613943494075
경제위기/NNG;극복하/VVX,1,0.23358289493977336,18,10,8,18,0.5010986364789798,0.3109613943494075
경기/NNG;회복되/VVX;않/VX,1,0.23358289493977336,18,10,8,18,0.5010986364789798,0.3109613943494075
실업률/NNG;유지하/VVX,1,0.23358289493977336,18,10,8,20,0.5010986364789798,0.3109613943494075
기준금리인상/NNG;인해/VV,1,0.23358289493977336,18,10,8,23,0.5010986364789798,0.3109613943494075
주택시장/NNG;둔화되/VVX,1,0.23358289493977336,18,10,8,20,0.5010986364789798,0.3109613943494075
금리인상/NNG;뒷받침할/VVX,1,0.23358289493977336,18,10,8,22,0.5010986364789798,0.3109613943494075
경제/NNG;부정적/VAX;영향/NNG;미치/VV,1,0.23358289493977336,18,10,8,21,0.5010986364789798,0.3109613943494075
유동성/NNG;사정/NNG;원활하/VVX,1,0.23358289493977336,18,10,8,9,0.5010986364789798,0.3109613943494075
소비자물가/NNG;안정세/NNG;보이/VV,1,0.23358289493977336,18,10,8,16,0.5010986364789798,0.3109613943494075
인플레율억제/NNG;두/VV,1,0.23358289493977336,18,10,8,28,0.5010986364789798,0.3109613943494075
금융시장/NNG;출렁이/VV,1,0.23358289493977336,18,10,8,22,0.5010986364789798,0.3109613943494075
금리/NNG;상승한/VAX;스프레드/NNG;확대된/VVX,1,0.23358289493977336,18,10,8,17,0.5010986364789798,0.3109613943494075
견조한/VAX;성장세/NNG;지속하/VVX,1,0.23358289493977336,18,10,8,17,0.5010986364789798,0.3109613943494075
금리인하/NNG;반영하/VVX,1,0.23358289493977336,18,10,8,47,0.5010986364789798,0.3109613943494075
기준금리/NNG;낮춰/VV,1,0.2334920399412408,48,26,22,42,0.620068039157513,0.38486284010438077
불확실성/NNG;해소되/VVX,1,0.23176232398348828,178,95,83,319,0.7940798617164626,0.4946722011635726
인플레이션/NNG;완화되/VVX,1,0.2284763851191174,33,18,15,37,0.5639808739410939,0.3537758916390827
물가/NNG;끌어올리/VV,1,0.2284763851191174,33,18,15,38,0.5639808739410939,0.3537758916390827
성장세/NNG;유지할/VVX,1,0.22571940363994614,52,28,24,48,0.6298570701249205,0.39740021019579513
고용지표/NNG;부진하/VVX,1,0.22571940363994614,52,28,24,65,0.6298570701249205,0.39740021019579513
금리하락/NNG;작용할/VVX,1,0.22258642770598058,35,19,16,47,0.5697887283544909,0.3618779541115757
재정위기/NNG;겪/VV,1,0.22224274627865093,54,29,25,137,0.6345832376951595,0.40332077059523247
수출/NNG;늘/VV,1,0.22199884411075743,94,50,44,72,0.7254011490397384,0.46127810358996013
금리인상/NNG;나서/VV,0,0.22145179173214125,192,102,90,293,0.7915798003286021,0.5039396190389144
성장세/NNG;둔화되/VVX,1,0.22121354350256972,75,40,35,98,0.6888691099466872,0.43877096257454806
지준율/NNG;올리/VV,1,0.22078585050427701,20,11,9,14,0.5069640172760874,0.32319784221888476
금리/NNG;낮춰야/VV,1,0.22078585050427701,20,11,9,26,0.5069640172760874,0.32319784221888476
금리인상/NNG;가능성/NNG;커졌/VV,1,0.22078585050427701,20,11,9,20,0.5069640172760874,0.32319784221888476
금리/NNG;최저치/NNG;경신하/VVX,1,0.22078585050427701,20,11,9,43,0.5069640172760874,0.32319784221888476
소비자물가/NNG;하락하/VVX,1,0.22078585050427701,20,11,9,24,0.5069640172760874,0.32319784221888476
재정긴축/NNG;따른/VV,1,0.22078585050427701,20,11,9,38,0.5069640172760874,0.32319784221888476
산업생산/NNG;감소했/VVX,1,0.22078585050427701,20,11,9,38,0.5069640172760874,0.32319784221888476
경기둔화/NNG;대응하/VVX,1,0.22078585050427701,20,11,9,23,0.5069640172760874,0.32319784221888476
소비/NNG;줄/VV,1,0.22078585050427701,20,11,9,27,0.5069640172760874,0.32319784221888476
경상수지흑자/NNG;줄어들/VV,1,0.22078585050427701,20,11,9,33,0.5069640172760874,0.32319784221888476
금융위기/NNG;이전/NNG;회복하/VVX,1,0.22078585050427701,20,11,9,27,0.5069640172760874,0.32319784221888476
산업생산/NNG;증가하/VVX,1,0.21899681668055448,56,30,26,58,0.639194517520219,0.40903032535915235
금리인상/NNG;시사했/VVX,1,0.2187651041999139,77,41,36,95,0.6921052826146666,0.4431041273821142
양적완화/NNG;유지하/VVX,1,0.21737061218157283,37,20,17,84,0.575534936643513,0.3695521058359776
기준금리인상/NNG;있/VV,1,0.21737061218157283,37,20,17,52,0.575534936643513,0.3695521058359776
물가상승압력/NNG;커지/VV,1,0.21737061218157283,37,20,17,62,0.575534936643513,0.3695521058359776
성장률/NNG;기록하/VVX,1,0.21572473011667603,119,63,56,120,0.7543761147498245,0.48606040944040974
금리인상/NNG;단행하/VVX,0,0.2153660086206599,217,115,102,269,0.7910783643533875,0.5100916797991485
금리동결/NNG;이어질/VV,1,0.21271484499290572,39,21,18,70,0.5812081973432881,0.3768523412602718
금리인상/NNG;지속될/VVX,1,0.2119112549509241,104,55,49,135,0.7351501354434385,0.47746955330864777
설비투자/NNG;증가하/VVX,1,0.2106080266237882,22,12,10,43,0.5129901449454392,0.334089051898155
마이너스/NNG;보이/VV,1,0.2106080266237882,22,12,10,37,0.5129901449454392,0.334089051898155
gdp/NNG;성장하/VVX,1,0.2106080266237882,22,12,10,33,0.5129901449454392,0.334089051898155
경제/NNG;성장세/NNG;지속하/VVX,1,0.2106080266237882,22,12,10,27,0.5129901449454392,0.334089051898155
가계대출/NNG;늘/VV,1,0.2106080266237882,22,12,10,13,0.5129901449454392,0.334089051898155
기업실적/NNG;개선되/VVX,1,0.2106080266237882,22,12,10,20,0.5129901449454392,0.334089051898155
변동성/NNG;커질/VA;있/VV,1,0.2106080266237882,22,12,10,35,0.5129901449454392,0.334089051898155
리스크/NNG;완화된/VVX,1,0.2106080266237882,22,12,10,28,0.5129901449454392,0.334089051898155
양적완화/NNG;할/VV,1,0.2106080266237882,22,12,10,28,0.5129901449454392,0.334089051898155
금리인상/NNG;가능성/NNG;시사할/VVX,1,0.2106080266237882,22,12,10,33,0.5129901449454392,0.334089051898155
금리/NNG;인하된/VVX,1,0.2106080266237882,22,12,10,24,0.5129901449454392,0.334089051898155
금리인상/NNG;시작된/VVX,1,0.2106080266237882,22,12,10,21,0.5129901449454392,0.334089051898155
기준금리/NNG;동결되/VVX,0,0.21000278407476447,161,85,76,438,0.7783271403998584,0.5075336489429649
불안/NNG;지속되/VVX,1,0.20989184988084597,85,45,40,97,0.7039608892502223,0.45914714528612716
기준금리/NNG;동결함/VVX,1,0.20852910349760667,41,22,19,94,0.5867990441308474,0.3838214767704645
경기둔화/NNG;인해/VV,1,0.20852910349760667,41,22,19,58,0.5867990441308474,0.3838214767704645
신용등급/NNG;강등되/VVX,1,0.20852910349760667,41,22,19,66,0.5867990441308474,0.3838214767704645
금리/NNG;하락/NNG;압력/NNG;받/VV,1,0.20852910349760667,41,22,19,92,0.5867990441308474,0.3838214767704645
성장세/NNG;둔화될/VVX,1,0.20785546452013093,64,34,30,75,0.6564696262238854,0.4299970536330962
금리상승압력/NNG;작용하/VVX,1,0.20474142719560806,43,23,20,49,0.5922995667403425,0.39049391562247504
금리하락/NNG;제한될/VVX,1,0.20474142719560806,43,23,20,59,0.5922995667403425,0.39049391562247504
금리인상/NNG;가능성/NNG;커지/VV,1,0.20474142719560806,43,23,20,48,0.5922995667403425,0.39049391562247504
성장세/NNG;보일/VV,1,0.203146963326712,68,36,32,98,0.6644007652823557,0.4394874330324254
인플레이션억제/NNG;위해/VV,1,0.203146963326712,68,36,32,94,0.6644007652823557,0.4394874330324254
성장/NNG;보였/VV,1,0.20233026333954096,24,13,11,24,0.5191186610074895,0.3439711069707553
경제/NNG;안정되/VVX,1,0.20233026333954096,24,13,11,40,0.5191186610074895,0.3439711069707553
금리인상/NNG;카드/NNG;꺼내/VV,1,0.20233026333954096,24,13,11,17,0.5191186610074895,0.3439711069707553
가계부채증가/NNG;따른/VV,1,0.20233026333954096,24,13,11,20,0.5191186610074895,0.3439711069707553
재정/NNG;풀/VV,1,0.20233026333954096,24,13,11,20,0.5191186610074895,0.3439711069707553
세계경제/NNG;미국/NNG;선진국/NNG;회복세/NNG;이/VV,1,0.20233026333954096,24,13,11,11,0.5191186610074895,0.3439711069707553
금리상승/NNG;막/VV,1,0.20233026333954096,24,13,11,30,0.5191186610074895,0.3439711069707553
성장/NNG;가능할/VVX,1,0.20220660916097488,93,49,44,119,0.7141602300084473,0.4733287128129525
불확실성/NNG;인해/VV,1,0.20220660916097488,93,49,44,225,0.7141602300084473,0.4733287128129525
기준금리/NNG;올리/VV,0,0.19944954465554043,344,181,163,515,0.7847719647313036,0.5231224701594092
금리/NNG;동결했/VVX,0,0.19678475294489295,200,105,95,272,0.78021604054874,0.5229754879087929
침체/NNG;벗어나/VV;못하/VX,1,0.19547303076297995,26,14,12,29,0.5253040990963384,0.3530700605255973
금융완화/NNG;유지되/VVX,1,0.19547303076297995,26,14,12,15,0.5253040990963384,0.3530700605255973
재정지출/NNG;줄이/VV,1,0.19547303076297995,26,14,12,18,0.5253040990963384,0.3530700605255973
불확실성/NNG;증가하/VVX,1,0.19547303076297995,26,14,12,35,0.5253040990963384,0.3530700605255973
유동성/NNG;공급했/VVX,1,0.19497451351208173,76,40,36,103,0.6788686494888349,0.4567573352038264
금리/NNG;인상하/VVX;않/VX,0,0.19285193085327546,149,78,71,183,0.7643611586429127,0.51654955820772
기준금리/NNG;인상될/VVX,0,0.1928368337672448,450,236,214,783,0.7814010602630054,0.5280815389780089
경기부양/NNG;나설/VV,1,0.1900649655244524,53,28,25,131,0.6182533624665911,0.4202328306200193
소비자물가/NNG;상승했/VVX,1,0.1900649655244524,53,28,25,77,0.6182533624665911,0.4202328306200193
금융시장/NNG;안정될/VVX,1,0.18970438817196844,28,15,13,18,0.5315106977400047,0.3615430822455276
경기/NNG;회복되/VVX,0,0.18924241855255342,277,145,132,371,0.7794147250146739,0.5306796115870257
경기회복세/NNG;지속될/VVX,1,0.18774614127653289,55,29,26,94,0.6231082903428798,0.4255723313143143
불안/NNG;지속될/VVX,1,0.18774614127653289,55,29,26,65,0.6231082903428798,0.4255723313143143
금리인상/NNG;가능할/VVX,1,0.1864715552781464,86,45,41,120,0.6944374364986999,0.47554211450082506
금리/NNG;인상할/VVX,0,0.18559849305668474,1219,637,582,1688,0.7776637578848783,0.5334974882886336
부양책/NNG;내놓/VV,0,0.1852485873456946,115,60,55,207,0.7347392263962894,0.5044151800467912
안전자산선호심리/NNG;강화되/VVX,1,0.18478729433213403,30,16,14,81,0.537710046784254,0.36950259658801093
산업생산/NNG;증가해/VVX,1,0.18478729433213403,30,16,14,42,0.537710046784254,0.36950259658801093
금리동결/NNG;유지할/VVX,1,0.18478729433213403,30,16,14,35,0.537710046784254,0.36950259658801093
리스크/NNG;인해/VV,1,0.18478729433213403,30,16,14,55,0.537710046784254,0.36950259658801093
리스크/NNG;상존하/VVX,1,0.18478729433213403,30,16,14,57,0.537710046784254,0.36950259658801093
수입/NNG;감소하/VVX,1,0.18478729433213403,30,16,14,38,0.537710046784254,0.36950259658801093
경제성장률/NNG;하향조정했/VVX,1,0.1835428799768659,59,31,28,99,0.6324648674925806,0.43573591485848273
자본확충/NNG;위해/VV,1,0.18054797800138345,32,17,15,70,0.5438793645545698,0.37703102615386935
양적완화/NNG;축소하/VVX,1,0.18054797800138345,32,17,15,113,0.5438793645545698,0.37703102615386935
금리인상/NNG;이루어질/VV,1,0.18054797800138345,32,17,15,28,0.5438793645545698,0.37703102615386935
자산/NNG;줄이/VV,1,0.17685617014247734,34,18,16,44,0.5500002333154258,0.38419011914014345
물가/NNG;오르/VV;않/VX,1,0.17685617014247734,34,18,16,43,0.5500002333154258,0.38419011914014345
임금/NNG;상승하/VVX,1,0.17685617014247734,34,18,16,31,0.5500002333154258,0.38419011914014345
불확실성/NNG;존재한/VVX,1,0.17685617014247734,34,18,16,38,0.5500002333154258,0.38419011914014345
금리/NNG;유지했/VVX,1,0.17685617014247734,34,18,16,29,0.5500002333154258,0.38419011914014345
불확실성/NNG;고조되/VVX,1,0.17361231528342747,36,19,17,82,0.5560576636721506,0.3910270345885655
금리하락압력/NNG;작용할/VVX,1,0.17361231528342747,36,19,17,55,0.5560576636721506,0.3910270345885655
금리/NNG;동결하/VVX,0,0.1723919311876172,314,163,151,437,0.770709825686799,0.5433370996236203
성장률/NNG;기록할/VVX,0,0.17130867627636892,139,72,67,166,0.7473553703008399,0.5280488348031995
기준금리인상/NNG;가능성/NNG;반영했/VVX,0,0.1711301173003803,166,86,80,122,0.7597772839846023,0.5370229371836226
성장세/NNG;이어지/VV,1,0.17073904694908282,38,20,18,67,0.5620393950411189,0.39757842097576357
고용/NNG;증가하/VVX,1,0.17073904694908282,38,20,18,78,0.5620393950411189,0.39757842097576357
물가/NNG;급등하/VVX,1,0.17073904694908282,38,20,18,38,0.5620393950411189,0.39757842097576357
성장/NNG;이끌/VV,1,0.1693897745197539,77,40,37,95,0.6686759404982261,0.4743263774196411
금리인상/NNG;서두르/VV;않/VX,1,0.16817535517422577,40,21,19,80,0.5679353664885799,0.403873215664451
경기/NNG;살아나/VV,1,0.16693684283361332,81,42,39,141,0.6754430409435941,0.481548988413976
물가/NNG;안정시/VVX,1,0.16465309759634628,85,44,41,128,0.6817675954100876,0.4883436410868433
채권시장/NNG;강세/NNG;보일/VV,0,0.16243250391166097,15,8,7,25,0.4691091990383908,0.3375535772245191
경기둔화/NNG;반영해/VVX,0,0.16243250391166097,15,8,7,11,0.4691091990383908,0.3375535772245191
금리인하기대감/NNG;확대되/VVX,0,0.16243250391166097,15,8,7,8,0.4691091990383908,0.3375535772245191
마이너스/NNG;수준이/VVX,0,0.16243250391166097,15,8,7,26,0.4691091990383908,0.3375535772245191
금리인상/NNG;가능성/NNG;불거지/VV,0,0.16243250391166097,15,8,7,14,0.4691091990383908,0.3375535772245191
완화적/VAX;통화정책/NNG;지속될/VVX,0,0.16243250391166097,15,8,7,33,0.4691091990383908,0.3375535772245191
연방기금금리/NNG;선물시장/NNG;반영된/VVX,0,0.16243250391166097,15,8,7,12,0.4691091990383908,0.3375535772245191
유가상승/NNG;제한됐/VVX,0,0.16243250391166097,15,8,7,17,0.4691091990383908,0.3375535772245191
금리하락/NNG;두드러졌/VV,0,0.16243250391166097,15,8,7,23,0.4691091990383908,0.3375535772245191
물가상승/NNG;주도했/VVX,0,0.16243250391166097,15,8,7,12,0.4691091990383908,0.3375535772245191
물가상승률/NNG;끌어올리/VV,0,0.16243250391166097,15,8,7,9,0.4691091990383908,0.3375535772245191
출구전략/NNG;있/VV,0,0.16243250391166097,15,8,7,12,0.4691091990383908,0.3375535772245191
경기부양책/NNG;쓰/VV,0,0.16243250391166097,15,8,7,27,0.4691091990383908,0.3375535772245191
투자심리/NNG;회복됐/VVX,0,0.16243250391166097,15,8,7,14,0.4691091990383908,0.3375535772245191
기준금리동결/NNG;지속될/VVX,0,0.16243250391166097,15,8,7,29,0.4691091990383908,0.3375535772245191
자산/NNG;매각하/VVX,1,0.16189902829962044,46,24,22,49,0.5850332125646515,0.421429218429386
금리인상/NNG;주장했/VVX,1,0.16189902829962044,46,24,22,61,0.5850332125646515,0.421429218429386
성장세/NNG;보이/VV,0,0.16097112063399166,130,67,63,192,0.7355100718708433,0.5308347672341344
금융위기/NNG;대응하/VVX,1,0.1601697731272802,48,25,23,23,0.5905171030241727,0.42689088416065807
수출부진/NNG;지속되/VVX,1,0.1601697731272802,48,25,23,40,0.5905171030241727,0.42689088416065807
경기회복세/NNG;이어지/VV,1,0.15858134560215187,50,26,24,70,0.5958864834754982,0.43217735051135736
불확실성/NNG;남/VV,0,0.15788274503028354,262,135,127,447,0.7626822371525622,0.5539413481785997
기준금리/NNG;동결하/VVX,0,0.15659841264771512,567,292,275,937,0.7622497760858435,0.555085669213965
불확실성/NNG;커지/VV,0,0.15536660409279346,177,91,86,265,0.7543022467328937,0.5506853196394415
금리인상/NNG;예상한/VVX,0,0.15458600595994443,17,9,8,26,0.4754156151938575,0.34763657700596223
성장세/NNG;기록할/VVX,0,0.15458600595994443,17,9,8,16,0.4754156151938575,0.34763657700596223
기준금리/NNG;낮춰야/VV,0,0.15458600595994443,17,9,8,22,0.4754156151938575,0.34763657700596223
성장률전망/NNG;상향했/VVX,0,0.15458600595994443,17,9,8,10,0.4754156151938575,0.34763657700596223
금리인상/NNG;계속할/VVX,0,0.15458600595994443,17,9,8,17,0.4754156151938575,0.34763657700596223
안전자산선호심리/NNG;완화되/VVX,0,0.15458600595994443,17,9,8,26,0.4754156151938575,0.34763657700596223
하방위험/NNG;커지/VV,0,0.15458600595994443,17,9,8,33,0.4754156151938575,0.34763657700596223
gdp갭/NNG;마이너스/NNG;유지하/VVX,0,0.15458600595994443,17,9,8,30,0.4754156151938575,0.34763657700596223
신용위험/NNG;나타내/VV,0,0.15458600595994443,17,9,8,4,0.4754156151938575,0.34763657700596223
수출증가율/NNG;둔화되/VVX,0,0.15458600595994443,17,9,8,29,0.4754156151938575,0.34763657700596223
설비투자/NNG;늘어나/VV,0,0.15458600595994443,17,9,8,15,0.4754156151938575,0.34763657700596223
완전고용/NNG;근접했/VVX,0,0.15458600595994443,17,9,8,10,0.4754156151938575,0.34763657700596223
유동성/NNG;과도하/VVX,0,0.15458600595994443,17,9,8,23,0.4754156151938575,0.34763657700596223
변동성/NNG;크/VA;확대됐/VVX,0,0.15458600595994443,17,9,8,14,0.4754156151938575,0.34763657700596223
물가/NNG;상승한/VVX,0,0.15458600595994443,17,9,8,28,0.4754156151938575,0.34763657700596223
소비자물가상승률/NNG;둔화되/VVX,0,0.15458600595994443,17,9,8,12,0.4754156151938575,0.34763657700596223
수출/NNG;통한/VV,0,0.15458600595994443,17,9,8,23,0.4754156151938575,0.34763657700596223
경기회복/NNG;위해서/VV,0,0.15458600595994443,17,9,8,27,0.4754156151938575,0.34763657700596223
금리인상/NNG;단행된/VVX,1,0.1544908929189468,56,29,27,54,0.6112819396528691,0.44707267637406334
성장/NNG;둔화될/VVX,1,0.15330810536684014,58,30,28,63,0.6161705669478047,0.4517400659634657
경기개선/NNG;따른/VV,1,0.15219827032601851,60,31,29,68,0.6209359822519714,0.4562684099393059
정책금리/NNG;올리/VV,1,0.15115312380687707,62,32,30,89,0.625577811554876,0.460662695296598
성장/NNG;지속하/VVX,1,0.15115312380687707,62,32,30,56,0.625577811554876,0.460662695296598
금리/NNG;낮/VA;유지하/VVX,1,0.1501655225640035,64,33,31,74,0.6300960114357773,0.46492745498562105
투자심리/NNG;위축됐/VVX,1,0.149229268078666,66,34,32,86,0.6344908301034138,0.4690668450182365
동결/NNG;예상된/VVX,0,0.14863545472423767,19,10,9,15,0.4819401939465174,0.3567216104237742
금리하락/NNG;예상된/VVX,0,0.14863545472423767,19,10,9,26,0.4819401939465174,0.3567216104237742
기준금리인하/NNG;나설/VV,0,0.14863545472423767,19,10,9,37,0.4819401939465174,0.3567216104237742
마이너스/NNG;떨어졌/VV,0,0.14863545472423767,19,10,9,20,0.4819401939465174,0.3567216104237742
수출증가율/NNG;기록하/VVX,0,0.14863545472423767,19,10,9,16,0.4819401939465174,0.3567216104237742
자산가격상승/NNG;따른/VV,0,0.14863545472423767,19,10,9,23,0.4819401939465174,0.3567216104237742
수익성/NNG;개선될/VVX,0,0.14863545472423767,19,10,9,24,0.4819401939465174,0.3567216104237742
자산매입/NNG;연장하/VVX,0,0.14863545472423767,19,10,9,13,0.4819401939465174,0.3567216104237742
경기둔화/NNG;우려/NNG;커지/VV,0,0.14863545472423767,19,10,9,32,0.4819401939465174,0.3567216104237742
흑자/NNG;전환되/VVX,0,0.14863545472423767,19,10,9,18,0.4819401939465174,0.3567216104237742
불확실성/NNG;키울/VV,0,0.14863545472423767,19,10,9,27,0.4819401939465174,0.3567216104237742
장단기금리차/NNG;축소될/VVX,0,0.14863545472423767,19,10,9,20,0.4819401939465174,0.3567216104237742
금리동결/NNG;전망했/VVX,0,0.14863545472423767,19,10,9,15,0.4819401939465174,0.3567216104237742
신용등급/NNG;강등할/VVX,0,0.14863545472423767,19,10,9,57,0.4819401939465174,0.3567216104237742
불확실성/NNG;해소/NNG;따른/VV,0,0.14863545472423767,19,10,9,35,0.4819401939465174,0.3567216104237742
경제지표/NNG;혼조세/NNG;나타내/VV,0,0.14863545472423767,19,10,9,18,0.4819401939465174,0.3567216104237742
고용/NNG;호조/NNG;보이/VV,0,0.14863545472423767,19,10,9,12,0.4819401939465174,0.3567216104237742
경제성장률/NNG;둔화될/VVX,1,0.14833896246400413,68,35,33,77,0.6387627734521761,0.4730847065268736
소비/NNG;증가하/VVX,1,0.1466779174485926,72,37,35,54,0.6469411712182509,0.48076992582038364
금리하락/NNG;견인할/VVX,0,0.1440057143009228,21,11,10,57,0.48859456674179064,0.36508130088110663
성장률/NNG;될/VV,0,0.1440057143009228,21,11,10,37,0.48859456674179064,0.36508130088110663
심리지표/NNG;개선되/VVX,0,0.1440057143009228,21,11,10,23,0.48859456674179064,0.36508130088110663
자산가격/NNG;상승하/VVX,0,0.1440057143009228,21,11,10,19,0.48859456674179064,0.36508130088110663
불안/NNG;고조되/VVX,0,0.1440057143009228,21,11,10,27,0.48859456674179064,0.36508130088110663
금리상승/NNG;동조화되/VVX,0,0.1440057143009228,21,11,10,18,0.48859456674179064,0.36508130088110663
큰/VA;변동성/NNG;보였/VV,0,0.1440057143009228,21,11,10,15,0.48859456674179064,0.36508130088110663
금융시장변동성/NNG;확대되/VVX,0,0.1440057143009228,21,11,10,34,0.48859456674179064,0.36508130088110663
채권시장/NNG;부담/NNG;되/VV,0,0.1440057143009228,21,11,10,26,0.48859456674179064,0.36508130088110663
금리/NNG;낮/VA;유지되/VVX,0,0.1440057143009228,21,11,10,34,0.48859456674179064,0.36508130088110663
기준금리인상/NNG;가능성/NNG;시사하/VVX,0,0.1440057143009228,21,11,10,12,0.48859456674179064,0.36508130088110663
취업자수/NNG;증가했/VVX,0,0.1440057143009228,21,11,10,40,0.48859456674179064,0.36508130088110663
듀레이션/NNG;줄이/VV,0,0.1440057143009228,21,11,10,55,0.48859456674179064,0.36508130088110663
성장/NNG;하/VV,0,0.14303190035596414,139,71,68,111,0.7319468778196783,0.5480032990325668
금리/NNG;인상했/VVX,0,0.14224406437815618,268,137,131,256,0.7541589569666985,0.5655411739570556
금리인상/NNG;이어질/VV,0,0.1417758508500646,86,44,42,98,0.671858873995611,0.5043058171973491
성장/NNG;뒷받침하/VVX,0,0.14033039736230224,23,12,11,21,0.4953166834803571,0.3728880049230894
소비/NNG;제약하/VVX,0,0.14033039736230224,23,12,11,42,0.4953166834803571,0.3728880049230894
시장금리/NNG;상승했/VVX,0,0.14033039736230224,23,12,11,41,0.4953166834803571,0.3728880049230894
성장/NNG;기대되/VVX,0,0.14033039736230224,23,12,11,34,0.4953166834803571,0.3728880049230894
경제/NNG;타격/NNG;줄/VV,0,0.14033039736230224,23,12,11,29,0.4953166834803571,0.3728880049230894
경기회복/NNG;이어지/VV,1,0.1373649946852351,25,13,12,32,0.5020615696121188,0.3802557569060353
투자심리/NNG;부정적/VAX;영향/NNG;미쳤/VV,1,0.1373649946852351,25,13,12,33,0.5020615696121188,0.3802557569060353
금리상승/NNG;이어질/VV,1,0.1373649946852351,25,13,12,48,0.5020615696121188,0.3802557569060353
잠재성장률/NNG;높이/VV,1,0.1373649946852351,25,13,12,29,0.5020615696121188,0.3802557569060353
금리하락/NNG;작용했/VVX,1,0.1373649946852351,25,13,12,31,0.5020615696121188,0.3802557569060353
인플레이션우려/NNG;커지/VV,1,0.13494009851363153,27,14,13,41,0.5087957399833472,0.3872628676270743
기준금리인하/NNG;예상하/VVX,1,0.13494009851363153,27,14,13,40,0.5087957399833472,0.3872628676270743
물가상승압력/NNG;지속될/VVX,1,0.13494009851363153,27,14,13,38,0.5087957399833472,0.3872628676270743
금리인상/NNG;점치/VV,1,0.13494009851363153,27,14,13,30,0.5087957399833472,0.3872628676270743
금리인상/NNG;나선/VV,1,0.13494009851363153,27,14,13,32,0.5087957399833472,0.3872628676270743
재정정책/NNG;통한/VV,1,0.13494009851363153,27,14,13,39,0.5087957399833472,0.3872628676270743
경기후퇴/NNG;막/VV,1,0.13494009851363153,27,14,13,13,0.5087957399833472,0.3872628676270743
통화완화정책/NNG;따른/VV,1,0.13293465732609477,29,15,14,25,0.5154936960136035,0.3939648224838223
금리변동성/NNG;확대되/VVX,1,0.13293465732609477,29,15,14,58,0.5154936960136035,0.3939648224838223
물가상승압력/NNG;지속되/VVX,1,0.13293465732609477,29,15,14,28,0.5154936960136035,0.3939648224838223
기준금리/NNG;유지될/VVX,1,0.13293465732609477,29,15,14,46,0.5154936960136035,0.3939648224838223
경기선행지수/NNG;하락했/VVX,1,0.13293465732609477,29,15,14,31,0.5154936960136035,0.3939648224838223
금리/NNG;인상되/VVX,0,0.13158134277902955,126,64,62,132,0.716176954574928,0.5488446813597782
유가상승/NNG;부추겼/VV,1,0.1312599126159082,31,16,15,31,0.5221356558067985,0.40040200292817085
경기/NNG;개선된/VVX,1,0.1312599126159082,31,16,15,65,0.5221356558067985,0.40040200292817085
유가하락/NNG;인해/VV,1,0.1312599126159082,31,16,15,33,0.5221356558067985,0.40040200292817085
유가하락/NNG;힘입/VV,1,0.1312599126159082,31,16,15,29,0.5221356558067985,0.40040200292817085
금리인상/NNG;더불/VV,1,0.1312599126159082,31,16,15,41,0.5221356558067985,0.40040200292817085
성장/NNG;이/VV;가/VX,1,0.1312599126159082,31,16,15,42,0.5221356558067985,0.40040200292817085
금리인상/NNG;나설/VV,0,0.13049942317340846,429,218,211,540,0.7477759944670128,0.5743223309917279
불확실성/NNG;확대된/VVX,1,0.12984934648395252,33,17,16,35,0.5287060393315263,0.40660449799240544
금리동결/NNG;따른/VV,1,0.12984934648395252,33,17,16,55,0.5287060393315263,0.40660449799240544
금리인상/NNG;늦추/VV,1,0.12984934648395252,33,17,16,51,0.5287060393315263,0.40660449799240544
추경/NNG;편성하/VVX,1,0.12865216757100328,35,18,17,51,0.5351924303772417,0.41259520652046633
기준금리/NNG;인하하/VVX;않/VX,1,0.12865216757100328,35,18,17,54,0.5351924303772417,0.41259520652046633
경기둔화우려/NNG;따른/VV,1,0.12865216757100328,35,18,17,60,0.5351924303772417,0.41259520652046633
물가안정/NNG;유지될/VVX,1,0.12598669912185723,41,21,20,33,0.554057016542544,0.4294566310947728
기준금리인상/NNG;단행하/VVX,1,0.12598669912185723,41,21,20,54,0.554057016542544,0.4294566310947728
금리인상/NNG;계속될/VVX,1,0.12598669912185723,41,21,20,36,0.554057016542544,0.4294566310947728
경제/NNG;위협하/VVX,1,0.12532302731174028,43,22,21,55,0.5601249318892476,0.43474519290564956
주택가격/NNG;하락하/VVX,1,0.12532302731174028,43,22,21,33,0.5601249318892476,0.43474519290564956
국제유가상승/NNG;따른/VV,1,0.12532302731174028,43,22,21,59,0.5601249318892476,0.43474519290564956
정책금리/NNG;동결될/VVX,1,0.12474151186588389,45,23,22,72,0.5660746987709295,0.43988196488842213
금리인상/NNG;결정하/VVX,1,0.12474151186588389,45,23,22,63,0.5660746987709295,0.43988196488842213
유가급등/NNG;따른/VV,1,0.1242288843067143,47,24,23,56,0.5719029044775287,0.44487342526434903
금리/NNG;상승세/NNG;보이/VV,1,0.1242288843067143,47,24,23,65,0.5719029044775287,0.44487342526434903
기준금리인하/NNG;단행될/VVX,1,0.12377418392076645,49,25,24,66,0.5776068617971313,0.4497251318251954
장단기금리차/NNG;확대되/VVX,1,0.12336829642411029,51,26,25,80,0.583184503477531,0.4544419261153659
불확실성/NNG;커졌/VV,1,0.12160510382200784,63,32,31,101,0.6139413530177557,0.48012279174723305
금리/NNG;인상한/VVX,0,0.11989833952861884,81,41,40,98,0.6514777796150776,0.5112433989185962
금리/NNG;올렸/VV,0,0.11894400430933194,204,103,101,215,0.7383008281868685,0.5804989038951509
금리인상/NNG;예상되/VVX,0,0.1170009986533469,115,58,57,158,0.6978799335428584,0.550881597930711
금리/NNG;유지하/VVX,0,0.11590605953876643,127,64,63,191,0.7081594582245245,0.5602367830372306
금리/NNG;올릴/VV,0,0.11149461577457132,946,476,470,1209,0.7368809287288983,0.5881867952131654
기준금리/NNG;인상할/VVX,0,0.10158651293180654,881,441,440,1277,0.7310833922736387,0.5953599203971393
성장/NNG;할/VV,0,0.0996741297282231,110,55,55,89,0.6827732101500906,0.5581683834489507
금리인상/NNG;단행되/VVX,0,0.09906179301380891,102,51,51,139,0.6728700622022418,0.5507525330599252
불확실성/NNG;상존하/VVX,0,0.09847594335891863,96,48,48,159,0.6644262339752076,0.5444842678019103
물가/NNG;미치/VV,0,0.09825400165012321,94,47,47,116,0.6614057938790031,0.5422517822077056
금리인하/NNG;기대하/VVX,0,0.097219414259202,86,43,43,101,0.6482344491227651,0.5325634069287397
금리인상/NNG;가능성/NNG;시사했/VVX,0,0.09555520698396136,76,38,38,89,0.6291543171121924,0.5186253382998962
기준금리/NNG;동결될/VVX,0,0.09515578858915386,445,222,223,707,0.7272779521028864,0.5999936714368462
기준금리/NNG;동결했/VVX,0,0.09435890281483839,375,187,188,707,0.7268035994118293,0.6005662515561371
소비자물가/NNG;상승하/VVX,0,0.09433111681653195,70,35,35,108,0.6162121446210156,0.5092117658929408
금리인하/NNG;예상하/VVX,1,0.09186087878961646,60,30,30,70,0.5919970300852323,0.4916425989875748
성장세/NNG;보였/VV,1,0.09129635127539903,58,29,29,77,0.5867442038283445,0.4878346959292889
대외불확실성/NNG;따른/VV,1,0.09129635127539903,58,29,29,135,0.5867442038283445,0.4878346959292889
불확실성/NNG;해소될/VVX,1,0.0900912883665883,54,27,27,81,0.5758198947598778,0.47991537880533225
리스크/NNG;있/VV,1,0.0900912883665883,54,27,27,52,0.5758198947598778,0.47991537880533225
채권시장/NNG;국채가격/NNG;올랐/VV,1,0.08808293982105853,48,24,24,93,0.5583766856463567,0.46726317787726235
금리/NNG;올려/VV,0,0.08610885525046252,135,67,68,168,0.6967328384626097,0.5853643430761457
경제/NNG;회복되/VVX,0,0.08585331348598757,133,66,67,212,0.6952235553439335,0.5843967710206096
수출/NNG;둔화되/VVX,1,0.08581612985360687,42,21,21,59,0.5396595839211622,0.4536654663774546
인플레이션압력/NNG;커지/VV,1,0.08581612985360687,42,21,21,65,0.5396595839211622,0.4536654663774546
불확실성/NNG;커질/VV,1,0.08581612985360687,42,21,21,53,0.5396595839211622,0.4536654663774546
불확실성/NNG;이어질/VV,1,0.0849996221310203,40,20,20,46,0.533138626097672,0.4489206034848904
성장/NNG;있/VV,1,0.0849996221310203,40,20,20,53,0.533138626097672,0.4489206034848904
금리/NNG;동결된/VVX,1,0.08327075389308058,36,18,18,57,0.5196786632785354,0.4391115267050698
인플레이션/NNG;따른/VV,1,0.08327075389308058,36,18,18,50,0.5196786632785354,0.4391115267050698
경제성장/NNG;따른/VV,1,0.08327075389308058,36,18,18,43,0.5196786632785354,0.4391115267050698
성장/NNG;이/VV,1,0.08327075389308058,36,18,18,33,0.5196786632785354,0.4391115267050698
기준금리인상/NNG;단행될/VVX,1,0.08235689470609686,34,17,17,65,0.5127422318639209,0.4340475677373688
금리인하/NNG;주장하/VVX,1,0.08235689470609686,34,17,17,54,0.5127422318639209,0.4340475677373688
물가/NNG;치솟/VV,1,0.08235689470609686,34,17,17,26,0.5127422318639209,0.4340475677373688
경기후퇴/NNG;따른/VV,1,0.08235689470609686,34,17,17,27,0.5127422318639209,0.4340475677373688
유동성/NNG;회수하/VVX,1,0.08235689470609686,34,17,17,38,0.5127422318639209,0.4340475677373688
실업률/NNG;치솟/VV,1,0.08140909060911761,32,16,16,36,0.5056703753381045,0.4288777916795877
유동성확보/NNG;위한/VV,1,0.08140909060911761,32,16,16,20,0.5056703753381045,0.4288777916795877
경기부진/NNG;따른/VV,1,0.08140909060911761,32,16,16,73,0.5056703753381045,0.4288777916795877
산업생산/NNG;증가했/VVX,1,0.08140909060911761,32,16,16,71,0.5056703753381045,0.4288777916795877
금융위기/NNG;거치/VV,0,0.08042660128426449,30,15,15,64,0.4984651381825896,0.42360278141127344
실업률/NNG;떨어지/VV,0,0.08042660128426449,30,15,15,49,0.4984651381825896,0.42360278141127344
불안심리/NNG;해소되/VVX,0,0.08042660128426449,30,15,15,22,0.4984651381825896,0.42360278141127344
콜금리/NNG;동결되/VVX,0,0.07940869335764811,28,14,14,23,0.49112888994369686,0.41822332041238014
금리/NNG;크/VA;상승했/VVX,0,0.07940869335764811,28,14,14,23,0.49112888994369686,0.41822332041238014
유동성/NNG;늘어나/VV,0,0.07940869335764811,28,14,14,30,0.49112888994369686,0.41822332041238014
경제/NNG;성장했/VVX,0,0.07940869335764811,28,14,14,31,0.49112888994369686,0.41822332041238014
수출/NNG;타격/NNG;받/VV,0,0.07940869335764811,28,14,14,47,0.49112888994369686,0.41822332041238014
변동성/NNG;확대하/VVX,0,0.07835464243248125,26,13,13,37,0.4836643364521739,0.4127404028575277
금융안정/NNG;위해/VV,0,0.07835464243248125,26,13,13,30,0.4836643364521739,0.4127404028575277
변동성/NNG;크/VA;확대되/VVX,0,0.07835464243248125,26,13,13,49,0.4836643364521739,0.4127404028575277
글로벌/NNG;경기둔화/NNG;따른/VV,0,0.07835464243248125,26,13,13,47,0.4836643364521739,0.4127404028575277
과잉유동성/NNG;흡수하/VVX,0,0.07835464243248125,26,13,13,26,0.4836643364521739,0.4127404028575277
금융시장/NNG;불안하/VVX,0,0.07726373523150265,24,12,12,31,0.4760745301964667,0.4071552435027089
리스크/NNG;작용하/VVX,0,0.07726373523150265,24,12,12,27,0.4760745301964667,0.4071552435027089
수입/NNG;줄어들/VV,0,0.07726373523150265,24,12,12,24,0.4760745301964667,0.4071552435027089
물가상승압력/NNG;완화되/VVX,0,0.07726373523150265,24,12,12,23,0.4760745301964667,0.4071552435027089
불확실성/NNG;상존해/VVX,0,0.07726373523150265,24,12,12,45,0.4760745301964667,0.4071552435027089
성장/NNG;견인할/VVX,0,0.07726373523150265,24,12,12,38,0.4760745301964667,0.4071552435027089
적자/NNG;기록할/VVX,0,0.07726373523150265,24,12,12,39,0.4760745301964667,0.4071552435027089
인플레이션압력/NNG;높일/VV,0,0.07726373523150265,24,12,12,20,0.4760745301964667,0.4071552435027089
유동성/NNG;억제하/VVX,0,0.07726373523150265,24,12,12,24,0.4760745301964667,0.4071552435027089
소비심리/NNG;회복되/VVX,0,0.07726373523150265,24,12,12,27,0.4760745301964667,0.4071552435027089
소비심리/NNG;살아나/VV,0,0.07726373523150265,24,12,12,17,0.4760745301964667,0.4071552435027089
성장/NNG;유지할/VVX,0,0.07726373523150265,24,12,12,40,0.4760745301964667,0.4071552435027089
수출/NNG;감소할/VVX,0,0.0761352718424615,22,11,11,27,0.46836287969603263,0.4014692872755662
출구전략/NNG;나서/VV,0,0.0761352718424615,22,11,11,26,0.46836287969603263,0.4014692872755662
금리/NNG;하락세/NNG;출발했/VVX,0,0.0761352718424615,22,11,11,51,0.46836287969603263,0.4014692872755662
기준금리인상/NNG;나서/VV,0,0.0761352718424615,22,11,11,58,0.46836287969603263,0.4014692872755662
자산/NNG;팔/VV,0,0.0761352718424615,22,11,11,29,0.46836287969603263,0.4014692872755662
시장금리/NNG;상승압력/NNG;받/VV,0,0.0761352718424615,22,11,11,21,0.46836287969603263,0.4014692872755662
금리/NNG;상승세/NNG;이어졌/VV,0,0.0761352718424615,22,11,11,34,0.46836287969603263,0.4014692872755662
성장률/NNG;하향조정하/VVX,0,0.0761352718424615,22,11,11,44,0.46836287969603263,0.4014692872755662
금리/NNG;상승세/NNG;보임/VV,0,0.0761352718424615,22,11,11,43,0.46836287969603263,0.4014692872755662
경기/NNG;반등하/VVX,0,0.0761352718424615,22,11,11,44,0.46836287969603263,0.4014692872755662
잠재성장률/NNG;부합하/VVX,0,0.0761352718424615,22,11,11,26,0.46836287969603263,0.4014692872755662
투자심리/NNG;줬/VV,0,0.0761352718424615,22,11,11,36,0.46836287969603263,0.4014692872755662
경기/NNG;호조/NNG;보이/VV,0,0.0761352718424615,22,11,11,26,0.46836287969603263,0.4014692872755662
추경/NNG;편성할/VVX,0,0.0761352718424615,22,11,11,41,0.46836287969603263,0.4014692872755662
금리인하/NNG;나서/VV;않/VX,0,0.0761352718424615,22,11,11,41,0.46836287969603263,0.4014692872755662
정책금리/NNG;인상할/VVX,0,0.07535460433312569,87,43,44,131,0.6378827999933249,0.5476359057021528
변동성/NNG;확대시/VVX;있/VV,0,0.07496856805875196,20,10,10,29,0.4605331577155789,0.3956842184737709
경기부양/NNG;하/VV,0,0.07496856805875196,20,10,10,29,0.4605331577155789,0.3956842184737709
수입/NNG;늘리/VV,0,0.07496856805875196,20,10,10,12,0.4605331577155789,0.3956842184737709
금리/NNG;인상하/VVX;어려울/VA,0,0.07496856805875196,20,10,10,45,0.4605331577155789,0.3956842184737709
신용경색/NNG;나타나/VV,0,0.07496856805875196,20,10,10,8,0.4605331577155789,0.3956842184737709
금리인상/NNG;지연시/VVX,0,0.07496856805875196,20,10,10,30,0.4605331577155789,0.3956842184737709
금리인상/NNG;기대하/VVX,0,0.07496856805875196,20,10,10,31,0.4605331577155789,0.3956842184737709
신용경색/NNG;인해/VV,0,0.07496856805875196,20,10,10,22,0.4605331577155789,0.3956842184737709
경제지표/NNG;호조/NNG;보였/VV,0,0.07496856805875196,20,10,10,54,0.4605331577155789,0.3956842184737709
경기/NNG;후퇴하/VVX,0,0.07496856805875196,20,10,10,20,0.4605331577155789,0.3956842184737709
기준금리/NNG;역전된/VVX,0,0.07496856805875196,20,10,10,32,0.4605331577155789,0.3956842184737709
투자심리/NNG;개선됐/VVX,0,0.07496856805875196,20,10,10,41,0.4605331577155789,0.3956842184737709
인플레이션/NNG;억제되/VVX,0,0.07496856805875196,20,10,10,28,0.4605331577155789,0.3956842184737709
경기침체/NNG;우려/NNG;커지/VV,0,0.07496856805875196,20,10,10,20,0.4605331577155789,0.3956842184737709
경기회복세/NNG;둔화되/VVX,0,0.07496856805875196,20,10,10,38,0.4605331577155789,0.3956842184737709
수출/NNG;증가할/VVX,0,0.07496856805875196,20,10,10,36,0.4605331577155789,0.3956842184737709
경제성장세/NNG;둔화되/VVX,0,0.07496856805875196,20,10,10,43,0.4605331577155789,0.3956842184737709
경기둔화/NNG;이어지/VV,0,0.07496856805875196,20,10,10,21,0.4605331577155789,0.3956842184737709
글로벌/NNG;경기회복/NNG;의심/NNG;걷히/VV,0,0.07496856805875196,20,10,10,24,0.4605331577155789,0.3956842184737709
불확실성/NNG;작용하/VVX,0,0.07376295780553166,18,9,9,38,0.4525895081571124,0.3898019694698428
물가/NNG;올라갈/VV,0,0.07376295780553166,18,9,9,17,0.4525895081571124,0.3898019694698428
경기회복/NNG;맞물려/VV,0,0.07376295780553166,18,9,9,26,0.4525895081571124,0.3898019694698428
글로벌/NNG;신용경색/NNG;따른/VV,0,0.07376295780553166,18,9,9,13,0.4525895081571124,0.3898019694698428
금리하락/NNG;지지하/VVX,0,0.07376295780553166,18,9,9,50,0.4525895081571124,0.3898019694698428
유동성/NNG;흡수해/VVX,0,0.07376295780553166,18,9,9,31,0.4525895081571124,0.3898019694698428
통화긴축/NNG;단행할/VVX,0,0.07376295780553166,18,9,9,16,0.4525895081571124,0.3898019694698428
수출/NNG;품목인/VVX,0,0.07376295780553166,18,9,9,26,0.4525895081571124,0.3898019694698428
신용경색/NNG;지속되/VVX,0,0.07376295780553166,18,9,9,10,0.4525895081571124,0.3898019694698428
환율급락/NNG;따른/VV,0,0.07376295780553166,18,9,9,16,0.4525895081571124,0.3898019694698428
통화긴축/NNG;중단할/VVX,0,0.07376295780553166,18,9,9,18,0.4525895081571124,0.3898019694698428
경제성장률/NNG;하향조정할/VVX,0,0.07376295780553166,18,9,9,21,0.4525895081571124,0.3898019694698428
금리인하기대/NNG;소멸되/VVX,0,0.07376295780553166,18,9,9,32,0.4525895081571124,0.3898019694698428
금리인하/NNG;대응할/VVX,0,0.07376295780553166,18,9,9,27,0.4525895081571124,0.3898019694698428
더블딥/NNG;빠지/VV,0,0.07376295780553166,18,9,9,22,0.4525895081571124,0.3898019694698428
자산/NNG;매각할/VVX,0,0.07376295780553166,18,9,9,11,0.4525895081571124,0.3898019694698428
경기/NNG;둔화할/VVX,0,0.07376295780553166,18,9,9,18,0.4525895081571124,0.3898019694698428
지준율/NNG;인상할/VVX,0,0.07251779563983773,16,8,8,24,0.44453645146441606,0.38382472881510776
금리/NNG;고점/NNG;확인하/VVX,0,0.07251779563983773,16,8,8,10,0.44453645146441606,0.38382472881510776
기준금리인상/NNG;시작하/VVX,0,0.07251779563983773,16,8,8,15,0.44453645146441606,0.38382472881510776
공공요금/NNG;인상되/VVX,0,0.07251779563983773,16,8,8,3,0.44453645146441606,0.38382472881510776
가계부채/NNG;문제/NNG;해결하/VVX,0,0.07251779563983773,16,8,8,13,0.44453645146441606,0.38382472881510776
실업률/NNG;높/VA;유지하/VVX,0,0.07251779563983773,16,8,8,19,0.44453645146441606,0.38382472881510776
경제상황/NNG;악화될/VVX,0,0.07251779563983773,16,8,8,16,0.44453645146441606,0.38382472881510776
금리인상시기/NNG;앞당겨질/VV,0,0.07251779563983773,16,8,8,35,0.44453645146441606,0.38382472881510776
경제/NNG;긍정적/VAX;작용할/VVX,0,0.07251779563983773,16,8,8,18,0.44453645146441606,0.38382472881510776
양적완화/NNG;끝나/VV,0,0.07251779563983773,16,8,8,13,0.44453645146441606,0.38382472881510776
금리상승/NNG;견인하/VVX,0,0.07251779563983773,16,8,8,26,0.44453645146441606,0.38382472881510776
물가상승/NNG;이어지/VV,0,0.07251779563983773,16,8,8,29,0.44453645146441606,0.38382472881510776
경기회복/NNG;이어질/VV,0,0.07251779563983773,16,8,8,14,0.44453645146441606,0.38382472881510776
유동성확보/NNG;위해/VV,0,0.07251779563983773,16,8,8,16,0.44453645146441606,0.38382472881510776
물가상승압력/NNG;완화시/VVX,0,0.07251779563983773,16,8,8,17,0.44453645146441606,0.38382472881510776
경기회복세/NNG;뒷받침하/VVX,0,0.07251779563983773,16,8,8,13,0.44453645146441606,0.38382472881510776
금리하락/NNG;되돌리/VV,0,0.07251779563983773,16,8,8,22,0.44453645146441606,0.38382472881510776
금융위기/NNG;터지/VV,0,0.07251779563983773,16,8,8,13,0.44453645146441606,0.38382472881510776
경제/NNG;나아지/VV,0,0.07251779563983773,16,8,8,32,0.44453645146441606,0.38382472881510776
양적완화/NNG;확대할/VVX,0,0.07251779563983773,16,8,8,25,0.44453645146441606,0.38382472881510776
인플레이션압력/NNG;줄어들/VV,0,0.07251779563983773,16,8,8,16,0.44453645146441606,0.38382472881510776
금리역전/NNG;해소되/VVX,0,0.07251779563983773,16,8,8,12,0.44453645146441606,0.38382472881510776
경제회복/NNG;따른/VV,0,0.07251779563983773,16,8,8,25,0.44453645146441606,0.38382472881510776
경기회복/NNG;걸림돌/NNG;될/VV,0,0.07251779563983773,16,8,8,24,0.44453645146441606,0.38382472881510776
마이너스/NNG;보일/VV,0,0.07251779563983773,16,8,8,26,0.44453645146441606,0.38382472881510776
추경/NNG;편성되/VVX,0,0.07251779563983773,16,8,8,18,0.44453645146441606,0.38382472881510776
경제/NNG;부정적/VAX;영향/NNG;줄/VV,0,0.07251779563983773,16,8,8,31,0.44453645146441606,0.38382472881510776
변동성확대/NNG;예상되/VVX,0,0.07251779563983773,16,8,8,13,0.44453645146441606,0.38382472881510776
물가/NNG;안정되/VVX,0,0.06502944252943377,65,32,33,133,0.5900544224209548,0.5171837655691521
리스크/NNG;완화되/VVX,0,0.06117297611066319,59,29,30,93,0.5741171635222609,0.5071217992191678
경기/NNG;개선될/VVX,0,0.06117297611066319,59,29,30,99,0.5741171635222609,0.5071217992191678
기준금리인상/NNG;나설/VV,0,0.06117297611066319,59,29,30,100,0.5741171635222609,0.5071217992191678
투자심리/NNG;위축된/VVX,0,0.06117297611066319,59,29,30,96,0.5741171635222609,0.5071217992191678
경기/NNG;개선되/VVX,0,0.059653870991593916,143,70,73,224,0.6856668613005895,0.607501820766106
물가/NNG;안정된/VVX,1,0.058264182763385186,55,27,28,98,0.5627446989949614,0.49998343407726004
물가/NNG;안정될/VVX,1,0.058264182763385186,55,27,28,62,0.5627446989949614,0.49998343407726004
금리/NNG;올라갈/VV,1,0.058264182763385186,55,27,28,83,0.5627446989949614,0.49998343407726004
기준금리/NNG;인상하/VVX,0,0.05822569229325447,599,293,306,809,0.7047879493563085,0.6262333278694607
성장세/NNG;나타내/VV,1,0.05669310638007796,53,26,27,64,0.5568274744014189,0.49628631875892654
금리인상/NNG;가능성/NNG;제기되/VVX,1,0.055035826851743685,51,25,26,76,0.5507531139614116,0.49250519493754713
경제/NNG;미치/VV;부정적/VAX,1,0.055035826851743685,51,25,26,82,0.5507531139614116,0.49250519493754713
콜금리/NNG;유지하/VVX,1,0.051431745224004954,47,23,24,46,0.5381227075461836,0.48469732742836347
변동성/NNG;커질/VV,0,0.050837618778078575,195,95,100,261,0.6961994299331161,0.6278266225938147
금리하락/NNG;따른/VV,0,0.049889434603980876,117,57,60,198,0.6607935151390402,0.5970304484111224
양적완화/NNG;나설/VV,1,0.04946640278486858,45,22,23,75,0.5315609391544118,0.48067513517384564
성장률/NNG;끌어올리/VV,1,0.04946640278486858,45,22,23,57,0.5315609391544118,0.48067513517384564
기준금리/NNG;낮췄/VV,1,0.04946640278486858,45,22,23,66,0.5315609391544118,0.48067513517384564
금리상승/NNG;이끌/VV,1,0.04946640278486858,45,22,23,88,0.5315609391544118,0.48067513517384564
금리인상/NNG;시사하/VVX,0,0.0479006025955806,148,72,76,184,0.6810064501607366,0.6177480482401483
금리/NNG;인상하/VVX,0,0.045790789824254,743,361,382,877,0.6969777800016307,0.634911763634583
자산/NNG;투자하/VVX,1,0.04515038412533112,41,20,21,55,0.5179271642629177,0.4724108145171158
금리인하/NNG;필요하/VVX,1,0.04515038412533112,41,20,21,60,0.5179271642629177,0.4724108145171158
금리인상/NNG;지속되/VVX,1,0.04515038412533112,41,20,21,47,0.5179271642629177,0.4724108145171158
금리인상/NNG;단행할/VVX,0,0.04323501886300596,439,213,226,597,0.6953581488975142,0.6366848424945117
소비심리/NNG;개선되/VVX,1,0.04276949786764406,39,19,20,49,0.5108465703757706,0.4681780286737647
침체/NNG;빠질/VV,1,0.04276949786764406,39,19,20,52,0.5108465703757706,0.4681780286737647
경제/NNG;악영향/NNG;미칠/VV,1,0.04021474840931116,37,18,19,52,0.5035829611861459,0.4638863774489521
금리인하기대감/NNG;약화되/VVX,1,0.04021474840931116,37,18,19,63,0.5035829611861459,0.4638863774489521
변동성/NNG;높일/VV,1,0.04021474840931116,37,18,19,34,0.5035829611861459,0.4638863774489521
불확실성/NNG;제거되/VVX,0,0.03746200423408608,35,17,18,48,0.4961293125774126,0.459543956364367
금리인하기대/NNG;약화되/VVX,0,0.03746200423408608,35,17,18,90,0.4961293125774126,0.459543956364367
금융시장불안/NNG;따른/VV,0,0.03746200423408608,35,17,18,19,0.4961293125774126,0.459543956364367
금리인상/NNG;반대하/VVX,0,0.0344814917202827,33,16,17,43,0.48847672070044407,0.4551608930499391
정책금리/NNG;올릴/VV,0,0.0344814917202827,33,16,17,53,0.48847672070044407,0.4551608930499391
소비/NNG;늘리/VV,0,0.0344814917202827,33,16,17,52,0.48847672070044407,0.4551608930499391
경제/NNG;둔화되/VVX,0,0.03423972691953803,147,71,76,145,0.6719897007288336,0.6264604537486704
경제/NNG;둔화하/VVX,0,0.03123597328173089,31,15,16,48,0.48061367360702384,0.4507499194405349
변동성/NNG;커졌/VV,0,0.03123597328173089,31,15,16,50,0.48061367360702384,0.4507499194405349
금리인상/NNG;나섰/VV,0,0.03123597328173089,31,15,16,44,0.48061367360702384,0.4507499194405349
경기회복/NNG;발목/NNG;잡/VV,0,0.03123597328173089,31,15,16,26,0.48061367360702384,0.4507499194405349
경제/NNG;성장할/VVX,0,0.030036406407058625,112,54,58,133,0.6439277350284145,0.6053662993646248
불안요인/NNG;작용하/VVX,0,0.029731885789882062,58,28,30,75,0.5554652313385318,0.5225193635222367
신용스프레드/NNG;확대되/VVX,0,0.028051875543793736,83,40,43,125,0.6046239900264457,0.5706758141869385
금리인하/NNG;결정하/VVX,0,0.027678167473676574,29,14,15,32,0.4725249986252505,0.44632715963361064
경제/NNG;확산되/VVX,0,0.027678167473676574,29,14,15,39,0.4725249986252505,0.44632715963361064
경기침체/NNG;겪/VV,0,0.027678167473676574,29,14,15,59,0.4725249986252505,0.44632715963361064
경기하강/NNG;막/VV,0,0.027678167473676574,29,14,15,21,0.4725249986252505,0.44632715963361064
금리/NNG;하락세/NNG;보임/VV,0,0.027678167473676574,29,14,15,42,0.4725249986252505,0.44632715963361064
침체/NNG;따른/VV,0,0.02742188705768167,56,27,29,55,0.5494575020357203,0.5192602976411782
불확실성/NNG;높이/VV,0,0.02498501378221807,54,26,28,85,0.5432794798818843,0.5159286920456917
불확실성/NNG;확대되/VVX,0,0.02441864808904759,104,50,54,152,0.6318569620561738,0.6007264554283656
경기회복/NNG;지원하/VVX,0,0.02374701439265481,27,13,14,52,0.46419030763249575,0.44191323609199146
큰/VA;금리/NNG;상승세/NNG;보였/VV,0,0.02374701439265481,27,13,14,26,0.46419030763249575,0.44191323609199146
금리상승/NNG;이어지/VV,0,0.02374701439265481,27,13,14,40,0.46419030763249575,0.44191323609199146
디플레이션/NNG;우려/NNG;커지/VV,0,0.02374701439265481,27,13,14,27,0.46419030763249575,0.44191323609199146
경기/NNG;호전될/VVX,0,0.02374701439265481,27,13,14,46,0.46419030763249575,0.44191323609199146
금리/NNG;하락세/NNG;보이/VV,0,0.02374701439265481,27,13,14,58,0.46419030763249575,0.44191323609199146
높/VA;변동성/NNG;보일/VV,0,0.02374701439265481,27,13,14,22,0.46419030763249575,0.44191323609199146
경제성장률/NNG;낮췄/VV,0,0.02374701439265481,27,13,14,36,0.46419030763249575,0.44191323609199146
경제지표/NNG;호조/NNG;나타내/VV,0,0.02374701439265481,27,13,14,45,0.46419030763249575,0.44191323609199146
금리/NNG;오른/VV,0,0.02327596656846187,200,96,104,297,0.6792714731744611,0.6472814514722842
침체/NNG;겪/VV,0,0.022409857359885432,52,25,27,60,0.5369266779013945,0.5125266836141865
소비/NNG;회복되/VVX,0,0.022409857359885432,52,25,27,43,0.5369266779013945,0.5125266836141865
변동성/NNG;높이/VV,0,0.01936213214153515,25,12,13,38,0.4555816416700141,0.43753485658329316
리스크/NNG;부각될/VVX,0,0.01936213214153515,25,12,13,48,0.4555816416700141,0.43753485658329316
신용경색/NNG;우려/NNG;완화되/VVX,0,0.01936213214153515,25,12,13,18,0.4555816416700141,0.43753485658329316
물가/NNG;상승했/VVX,0,0.01936213214153515,25,12,13,35,0.4555816416700141,0.43753485658329316
금리인상/NNG;점쳤/VV,0,0.01936213214153515,25,12,13,22,0.4555816416700141,0.43753485658329316
물가안정/NNG;하/VV,0,0.01936213214153515,25,12,13,50,0.4555816416700141,0.43753485658329316
시장금리/NNG;상승할/VVX,0,0.018352363162020602,73,35,38,124,0.581327678826191,0.5594273427443041
기준금리/NNG;동결된/VVX,0,0.017955069375745758,96,46,50,152,0.6180422670697313,0.5952310997883296
시장금리/NNG;급등하/VVX,0,0.01615060753783437,71,34,37,60,0.5762302878348228,0.5569667492116271
금리/NNG;인상될/VVX,0,0.01593852030341636,318,152,166,434,0.6777482067720717,0.6553685365327468
인플레이션우려/NNG;따른/VV,0,0.01441534672778233,23,11,12,36,0.4466597951138435,0.43322714574131516
불확실성/NNG;완화하/VVX,0,0.01441534672778233,23,11,12,16,0.4466597951138435,0.43322714574131516
대외불확실성/NNG;인해/VV,0,0.01441534672778233,23,11,12,37,0.4466597951138435,0.43322714574131516
지정학적리스크/NNG;부각되/VVX,0,0.01441534672778233,23,11,12,36,0.4466597951138435,0.43322714574131516
추경/NNG;하/VV,0,0.01441534672778233,23,11,12,37,0.4466597951138435,0.43322714574131516
통화정책/NNG;불확실성/NNG;해소되/VVX,0,0.01441534672778233,23,11,12,22,0.4466597951138435,0.43322714574131516
불확실성/NNG;완화됐/VVX,0,0.01441534672778233,23,11,12,24,0.4466597951138435,0.43322714574131516
채권시장/NNG;강세/NNG;보였/VV,0,0.01441534672778233,23,11,12,47,0.4466597951138435,0.43322714574131516
금리인상/NNG;결정할/VVX,0,0.01441534672778233,23,11,12,41,0.4466597951138435,0.43322714574131516
불안/NNG;심화되/VVX,0,0.01441534672778233,23,11,12,16,0.4466597951138435,0.43322714574131516
물가/NNG;올라가/VV,0,0.01441534672778233,23,11,12,34,0.4466597951138435,0.43322714574131516
금리인상/NNG;가능성/NNG;열려/VV,0,0.01441534672778233,23,11,12,46,0.4466597951138435,0.43322714574131516
금리인상/NNG;가능성/NNG;언급하/VVX,0,0.01441534672778233,23,11,12,25,0.4466597951138435,0.43322714574131516
정책금리/NNG;내리/VV,0,0.01441534672778233,23,11,12,15,0.4466597951138435,0.43322714574131516
불확실성/NNG;커질/VV;있/VV,0,0.01441534672778233,23,11,12,38,0.4466597951138435,0.43322714574131516
성장세/NNG;유지될/VVX,0,0.01441534672778233,23,11,12,29,0.4466597951138435,0.43322714574131516
경기회복/NNG;지속될/VVX,0,0.01441534672778233,23,11,12,43,0.4466597951138435,0.43322714574131516
금리/NNG;크/VA;하락하/VVX,0,0.013712888026935932,46,22,24,100,0.5167660478445347,0.5019289458229418
실업률/NNG;하락하/VVX,0,0.010474990736514922,88,42,46,148,0.6023022786571353,0.5888055618032875
유동성/NNG;공급하/VVX,0,0.010138057123680877,361,172,189,401,0.6739546523256037,0.6592959020616314
수입/NNG;의존하/VVX,0,0.008757306711786317,21,10,11,18,0.4373683756949532,0.4290371632835889
경제성장률/NNG;웃돌/VV,0,0.008757306711786317,21,10,11,11,0.4373683756949532,0.4290371632835889
경기둔화/NNG;지속될/VVX,0,0.008757306711786317,21,10,11,29,0.4373683756949532,0.4290371632835889
완화적/VAX;통화정책/NNG;유지할/VVX,0,0.008757306711786317,21,10,11,32,0.4373683756949532,0.4290371632835889
경제/NNG;회복시/VVX,0,0.008757306711786317,21,10,11,31,0.4373683756949532,0.4290371632835889
경기회복/NNG;둔화되/VVX,0,0.008757306711786317,21,10,11,53,0.4373683756949532,0.4290371632835889
성장률/NNG;둔화하/VVX,0,0.008757306711786317,21,10,11,24,0.4373683756949532,0.4290371632835889
gdp/NNG;감소할/VVX,0,0.008757306711786317,21,10,11,20,0.4373683756949532,0.4290371632835889
물가/NNG;안정세/NNG;유지하/VVX,0,0.008757306711786317,21,10,11,16,0.4373683756949532,0.4290371632835889
경제/NNG;성장세/NNG;이/VV;갈/VX,0,0.008757306711786317,21,10,11,18,0.4373683756949532,0.4290371632835889
금융위기/NNG;발생했/VVX,0,0.008757306711786317,21,10,11,15,0.4373683756949532,0.4290371632835889
실물경제/NNG;영향/NNG;주/VV,0,0.008757306711786317,21,10,11,19,0.4373683756949532,0.4290371632835889
수출/NNG;감소해/VVX,0,0.008757306711786317,21,10,11,12,0.4373683756949532,0.4290371632835889
자금이탈/NNG;지속되/VVX,0,0.008757306711786317,21,10,11,37,0.4373683756949532,0.4290371632835889
불확실성/NNG;걷히/VV,0,0.008757306711786317,21,10,11,25,0.4373683756949532,0.4290371632835889
금리인상/NNG;유지하/VVX,0,0.008757306711786317,21,10,11,29,0.4373683756949532,0.4290371632835889
실업률/NNG;기록하/VVX,0,0.008757306711786317,21,10,11,38,0.4373683756949532,0.4290371632835889
리스크/NNG;해소되/VVX;않/VX,0,0.008757306711786317,21,10,11,35,0.4373683756949532,0.4290371632835889
기준금리/NNG;낮/VA;유지하/VVX,0,0.008757306711786317,21,10,11,18,0.4373683756949532,0.4290371632835889
금리인하/NNG;단행되/VVX;않/VX,0,0.008757306711786317,21,10,11,28,0.4373683756949532,0.4290371632835889
물가/NNG;상승해/VVX,0,0.008757306711786317,21,10,11,29,0.4373683756949532,0.4290371632835889
듀레이션/NNG;확대하/VVX,1,0.006918807000954708,42,20,22,48,0.502338229084686,0.4945824012685572
불안/NNG;인해/VV,1,0.006918807000954708,42,20,22,67,0.502338229084686,0.4945824012685572
수출/NNG;감소세/NNG;지속하/VVX,1,0.006918807000954708,42,20,22,36,0.502338229084686,0.4945824012685572
마이너스/NNG;기록할/VVX,1,0.006918807000954708,42,20,22,59,0.502338229084686,0.4945824012685572
소비/NNG;줄이/VV,1,0.006918807000954708,42,20,22,48,0.502338229084686,0.4945824012685572
변동성/NNG;확대되/VVX,0,0.006355094567488173,265,126,139,370,0.6712360058075046,0.6616170408434492
채권시장/NNG;국채가격/NNG;오른/VV,0,0.004314575087550843,181,86,95,212,0.663937183198233,0.6570955247751854
성장/NNG;보이/VV,0,0.003148144951450771,40,19,21,75,0.4948004669013536,0.49084394553833705
환율급등/NNG;따른/VV,0,0.003148144951450771,40,19,21,35,0.4948004669013536,0.49084394553833705
기준금리/NNG;동결할/VVX,0,0.0022985752982689345,527,250,277,641,0.668773788326298,0.6645528639426521
수출/NNG;잘/MAG;되/VV,0,0.0021754705641761074,19,9,10,24,0.427623801173517,0.42502937499314075
단기금리/NNG;오르/VV,0,0.0021754705641761074,19,9,10,21,0.427623801173517,0.42502937499314075
자산매입/NNG;유지하/VVX,0,0.0021754705641761074,19,9,10,56,0.427623801173517,0.42502937499314075
경제/NNG;미칠/VV;부정적/VAX,0,0.0021754705641761074,19,9,10,39,0.427623801173517,0.42502937499314075
연방기금금리/NNG;동결하/VVX,0,0.0021754705641761074,19,9,10,26,0.427623801173517,0.42502937499314075
gdp/NNG;증가할/VVX,0,0.0021754705641761074,19,9,10,36,0.427623801173517,0.42502937499314075
리스크/NNG;해소되/VVX,0,0.0021754705641761074,19,9,10,44,0.427623801173517,0.42502937499314075
금리인상/NNG;멈추/VV,0,0.0021754705641761074,19,9,10,35,0.427623801173517,0.42502937499314075
디플레이션/NNG;벗어나/VV,0,0.0021754705641761074,19,9,10,37,0.427623801173517,0.42502937499314075
불확실성/NNG;증대되/VVX,0,0.0021754705641761074,19,9,10,47,0.427623801173517,0.42502937499314075
물가안정/NNG;강조하/VVX,0,0.0021754705641761074,19,9,10,37,0.427623801173517,0.42502937499314075
금리인상/NNG;가능성/NNG;시사함/VVX,0,0.0021754705641761074,19,9,10,17,0.427623801173517,0.42502937499314075
인플레이션/NNG;걱정하/VVX,0,0.0021754705641761074,19,9,10,19,0.427623801173517,0.42502937499314075
금리상승/NNG;이어졌/VV,0,0.0021754705641761074,19,9,10,16,0.427623801173517,0.42502937499314075
금리/NNG;상승세/NNG;제한될/VVX,0,0.0021754705641761074,19,9,10,48,0.427623801173517,0.42502937499314075
출구전략/NNG;시행하/VVX,0,0.0005588102155962282,59,28,31,67,0.5422702188846638,0.5407234199977055
수출/NNG;호조/NNG;보이/VV,0,0.0005588102155962282,59,28,31,75,0.5422702188846638,0.5407234199977055
안전자산선호현상/NNG;강화됐/VVX,0,-0.0009167873944299076,38,18,20,21,0.48702980891043857,0.48707400326836864
가계부채/NNG;늘어나/VV,0,-0.0009167873944299076,38,18,20,46,0.48702980891043857,0.48707400326836864
경제/NNG;부정적/VAX;영향/NNG;미칠/VV,0,-0.002522324882525351,57,27,30,67,0.5360060708148358,0.5377764885431288
금리인상/NNG;하/VV;않/VX,0,-0.002522324882525351,57,27,30,66,0.5360060708148358,0.5377764885431288
물가/NNG;안정세/NNG;보이/VV,0,-0.005319184220864859,36,17,19,57,0.479009638414502,0.4832840508718893
성장/NNG;그칠/VV,0,-0.005319184220864859,36,17,19,68,0.479009638414502,0.4832840508718893
실업률/NNG;상승하/VVX,0,-0.005319184220864859,36,17,19,68,0.479009638414502,0.4832840508718893
변동성/NNG;줄이/VV,0,-0.005319184220864859,36,17,19,58,0.479009638414502,0.4832840508718893
경제지표/NNG;부진한/VAX;모습/NNG;보이/VV,0,-0.005319184220864859,36,17,19,61,0.479009638414502,0.4832840508718893
금리인하/NNG;가능하/VVX,0,-0.005319184220864859,36,17,19,42,0.479009638414502,0.4832840508718893
부양책/NNG;나올/VV,0,-0.005319184220864859,36,17,19,64,0.479009638414502,0.4832840508718893
정책금리/NNG;동결했/VVX,0,-0.005319184220864859,36,17,19,39,0.479009638414502,0.4832840508718893
금리변동성/NNG;커지/VV,0,-0.005643869014801073,17,8,9,26,0.41729759853868403,0.4212944559821757
경기/NNG;회복세/NNG;보일/VV,0,-0.005643869014801073,17,8,9,22,0.41729759853868403,0.4212944559821757
고용/NNG;줄어들/VV,0,-0.005643869014801073,17,8,9,11,0.41729759853868403,0.4212944559821757
회복속도/NNG;둔화되/VVX,0,-0.005643869014801073,17,8,9,17,0.41729759853868403,0.4212944559821757
성장률/NNG;웃돌/VV,0,-0.005643869014801073,17,8,9,21,0.41729759853868403,0.4212944559821757
성장세/NNG;나타냈/VV,0,-0.005643869014801073,17,8,9,30,0.41729759853868403,0.4212944559821757
기준금리/NNG;인상하/VVX;어려울/VA,0,-0.005643869014801073,17,8,9,31,0.41729759853868403,0.4212944559821757
성장률전망/NNG;낮추/VV,0,-0.005643869014801073,17,8,9,16,0.41729759853868403,0.4212944559821757
성장모멘텀/NNG;불확실성/NNG;해소되/VVX;않/VX,0,-0.005643869014801073,17,8,9,4,0.41729759853868403,0.4212944559821757
양적완화정책/NNG;펴/VV,0,-0.005643869014801073,17,8,9,20,0.41729759853868403,0.4212944559821757
수출/NNG;하/VV,0,-0.005643869014801073,17,8,9,19,0.41729759853868403,0.4212944559821757
수출/NNG;둔화될/VVX,0,-0.005643869014801073,17,8,9,27,0.41729759853868403,0.4212944559821757
강한/VA;성장세/NNG;보이/VV,0,-0.005643869014801073,17,8,9,11,0.41729759853868403,0.4212944559821757
물가/NNG;밑돌/VV,0,-0.005643869014801073,17,8,9,14,0.41729759853868403,0.4212944559821757
투자심리/NNG;지지했/VVX,0,-0.005643869014801073,17,8,9,5,0.41729759853868403,0.4212944559821757
지정학적리스크/NNG;인해/VV,0,-0.005643869014801073,17,8,9,21,0.41729759853868403,0.4212944559821757
실업률/NNG;웃돌/VV,0,-0.005643869014801073,17,8,9,32,0.41729759853868403,0.4212944559821757
금리인상/NNG;가능성/NNG;남/VV,0,-0.005643869014801073,17,8,9,29,0.41729759853868403,0.4212944559821757
불안심리/NNG;진정되/VVX,0,-0.005643869014801073,17,8,9,32,0.41729759853868403,0.4212944559821757
금리인상/NNG;대비하/VVX,0,-0.005643869014801073,17,8,9,25,0.41729759853868403,0.4212944559821757
마이너스/NNG;하락하/VVX,0,-0.005643869014801073,17,8,9,13,0.41729759853868403,0.4212944559821757
유동성/NNG;흡수하/VVX,0,-0.005772700555065957,129,61,68,178,0.6359521213792015,0.6422084774363963
성장/NNG;지속할/VVX,0,-0.005773154666973923,55,26,29,56,0.5295550198972461,0.5347651498960043
기준금리/NNG;인하된/VVX,0,-0.010034413253728114,89,42,47,128,0.5915925155175595,0.6025196525199299
금리인상/NNG;전망하/VVX,0,-0.010112373367622496,34,16,18,40,0.47071896099306887,0.47948813974346666
금리/NNG;올릴/VV;없/VA,0,-0.010112373367622496,34,16,18,34,0.47071896099306887,0.47948813974346666
투자심리/NNG;위축시/VVX,0,-0.01065097208719501,191,90,101,301,0.6557628655089606,0.6686983265672758
경제지표/NNG;개선되/VVX,0,-0.011095777007678831,123,58,65,211,0.6281088214251682,0.6410681282428696
성장/NNG;가능하/VVX,0,-0.011369494646211287,70,33,37,86,0.5587943864338756,0.5706354974447465
금리상승/NNG;따른/VV,0,-0.0135561077312919,219,103,116,393,0.6565947659115327,0.6734434888721073
시장금리/NNG;상승하/VVX,0,-0.014921723574701118,119,56,63,188,0.6224155635674821,0.6401311706615438
인플레이션/NNG;유발하/VVX,0,-0.01518506213737969,15,7,8,22,0.40618313809494955,0.41796401866279415
인플레이션우려/NNG;고조되/VVX,0,-0.01518506213737969,15,7,8,11,0.40618313809494955,0.41796401866279415
마이너스/NNG;축소되/VVX,0,-0.01518506213737969,15,7,8,23,0.40618313809494955,0.41796401866279415
인플레이션압력/NNG;억제하/VVX,0,-0.01518506213737969,15,7,8,26,0.40618313809494955,0.41796401866279415
인플레이션우려/NNG;완화됐/VVX,0,-0.01518506213737969,15,7,8,18,0.40618313809494955,0.41796401866279415
인플레이션압력/NNG;가중시/VVX,0,-0.01518506213737969,15,7,8,27,0.40618313809494955,0.41796401866279415
경기안정/NNG;위한/VV,0,-0.01518506213737969,15,7,8,28,0.40618313809494955,0.41796401866279415
흑자/NNG;이/VV,0,-0.01518506213737969,15,7,8,17,0.40618313809494955,0.41796401866279415
경기불확실성/NNG;따른/VV,0,-0.01518506213737969,15,7,8,35,0.40618313809494955,0.41796401866279415
경기진작/NNG;위해/VV,0,-0.01518506213737969,15,7,8,23,0.40618313809494955,0.41796401866279415
인플레이션압력/NNG;가중되/VVX,0,-0.01518506213737969,15,7,8,23,0.40618313809494955,0.41796401866279415
금리하락/NNG;인해/VV,0,-0.01518506213737969,15,7,8,27,0.40618313809494955,0.41796401866279415
세계경제/NNG;위험요인/NNG;작용할/VVX,0,-0.01518506213737969,15,7,8,17,0.40618313809494955,0.41796401866279415
금리/NNG;횡보하/VVX,0,-0.01518506213737969,15,7,8,18,0.40618313809494955,0.41796401866279415
금리인상/NNG;나설/VV;가능성/NNG;낮/VA,0,-0.01518506213737969,15,7,8,9,0.40618313809494955,0.41796401866279415
경기/NNG;회복세/NNG;이/VV,0,-0.01518506213737969,15,7,8,15,0.40618313809494955,0.41796401866279415
마이너스/NNG;떨어지/VV,0,-0.01518506213737969,15,7,8,17,0.40618313809494955,0.41796401866279415
성장률/NNG;부진했/VVX,0,-0.01518506213737969,15,7,8,11,0.40618313809494955,0.41796401866279415
소비자물가지수/NNG;상승할/VVX,0,-0.01518506213737969,15,7,8,12,0.40618313809494955,0.41796401866279415
투자심리/NNG;부담/NNG;주/VV,0,-0.01518506213737969,15,7,8,12,0.40618313809494955,0.41796401866279415
근원소비자물가/NNG;상승하/VVX,0,-0.01518506213737969,15,7,8,17,0.40618313809494955,0.41796401866279415
성장/NNG;주도하/VVX,0,-0.01518506213737969,15,7,8,37,0.40618313809494955,0.41796401866279415
투자심리/NNG;부정적/VAX;영향/NNG;미칠/VV,0,-0.01518506213737969,15,7,8,20,0.40618313809494955,0.41796401866279415
성장/NNG;예상했/VVX,0,-0.01518506213737969,15,7,8,22,0.40618313809494955,0.41796401866279415
금리인하/NNG;검토할/VVX,0,-0.01518506213737969,15,7,8,24,0.40618313809494955,0.41796401866279415
수출액/NNG;줄/VV,0,-0.01518506213737969,15,7,8,7,0.40618313809494955,0.41796401866279415
가계부채/NNG;급증하/VVX,0,-0.01518506213737969,15,7,8,25,0.40618313809494955,0.41796401866279415
부양책/NNG;나오/VV;않/VX,0,-0.01518506213737969,15,7,8,17,0.40618313809494955,0.41796401866279415
정책금리인상/NNG;반영하/VVX,0,-0.01518506213737969,15,7,8,12,0.40618313809494955,0.41796401866279415
경제/NNG;성장세/NNG;유지하/VVX,0,-0.01518506213737969,15,7,8,9,0.40618313809494955,0.41796401866279415
금융안정리스크/NNG;있/VV,0,-0.01518506213737969,15,7,8,6,0.40618313809494955,0.41796401866279415
물가상승압력/NNG;확대되/VVX,0,-0.01518506213737969,15,7,8,17,0.40618313809494955,0.41796401866279415
금리인상/NNG;가능성/NNG;인해/VV,0,-0.01518506213737969,15,7,8,6,0.40618313809494955,0.41796401866279415
금융시장변동성/NNG;확대될/VVX,0,-0.01518506213737969,15,7,8,24,0.40618313809494955,0.41796401866279415
연방기금금리/NNG;유지했/VVX,0,-0.01518506213737969,15,7,8,14,0.40618313809494955,0.41796401866279415
동결/NNG;예상한/VVX,0,-0.01518506213737969,15,7,8,24,0.40618313809494955,0.41796401866279415
금리/NNG;크/VA;올랐/VV,0,-0.01518506213737969,15,7,8,23,0.40618313809494955,0.41796401866279415
금리상승/NNG;크/VA;나타났/VV,0,-0.01518506213737969,15,7,8,5,0.40618313809494955,0.41796401866279415
안전자산선호현상/NNG;약화됐/VVX,0,-0.01518506213737969,15,7,8,20,0.40618313809494955,0.41796401866279415
단기금리/NNG;오를/VV,0,-0.01518506213737969,15,7,8,13,0.40618313809494955,0.41796401866279415
기준금리/NNG;올릴/VV,0,-0.015279118883938847,347,163,184,513,0.6570034403247382,0.6761861233149649
기준금리인상/NNG;단행했/VVX,0,-0.015363078064013713,32,15,17,33,0.46213082329547844,0.4757035477931629
인플레이션기대심리/NNG;낮추/VV,0,-0.015363078064013713,32,15,17,62,0.46213082329547844,0.4757035477931629
신용등급/NNG;하향조정하/VVX,0,-0.015363078064013713,32,15,17,52,0.46213082329547844,0.4757035477931629
금리인상/NNG;지속하/VVX,0,-0.015363078064013713,32,15,17,25,0.46213082329547844,0.4757035477931629
금융시장/NNG;안정된/VVX,0,-0.015363078064013713,32,15,17,31,0.46213082329547844,0.4757035477931629
경제성장/NNG;위한/VV,0,-0.02115604072152899,30,14,16,29,0.45321003598786064,0.47195164197290235
경제지표/NNG;부진했/VVX,0,-0.02115604072152899,30,14,16,70,0.45321003598786064,0.47195164197290235
금리인하/NNG;카드/NNG;꺼내/VV,0,-0.02115604072152899,30,14,16,34,0.45321003598786064,0.47195164197290235
경기/NNG;부양하/VVX,0,-0.024045484579316767,201,94,107,283,0.6480267500336131,0.6787322638815748
투자심리/NNG;악화시/VVX,-1,-0.025218752028411173,45,21,24,63,0.49422325126947325,0.5188562311199973
소비/NNG;늘어나/VV,-1,-0.025218752028411173,45,21,24,81,0.49422325126947325,0.5188562311199973
신용등급/NNG;강등될/VVX,0,-0.027600729501867205,28,13,15,53,0.443909821408959,0.4682590347161883
마이너스/NNG;유지하/VVX,0,-0.027600729501867205,28,13,15,25,0.443909821408959,0.4682590347161883
재정/NNG;통한/VV,0,-0.027600729501867205,28,13,15,25,0.443909821408959,0.4682590347161883
금리인하/NNG;지지하/VVX,0,-0.027600729501867205,28,13,15,20,0.443909821408959,0.4682590347161883
금리인상/NNG;단행한/VVX,0,-0.027600729501867205,28,13,15,29,0.443909821408959,0.4682590347161883
경기침체/NNG;막/VV,0,-0.02794113875913573,107,50,57,96,0.6028675181599368,0.6363686726316328
변동성/NNG;확대된/VVX,0,-0.02936860970659283,75,35,40,95,0.557670108556215,0.5903416992717312
리스크/NNG;남/VV,0,-0.02936860970659283,75,35,40,98,0.557670108556215,0.5903416992717312
인플레이션압력/NNG;완화되/VVX,-1,-0.029922253681021638,43,20,23,39,0.4864676485330185,0.5155380248536279
금리/NNG;오르/VV,0,-0.03278721579610433,430,200,230,649,0.6450903385266776,0.6875665541894525
잠재성장률/NNG;상회하/VVX,0,-0.034841324674381835,26,12,14,32,0.43416675192869275,0.4646591547147946
금리상승/NNG;나타날/VV,0,-0.034841324674381835,26,12,14,50,0.43416675192869275,0.4646591547147946
인플레이션압력/NNG;증가하/VVX,0,-0.034841324674381835,26,12,14,31,0.43416675192869275,0.4646591547147946
경기과열/NNG;억제하/VVX,0,-0.034841324674381835,26,12,14,32,0.43416675192869275,0.4646591547147946
금리인상/NNG;뒷받침하/VVX,0,-0.034841324674381835,26,12,14,16,0.43416675192869275,0.4646591547147946
가계대출/NNG;크/VA;상회하/VVX,0,-0.034841324674381835,26,12,14,16,0.43416675192869275,0.4646591547147946
경제성장/NNG;둔화하/VVX,0,-0.034841324674381835,26,12,14,36,0.43416675192869275,0.4646591547147946
유동성/NNG;따른/VV,0,-0.034841324674381835,26,12,14,22,0.43416675192869275,0.4646591547147946
경기둔화/NNG;우려하/VVX,0,-0.034841324674381835,26,12,14,28,0.43416675192869275,0.4646591547147946
기준금리인상/NNG;시사하/VVX,0,-0.034841324674381835,26,12,14,22,0.43416675192869275,0.4646591547147946
수출/NNG;늘어나/VV,0,-0.035664181369781,56,26,30,77,0.5157047073582699,0.5528326007169271
인플레이션/NNG;잡/VV,0,-0.03953832700667903,69,32,37,89,0.5407404649553635,0.5841797632927471
정책금리/NNG;인상되/VVX,-1,-0.04043738514940709,39,18,21,48,0.4701419675744775,0.5088241575830547
경기부양책/NNG;따른/VV,-1,-0.04043738514940709,39,18,21,60,0.4701419675744775,0.5088241575830547
경제성장률/NNG;둔화되/VVX,-1,-0.04043738514940709,39,18,21,57,0.4701419675744775,0.5088241575830547
금리/NNG;올라가/VV,0,-0.0421638415874509,110,51,59,181,0.5968584622180805,0.6482015809422045
소비자물가/NNG;올랐/VV,0,-0.043072047490769094,24,11,13,42,0.423892882493154,0.46119440822035546
유가상승/NNG;견인했/VVX,0,-0.043072047490769094,24,11,13,48,0.423892882493154,0.46119440822035546
물가/NNG;올라/VV,0,-0.043072047490769094,24,11,13,49,0.423892882493154,0.46119440822035546
성장/NNG;위해서/VV,0,-0.043072047490769094,24,11,13,69,0.423892882493154,0.46119440822035546
불안/NNG;계속되/VVX,0,-0.043072047490769094,24,11,13,31,0.423892882493154,0.46119440822035546
물가상승/NNG;막/VV,0,-0.043072047490769094,24,11,13,27,0.423892882493154,0.46119440822035546
침체/NNG;빠져/VV,0,-0.043072047490769094,24,11,13,41,0.423892882493154,0.46119440822035546
경제/NNG;회복할/VVX,0,-0.043072047490769094,24,11,13,29,0.423892882493154,0.46119440822035546
경기부진/NNG;지속되/VVX,0,-0.043072047490769094,24,11,13,37,0.423892882493154,0.46119440822035546
기준금리/NNG;낮추/VV,0,-0.04378790778194397,95,44,51,116,0.5791145023168441,0.6309783134801025
투자심리/NNG;회복되/VVX,0,-0.04441825579553893,52,24,28,123,0.5015908513762124,0.5472016569792708
경기둔화/NNG;따른/VV,0,-0.045298958080995266,121,56,65,248,0.604467979025819,0.6605968869955098
기준금리/NNG;유지할/VVX,0,-0.045298958080995266,121,56,65,142,0.604467979025819,0.6605968869955098
경제성장률/NNG;상향조정했/VVX,-1,-0.04635872427977916,37,17,20,57,0.4615237755851233,0.505450270865476
채권시장/NNG;부담/NNG;작용할/VVX,-1,-0.04635872427977916,37,17,20,84,0.4615237755851233,0.505450270865476
금리인하기대/NNG;선반영하/VVX,-1,-0.04635872427977916,37,17,20,75,0.4615237755851233,0.505450270865476
물가상승/NNG;억제하/VVX,-1,-0.049199588720814424,50,23,27,72,0.49418678574227465,0.5443085549695684
물가/NNG;안정돼/VVX,-1,-0.049199588720814424,50,23,27,54,0.49418678574227465,0.5443085549695684
금리/NNG;동결할/VVX,0,-0.05031371122038242,367,169,198,476,0.6329778259557127,0.6987330120481817
콜금리/NNG;동결될/VVX,0,-0.05243749147938426,76,35,41,59,0.5457945845096509,0.6050606662802057
금리/NNG;유지할/VVX,0,-0.05243749147938426,76,35,41,130,0.5457945845096509,0.6050606662802057
금리/NNG;유지한/VVX,0,-0.05256154111632361,22,10,12,36,0.41296310493902283,0.4579191890989964
금리인상전망/NNG;따른/VV,0,-0.05256154111632361,22,10,12,30,0.41296310493902283,0.4579191890989964
변동성/NNG;장세/NNG;이어질/VV,0,-0.05256154111632361,22,10,12,26,0.41296310493902283,0.4579191890989964
금리/NNG;인상돼/VVX,0,-0.05256154111632361,22,10,12,20,0.41296310493902283,0.4579191890989964
물가/NNG;하락했/VVX,0,-0.05256154111632361,22,10,12,21,0.41296310493902283,0.4579191890989964
유동성/NNG;조절하/VVX,0,-0.05256154111632361,22,10,12,36,0.41296310493902283,0.4579191890989964
인플레이션/NNG;하락하/VVX,0,-0.05256154111632361,22,10,12,22,0.41296310493902283,0.4579191890989964
물가/NNG;자극할/VVX,0,-0.05256154111632361,22,10,12,20,0.41296310493902283,0.4579191890989964
경제지표/NNG;호전되/VVX,0,-0.05256154111632361,22,10,12,51,0.41296310493902283,0.4579191890989964
경기/NNG;둔화된/VVX,0,-0.05256154111632361,22,10,12,33,0.41296310493902283,0.4579191890989964
듀레이션/NNG;축소하/VVX,0,-0.05256154111632361,22,10,12,41,0.41296310493902283,0.4579191890989964
인플레이션/NNG;자극할/VVX,0,-0.05256154111632361,22,10,12,22,0.41296310493902283,0.4579191890989964
성장잠재력/NNG;확충하/VVX,0,-0.05256154111632361,22,10,12,29,0.41296310493902283,0.4579191890989964
물가/NNG;상승세/NNG;지속될/VVX,0,-0.05256154111632361,22,10,12,19,0.41296310493902283,0.4579191890989964
불안/NNG;확대되/VVX,0,-0.05256154111632361,22,10,12,28,0.41296310493902283,0.4579191890989964
금리인하/NNG;요구하/VVX,-1,-0.05281730789205574,35,16,19,43,0.452559525922561,0.5020832778256208
경제/NNG;견조하/VVX,-1,-0.05281730789205574,35,16,19,20,0.452559525922561,0.5020832778256208
경기상승/NNG;따른/VV,-1,-0.05281730789205574,35,16,19,35,0.452559525922561,0.5020832778256208
경기/NNG;둔화되/VVX,0,-0.053549144239961155,224,103,121,293,0.6294747731997347,0.6993827747232895
기준금리/NNG;동결됐/VVX,-1,-0.05429014052266845,48,22,26,117,0.4865332951174248,0.5413694447966726
경기/NNG;악화되/VVX,-1,-0.05429014052266845,48,22,26,66,0.4865332951174248,0.5413694447966726
수출/NNG;미치/VV,-1,-0.05429014052266845,48,22,26,72,0.4865332951174248,0.5413694447966726
금리인상/NNG;그칠/VV,0,-0.05616991011542238,74,34,40,95,0.5401340357449697,0.6032788647920563
자산/NNG;축소하/VVX,0,-0.05990669560574724,33,15,18,44,0.4432062500156735,0.49874028745202614
동결/NNG;예상했/VVX,0,-0.05990669560574724,33,15,18,47,0.4432062500156735,0.49874028745202614
통화정책/NNG;완화/NNG;유지하/VVX,0,-0.05990669560574724,33,15,18,21,0.4432062500156735,0.49874028745202614
외화유동성/NNG;공급하/VVX,0,-0.05990669560574724,33,15,18,7,0.4432062500156735,0.49874028745202614
금리하락/NNG;확대되/VVX,0,-0.05999966455561945,59,27,32,67,0.5087943762257368,0.5726533470612627
동결/NNG;이/VV;갈/VX,0,-0.06369331628771024,20,9,11,20,0.4011940123799706,0.4549041121453276
금리인하/NNG;나올/VV,0,-0.06369331628771024,20,9,11,15,0.4011940123799706,0.4549041121453276
디플레이션/NNG;막/VV,0,-0.06369331628771024,20,9,11,27,0.4011940123799706,0.4549041121453276
정책금리/NNG;동결되/VVX,0,-0.06369331628771024,20,9,11,62,0.4011940123799706,0.4549041121453276
고용지표/NNG;호조/NNG;보인/VV,0,-0.06369331628771024,20,9,11,33,0.4011940123799706,0.4549041121453276
금융시장/NNG;흔들/VV,0,-0.06369331628771024,20,9,11,24,0.4011940123799706,0.4549041121453276
인플레이션/NNG;통제하/VVX,0,-0.06369331628771024,20,9,11,25,0.4011940123799706,0.4549041121453276
내수/NNG;부양/NNG;위해/VV,0,-0.06369331628771024,20,9,11,35,0.4011940123799706,0.4549041121453276
경기/NNG;낙관하/VVX,0,-0.06369331628771024,20,9,11,27,0.4011940123799706,0.4549041121453276
경제성장세/NNG;둔화될/VVX,0,-0.06369331628771024,20,9,11,32,0.4011940123799706,0.4549041121453276
성장/NNG;이어질/VV,0,-0.06369331628771024,20,9,11,18,0.4011940123799706,0.4549041121453276
부양책/NNG;힘입/VV,0,-0.06369331628771024,20,9,11,18,0.4011940123799706,0.4549041121453276
성장둔화/NNG;따른/VV,0,-0.06369331628771024,20,9,11,33,0.4011940123799706,0.4549041121453276
출구전략/NNG;나설/VV,0,-0.06369331628771024,20,9,11,20,0.4011940123799706,0.4549041121453276
소매판매/NNG;증가했/VVX,0,-0.06369331628771024,20,9,11,79,0.4011940123799706,0.4549041121453276
변동성/NNG;확대될/VVX,0,-0.06512366325799834,311,142,169,465,0.6225867617490166,0.7079637905397523
투자심리/NNG;위축될/VVX,-1,-0.06555115964172598,44,20,24,82,0.4704084203471552,0.5353756544278935
금리인상/NNG;가능성/NNG;배제하/VVX,-1,-0.06555115964172598,44,20,24,74,0.4704084203471552,0.5353756544278935
금리인상/NNG;기정사실화하/VVX,0,-0.06774601572913452,31,14,17,23,0.4334081407858249,0.4954419030541522
금융완화/NNG;유지될/VVX,0,-0.06774601572913452,31,14,17,21,0.4334081407858249,0.4954419030541522
원자재가격/NNG;하락/NNG;따른/VV,0,-0.06774601572913452,31,14,17,54,0.4334081407858249,0.4954419030541522
금리/NNG;하회하/VVX,-1,-0.06978413268809136,55,25,30,89,0.4945275000572921,0.5676259095076762
금리인하/NNG;주장했/VVX,-1,-0.0718165616646258,42,19,23,62,0.4618931364845881,0.5323348595932262
고용/NNG;늘리/VV,-1,-0.0718165616646258,42,19,23,42,0.4618931364845881,0.5323348595932262
동결/NNG;유지하/VVX,-1,-0.0718165616646258,42,19,23,77,0.4618931364845881,0.5323348595932262
금리인상/NNG;지속할/VVX,0,-0.07286298593407059,66,30,36,90,0.5156432808246858,0.595532010004615
경제/NNG;둔화될/VVX,0,-0.07286298593407059,66,30,36,95,0.5156432808246858,0.595532010004615
물가상승률/NNG;둔화되/VVX,0,-0.07648963059220681,29,13,16,44,0.4230914791837096,0.49221299961831894
금리/NNG;기준금리/NNG;하회하/VVX,0,-0.07648963059220681,29,13,16,86,0.4230914791837096,0.49221299961831894
소비/NNG;미치/VV,0,-0.07648963059220681,29,13,16,30,0.4230914791837096,0.49221299961831894
투자심리/NNG;냉각시/VVX,0,-0.07648963059220681,29,13,16,57,0.4230914791837096,0.49221299961831894
금융안정/NNG;유의해/VVX,0,-0.07648963059220681,29,13,16,10,0.4230914791837096,0.49221299961831894
인플레이션/NNG;억제하/VVX,0,-0.07702296787848018,143,65,78,180,0.5968965593731905,0.6951574508915428
경제지표/NNG;부진할/VVX,0,-0.07703632581570174,18,8,10,31,0.388306914627537,0.4522419917203122
금리인상/NNG;유지되/VVX,0,-0.07703632581570174,18,8,10,11,0.388306914627537,0.4522419917203122
마이너스/NNG;나타낼/VV,0,-0.07703632581570174,18,8,10,10,0.388306914627537,0.4522419917203122
수출/NNG;악영향/NNG;미칠/VV,0,-0.07703632581570174,18,8,10,11,0.388306914627537,0.4522419917203122
금리인상/NNG;재개될/VVX,0,-0.07703632581570174,18,8,10,27,0.388306914627537,0.4522419917203122
자산/NNG;보유하/VVX,0,-0.07703632581570174,18,8,10,36,0.388306914627537,0.4522419917203122
금융위기/NNG;촉발된/VVX,0,-0.07703632581570174,18,8,10,11,0.388306914627537,0.4522419917203122
유동성/NNG;인해/VV,0,-0.07703632581570174,18,8,10,27,0.388306914627537,0.4522419917203122
고용/NNG;줄/VV,0,-0.07703632581570174,18,8,10,12,0.388306914627537,0.4522419917203122
침체/NNG;진입했/VVX,0,-0.07703632581570174,18,8,10,4,0.388306914627537,0.4522419917203122
근원인플레이션율/NNG;상승하/VVX,0,-0.07703632581570174,18,8,10,14,0.388306914627537,0.4522419917203122
유동성/NNG;부족/NNG;따른/VV,0,-0.07703632581570174,18,8,10,11,0.388306914627537,0.4522419917203122
투자심리/NNG;위축돼/VVX,0,-0.07703632581570174,18,8,10,23,0.388306914627537,0.4522419917203122
시장금리/NNG;반등하/VVX,0,-0.07703632581570174,18,8,10,25,0.388306914627537,0.4522419917203122
변동성/NNG;작용할/VVX,0,-0.07703632581570174,18,8,10,18,0.388306914627537,0.4522419917203122
경기둔화/NNG;진행되/VVX,0,-0.07703632581570174,18,8,10,16,0.388306914627537,0.4522419917203122
물가/NNG;상승시/VVX,0,-0.07703632581570174,18,8,10,21,0.388306914627537,0.4522419917203122
경제지표/NNG;상회하/VVX,0,-0.07703632581570174,18,8,10,26,0.388306914627537,0.4522419917203122
주택시장/NNG;안정되/VVX,0,-0.07703632581570174,18,8,10,14,0.388306914627537,0.4522419917203122
재정정책/NNG;필요하/VVX,0,-0.07703632581570174,18,8,10,21,0.388306914627537,0.4522419917203122
소비/NNG;증가할/VVX,0,-0.07703632581570174,18,8,10,25,0.388306914627537,0.4522419917203122
경제성장률/NNG;하락하/VVX,0,-0.07703632581570174,18,8,10,35,0.388306914627537,0.4522419917203122
실물경제/NNG;부정적/VAX;영향/NNG;미칠/VV,0,-0.07703632581570174,18,8,10,14,0.388306914627537,0.4522419917203122
재할인율/NNG;인하했/VVX,-1,-0.0785851471425908,40,18,22,22,0.453038489390983,0.5292761657099949
유동성/NNG;풀/VV,-1,-0.0785851471425908,40,18,22,53,0.453038489390983,0.5292761657099949
실물경제/NNG;미치/VV;영향/NNG,-1,-0.0785851471425908,40,18,22,65,0.453038489390983,0.5292761657099949
물가/NNG;오르/VV,0,-0.07962458037525388,141,64,77,262,0.5941562655533621,0.6955928239459767
물가/NNG;상승하/VVX,0,-0.08020019630888253,130,59,71,142,0.5876439795327659,0.6887651123831016
성장/NNG;보일/VV,-1,-0.08076294809227957,51,23,28,55,0.47927592946815495,0.5623849911594387
금리하락/NNG;제한되/VVX,0,-0.08360205533681897,73,33,40,142,0.5220333328281083,0.6160634136738641
불확실성/NNG;키우/VV,-1,-0.08593365993278756,38,17,21,56,0.44380796541627326,0.5262099827343971
금리/NNG;크/VA;오르/VV,-1,-0.08593365993278756,38,17,21,36,0.44380796541627326,0.5262099827343971
양적완화/NNG;하/VV,-1,-0.08593365993278756,38,17,21,36,0.44380796541627326,0.5262099827343971
마이너스/NNG;나타내/VV,-1,-0.08593365993278756,38,17,21,46,0.44380796541627326,0.5262099827343971
소비/NNG;위축될/VVX,-1,-0.08593365993278756,38,17,21,45,0.44380796541627326,0.5262099827343971
신용경색/NNG;심화되/VVX,0,-0.08634161557566167,27,12,15,17,0.4121570450884785,0.48908368555183734
금융시장/NNG;변동성/NNG;확대될/VVX,0,-0.08634161557566167,27,12,15,52,0.4121570450884785,0.48908368555183734
금리/NNG;하락세/NNG;이/VV,0,-0.08634161557566167,27,12,15,55,0.4121570450884785,0.48908368555183734
불안요인/NNG;잠재해/VVX,0,-0.08634161557566167,27,12,15,15,0.4121570450884785,0.48908368555183734
경기선행지수/NNG;하락하/VVX,-1,-0.08678302202793187,49,22,27,55,0.4712414279670693,0.5596926793611752
기준금리/NNG;낮춘/VV,0,-0.08818577008647432,71,32,39,65,0.5158043010735772,0.6143517264028819
경기부양/NNG;위해/VV,0,-0.0901162428204928,540,243,297,747,0.6048611577598557,0.7232284324796777
물가상승/NNG;따른/VV,-1,-0.0932128531118317,47,21,26,99,0.4629076511128666,0.5569580950864644
금리인상/NNG;신중할/VVX,-1,-0.0932128531118317,47,21,26,54,0.4629076511128666,0.5569580950864644
금리/NNG;인하할/VVX;없/VA,0,-0.09347594475373322,16,7,9,15,0.3738594983214191,0.4500562088400752
경제성장/NNG;저해하/VVX,0,-0.09347594475373322,16,7,9,19,0.3738594983214191,0.4500562088400752
부양책/NNG;쓸/VV,0,-0.09347594475373322,16,7,9,22,0.3738594983214191,0.4500562088400752
불안/NNG;가중되/VVX,0,-0.09347594475373322,16,7,9,33,0.3738594983214191,0.4500562088400752
경기/NNG;둔화시/VVX,0,-0.09347594475373322,16,7,9,19,0.3738594983214191,0.4500562088400752
재정/NNG;투입하/VVX,0,-0.09347594475373322,16,7,9,30,0.3738594983214191,0.4500562088400752
금리인상우려/NNG;완화된/VVX,0,-0.09347594475373322,16,7,9,12,0.3738594983214191,0.4500562088400752
통화완화/NNG;지속될/VVX,0,-0.09347594475373322,16,7,9,22,0.3738594983214191,0.4500562088400752
출구전략/NNG;시행해/VVX,0,-0.09347594475373322,16,7,9,13,0.3738594983214191,0.4500562088400752
경제/NNG;악영향/NNG;줄/VV,0,-0.09347594475373322,16,7,9,26,0.3738594983214191,0.4500562088400752
임금인상/NNG;요구하/VVX,0,-0.09347594475373322,16,7,9,16,0.3738594983214191,0.4500562088400752
불확실성/NNG;반영하/VVX,0,-0.09347594475373322,16,7,9,27,0.3738594983214191,0.4500562088400752
적자/NNG;전환했/VVX,0,-0.09347594475373322,16,7,9,18,0.3738594983214191,0.4500562088400752
불확실성/NNG;사라지/VV,0,-0.09347594475373322,16,7,9,25,0.3738594983214191,0.4500562088400752
금리메리트/NNG;남/VV,0,-0.09347594475373322,16,7,9,52,0.3738594983214191,0.4500562088400752
글로벌/NNG;금융시장/NNG;안정되/VVX,0,-0.09347594475373322,16,7,9,25,0.3738594983214191,0.4500562088400752
경기부양책/NNG;발표하/VVX,0,-0.09347594475373322,16,7,9,15,0.3738594983214191,0.4500562088400752
경기회복세/NNG;이/VV,0,-0.09347594475373322,16,7,9,12,0.3738594983214191,0.4500562088400752
경기선행지수/NNG;반등하/VVX,0,-0.09347594475373322,16,7,9,27,0.3738594983214191,0.4500562088400752
금리인상시기/NNG;늦춰질/VV,0,-0.09347594475373322,16,7,9,43,0.3738594983214191,0.4500562088400752
경기확장/NNG;밑돌/VV,0,-0.09347594475373322,16,7,9,12,0.3738594983214191,0.4500562088400752
금리인상/NNG;걸릴/VV,0,-0.09347594475373322,16,7,9,19,0.3738594983214191,0.4500562088400752
금리하락/NNG;여지/NNG;남/VV,0,-0.09347594475373322,16,7,9,50,0.3738594983214191,0.4500562088400752
지정학적리스크/NNG;확대되/VVX,0,-0.09347594475373322,16,7,9,23,0.3738594983214191,0.4500562088400752
투자심리/NNG;얼어붙/VV,-1,-0.09395725803979149,36,16,20,60,0.4341557210939248,0.5231485113514642
통화정책/NNG;완화할/VVX,-1,-0.09395725803979149,36,16,20,58,0.4341557210939248,0.5231485113514642
수익성/NNG;개선되/VVX,-1,-0.09395725803979149,36,16,20,38,0.4341557210939248,0.5231485113514642
경기선행지수/NNG;상승하/VVX,-1,-0.09395725803979149,36,16,20,54,0.4341557210939248,0.5231485113514642
경기회복/NNG;위한/VV,0,-0.0971060523518571,78,35,43,121,0.522063234172361,0.6330799664149184
양적완화/NNG;내놓/VV,0,-0.09757812835755397,25,11,14,77,0.40046846043776707,0.4860904731452751
장단기금리차/NNG;확대될/VVX,0,-0.09757812835755397,25,11,14,39,0.40046846043776707,0.4860904731452751
실업률/NNG;낮추/VV,0,-0.09757812835755397,25,11,14,48,0.40046846043776707,0.4860904731452751
금리상승압력/NNG;가중시/VVX,0,-0.09757812835755397,25,11,14,39,0.40046846043776707,0.4860904731452751
투자심리/NNG;악화되/VVX,0,-0.09757812835755397,25,11,14,31,0.40046846043776707,0.4860904731452751
신용등급/NNG;강등했/VVX,0,-0.09757812835755397,25,11,14,78,0.40046846043776707,0.4860904731452751
경기/NNG;침체될/VVX,0,-0.09757812835755397,25,11,14,17,0.40046846043776707,0.4860904731452751
신용스프레드/NNG;축소된/VVX,0,-0.09757812835755397,25,11,14,46,0.40046846043776707,0.4860904731452751
성장/NNG;촉진하/VVX,0,-0.09757812835755397,25,11,14,30,0.40046846043776707,0.4860904731452751
안전자산선호심리/NNG;약화되/VVX,0,-0.09757812835755397,25,11,14,58,0.40046846043776707,0.4860904731452751
자금이탈/NNG;따른/VV,-1,-0.10010436479259888,45,20,25,36,0.45424958280922734,0.5541863777854168
인플레이션/NNG;막/VV,-1,-0.10277558756450789,34,15,19,55,0.4240234258101729,0.5201060137522335
침체/NNG;이어지/VV,-1,-0.10277558756450789,34,15,19,22,0.4240234258101729,0.5201060137522335
금리상승/NNG;인해/VV,-1,-0.10277558756450789,34,15,19,50,0.4240234258101729,0.5201060137522335
인플레이션/NNG;상승할/VVX,-1,-0.10277558756450789,34,15,19,46,0.4240234258101729,0.5201060137522335
금리인상/NNG;중단될/VVX,-1,-0.10277558756450789,34,15,19,58,0.4240234258101729,0.5201060137522335
국제유가하락/NNG;따른/VV,-1,-0.10751991139478623,43,19,24,58,0.4452369902498937,0.551383501252064
소비자물가/NNG;상승해/VVX,-1,-0.10751991139478623,43,19,24,36,0.4452369902498937,0.551383501252064
경제성장/NNG;위해/VV,-1,-0.10751991139478623,43,19,24,56,0.4452369902498937,0.551383501252064
금리인상/NNG;중단할/VVX,0,-0.1082667832618126,103,46,57,142,0.5470613487041692,0.6785063348555616
금리/NNG;상승압력/NNG;받/VV,0,-0.10914473373206446,83,37,46,174,0.5221158830573002,0.6487169978629825
금리/NNG;내려야/VV,0,-0.10914473373206446,83,37,46,80,0.5221158830573002,0.6487169978629825
경제/NNG;개선되/VVX,0,-0.10914473373206446,83,37,46,122,0.5221158830573002,0.6487169978629825
성장률/NNG;하향조정했/VVX,0,-0.11058322168443269,23,10,13,42,0.38783374017546657,0.48327765131585443
수입/NNG;늘어난/VV,0,-0.11058322168443269,23,10,13,26,0.38783374017546657,0.48327765131585443
금리인상/NNG;준비하/VVX,0,-0.11058322168443269,23,10,13,28,0.38783374017546657,0.48327765131585443
경기회복세/NNG;보이/VV,0,-0.11058322168443269,23,10,13,31,0.38783374017546657,0.48327765131585443
성장률/NNG;둔화할/VVX,0,-0.11058322168443269,23,10,13,18,0.38783374017546657,0.48327765131585443
물가상승압력/NNG;높일/VV,0,-0.11058322168443269,23,10,13,10,0.38783374017546657,0.48327765131585443
금리/NNG;큰/VA;하락하/VVX,0,-0.1109739438316939,92,41,51,144,0.532941783027019,0.664620835279121
금리상승/NNG;제한되/VVX,0,-0.1109739438316939,92,41,51,177,0.532941783027019,0.664620835279121
성장세/NNG;지속하/VVX,-1,-0.11147884985375311,52,23,29,72,0.46433716436582295,0.5796568635456232
금리인하/NNG;가능성/NNG;열려/VV,-1,-0.11147884985375311,52,23,29,77,0.46433716436582295,0.5796568635456232
콜금리/NNG;동결할/VVX,0,-0.11224200686180907,101,45,56,50,0.5423908702580346,0.6781411979533307
경기회복/NNG;나타나/VV,-1,-0.11254145996957121,32,14,18,43,0.4133357904077953,0.5170991072964749
소비/NNG;살아나/VV,-1,-0.11254145996957121,32,14,18,44,0.4133357904077953,0.5170991072964749
성장세/NNG;둔화하/VVX,-1,-0.11254145996957121,32,14,18,34,0.4133357904077953,0.5170991072964749
기준금리/NNG;낮출/VV,0,-0.11384784519454816,81,36,45,90,0.516275898088507,0.6475901992590255
금리인하/NNG;단행할/VVX,0,-0.11453140099551906,275,122,153,329,0.5871039359861012,0.7374524768992197
금리급등/NNG;따른/VV,-1,-0.11462209400353973,61,27,34,116,0.4814588532961019,0.6048642567272647
금리인상/NNG;시작되/VVX,-1,-0.11553514744824378,41,18,23,61,0.43583294949401724,0.5485563602925742
금리/NNG;오를/VV,0,-0.11773981503439046,271,120,151,421,0.5847437316170808,0.7392733936633147
환율하락/NNG;따른/VV,0,-0.12090222226647529,115,51,64,166,0.5495610351475332,0.6992581527755267
기준금리/NNG;인하될/VVX,0,-0.12189455125725734,437,193,244,685,0.5818875954102175,0.7418808087477801
금리/NNG;동결되/VVX,-1,-0.12257138358025454,68,30,38,99,0.4898600009850633,0.625407197901288
기준금리인상/NNG;반영하/VVX,-1,-0.12345353810232873,30,13,17,22,0.4019941157611685,0.5141470619534656
유가하락/NNG;부추겼/VV,-1,-0.12345353810232873,30,13,17,44,0.4019941157611685,0.5141470619534656
수입/NNG;늘/VV,-1,-0.12345353810232873,30,13,17,50,0.4019941157611685,0.5141470619534656
리스크/NNG;꼽/VV,-1,-0.12345353810232873,30,13,17,48,0.4019941157611685,0.5141470619534656
금리급락/NNG;따른/VV,-1,-0.12345353810232873,30,13,17,49,0.4019941157611685,0.5141470619534656
수출/NNG;늘리/VV,-1,-0.12345353810232873,30,13,17,45,0.4019941157611685,0.5141470619534656
성장/NNG;지속될/VVX,-1,-0.12345353810232873,30,13,17,48,0.4019941157611685,0.5141470619534656
환율상승/NNG;따른/VV,0,-0.12384250206172298,77,34,43,93,0.5040294074662862,0.6451580013377273
안전자산선호현상/NNG;강화되/VVX,-1,-0.12424290911279967,39,17,22,51,0.42599186927952704,0.5457128541518215
경제지표/NNG;둔화되/VVX,-1,-0.12424290911279967,39,17,22,75,0.42599186927952704,0.5457128541518215
금리/NNG;인하해/VVX,0,-0.1252284478097142,147,65,82,158,0.5652273851916824,0.7255281052807875
gdp/NNG;증가했/VVX,-1,-0.12577008044309657,48,21,27,69,0.4471801798908336,0.5746333315507742
성장모멘텀/NNG;약화되/VVX,0,-0.1259086072571366,21,9,12,29,0.37397508858685174,0.4806987632073837
경기/NNG;살아날/VV,0,-0.1259086072571366,21,9,12,43,0.37397508858685174,0.4806987632073837
유동성/NNG;떨어지/VV,0,-0.1259086072571366,21,9,12,55,0.37397508858685174,0.4806987632073837
금리인상/NNG;멈출/VV,0,-0.1259086072571366,21,9,12,39,0.37397508858685174,0.4806987632073837
양적완화정책/NNG;시행하/VVX,0,-0.1259086072571366,21,9,12,13,0.37397508858685174,0.4806987632073837
소비/NNG;둔화되/VVX,0,-0.1259086072571366,21,9,12,34,0.37397508858685174,0.4806987632073837
대외불확실성/NNG;커지/VV,0,-0.1259086072571366,21,9,12,34,0.37397508858685174,0.4806987632073837
금리/NNG;올린다/VV,0,-0.1259086072571366,21,9,12,16,0.37397508858685174,0.4806987632073837
성장세/NNG;확대될/VVX,0,-0.1259086072571366,21,9,12,21,0.37397508858685174,0.4806987632073837
기대인플레이션/NNG;상승하/VVX,0,-0.1259086072571366,21,9,12,31,0.37397508858685174,0.4806987632073837
불확실성/NNG;따른/VV,0,-0.12725196778568293,154,68,86,198,0.5663659960477481,0.7299807960457636
경기침체/NNG;따른/VV,0,-0.12927829440585836,102,45,57,75,0.5322488611815133,0.6888356628046329
금리/NNG;인하될/VVX,0,-0.1335159826761939,166,73,93,164,0.5653612778367921,0.7380170456205857
물가/NNG;오를/VV,0,-0.13367383915019537,100,44,56,126,0.5273041773681257,0.6885586254432404
채권시장/NNG;국채가격/NNG;떨어진/VV,-1,-0.1336831446275626,46,20,26,36,0.43807523727708114,0.5720534805976208
경기둔화/NNG;지속되/VVX,-1,-0.13375855007088078,37,16,21,56,0.4156568090841084,0.5428619568040269
변동성/NNG;보이/VV,-1,-0.13375855007088078,37,16,21,56,0.4156568090841084,0.5428619568040269
경기회복/NNG;진행되/VVX,-1,-0.13411274879753454,55,24,31,43,0.45787862058247236,0.5984359024407477
금리인하/NNG;단행해/VVX,-1,-0.13411274879753454,55,24,31,43,0.45787862058247236,0.5984359024407477
기준금리/NNG;올리/VV;않/VX,-1,-0.13411274879753454,55,24,31,82,0.45787862058247236,0.5984359024407477
불확실성/NNG;부각되/VVX,-1,-0.13411274879753454,55,24,31,77,0.45787862058247236,0.5984359024407477
금리/NNG;낮춰/VV,-1,-0.1345214784463522,64,28,36,89,0.47543362991506355,0.6218965233778462
기준금리동결/NNG;예상했/VVX,-1,-0.1357753706020267,28,12,16,43,0.38986679236549204,0.5112720578584697
금리/NNG;상승세/NNG;재개될/VVX,-1,-0.1357753706020267,28,12,16,65,0.38986679236549204,0.5112720578584697
물가/NNG;올랐/VV,-1,-0.1357753706020267,28,12,16,40,0.38986679236549204,0.5112720578584697
금리상승/NNG;작용했/VVX,-1,-0.1357753706020267,28,12,16,41,0.38986679236549204,0.5112720578584697
금리/NNG;하락세/NNG;재개될/VVX,-1,-0.1357753706020267,28,12,16,70,0.38986679236549204,0.5112720578584697
산업생산/NNG;감소하/VVX,-1,-0.1357753706020267,28,12,16,26,0.38986679236549204,0.5112720578584697
시장금리/NNG;하/VV,-1,-0.1357753706020267,28,12,16,45,0.38986679236549204,0.5112720578584697
금리인상/NNG;신중해/VVX,-1,-0.1357753706020267,28,12,16,35,0.38986679236549204,0.5112720578584697
경기회복/NNG;위해/VV,0,-0.13587535278128338,116,51,65,166,0.540236359380271,0.7086111073290077
금리인하/NNG;나서/VV,0,-0.1367796297084687,132,58,74,174,0.5500877245866015,0.7228615409859174
금리/NNG;인하할/VVX,0,-0.1383608945130108,734,321,413,771,0.5698314591310415,0.7512202312419982
성장/NNG;위한/VV,-1,-0.14096202353724252,62,27,35,111,0.4678444336058031,0.6200444419222872
성장률/NNG;둔화될/VVX,-1,-0.14140469654219623,53,23,30,116,0.44942824000747794,0.5961744907775449
자산/NNG;매입하/VVX,-1,-0.14422740807747503,35,15,20,70,0.4047557901080359,0.540013756684363
금리인하/NNG;가능성/NNG;반영하/VVX,-1,-0.14422740807747503,35,15,20,40,0.4047557901080359,0.540013756684363
경기/NNG;부진하/VVX,-1,-0.14422740807747503,35,15,20,43,0.4047557901080359,0.540013756684363
고용지표호조/NNG;따른/VV,-1,-0.14422740807747503,35,15,20,55,0.4047557901080359,0.540013756684363
수입/NNG;줄/VV,-1,-0.14422740807747503,35,15,20,38,0.4047557901080359,0.540013756684363
경기회복/NNG;기대하/VVX,-1,-0.14422740807747503,35,15,20,41,0.4047557901080359,0.540013756684363
콜금리/NNG;인하할/VVX,0,-0.1443783571969528,19,8,11,40,0.3584775314921091,0.47841784948557087
금리/NNG;내려왔/VV,0,-0.1443783571969528,19,8,11,13,0.3584775314921091,0.47841784948557087
소비/NNG;하/VV,0,-0.1443783571969528,19,8,11,23,0.3584775314921091,0.47841784948557087
불안요인/NNG;되/VV,0,-0.1443783571969528,19,8,11,23,0.3584775314921091,0.47841784948557087
기준금리인하/NNG;기대하/VVX,0,-0.1443783571969528,19,8,11,51,0.3584775314921091,0.47841784948557087
양적완화/NNG;종료되/VVX,0,-0.1443783571969528,19,8,11,50,0.3584775314921091,0.47841784948557087
경기부양책/NNG;필요하/VVX,0,-0.1443783571969528,19,8,11,8,0.3584775314921091,0.47841784948557087
투자심리/NNG;살아나/VV,0,-0.1443783571969528,19,8,11,33,0.3584775314921091,0.47841784948557087
인플레이션기대/NNG;억제하/VVX,0,-0.1443783571969528,19,8,11,17,0.3584775314921091,0.47841784948557087
경기둔화우려/NNG;지속되/VVX,0,-0.1443783571969528,19,8,11,27,0.3584775314921091,0.47841784948557087
경기회복/NNG;확인하/VVX,0,-0.1443783571969528,19,8,11,22,0.3584775314921091,0.47841784948557087
경기부진/NNG;이어지/VV,0,-0.1443783571969528,19,8,11,20,0.3584775314921091,0.47841784948557087
원자재가격/NNG;급락하/VVX,0,-0.1443783571969528,19,8,11,19,0.3584775314921091,0.47841784948557087
인플레이션/NNG;발생할/VVX,0,-0.1443783571969528,19,8,11,23,0.3584775314921091,0.47841784948557087
금리/NNG;안정될/VVX,0,-0.1443783571969528,19,8,11,32,0.3584775314921091,0.47841784948557087
정책금리/NNG;결정하/VVX,0,-0.1443783571969528,19,8,11,19,0.3584775314921091,0.47841784948557087
채권시장/NNG;부담/NNG;될/VV,-1,-0.1477513813524386,60,26,34,71,0.45998519791974773,0.618127405826295
금리/NNG;안정되/VVX,-1,-0.1477513813524386,60,26,34,93,0.45998519791974773,0.618127405826295
성장률/NNG;개선될/VVX,-1,-0.1498647992357679,26,11,15,41,0.3767749947415132,0.5084993107180964
경제/NNG;나아질/VV,-1,-0.1498647992357679,26,11,15,14,0.3767749947415132,0.5084993107180964
경제/NNG;타격/NNG;받/VV,-1,-0.1498647992357679,26,11,15,37,0.3767749947415132,0.5084993107180964
금리/NNG;상승세/NNG;예상된/VVX,-1,-0.1498647992357679,26,11,15,26,0.3767749947415132,0.5084993107180964
금리인상/NNG;시작될/VVX,-1,-0.15141103656760013,42,18,24,62,0.41863192724471937,0.5667774845711058
소비/NNG;위축되/VVX,-1,-0.1549238198236763,58,25,33,78,0.4518388264863363,0.6161451693998251
소비/NNG;늘/VV,-1,-0.1549238198236763,58,25,33,60,0.4518388264863363,0.6161451693998251
소비자물가/NNG;오르/VV,-1,-0.15583545869389548,33,14,19,26,0.393196647376271,0.5371794356422165
내수/NNG;살아나/VV,-1,-0.15583545869389548,33,14,19,53,0.393196647376271,0.5371794356422165
소비자물가/NNG;상승할/VVX,-1,-0.15583545869389548,33,14,19,66,0.393196647376271,0.5371794356422165
재할인율/NNG;인하하/VVX,-1,-0.15583545869389548,33,14,19,44,0.393196647376271,0.5371794356422165
완화적/VAX;통화정책/NNG;유지하/VVX,-1,-0.15746509323191904,49,21,28,57,0.4315018433833761,0.5914811189462461
재정적자/NNG;줄이/VV,-1,-0.1614226919145304,40,17,23,98,0.4081966423920296,0.5640906704386329
성장세회복/NNG;이어지/VV,-1,-0.16351551105047457,72,31,41,47,0.4716140648708184,0.6545309089834893
유동성/NNG;공급할/VVX,0,-0.16568236669113323,95,41,54,126,0.5009348340083569,0.6983222444944724
금리/NNG;낮/VA;수준이/VVX,-1,-0.16622091721488597,24,10,14,41,0.3624706169220284,0.5058568763152222
금리인상/NNG;전망했/VVX,-1,-0.16622091721488597,24,10,14,44,0.3624706169220284,0.5058568763152222
금리인하기대감/NNG;형성되/VVX,-1,-0.16622091721488597,24,10,14,25,0.3624706169220284,0.5058568763152222
경제지표개선/NNG;따른/VV,-1,-0.16622091721488597,24,10,14,26,0.3624706169220284,0.5058568763152222
물가상승률/NNG;하락하/VVX,-1,-0.16622091721488597,24,10,14,37,0.3624706169220284,0.5058568763152222
경제/NNG;회복세/NNG;지속하/VVX,-1,-0.16622091721488597,24,10,14,41,0.3624706169220284,0.5058568763152222
생산/NNG;늘리/VV,-1,-0.16622091721488597,24,10,14,22,0.3624706169220284,0.5058568763152222
변동성/NNG;지속될/VVX,-1,-0.16622091721488597,24,10,14,35,0.3624706169220284,0.5058568763152222
금리인상/NNG;가능성/NNG;낮추/VV,-1,-0.16622091721488597,24,10,14,27,0.3624706169220284,0.5058568763152222
금리/NNG;낮췄/VV,-1,-0.16635982521470283,47,20,27,50,0.4219637363081735,0.5890522970342094
금리/NNG;인하되/VVX,-1,-0.16635982521470283,47,20,27,58,0.4219637363081735,0.5890522970342094
기준금리/NNG;내려야/VV,-1,-0.16635982521470283,47,20,27,54,0.4219637363081735,0.5890522970342094
금리인하/NNG;예상되/VVX,-1,-0.16669176549900866,63,27,36,50,0.4543138908292153,0.6346448760237997
금리인상/NNG;지지하/VVX,-1,-0.16669176549900866,63,27,36,76,0.4543138908292153,0.6346448760237997
수출/NNG;영향/NNG;미치/VV,0,-0.1672831434761447,17,7,10,19,0.34069777682669217,0.47650949532679804
리스크/NNG;존재한/VVX,0,-0.1672831434761447,17,7,10,24,0.34069777682669217,0.47650949532679804
금리인상/NNG;이뤄진/VV,0,-0.1672831434761447,17,7,10,7,0.34069777682669217,0.47650949532679804
기준금리인상/NNG;예상된/VVX,0,-0.1672831434761447,17,7,10,28,0.34069777682669217,0.47650949532679804
고용/NNG;감소해/VVX,0,-0.1672831434761447,17,7,10,12,0.34069777682669217,0.47650949532679804
스태그플레이션/NNG;빠질/VV,0,-0.1672831434761447,17,7,10,18,0.34069777682669217,0.47650949532679804
고용지표개선/NNG;따른/VV,0,-0.1672831434761447,17,7,10,26,0.34069777682669217,0.47650949532679804
물가상승압력/NNG;확대될/VVX,0,-0.1672831434761447,17,7,10,24,0.34069777682669217,0.47650949532679804
금리/NNG;상승세/NNG;돌아섰/VV,0,-0.1672831434761447,17,7,10,15,0.34069777682669217,0.47650949532679804
견실한/VAX;경제성장/NNG;지속되/VVX,0,-0.1672831434761447,17,7,10,38,0.34069777682669217,0.47650949532679804
경기회복세/NNG;지원하/VVX,0,-0.1672831434761447,17,7,10,30,0.34069777682669217,0.47650949532679804
금융시장/NNG;충격/NNG;받/VV,0,-0.1672831434761447,17,7,10,12,0.34069777682669217,0.47650949532679804
불안/NNG;키우/VV,0,-0.1672831434761447,17,7,10,12,0.34069777682669217,0.47650949532679804
금리하락/NNG;주도했/VVX,0,-0.1672831434761447,17,7,10,16,0.34069777682669217,0.47650949532679804
경제/NNG;침체되/VVX,0,-0.1672831434761447,17,7,10,30,0.34069777682669217,0.47650949532679804
금리인상/NNG;반영해/VVX,0,-0.1672831434761447,17,7,10,18,0.34069777682669217,0.47650949532679804
인플레이션우려/NNG;완화된/VVX,0,-0.1672831434761447,17,7,10,19,0.34069777682669217,0.47650949532679804
불안/NNG;확산될/VVX,0,-0.1672831434761447,17,7,10,30,0.34069777682669217,0.47650949532679804
유동성/NNG;풀리/VV,0,-0.1672831434761447,17,7,10,14,0.34069777682669217,0.47650949532679804
원자재가격/NNG;오르/VV,0,-0.1672831434761447,17,7,10,22,0.34069777682669217,0.47650949532679804
유동성/NNG;증가/NNG;따른/VV,0,-0.1672831434761447,17,7,10,13,0.34069777682669217,0.47650949532679804
채권시장/NNG;약세/NNG;보일/VV,0,-0.1672831434761447,17,7,10,13,0.34069777682669217,0.47650949532679804
인플레이션/NNG;발생하/VVX,0,-0.1672831434761447,17,7,10,26,0.34069777682669217,0.47650949532679804
저성장/NNG;지속되/VVX,0,-0.1672831434761447,17,7,10,32,0.34069777682669217,0.47650949532679804
안전자산선호현상/NNG;강화돼/VVX,-1,-0.16882484656063224,31,13,18,26,0.3808597354957298,0.5343711349908583
고용/NNG;증가해/VVX,-1,-0.16882484656063224,31,13,18,31,0.3808597354957298,0.5343711349908583
경기회복/NNG;지연될/VVX,-1,-0.17237059995829906,38,16,22,42,0.397201533998351,0.5613781805625958
시장금리/NNG;큰/VA;상승하/VVX,-1,-0.17237059995829906,38,16,22,40,0.397201533998351,0.5613781805625958
안전자산선호/NNG;약화되/VVX,-1,-0.17237059995829906,38,16,22,71,0.397201533998351,0.5613781805625958
금리/NNG;하락세/NNG;이어질/VV,-1,-0.17237059995829906,38,16,22,78,0.397201533998351,0.5613781805625958
경기/NNG;바닥/NNG;찍/VV,-1,-0.17237059995829906,38,16,22,29,0.397201533998351,0.5613781805625958
투자심리/NNG;개선될/VVX,-1,-0.17237059995829906,38,16,22,33,0.397201533998351,0.5613781805625958
성장/NNG;달성하/VVX,-1,-0.17593644799977626,45,19,26,66,0.4119906757707045,0.5865710444924342
기준금리/NNG;인하할/VVX,0,-0.17780342627570733,644,275,369,868,0.5406185122241277,0.7726721313356644
정책금리/NNG;동결하/VVX,-1,-0.1792723044812381,75,32,43,93,0.46645118212780984,0.6686919591194873
기준금리인하/NNG;단행했/VVX,-1,-0.18351706821190317,29,12,17,26,0.36758742776108266,0.5316016186464821
성장/NNG;힘입/VV,-1,-0.18351706821190317,29,12,17,23,0.36758742776108266,0.5316016186464821
수출/NNG;부진했/VVX,-1,-0.18351706821190317,29,12,17,27,0.36758742776108266,0.5316016186464821
콜금리/NNG;동결했/VVX,-1,-0.18351706821190317,29,12,17,30,0.36758742776108266,0.5316016186464821
경기/NNG;둔화될/VVX,-1,-0.18380220089821886,103,44,59,147,0.4969308496574373,0.7190804195822822
경기/NNG;살리/VV,-1,-0.18380220089821886,103,44,59,131,0.4969308496574373,0.7190804195822822
침체/NNG;빠진/VV,-1,-0.18442485823332289,36,15,21,47,0.38556352196896365,0.5586454551990513
지준율/NNG;인상하/VVX,-1,-0.18442485823332289,36,15,21,56,0.38556352196896365,0.5586454551990513
금리상승/NNG;억제하/VVX,-1,-0.18556189926347544,22,9,13,27,0.3466013717023057,0.5033747517236647
양적완화/NNG;통한/VV,-1,-0.18556189926347544,22,9,13,39,0.3466013717023057,0.5033747517236647
하방위험/NNG;상존하/VVX,-1,-0.18556189926347544,22,9,13,19,0.3466013717023057,0.5033747517236647
경기/NNG;바닥/NNG;다지/VV,-1,-0.18556189926347544,22,9,13,24,0.3466013717023057,0.5033747517236647
성장/NNG;둔화하/VVX,-1,-0.18556189926347544,22,9,13,41,0.3466013717023057,0.5033747517236647
리스크/NNG;감수하/VVX,-1,-0.18556189926347544,22,9,13,22,0.3466013717023057,0.5033747517236647
금리상승/NNG;작용할/VVX,-1,-0.18834503313153472,50,21,29,68,0.41593769051355123,0.607561102893552
소비자물가지수/NNG;상승해/VVX,-1,-0.18834503313153472,50,21,29,58,0.41593769051355123,0.607561102893552
정책금리/NNG;동결할/VVX,-1,-0.18834503313153472,50,21,29,35,0.41593769051355123,0.607561102893552
금리인하/NNG;단행될/VVX,0,-0.19279099741190553,153,65,88,213,0.5191174914987567,0.7652925520549354
금리/NNG;인하하/VVX;않/VX,-1,-0.19396398541572046,78,33,45,84,0.4615437132546761,0.6820735375042069
기준금리/NNG;하/VV,0,-0.19676573965898692,15,6,9,19,0.3195950284983564,0.47505510745582274
소비자물가/NNG;이/VV,0,-0.19676573965898692,15,6,9,13,0.3195950284983564,0.47505510745582274
소비자물가상승률/NNG;하락하/VVX,0,-0.19676573965898692,15,6,9,18,0.3195950284983564,0.47505510745582274
경제/NNG;호전되/VVX,0,-0.19676573965898692,15,6,9,23,0.3195950284983564,0.47505510745582274
소비위축/NNG;이어질/VV,0,-0.19676573965898692,15,6,9,5,0.3195950284983564,0.47505510745582274
수입/NNG;감소했/VVX,0,-0.19676573965898692,15,6,9,18,0.3195950284983564,0.47505510745582274
기준금리/NNG;인하할/VVX;가능성/NNG;낮/VA,0,-0.19676573965898692,15,6,9,18,0.3195950284983564,0.47505510745582274
기준금리/NNG;올려도/VV,0,-0.19676573965898692,15,6,9,21,0.3195950284983564,0.47505510745582274
금리인상/NNG;중단해/VVX,0,-0.19676573965898692,15,6,9,6,0.3195950284983564,0.47505510745582274
기준금리/NNG;인하한/VAX;이/VV,0,-0.19676573965898692,15,6,9,17,0.3195950284983564,0.47505510745582274
소비/NNG;회복세/NNG;이/VV,0,-0.19676573965898692,15,6,9,6,0.3195950284983564,0.47505510745582274
불확실성/NNG;제거하/VVX,0,-0.19676573965898692,15,6,9,19,0.3195950284983564,0.47505510745582274
임금/NNG;오르/VV;않/VX,0,-0.19676573965898692,15,6,9,13,0.3195950284983564,0.47505510745582274
리스크관리/NNG;강화할/VVX,0,-0.19676573965898692,15,6,9,10,0.3195950284983564,0.47505510745582274
금리인상/NNG;시사해/VVX,0,-0.19676573965898692,15,6,9,16,0.3195950284983564,0.47505510745582274
내수회복/NNG;힘입/VV,0,-0.19676573965898692,15,6,9,14,0.3195950284983564,0.47505510745582274
금융시장/NNG;안정세/NNG;보이/VV,0,-0.19676573965898692,15,6,9,3,0.3195950284983564,0.47505510745582274
경기회복/NNG;될/VV,0,-0.19676573965898692,15,6,9,16,0.3195950284983564,0.47505510745582274
취업자수/NNG;늘어나/VV,0,-0.19676573965898692,15,6,9,19,0.3195950284983564,0.47505510745582274
변동성/NNG;장세/NNG;예상되/VVX,0,-0.19676573965898692,15,6,9,17,0.3195950284983564,0.47505510745582274
금리하락/NNG;기대하/VVX,0,-0.19676573965898692,15,6,9,32,0.3195950284983564,0.47505510745582274
인플레이션우려/NNG;부각돼/VVX,0,-0.19676573965898692,15,6,9,10,0.3195950284983564,0.47505510745582274
불확실성/NNG;자리/NNG;잡/VV,0,-0.19676573965898692,15,6,9,13,0.3195950284983564,0.47505510745582274
물가/NNG;오른/VV,0,-0.19676573965898692,15,6,9,22,0.3195950284983564,0.47505510745582274
금리/NNG;안정세/NNG;보이/VV,0,-0.19676573965898692,15,6,9,13,0.3195950284983564,0.47505510745582274
금리인하/NNG;대응하/VVX,0,-0.19676573965898692,15,6,9,23,0.3195950284983564,0.47505510745582274
고용/NNG;늘릴/VV,0,-0.19676573965898692,15,6,9,12,0.3195950284983564,0.47505510745582274
금리상승/NNG;키웠/VV,0,-0.19676573965898692,15,6,9,11,0.3195950284983564,0.47505510745582274
성장률/NNG;높일/VV,0,-0.19676573965898692,15,6,9,17,0.3195950284983564,0.47505510745582274
금리인상/NNG;중단하/VVX,-1,-0.19756001964262282,41,17,24,48,0.39053338198287185,0.5814584106751217
주택시장침체/NNG;따른/VV,-1,-0.19756001964262282,41,17,24,51,0.39053338198287185,0.5814584106751217
마이너스/NNG;돌아섰/VV,-1,-0.19818337313980416,48,20,28,31,0.40598704734441776,0.6052505051780589
변동성/NNG;키우/VV,-1,-0.19818337313980416,48,20,28,62,0.40598704734441776,0.6052505051780589
경제지표/NNG;호조/NNG;보인/VV,-1,-0.19818337313980416,48,20,28,77,0.40598704734441776,0.6052505051780589
장단기금리차/NNG;축소되/VVX,-1,-0.19985195942247658,62,26,36,85,0.43252166035418443,0.6470490658046255
금리인상/NNG;가능성/NNG;따른/VV,-1,-0.20034848293482,27,11,16,39,0.35316875595583747,0.5288835770153854
임금상승/NNG;따른/VV,-1,-0.20034848293482,27,11,16,21,0.35316875595583747,0.5288835770153854
양적완화정책/NNG;따른/VV,-1,-0.20034848293482,27,11,16,20,0.35316875595583747,0.5288835770153854
내수/NNG;살리/VV,-1,-0.20034848293482,27,11,16,33,0.35316875595583747,0.5288835770153854
금리동결/NNG;지속될/VVX,-1,-0.20034848293482,27,11,16,47,0.35316875595583747,0.5288835770153854
불안요인/NNG;될/VV,-1,-0.20034848293482,27,11,16,39,0.35316875595583747,0.5288835770153854
물가/NNG;떨어지/VV,-1,-0.20034848293482,27,11,16,33,0.35316875595583747,0.5288835770153854
기준금리/NNG;인하해/VVX,0,-0.20085090971817576,180,76,104,223,0.5189837556288446,0.7780104832625087
금리인상/NNG;단행했/VVX,0,-0.20353781701080054,154,65,89,147,0.5116327484557375,0.77129215228922
변동성/NNG;확대됐/VVX,-1,-0.20877739306774734,46,19,27,50,0.39556799975575563,0.6028734015624705
정책금리/NNG;인하되/VVX,-1,-0.20895950228790694,20,8,12,30,0.32865418653277534,0.501082495499767
기준금리인하/NNG;나서/VV,-1,-0.20895950228790694,20,8,12,36,0.32865418653277534,0.501082495499767
물가상승/NNG;이어질/VV,-1,-0.20895950228790694,20,8,12,25,0.32865418653277534,0.501082495499767
연방기금금리/NNG;인상하/VVX,-1,-0.20895950228790694,20,8,12,32,0.32865418653277534,0.501082495499767
경기둔화/NNG;가능성/NNG;시사하/VVX,-1,-0.20895950228790694,20,8,12,8,0.32865418653277534,0.501082495499767
금리/NNG;상승세/NNG;진정되/VVX,-1,-0.20895950228790694,20,8,12,31,0.32865418653277534,0.501082495499767
성장/NNG;견인했/VVX,-1,-0.20895950228790694,20,8,12,17,0.32865418653277534,0.501082495499767
기준금리인상/NNG;가능성/NNG;커지/VV,-1,-0.20895950228790694,20,8,12,12,0.32865418653277534,0.501082495499767
물가/NNG;낮추/VV,-1,-0.20895950228790694,20,8,12,26,0.32865418653277534,0.501082495499767
긴축정책/NNG;펴/VV,-1,-0.20895950228790694,20,8,12,41,0.32865418653277534,0.501082495499767
주택가격/NNG;상승하/VVX,-1,-0.20895950228790694,20,8,12,36,0.32865418653277534,0.501082495499767
고용/NNG;감소하/VVX,-1,-0.20895950228790694,20,8,12,14,0.32865418653277534,0.501082495499767
금리/NNG;상승세/NNG;지속될/VVX,-1,-0.20988364272951898,39,16,23,72,0.37891615852002386,0.5788301793289765
변동성/NNG;줄여/VV,-1,-0.21278824533767204,32,13,19,86,0.3599077489264426,0.553140217077881
금리인하/NNG;기대하/VVX;어렵/VA,-1,-0.21278824533767204,32,13,19,37,0.3599077489264426,0.553140217077881
안전자산선호현상/NNG;약화되/VVX,-1,-0.21278824533767204,32,13,19,42,0.3599077489264426,0.553140217077881
금리인상/NNG;고려하/VVX,-1,-0.21278824533767204,32,13,19,44,0.3599077489264426,0.553140217077881
투자심리/NNG;개선되/VVX,-1,-0.21729036140304292,58,24,34,112,0.4147939550515561,0.6435302373057918
금리/NNG;하락세/NNG;보였/VV,-1,-0.21729036140304292,58,24,34,89,0.4147939550515561,0.6435302373057918
경제성장률/NNG;상향조정하/VVX,-1,-0.2199262576646147,25,10,15,40,0.33731660534402413,0.5262282974444354
가계부채/NNG;증가세/NNG;점검해/VVX,-1,-0.2199262576646147,25,10,15,15,0.33731660534402413,0.5262282974444354
금융위기/NNG;벗어나/VV,-1,-0.2199262576646147,25,10,15,26,0.33731660534402413,0.5262282974444354
금리상승압력/NNG;가중될/VVX,-1,-0.2199262576646147,25,10,15,14,0.33731660534402413,0.5262282974444354
투자심리/NNG;안정시/VVX,-1,-0.22023871418779617,44,18,26,55,0.38462764133806715,0.600428981778038
불안/NNG;커지/VV,-1,-0.22023871418779617,44,18,26,66,0.38462764133806715,0.600428981778038
유동성/NNG;공급해/VVX,-1,-0.2219645225540653,77,32,45,81,0.44239375103582096,0.6931117402844374
침체/NNG;빠졌/VV,-1,-0.22345920950395604,37,15,22,32,0.36659103245414193,0.5761553103602302
경기/NNG;부양할/VVX,-1,-0.22345920950395604,37,15,22,36,0.36659103245414193,0.5761553103602302
경제/NNG;회복세/NNG;보이/VV,-1,-0.2236236894064978,96,40,56,118,0.46362038872181977,0.7289040380321853
금융위기/NNG;따른/VV,-1,-0.2255973668741289,89,37,52,71,0.45496204469417056,0.7182654785201174
경제성장/NNG;둔화될/VVX,-1,-0.22918431713441967,49,20,29,78,0.3902102960727179,0.6207086582121669
소비/NNG;위축시/VVX,-1,-0.22918431713441967,49,20,29,51,0.3902102960727179,0.6207086582121669
통화완화/NNG;나서/VV,-1,-0.2297550649308483,30,12,18,28,0.3455796363412937,0.5503760518089791
물가/NNG;자극하/VVX,-1,-0.2297550649308483,30,12,18,30,0.3455796363412937,0.5503760518089791
적자/NNG;기록하/VVX,-1,-0.23270422415303238,42,17,25,62,0.37310197953482205,0.5979158820280461
금융시장/NNG;안정되/VVX,-1,-0.23407822607187323,61,25,36,78,0.4100703387198757,0.6590686825787135
경기부양/NNG;나서/VV,-1,-0.23494451770863056,80,33,47,114,0.43810389341234796,0.7054141161718965
채권시장/NNG;부담/NNG;작용하/VVX,0,-0.23808244380716181,18,7,11,29,0.30786142331106253,0.49900376446247513
성장세/NNG;둔화된/VVX,0,-0.23808244380716181,18,7,11,14,0.30786142331106253,0.49900376446247513
금리인하기대/NNG;지속되/VVX,0,-0.23808244380716181,18,7,11,29,0.30786142331106253,0.49900376446247513
소비/NNG;진작시/VVX,0,-0.23808244380716181,18,7,11,25,0.30786142331106253,0.49900376446247513
금리상승/NNG;견인할/VVX,0,-0.23808244380716181,18,7,11,23,0.30786142331106253,0.49900376446247513
기준금리/NNG;내려도/VV,0,-0.23808244380716181,18,7,11,8,0.30786142331106253,0.49900376446247513
가계부채/NNG;따른/VV,0,-0.23808244380716181,18,7,11,12,0.30786142331106253,0.49900376446247513
동결/NNG;주장하/VVX,0,-0.23808244380716181,18,7,11,12,0.30786142331106253,0.49900376446247513
성장/NNG;미치/VV,0,-0.23808244380716181,18,7,11,35,0.30786142331106253,0.49900376446247513
경제성장률/NNG;머물/VV,0,-0.23808244380716181,18,7,11,30,0.30786142331106253,0.49900376446247513
취업자수/NNG;감소하/VVX,0,-0.23808244380716181,18,7,11,11,0.30786142331106253,0.49900376446247513
경제성장률/NNG;유지하/VVX,0,-0.23808244380716181,18,7,11,26,0.30786142331106253,0.49900376446247513
금융시장/NNG;안정/NNG;되찾/VV,-1,-0.23853290464311716,35,14,21,42,0.3534439449948033,0.5734335751881198
금리인상/NNG;시작할/VVX,-1,-0.23853290464311716,35,14,21,68,0.3534439449948033,0.5734335751881198
고용/NNG;늘/VV,-1,-0.23853290464311716,35,14,21,53,0.3534439449948033,0.5734335751881198
성장세/NNG;이어질/VV,-1,-0.24039797554186082,66,27,39,64,0.41454123659342756,0.6752203365918162
변동성/NNG;커지/VV,-1,-0.24063402273988033,160,66,94,203,0.48611652572294417,0.7922009444721967
경기/NNG;상승기조/NNG;이/VV,-1,-0.24311918332589022,23,9,14,17,0.31963346644587104,0.5236432144213119
경기/NNG;회복시/VVX,-1,-0.24311918332589022,23,9,14,40,0.31963346644587104,0.5236432144213119
기준금리/NNG;내려갈/VV,-1,-0.24311918332589022,23,9,14,38,0.31963346644587104,0.5236432144213119
리스크/NNG;불거지/VV,-1,-0.24311918332589022,23,9,14,30,0.31963346644587104,0.5236432144213119
기준금리/NNG;올려야/VV,-1,-0.24369044782978277,59,24,35,70,0.40077418951889493,0.6573692656417487
단기금리/NNG;상승하/VVX,-1,-0.24777157088648605,52,21,31,89,0.38538286399503674,0.6376278850890994
기준금리동결/NNG;예상되/VVX,-1,-0.2492096095840165,28,11,17,63,0.3299627531549466,0.5476063436074114
금리인상/NNG;유지할/VVX,-1,-0.2492096095840165,28,11,17,56,0.3299627531549466,0.5476063436074114
금리인하/NNG;할/VV,-1,-0.24955398368765758,64,26,38,75,0.40570022251661964,0.6737939784732808
불확실성/NNG;해소됐/VVX,-1,-0.25389175757434357,57,23,34,80,0.39110044888525375,0.6555787706631393
양적완화/NNG;따른/VV,-1,-0.2541968605785342,93,38,55,220,0.44032142637722455,0.738565668346684
기준금리인상/NNG;위한/VV,-1,-0.25542351730506807,33,13,20,63,0.339330769919963,0.5706630008627219
시장금리/NNG;오르/VV,-1,-0.25542351730506807,33,13,20,74,0.339330769919963,0.5706630008627219
시장금리/NNG;오를/VV,-1,-0.25542351730506807,33,13,20,37,0.339330769919963,0.5706630008627219
금리인상/NNG;가능성/NNG;높이/VV,-1,-0.25542351730506807,33,13,20,33,0.339330769919963,0.5706630008627219
소비자물가지수/NNG;상승하/VVX,-1,-0.25542351730506807,33,13,20,56,0.339330769919963,0.5706630008627219
소비자물가지수/NNG;상승했/VVX,-1,-0.25937902322930617,50,20,30,59,0.3746914869654242,0.6354808211555671
경제지표/NNG;부진하/VVX,-1,-0.25937902322930617,50,20,30,89,0.3746914869654242,0.6354808211555671
금리인하/NNG;단행하/VVX,-1,-0.2608540318893988,167,68,99,177,0.4726423868428434,0.8041418811576686
금리인하/NNG;가능성/NNG;배제할/VVX,-1,-0.2613696732323123,38,15,23,91,0.347965237759111,0.5926735664527695
금리인하/NNG;통한/VV,-1,-0.266273558928228,101,41,60,105,0.4395584544064958,0.7565980124487106
기준금리/NNG;인하한/VVX,-1,-0.2668766807222467,43,17,26,73,0.3559903854896507,0.6135495200952817
물가상승압력/NNG;완화될/VVX,-1,-0.27120967371948246,21,8,13,29,0.29955985584260353,0.5211274631846591
금리상승/NNG;예상된/VVX,-1,-0.27120967371948246,21,8,13,41,0.29955985584260353,0.5211274631846591
불확실성/NNG;영향/NNG;받/VV,-1,-0.27120967371948246,21,8,13,16,0.29955985584260353,0.5211274631846591
금융위기/NNG;확산되/VVX,-1,-0.27120967371948246,21,8,13,14,0.29955985584260353,0.5211274631846591
금리/NNG;상승세/NNG;이/VV,-1,-0.27120967371948246,21,8,13,54,0.29955985584260353,0.5211274631846591
물가/NNG;하회하/VVX,-1,-0.27120967371948246,21,8,13,24,0.29955985584260353,0.5211274631846591
기준금리/NNG;상향조정할/VVX,-1,-0.27120967371948246,21,8,13,34,0.29955985584260353,0.5211274631846591
통화완화/NNG;유지할/VVX,-1,-0.27120967371948246,21,8,13,20,0.29955985584260353,0.5211274631846591
경기둔화/NNG;반영하/VVX,-1,-0.27120967371948246,21,8,13,27,0.29955985584260353,0.5211274631846591
gdp/NNG;증가해/VVX,-1,-0.27120967371948246,21,8,13,31,0.29955985584260353,0.5211274631846591
금리/NNG;인하함/VVX,-1,-0.27120967371948246,21,8,13,20,0.29955985584260353,0.5211274631846591
내수/NNG;회복세/NNG;약화되/VVX,-1,-0.27120967371948246,21,8,13,0,0.29955985584260353,0.5211274631846591
소비자물가상승률/NNG;기록하/VVX,-1,-0.27120967371948246,21,8,13,37,0.29955985584260353,0.5211274631846591
경제활성화/NNG;위해/VV,-1,-0.27120967371948246,21,8,13,37,0.29955985584260353,0.5211274631846591
동결/NNG;유지될/VVX,-1,-0.27120967371948246,21,8,13,39,0.29955985584260353,0.5211274631846591
경기불확실성/NNG;지속되/VVX,-1,-0.27120967371948246,21,8,13,42,0.29955985584260353,0.5211274631846591
유동성/NNG;늘리/VV,-1,-0.27120967371948246,21,8,13,19,0.29955985584260353,0.5211274631846591
양적완화/NNG;줄이/VV,-1,-0.27120967371948246,21,8,13,60,0.29955985584260353,0.5211274631846591
물가/NNG;영향/NNG;미칠/VV,-1,-0.27185028484071394,26,10,16,14,0.312751360719735,0.544827526227024
소비심리/NNG;위축시/VVX,-1,-0.27185028484071394,26,10,16,28,0.312751360719735,0.544827526227024
경제지표부진/NNG;따른/VV,-1,-0.27185028484071394,26,10,16,39,0.312751360719735,0.544827526227024
기준금리/NNG;오르/VV,-1,-0.27185028484071394,26,10,16,53,0.312751360719735,0.544827526227024
재정지출/NNG;늘리/VV,-1,-0.27185028484071394,26,10,16,46,0.312751360719735,0.544827526227024
큰/VA;금리/NNG;하락세/NNG;보였/VV,-1,-0.27185028484071394,26,10,16,24,0.312751360719735,0.544827526227024
수익성/NNG;악화되/VVX,-1,-0.27185028484071394,26,10,16,40,0.312751360719735,0.544827526227024
테이퍼링/NNG;따른/VV,-1,-0.27185028484071394,26,10,16,41,0.312751360719735,0.544827526227024
불안/NNG;완화되/VVX,-1,-0.27187491375318884,48,19,29,72,0.3634822831796682,0.6332367816404189
금리/NNG;크/VA;상승하/VVX,-1,-0.2745504496019796,31,12,19,51,0.3240678692665252,0.56783884389203
과잉유동성/NNG;따른/VV,-1,-0.2745504496019796,31,12,19,32,0.3240678692665252,0.56783884389203
금융위기/NNG;극복/NNG;위해/VV,-1,-0.2745504496019796,31,12,19,27,0.3240678692665252,0.56783884389203
수출부진/NNG;지속될/VVX,0,-0.2756585422035511,16,6,10,10,0.28304422469837365,0.4971444041463513
경제지표/NNG;호조/NNG;보임/VV,0,-0.2756585422035511,16,6,10,21,0.28304422469837365,0.4971444041463513
금리인상/NNG;중단되/VVX,0,-0.2756585422035511,16,6,10,16,0.28304422469837365,0.4971444041463513
적자/NNG;확대되/VVX,0,-0.2756585422035511,16,6,10,15,0.28304422469837365,0.4971444041463513
마이너스/NNG;돌아선/VV,0,-0.2756585422035511,16,6,10,23,0.28304422469837365,0.4971444041463513
경제/NNG;회복된/VVX,0,-0.2756585422035511,16,6,10,16,0.28304422469837365,0.4971444041463513
시장금리/NNG;미치/VV;영향/NNG,0,-0.2756585422035511,16,6,10,15,0.28304422469837365,0.4971444041463513
고용지표/NNG;악화되/VVX,0,-0.2756585422035511,16,6,10,4,0.28304422469837365,0.4971444041463513
불안/NNG;해소되/VVX,0,-0.2756585422035511,16,6,10,39,0.28304422469837365,0.4971444041463513
금융시장/NNG;큰/VA;충격/NNG;주/VV,0,-0.2756585422035511,16,6,10,8,0.28304422469837365,0.4971444041463513
침체/NNG;가/VV,0,-0.2756585422035511,16,6,10,14,0.28304422469837365,0.4971444041463513
동결/NNG;지속될/VVX,0,-0.2756585422035511,16,6,10,23,0.28304422469837365,0.4971444041463513
대외불확실성/NNG;해소되/VVX;않/VX,0,-0.2756585422035511,16,6,10,12,0.28304422469837365,0.4971444041463513
성장잠재력/NNG;높이/VV,0,-0.2756585422035511,16,6,10,44,0.28304422469837365,0.4971444041463513
금리/NNG;내릴/VV;없/VA,0,-0.2756585422035511,16,6,10,29,0.28304422469837365,0.4971444041463513
출구전략/NNG;실행하/VVX,0,-0.2756585422035511,16,6,10,7,0.28304422469837365,0.4971444041463513
금리인상/NNG;단행함/VVX,0,-0.2756585422035511,16,6,10,14,0.28304422469837365,0.4971444041463513
경기침체/NNG;빠져/VV,0,-0.2756585422035511,16,6,10,10,0.28304422469837365,0.4971444041463513
금리/NNG;폭등하/VVX,0,-0.2756585422035511,16,6,10,21,0.28304422469837365,0.4971444041463513
경제/NNG;과열되/VVX,0,-0.2756585422035511,16,6,10,20,0.28304422469837365,0.4971444041463513
경기회복/NNG;둔화될/VVX,0,-0.2756585422035511,16,6,10,41,0.28304422469837365,0.4971444041463513
소비위축/NNG;따른/VV,0,-0.2756585422035511,16,6,10,9,0.28304422469837365,0.4971444041463513
실업률/NNG;하/VV,0,-0.2756585422035511,16,6,10,39,0.28304422469837365,0.4971444041463513
소비/NNG;감소할/VVX,0,-0.2756585422035511,16,6,10,10,0.28304422469837365,0.4971444041463513
금리/NNG;상승하/VVX;모습/NNG;보였/VV,0,-0.2756585422035511,16,6,10,18,0.28304422469837365,0.4971444041463513
유동성/NNG;넘치/VV,0,-0.2756585422035511,16,6,10,13,0.28304422469837365,0.4971444041463513
금융위기/NNG;발생하/VVX,0,-0.2756585422035511,16,6,10,42,0.28304422469837365,0.4971444041463513
불확실성/NNG;가중시/VVX,0,-0.2756585422035511,16,6,10,17,0.28304422469837365,0.4971444041463513
불안/NNG;요소/NNG;남/VV,0,-0.2756585422035511,16,6,10,19,0.28304422469837365,0.4971444041463513
금리/NNG;올리/VV;어렵/VA,0,-0.2756585422035511,16,6,10,31,0.28304422469837365,0.4971444041463513
채권시장/NNG;우호적/VAX;지속될/VVX,0,-0.2756585422035511,16,6,10,24,0.28304422469837365,0.4971444041463513
경제/NNG;침체/NNG;빠질/VV,-1,-0.27805249173830726,36,14,22,51,0.3341404482107547,0.5899356104549592
기준금리인상/NNG;예상되/VVX,-1,-0.27805249173830726,36,14,22,55,0.3341404482107547,0.5899356104549592
금리인하/NNG;있/VV,-1,-0.2802973183567863,58,23,35,77,0.3770587563547098,0.6689518148000615
금리인상/NNG;가능성/NNG;반영하/VVX,-1,-0.2817645030437911,41,16,25,90,0.3432898664796984,0.6109807948039041
신용스프레드/NNG;축소되/VVX,-1,-0.2912498995107726,140,56,84,131,0.44385575579151954,0.8064274059182212
경제/NNG;회복될/VVX,-1,-0.2918424066122379,56,22,34,68,0.366714587864392,0.6671336756296145
금리인하/NNG;단행되/VVX,-1,-0.29583313030264846,93,37,56,121,0.4126945861627584,0.75735447970854
금리/NNG;크/VA;하락했/VVX,-1,-0.2964747865856068,29,11,18,48,0.30741960569568494,0.56495205399851
경제회복/NNG;위해/VV,-1,-0.2964747865856068,29,11,18,40,0.30741960569568494,0.56495205399851
하방압력/NNG;받/VV,-1,-0.2964747865856068,29,11,18,39,0.30741960569568494,0.56495205399851
금리인하/NNG;힘입/VV,-1,-0.2964747865856068,29,11,18,22,0.30741960569568494,0.56495205399851
금리인상/NNG;의미하/VVX,-1,-0.2964747865856068,29,11,18,26,0.30741960569568494,0.56495205399851
임금/NNG;오르/VV,-1,-0.2964747865856068,29,11,18,32,0.30741960569568494,0.56495205399851
경기침체/NNG;이어지/VV,-1,-0.2964747865856068,29,11,18,40,0.30741960569568494,0.56495205399851
정책금리/NNG;인상했/VVX,-1,-0.29673929432018264,34,13,21,60,0.31929208684194277,0.5871101039891633
소매판매/NNG;증가하/VVX,-1,-0.29673929432018264,34,13,21,70,0.31929208684194277,0.5871101039891633
불안요인/NNG;작용할/VVX,-1,-0.29692980751547726,66,26,40,102,0.379742777474032,0.6985572395473587
더블딥/NNG;빠질/VV,-1,-0.2981591951862793,39,15,24,36,0.3297946178349539,0.6083101555869279
경기부양책/NNG;나올/VV,-1,-0.2986633698141422,24,9,15,40,0.29353556136473496,0.5420282435822505
하방리스크/NNG;작용할/VVX,-1,-0.2986633698141422,24,9,15,18,0.29353556136473496,0.5420282435822505
가계부채/NNG;증가하/VVX,-1,-0.2986633698141422,24,9,15,22,0.29353556136473496,0.5420282435822505
금리하락/NNG;요인이/VVX,-1,-0.2986633698141422,24,9,15,32,0.29353556136473496,0.5420282435822505
리스크/NNG;줄이/VV,-1,-0.2986633698141422,24,9,15,67,0.29353556136473496,0.5420282435822505
성장/NNG;이루/VV,-1,-0.2986633698141422,24,9,15,41,0.29353556136473496,0.5420282435822505
금리인하기대/NNG;커지/VV,-1,-0.2986633698141422,24,9,15,41,0.29353556136473496,0.5420282435822505
지준율/NNG;인하하/VVX,-1,-0.2986633698141422,24,9,15,19,0.29353556136473496,0.5420282435822505
변동성확대/NNG;따른/VV,-1,-0.2986633698141422,24,9,15,33,0.29353556136473496,0.5420282435822505
시장금리/NNG;급락하/VVX,-1,-0.2986633698141422,24,9,15,28,0.29353556136473496,0.5420282435822505
금리인상/NNG;우려/NNG;완화되/VVX,-1,-0.2986633698141422,24,9,15,31,0.29353556136473496,0.5420282435822505
내수/NNG;부양/NNG;위한/VV,-1,-0.2986633698141422,24,9,15,36,0.29353556136473496,0.5420282435822505
경제지표/NNG;호조/NNG;보이/VV,-1,-0.3039022051407422,91,36,55,153,0.40547202759854944,0.7573836366173872
기준금리/NNG;올렸/VV,-1,-0.3045062831795884,121,48,73,140,0.4265393538536526,0.7977945507233779
콜금리/NNG;유지할/VVX,-1,-0.3061553685129704,19,7,12,13,0.27629805345756503,0.5186638383739633
경제/NNG;침체/NNG;빠지/VV;않/VX,-1,-0.3061553685129704,19,7,12,21,0.27629805345756503,0.5186638383739633
양적완화/NNG;단행하/VVX,-1,-0.3061553685129704,19,7,12,23,0.27629805345756503,0.5186638383739633
유동성/NNG;확대되/VVX,-1,-0.3061553685129704,19,7,12,27,0.27629805345756503,0.5186638383739633
수출부진/NNG;심화되/VVX,-1,-0.3061553685129704,19,7,12,4,0.27629805345756503,0.5186638383739633
유동성/NNG;관리하/VVX,-1,-0.3061553685129704,19,7,12,22,0.27629805345756503,0.5186638383739633
재정정책/NNG;펴/VV,-1,-0.3061553685129704,19,7,12,20,0.27629805345756503,0.5186638383739633
금리인하/NNG;이어지/VV,-1,-0.3061553685129704,19,7,12,22,0.27629805345756503,0.5186638383739633
금리/NNG;큰/VA;상승하/VVX,-1,-0.30767897615514217,64,25,39,124,0.3701615128630851,0.6971997330142593
금리/NNG;내릴/VV,-1,-0.3148874003390313,378,148,230,414,0.4374758622364984,0.8372163115600126
경제성장/NNG;둔화되/VVX,-1,-0.31613849021716833,42,16,26,94,0.32612918973425664,0.6258602684836002
유동성/NNG;의한/VV,-1,-0.3163487074632986,37,14,23,47,0.31538718875175026,0.6055279409152915
금리하락/NNG;작용하/VVX,-1,-0.3163487074632986,37,14,23,64,0.31538718875175026,0.6055279409152915
기준금리/NNG;하회하/VVX,-1,-0.3166000219166031,47,18,29,105,0.3358044158501226,0.6450874383796559
물가목표/NNG;달성하/VVX,-1,-0.317882333476878,32,12,20,44,0.30323742267859594,0.5841853277065684
경제/NNG;위축될/VVX,-1,-0.317882333476878,32,12,20,27,0.30323742267859594,0.5841853277065684
금리인하/NNG;하/VV,-1,-0.3197554076896094,67,26,41,52,0.3671439273473747,0.7102498337072892
기준금리인하/NNG;따른/VV,-1,-0.32031865298370166,72,28,44,120,0.3735865268491348,0.7236187706242717
투자심리/NNG;호전시/VVX,-1,-0.3219601695233777,27,10,17,42,0.2890822720687598,0.5619869673718706
금리인하/NNG;될/VV,-1,-0.3219601695233777,27,10,17,24,0.2890822720687598,0.5619869673718706
소비/NNG;줄어들/VV,-1,-0.3219601695233777,27,10,17,44,0.2890822720687598,0.5619869673718706
금리/NNG;낮출/VV,-1,-0.3281039061216685,100,39,61,161,0.39706925718938074,0.7825718896174135
금리/NNG;높일/VV,-1,-0.33107482498183294,22,8,14,26,0.2717632597843601,0.5391840864116078
채권시장/NNG;강세/NNG;보이/VV,-1,-0.33107482498183294,22,8,14,41,0.2717632597843601,0.5391840864116078
기준금리인하/NNG;단행하/VVX,-1,-0.33107482498183294,22,8,14,44,0.2717632597843601,0.5391840864116078
경기/NNG;반등할/VVX,-1,-0.33107482498183294,22,8,14,31,0.2717632597843601,0.5391840864116078
금리인하효과/NNG;지켜볼/VV,-1,-0.33107482498183294,22,8,14,40,0.2717632597843601,0.5391840864116078
금리/NNG;하락세/NNG;이끌/VV,-1,-0.33107482498183294,22,8,14,49,0.2717632597843601,0.5391840864116078
경제/NNG;부양하/VVX,-1,-0.33122869978363445,55,21,34,41,0.34168982388897545,0.678153703168539
인플레이션/NNG;상승하/VVX,-1,-0.33229932907534954,45,17,28,66,0.32301706546691766,0.6426345956986962
기준금리/NNG;내려가/VV,-1,-0.3366994935267279,35,13,22,18,0.2999247601286354,0.6026212346060908
동결/NNG;예상하/VVX,-1,-0.3366994935267279,35,13,22,43,0.2999247601286354,0.6026212346060908
리스크/NNG;될/VV,-1,-0.3366994935267279,35,13,22,80,0.2999247601286354,0.6026212346060908
고용지표/NNG;호조/NNG;보일/VV,-1,-0.3366994935267279,35,13,22,16,0.2999247601286354,0.6026212346060908
금융안정/NNG;유의하/VVX,-1,-0.3384721976219027,88,34,54,83,0.37992123626655155,0.7664069302019644
시장금리/NNG;하락하/VVX,-1,-0.33853979318515026,116,45,71,166,0.4002453331059652,0.8075292946844262
성장/NNG;위해/VV,-1,-0.34032410935339197,78,30,48,98,0.3682929950632712,0.7460587313896175
경기활성화/NNG;위해/VV,-1,-0.342078306608701,30,11,19,41,0.2857484706639489,0.5811441246163511
불안요인/NNG;상존하/VVX,-1,-0.342078306608701,30,11,19,54,0.2857484706639489,0.5811441246163511
금융시장/NNG;안정시/VVX,-1,-0.3438866540168789,58,22,36,65,0.33908026823175724,0.6924339819544286
시장금리/NNG;큰/VA;하락하/VVX,-1,-0.34688839794569426,48,18,30,39,0.32035874083429505,0.6586669260277267
금리/NNG;상승세/NNG;보였/VV,-1,-0.3494441880295891,43,16,27,97,0.3094987630956307,0.6400417796901745
성장률/NNG;유지하/VVX,-1,-0.3494441880295891,43,16,27,63,0.3094987630956307,0.6400417796901745
성장률/NNG;끌어올릴/VV,-1,-0.3510469148147892,17,6,11,35,0.24870767184344367,0.5162042197088403
불안심리/NNG;커지/VV,-1,-0.3510469148147892,17,6,11,13,0.24870767184344367,0.5162042197088403
성장률/NNG;상회하/VVX,-1,-0.3510469148147892,17,6,11,30,0.24870767184344367,0.5162042197088403
통화완화/NNG;따른/VV,-1,-0.3510469148147892,17,6,11,42,0.24870767184344367,0.5162042197088403
금리인하/NNG;기대할/VVX,-1,-0.3510469148147892,17,6,11,21,0.24870767184344367,0.5162042197088403
주택가격/NNG;하락했/VVX,-1,-0.3510469148147892,17,6,11,23,0.24870767184344367,0.5162042197088403
경제성장/NNG;하/VV,-1,-0.3510469148147892,17,6,11,21,0.24870767184344367,0.5162042197088403
금리상승/NNG;확대시/VVX,-1,-0.3510469148147892,17,6,11,19,0.24870767184344367,0.5162042197088403
금리인상/NNG;나타날/VV,-1,-0.3510469148147892,17,6,11,20,0.24870767184344367,0.5162042197088403
경제/NNG;둔화할/VVX,-1,-0.3510469148147892,17,6,11,17,0.24870767184344367,0.5162042197088403
불안/NNG;가중시/VVX,-1,-0.3510469148147892,17,6,11,30,0.24870767184344367,0.5162042197088403
금리/NNG;상승세/NNG;보일/VV,-1,-0.3510469148147892,17,6,11,41,0.24870767184344367,0.5162042197088403
소비자물가/NNG;상승/NNG;영향/NNG;미칠/VV,-1,-0.3510469148147892,17,6,11,15,0.24870767184344367,0.5162042197088403
듀레이션확대/NNG;지속하/VVX,-1,-0.3510469148147892,17,6,11,34,0.24870767184344367,0.5162042197088403
경제지표/NNG;개선될/VVX,-1,-0.3510469148147892,17,6,11,35,0.24870767184344367,0.5162042197088403
금리인하/NNG;전망하/VVX,-1,-0.3510469148147892,17,6,11,24,0.24870767184344367,0.5162042197088403
신용등급/NNG;떨어지/VV,-1,-0.3510469148147892,17,6,11,4,0.24870767184344367,0.5162042197088403
신용등급/NNG;하향조정되/VVX,-1,-0.3510469148147892,17,6,11,25,0.24870767184344367,0.5162042197088403
금리/NNG;큰/VA;오르/VV,-1,-0.3510469148147892,17,6,11,21,0.24870767184344367,0.5162042197088403
성장/NNG;기대하/VVX,-1,-0.3520633337005038,25,9,16,41,0.26866473639188665,0.5589178315216294
시장금리상승/NNG;따른/VV,-1,-0.3520633337005038,25,9,16,22,0.26866473639188665,0.5589178315216294
기준금리인상/NNG;가능성/NNG;열/VV,-1,-0.3520633337005038,25,9,16,33,0.26866473639188665,0.5589178315216294
경기/NNG;하강하/VVX,-1,-0.3520633337005038,25,9,16,25,0.26866473639188665,0.5589178315216294
재정정책/NNG;따른/VV,-1,-0.3520633337005038,25,9,16,19,0.26866473639188665,0.5589178315216294
금리상승/NNG;작용하/VVX,-1,-0.35338385046976584,38,14,24,70,0.2972811781503436,0.6203139138534614
금리/NNG;인하하/VVX,-1,-0.35382480568581387,422,161,261,452,0.40831669606068954,0.8528603698326513
경기침체/NNG;벗어나/VV,-1,-0.3596824614035993,33,12,21,37,0.2832339337130442,0.5995726844722031
외환위기/NNG;겪/VV,-1,-0.3596824614035993,33,12,21,61,0.2832339337130442,0.5995726844722031
경기/NNG;회복하/VVX,-1,-0.3596824614035993,33,12,21,53,0.2832339337130442,0.5995726844722031
리스크/NNG;확대되/VVX,-1,-0.36351857935988896,46,17,29,83,0.3072702860311052,0.6562071373726847
경기/NNG;위축되/VVX,-1,-0.3660860138750135,64,24,40,64,0.33465630995140316,0.7189280590100069
수출/NNG;증가하/VVX,-1,-0.36917662373660176,121,46,75,157,0.3814355087569657,0.8252847358733283
기준금리/NNG;인하됐/VVX,-1,-0.37012380923631116,28,10,18,27,0.26654203852179587,0.5779615594978075
금리/NNG;상승세/NNG;이어질/VV,-1,-0.37012380923631116,28,10,18,33,0.26654203852179587,0.5779615594978075
리스크/NNG;완화하/VVX,-1,-0.37012380923631116,28,10,18,25,0.26654203852179587,0.5779615594978075
신용경색/NNG;해소하/VVX,-1,-0.37012380923631116,28,10,18,15,0.26654203852179587,0.5779615594978075
금리/NNG;상승세/NNG;지속되/VVX,-1,-0.3701563482656297,77,29,48,118,0.3482990349699798,0.7552977285824942
성장률/NNG;개선되/VVX,-1,-0.37119130564118774,20,7,13,29,0.24669540962125464,0.5362490217505653
변동성/NNG;완화하/VVX,-1,-0.37119130564118774,20,7,13,32,0.24669540962125464,0.5362490217505653
금리인하기대/NNG;형성되/VVX,-1,-0.37119130564118774,20,7,13,39,0.24669540962125464,0.5362490217505653
듀레이션확대/NNG;유지하/VVX,-1,-0.37119130564118774,20,7,13,18,0.24669540962125464,0.5362490217505653
금리상승/NNG;나타나/VV,-1,-0.37119130564118774,20,7,13,42,0.24669540962125464,0.5362490217505653
침체/NNG;심화되/VVX,-1,-0.37119130564118774,20,7,13,11,0.24669540962125464,0.5362490217505653
금리인하/NNG;위한/VV,-1,-0.37119130564118774,20,7,13,41,0.24669540962125464,0.5362490217505653
기준금리동결/NNG;따른/VV,-1,-0.37119130564118774,20,7,13,45,0.24669540962125464,0.5362490217505653
정책금리/NNG;인하했/VVX,-1,-0.37119130564118774,20,7,13,24,0.24669540962125464,0.5362490217505653
경제/NNG;회복세/NNG;나타낼/VV,-1,-0.37119130564118774,20,7,13,24,0.24669540962125464,0.5362490217505653
성장세/NNG;지속될/VVX,-1,-0.3721175578648904,54,20,34,70,0.31610444990200515,0.6886002654894539
실물경제/NNG;전이되/VVX,-1,-0.37524376509017066,36,13,23,25,0.281332161888794,0.6173111519580375
수출/NNG;개선될/VVX,-1,-0.37524376509017066,36,13,23,33,0.281332161888794,0.6173111519580375
동결/NNG;유지할/VVX,-1,-0.3762378774435666,49,18,31,63,0.30540127120916816,0.6716738817549385
성장률/NNG;떨어질/VV,-1,-0.381653204869159,44,16,28,58,0.2934520470380198,0.6535867172836964
실물경제/NNG;파급되/VVX,-1,-0.3859077860993053,31,11,20,20,0.26510563259436826,0.5963588900369244
신용스프레드/NNG;확대될/VVX,-1,-0.3859077860993053,31,11,20,33,0.26510563259436826,0.5963588900369244
견조한/VAX;성장세/NNG;이/VV,-1,-0.38826702116785206,23,8,15,44,0.2456689716304584,0.5557035601420061
내수/NNG;부양하/VVX,-1,-0.38826702116785206,23,8,15,26,0.2456689716304584,0.5557035601420061
정책금리/NNG;낮추/VV,-1,-0.38826702116785206,23,8,15,19,0.2456689716304584,0.5557035601420061
인플레이션/NNG;달성하/VVX,-1,-0.38826702116785206,23,8,15,30,0.2456689716304584,0.5557035601420061
재정위기/NNG;부각되/VVX,-1,-0.38826702116785206,23,8,15,37,0.2456689716304584,0.5557035601420061
고용지표/NNG;개선되/VVX,-1,-0.38826702116785206,23,8,15,53,0.2456689716304584,0.5557035601420061
경제/NNG;악화되/VVX,-1,-0.38826702116785206,23,8,15,26,0.2456689716304584,0.5557035601420061
기준금리인하/NNG;단행할/VVX,-1,-0.38826702116785206,23,8,15,38,0.2456689716304584,0.5557035601420061
경기/NNG;미치/VV;영향/NNG,-1,-0.3886464064855646,65,24,41,55,0.32238187772111954,0.7298785095681629
양적완화/NNG;종료하/VVX,-1,-0.38910818696030813,39,14,25,41,0.2798969461128185,0.6343799502133975
고용/NNG;증가했/VVX,-1,-0.38910818696030813,39,14,25,47,0.2798969461128185,0.6343799502133975
듀레이션/NNG;유지하/VVX,-1,-0.38910818696030813,39,14,25,61,0.2798969461128185,0.6343799502133975
기준금리/NNG;내릴/VV,-1,-0.3920203383103884,231,86,145,257,0.3795315498669221,0.8661161758180118
불안/NNG;따른/VV,-1,-0.39648372132669485,180,67,113,266,0.3744992652786126,0.8636892700483191
경기부양책/NNG;내놓/VV,-1,-0.40117875968570704,105,39,66,132,0.35138706923024154,0.8194621699593683
양적완화축소/NNG;따른/VV,-1,-0.4015375612937192,42,15,27,130,0.2788221648317544,0.6507900896951443
실물경제/NNG;미칠/VV,-1,-0.4015375612937192,42,15,27,34,0.2788221648317544,0.6507900896951443
금리/NNG;상승세/NNG;나타나/VV,-1,-0.40309164333641045,26,9,17,26,0.24527142639389693,0.5746015825242731
금리/NNG;하락세/NNG;제한되/VVX,-1,-0.40309164333641045,26,9,17,42,0.24527142639389693,0.5746015825242731
경기침체/NNG;심화되/VVX,-1,-0.40309164333641045,26,9,17,25,0.24527142639389693,0.5746015825242731
경기/NNG;침체되/VVX,-1,-0.40309164333641045,26,9,17,48,0.24527142639389693,0.5746015825242731
물가안정/NNG;유지하/VVX,-1,-0.4046309756688389,50,18,32,30,0.29096246296959094,0.6841481572815354
수출/NNG;감소하/VVX,-1,-0.405521596343558,100,37,63,141,0.3453753064852045,0.8138182477173845
정책금리/NNG;인하하/VVX,-1,-0.40921651006493,87,32,55,81,0.333203924587018,0.7921068427258352
경기회복/NNG;뒷받침하/VVX,-1,-0.40921651006493,87,32,55,58,0.333203924587018,0.7921068427258352
유동성/NNG;있/VV,-1,-0.4108929495061334,15,5,10,25,0.2151999220890491,0.5136431145107794
경기/NNG;위축시/VVX,-1,-0.4108929495061334,15,5,10,26,0.2151999220890491,0.5136431145107794
변동성/NNG;키웠/VV,-1,-0.4108929495061334,15,5,10,15,0.2151999220890491,0.5136431145107794
경기/NNG;하/VV,-1,-0.4108929495061334,15,5,10,24,0.2151999220890491,0.5136431145107794
적자/NNG;줄어들/VV,-1,-0.4108929495061334,15,5,10,8,0.2151999220890491,0.5136431145107794
하방리스크/NNG;확대되/VVX,-1,-0.4108929495061334,15,5,10,15,0.2151999220890491,0.5136431145107794
gdp갭/NNG;마이너스/NNG;지속될/VVX,-1,-0.4108929495061334,15,5,10,22,0.2151999220890491,0.5136431145107794
내수부진/NNG;이어지/VV,-1,-0.4108929495061334,15,5,10,26,0.2151999220890491,0.5136431145107794
인플레이션/NNG;높/VA;질/VX;있/VV,-1,-0.4108929495061334,15,5,10,9,0.2151999220890491,0.5136431145107794
인플레이션/NNG;억제할/VVX,-1,-0.4108929495061334,15,5,10,16,0.2151999220890491,0.5136431145107794
실물경제/NNG;확산되/VVX,-1,-0.4108929495061334,15,5,10,12,0.2151999220890491,0.5136431145107794
재정지출/NNG;따른/VV,-1,-0.4108929495061334,15,5,10,12,0.2151999220890491,0.5136431145107794
경제성장률/NNG;마이너스/NNG;기록할/VVX,-1,-0.4108929495061334,15,5,10,12,0.2151999220890491,0.5136431145107794
금리인하/NNG;진행될/VVX,-1,-0.4108929495061334,15,5,10,16,0.2151999220890491,0.5136431145107794
자본확충/NNG;필요하/VVX,-1,-0.4108929495061334,15,5,10,13,0.2151999220890491,0.5136431145107794
경제성장/NNG;힘입/VV,-1,-0.4108929495061334,15,5,10,15,0.2151999220890491,0.5136431145107794
경기회복세/NNG;유지되/VVX,-1,-0.4108929495061334,15,5,10,18,0.2151999220890491,0.5136431145107794
금리인하/NNG;나설/VV,-1,-0.41205273893782723,248,91,157,352,0.36500143489188946,0.8736215199260392
유동성/NNG;공급되/VVX,-1,-0.4123029524830871,37,13,24,60,0.26358968129681165,0.6312745087546877
경제/NNG;회복하/VVX,-1,-0.4123029524830871,37,13,24,90,0.26358968129681165,0.6312745087546877
금리/NNG;낮춘/VV,-1,-0.4123029524830871,37,13,24,24,0.26358968129681165,0.6312745087546877
경기/NNG;악화될/VVX,-1,-0.41454235101320946,53,19,34,62,0.29006701529304796,0.6984380154991205
경제/NNG;개선될/VVX,-1,-0.41617026519003897,29,10,19,40,0.24529186902884773,0.5929482051388757
금리/NNG;내린/VV,-1,-0.4164527119113264,235,86,149,263,0.36167110917366135,0.874869686479399
기준금리/NNG;인하되/VVX,-1,-0.42010208582098363,85,31,54,224,0.3245293709159414,0.7919812442644103
금리/NNG;인상할/VVX;없/VA,-1,-0.4221677913669626,18,6,12,25,0.21737348504068782,0.53314144286648
투자심리/NNG;회복시/VVX,-1,-0.4221677913669626,18,6,12,32,0.21737348504068782,0.53314144286648
추경/NNG;집행/NNG;따른/VV,-1,-0.4221677913669626,18,6,12,16,0.21737348504068782,0.53314144286648
재정위기/NNG;확산되/VVX,-1,-0.4221677913669626,18,6,12,45,0.21737348504068782,0.53314144286648
기준금리인상/NNG;지지하/VVX,-1,-0.4221677913669626,18,6,12,18,0.21737348504068782,0.53314144286648
경기회복/NNG;도모하/VVX,-1,-0.4221677913669626,18,6,12,23,0.21737348504068782,0.53314144286648
금리인상/NNG;시점/NNG;앞당겨질/VV,-1,-0.4221677913669626,18,6,12,21,0.21737348504068782,0.53314144286648
경제전망/NNG;악화되/VVX,-1,-0.4221677913669626,18,6,12,10,0.21737348504068782,0.53314144286648
저성장/NNG;따른/VV,-1,-0.4221677913669626,18,6,12,27,0.21737348504068782,0.53314144286648
장단기/NNG;금리/NNG;역전되/VVX,-1,-0.4221677913669626,18,6,12,38,0.21737348504068782,0.53314144286648
기준금리/NNG;인상한/VAX;있/VV,-1,-0.4221677913669626,18,6,12,30,0.21737348504068782,0.53314144286648
경제성장/NNG;유지하/VVX,-1,-0.4221677913669626,18,6,12,16,0.21737348504068782,0.53314144286648
개인소비지출/NNG;가격지수/NNG;상승해/VVX,-1,-0.4221677913669626,18,6,12,20,0.21737348504068782,0.53314144286648
금리인하/NNG;이어질/VV,-1,-0.42346944284043486,40,14,26,23,0.26328811681251163,0.6477985934244621
경기회복/NNG;이끌/VV,-1,-0.4278372034327089,32,11,21,35,0.24559800875367424,0.6107363616232324
금리/NNG;낮추/VV,-1,-0.42859619869293575,212,77,135,316,0.352492398691386,0.8781802972524286
기준금리/NNG;인하하/VVX,-1,-0.42940662100121163,511,185,326,683,0.35258903472603853,0.880162740665961
원자재가격/NNG;상승/NNG;따른/VV,-1,-0.4317888571486397,59,21,38,86,0.28877492677285155,0.7250811019527119
재정확대/NNG;따른/VV,-1,-0.4326649352234707,21,7,14,19,0.2194820415034566,0.5522798382449647
금리인상/NNG;지지할/VVX,-1,-0.4326649352234707,21,7,14,24,0.2194820415034566,0.5522798382449647
투자심리/NNG;긍정적/VAX;영향/NNG;미쳤/VV,-1,-0.4326649352234707,21,7,14,29,0.2194820415034566,0.5522798382449647
수입/NNG;증가하/VVX,-1,-0.4326649352234707,21,7,14,40,0.2194820415034566,0.5522798382449647
투자심리/NNG;부담/NNG;줬/VV,-1,-0.4326649352234707,21,7,14,14,0.2194820415034566,0.5522798382449647
금리인하/NNG;가능성/NNG;시사하/VVX,-1,-0.4326649352234707,21,7,14,34,0.2194820415034566,0.5522798382449647
자산매입/NNG;유지했/VVX,-1,-0.4326649352234707,21,7,14,33,0.2194820415034566,0.5522798382449647
수출증가/NNG;힘입/VV,-1,-0.4326649352234707,21,7,14,34,0.2194820415034566,0.5522798382449647
마이너스/NNG;되/VV,-1,-0.4326649352234707,21,7,14,34,0.2194820415034566,0.5522798382449647
기준금리인상/NNG;그칠/VV,-1,-0.4326649352234707,21,7,14,12,0.2194820415034566,0.5522798382449647
금리/NNG;하락세/NNG;지속되/VVX,-1,-0.43853916785841185,70,25,45,117,0.2982971579640063,0.7615323660281555
금리/NNG;내려가/VV,-1,-0.43853916785841185,70,25,45,90,0.2982971579640063,0.7615323660281555
양적완화/NNG;시행하/VVX,-1,-0.44242935386758897,24,8,16,49,0.221526669677761,0.5710122953862911
추경/NNG;편성해/VVX,-1,-0.44242935386758897,24,8,16,19,0.221526669677761,0.5710122953862911
금리/NNG;유지해/VVX,-1,-0.44242935386758897,24,8,16,29,0.221526669677761,0.5710122953862911
내수부진/NNG;따른/VV,-1,-0.44242935386758897,24,8,16,34,0.221526669677761,0.5710122953862911
금리하락/NNG;이어질/VV,-1,-0.44242935386758897,24,8,16,45,0.221526669677761,0.5710122953862911
금리상승/NNG;제한됨/VVX,-1,-0.44242935386758897,24,8,16,28,0.221526669677761,0.5710122953862911
마이너스/NNG;떨어질/VV,-1,-0.44242935386758897,24,8,16,11,0.221526669677761,0.5710122953862911
금융위기/NNG;겪/VV,-1,-0.4426620287377402,46,16,30,110,0.2632578879524028,0.6789712981695278
수출/NNG;감소했/VVX,-1,-0.4446889852233984,73,26,47,69,0.29778591415415273,0.7718978567123611
수출/NNG;급감하/VVX,-1,-0.4478103539036745,38,13,25,19,0.2467472773444729,0.6445897378070399
성장세/NNG;지속할/VVX,-1,-0.4478103539036745,38,13,25,37,0.2467472773444729,0.6445897378070399
금리상승압력/NNG;지속될/VVX,-1,-0.45150431439958083,27,9,18,43,0.22350851146314124,0.5892977609888779
경상수지흑자/NNG;지속되/VVX,-1,-0.45150431439958083,27,9,18,40,0.22350851146314124,0.5892977609888779
고용/NNG;개선되/VVX,-1,-0.45150431439958083,27,9,18,37,0.22350851146314124,0.5892977609888779
투자심리/NNG;약화시/VVX,-1,-0.45150431439958083,27,9,18,22,0.22350851146314124,0.5892977609888779
경기부양/NNG;위한/VV,-1,-0.4543814302899247,450,160,290,700,0.33451447621226216,0.8883625838913156
경제/NNG;살리/VV,-1,-0.45470719279148675,182,65,117,237,0.3327165070897306,0.8843114608333782
금리변동성/NNG;확대될/VVX,-1,-0.4564196975162427,41,14,27,68,0.24748945558944135,0.6606309976807053
불안/NNG;진정되/VVX,-1,-0.4564196975162427,41,14,27,70,0.24748945558944135,0.6606309976807053
불안/NNG;이어질/VV,-1,-0.459931252959783,30,10,20,49,0.22542876283566537,0.6071001754529015
금리/NNG;상승압력/NNG;작용할/VVX,-1,-0.459931252959783,30,10,20,28,0.22542876283566537,0.6071001754529015
양적완화/NNG;지속하/VVX,-1,-0.459931252959783,30,10,20,28,0.22542876283566537,0.6071001754529015
불확실성/NNG;완화되/VVX,-1,-0.4600131141636158,115,41,74,222,0.31689754547219356,0.8536106307910962
기준금리/NNG;인하했/VVX,-1,-0.4603315973006801,288,102,186,340,0.3301640868421969,0.8900627910779286
소비자물가/NNG;올라/VV,-1,-0.4677496964135398,33,11,22,32,0.22728866489246827,0.6243884349122414
성장/NNG;견인하/VVX,-1,-0.4677496964135398,33,11,22,53,0.22728866489246827,0.6243884349122414
기준금리인하/NNG;단행되/VVX,-1,-0.4677496964135398,33,11,22,75,0.22728866489246827,0.6243884349122414
금리/NNG;내리/VV,-1,-0.4700733225016158,478,168,310,474,0.3232596530680578,0.8933211825440712
금융위기/NNG;인해/VV,-1,-0.47140990306322994,47,16,31,62,0.2491552387988849,0.6908963782928966
리스크/NNG;커졌/VV,-1,-0.4817094558106031,39,13,26,32,0.2308325619294676,0.6573221546583744
높/VA;변동성/NNG;보이/VV,-1,-0.4817094558106031,39,13,26,31,0.2308325619294676,0.6573221546583744
불안/NNG;이어지/VV,-1,-0.4817094558106031,39,13,26,57,0.2308325619294676,0.6573221546583744
단기금리/NNG;하락하/VVX,-1,-0.4817094558106031,39,13,26,41,0.2308325619294676,0.6573221546583744
마이너스/NNG;기록하/VVX,-1,-0.48338638556540947,117,41,76,199,0.3020454551925409,0.8638653443856338
리스크/NNG;요인이/VVX,-1,-0.48792008025787637,42,14,28,46,0.2325191932729109,0.6729289503418276
수입/NNG;증가했/VVX,-1,-0.48817709692120337,19,6,13,20,0.1894138257754846,0.5485474044977164
금리상승압력/NNG;우세할/VVX,-1,-0.48817709692120337,19,6,13,17,0.1894138257754846,0.5485474044977164
경제/NNG;활력/NNG;불어넣/VV,-1,-0.48817709692120337,19,6,13,12,0.1894138257754846,0.5485474044977164
금리인하/NNG;점치/VV,-1,-0.48817709692120337,19,6,13,15,0.1894138257754846,0.5485474044977164
기준금리/NNG;인하/VV,-1,-0.48817709692120337,19,6,13,28,0.1894138257754846,0.5485474044977164
가계부채/NNG;늘/VV,-1,-0.48817709692120337,19,6,13,28,0.1894138257754846,0.5485474044977164
금리상승/NNG;대비하/VVX,-1,-0.48817709692120337,19,6,13,32,0.1894138257754846,0.5485474044977164
경기부양/NNG;위해서/VV,-1,-0.48817709692120337,19,6,13,28,0.1894138257754846,0.5485474044977164
성장률/NNG;하회하/VVX,-1,-0.48817709692120337,19,6,13,20,0.1894138257754846,0.5485474044977164
유동성/NNG;부족하/VVX,-1,-0.48868131278841964,16,5,11,21,0.18267202030701252,0.5297217535766341
적자/NNG;국채발행/NNG;따른/VV,-1,-0.48868131278841964,16,5,11,8,0.18267202030701252,0.5297217535766341
경기부진/NNG;지속될/VVX,-1,-0.48868131278841964,16,5,11,15,0.18267202030701252,0.5297217535766341
금리인하/NNG;하/VV;않/VX,-1,-0.48868131278841964,16,5,11,17,0.18267202030701252,0.5297217535766341
수익성/NNG;악화시/VVX,-1,-0.48868131278841964,16,5,11,23,0.18267202030701252,0.5297217535766341
흑자/NNG;유지하/VVX,-1,-0.48868131278841964,16,5,11,33,0.18267202030701252,0.5297217535766341
금리인하/NNG;가능성/NNG;높이/VV,-1,-0.48868131278841964,16,5,11,29,0.18267202030701252,0.5297217535766341
불안/NNG;있/VV,-1,-0.48868131278841964,16,5,11,28,0.18267202030701252,0.5297217535766341
금리동결/NNG;주장하/VVX,-1,-0.48868131278841964,16,5,11,16,0.18267202030701252,0.5297217535766341
기준금리인하/NNG;예상되/VVX,-1,-0.48868131278841964,16,5,11,23,0.18267202030701252,0.5297217535766341
성장률/NNG;달성/NNG;가능할/VVX,-1,-0.48868131278841964,16,5,11,16,0.18267202030701252,0.5297217535766341
불확실성/NNG;확대/NNG;따른/VV,-1,-0.48868131278841964,16,5,11,23,0.18267202030701252,0.5297217535766341
금리/NNG;상승세/NNG;나타났/VV,-1,-0.48868131278841964,16,5,11,14,0.18267202030701252,0.5297217535766341
금리/NNG;스프레드/NNG;확대되/VVX,-1,-0.48868131278841964,16,5,11,15,0.18267202030701252,0.5297217535766341
금융위기/NNG;직전인/VVX,-1,-0.48868131278841964,16,5,11,17,0.18267202030701252,0.5297217535766341
실업률/NNG;상승할/VVX,-1,-0.48868131278841964,16,5,11,21,0.18267202030701252,0.5297217535766341
충분한/VAX;유동성/NNG;공급하/VVX,-1,-0.48868131278841964,16,5,11,7,0.18267202030701252,0.5297217535766341
동결/NNG;예상되/VVX,-1,-0.49006472535977297,22,7,15,34,0.19486051891922002,0.5671193323572732
불확실성/NNG;줄/VV,-1,-0.49006472535977297,22,7,15,22,0.19486051891922002,0.5671193323572732
기준금리인상/NNG;가능할/VVX,-1,-0.49006472535977297,22,7,15,45,0.19486051891922002,0.5671193323572732
적자/NNG;냈/VV,-1,-0.49006472535977297,22,7,15,22,0.19486051891922002,0.5671193323572732
성장률/NNG;하향조정될/VVX,-1,-0.49006472535977297,22,7,15,30,0.19486051891922002,0.5671193323572732
기준금리/NNG;유지키/VVX,-1,-0.49006472535977297,22,7,15,18,0.19486051891922002,0.5671193323572732
물가상승률/NNG;접근하/VVX,-1,-0.49006472535977297,22,7,15,22,0.19486051891922002,0.5671193323572732
양적완화/NNG;실시하/VVX,-1,-0.49323870929804325,25,8,17,43,0.1994531605287745,0.5853494929831896
금리인하/NNG;가능성/NNG;제기되/VVX,-1,-0.49323870929804325,25,8,17,34,0.1994531605287745,0.5853494929831896
금리인상/NNG;대응하/VVX,-1,-0.49323870929804325,25,8,17,20,0.1994531605287745,0.5853494929831896
수출/NNG;늘어난/VV,-1,-0.49323870929804325,25,8,17,25,0.1994531605287745,0.5853494929831896
금리인하/NNG;결정했/VVX,-1,-0.49323870929804325,25,8,17,20,0.1994531605287745,0.5853494929831896
신용스프레드/NNG;축소될/VVX,-1,-0.49323870929804325,25,8,17,33,0.1994531605287745,0.5853494929831896
금리인상시기/NNG;지연될/VVX,-1,-0.49323870929804325,25,8,17,30,0.1994531605287745,0.5853494929831896
흑자/NNG;기록할/VVX,-1,-0.49323870929804325,25,8,17,32,0.1994531605287745,0.5853494929831896
경제/NNG;회복세/NNG;나타내/VV,-1,-0.49323870929804325,25,8,17,27,0.1994531605287745,0.5853494929831896
금리/NNG;하락세/NNG;지속될/VVX,-1,-0.49580564376131453,73,25,48,133,0.266920152469121,0.7886735160960836
물가상승압력/NNG;작용하/VVX,-1,-0.49709122016168805,28,9,19,33,0.2034458058153026,0.6031725123196829
성장세/NNG;유지되/VVX,-1,-0.49709122016168805,28,9,19,42,0.2034458058153026,0.6031725123196829
하방압력/NNG;작용할/VVX,-1,-0.49709122016168805,28,9,19,35,0.2034458058153026,0.6031725123196829
소비심리/NNG;위축되/VVX,-1,-0.49709122016168805,28,9,19,33,0.2034458058153026,0.6031725123196829
물가안정/NNG;달성하/VVX,-1,-0.5012675028262765,31,10,21,47,0.2069952014985862,0.6205377352386392
금융안정/NNG;위한/VV,-1,-0.5055520265036793,34,11,23,31,0.21020344867356563,0.6374051318741988
금리인하/NNG;이뤄질/VV,-1,-0.5055520265036793,34,11,23,51,0.21020344867356563,0.6374051318741988
금리/NNG;내렸/VV,-1,-0.5141634784667111,149,51,98,143,0.2885104187962827,0.8953848019239626
수출/NNG;줄/VV,-1,-0.5163051798484108,60,20,40,67,0.24152958056307378,0.7539494706097571
금리인상/NNG;가능성/NNG;부각되/VVX,-1,-0.5286602386856041,52,17,35,68,0.22508183844657895,0.7268107383766211
리스크/NNG;부각되/VVX,-1,-0.5346867347401925,58,19,39,96,0.22897133273512885,0.7518525790849918
기준금리/NNG;내리/VV,-1,-0.5353185384278893,254,85,169,264,0.2772471870406236,0.9119787782243274
금리/NNG;내리/VV;않/VX,-1,-0.5373670702553093,61,20,41,68,0.23077515146166594,0.7634757632307175
기준금리/NNG;내렸/VV,-1,-0.5391110989729798,143,48,95,109,0.27086212887163935,0.9004907168130448
물가상승률/NNG;달성하/VVX,-1,-0.5397037643466343,29,9,20,28,0.18508687729771842,0.6163535409258526
금리인하기대/NNG;반영하/VVX,-1,-0.540083194348947,32,10,22,50,0.1899897643667898,0.6333559933764944
경기/NNG;살아나/VV;않/VX,-1,-0.540083194348947,32,10,22,37,0.1899897643667898,0.6333559933764944
경기부양책/NNG;힘입/VV,-1,-0.540083194348947,32,10,22,54,0.1899897643667898,0.6333559933764944
기준금리/NNG;위한/VV,-1,-0.5404617702331858,26,8,18,53,0.1794604147939946,0.5988926503825843
소매판매/NNG;감소했/VVX,-1,-0.5404617702331858,26,8,18,34,0.1794604147939946,0.5988926503825843
금리인하/NNG;따른/VV,-1,-0.5417174283251682,222,74,148,249,0.27267609163501955,0.9131954713323048
단기금리/NNG;급등하/VVX,-1,-0.5430150411620187,23,7,16,18,0.1728571474429112,0.5810250108906634
금리/NNG;인하할/VVX;가능성/NNG;낮/VA,-1,-0.5430150411620187,23,7,16,9,0.1728571474429112,0.5810250108906634
금리인상/NNG;유지될/VVX,-1,-0.5430150411620187,23,7,16,36,0.1728571474429112,0.5810250108906634
신용등급/NNG;하향조정했/VVX,-1,-0.5430150411620187,23,7,16,37,0.1728571474429112,0.5810250108906634
경기/NNG;과도한/VAX;위축/NNG;방지하/VVX,-1,-0.5430150411620187,23,7,16,0,0.1728571474429112,0.5810250108906634
유동성/NNG;위기/NNG;겪/VV,-1,-0.5430150411620187,23,7,16,32,0.1728571474429112,0.5810250108906634
디플레이션/NNG;빠질/VV,-1,-0.5430150411620187,23,7,16,29,0.1728571474429112,0.5810250108906634
물가/NNG;영향/NNG;미치/VV,-1,-0.5430150411620187,23,7,16,29,0.1728571474429112,0.5810250108906634
변동성/NNG;크/VA;확대된/VVX,-1,-0.5430150411620187,23,7,16,10,0.1728571474429112,0.5810250108906634
금리/NNG;인하한/VVX,-1,-0.5445341915824581,41,13,28,75,0.2018049010474198,0.681248567885206
금리/NNG;인하했/VVX,-1,-0.5457144460765602,171,57,114,177,0.2688311662794733,0.910555799782412
금리인하/NNG;가능성/NNG;열/VV,-1,-0.5457144460765602,171,57,114,186,0.2688311662794733,0.910555799782412
성장률/NNG;떨어지/VV,-1,-0.5464767648111721,44,14,30,54,0.20506869481605147,0.6960913597442498
변동성/NNG;확대할/VVX,-1,-0.5484453273544887,20,6,14,16,0.16487998307112775,0.562816938855306
금리인하기대/NNG;지속될/VVX,-1,-0.5484453273544887,20,6,14,39,0.16487998307112775,0.562816938855306
금리상승/NNG;될/VV,-1,-0.5484453273544887,20,6,14,14,0.16487998307112775,0.562816938855306
금리인하/NNG;주장하/VVX;소수의견/NNG,-1,-0.5484453273544887,20,6,14,21,0.16487998307112775,0.562816938855306
금리인하/NNG;가능성/NNG;낮추/VV,-1,-0.5484453273544887,20,6,14,16,0.16487998307112775,0.562816938855306
흑자/NNG;전환했/VVX,-1,-0.5484453273544887,20,6,14,13,0.16487998307112775,0.562816938855306
금융위기/NNG;직후인/VVX,-1,-0.5484681468104811,47,15,32,64,0.2080861187401023,0.7103470391866614
침체/NNG;지속되/VVX,-1,-0.5504478995220699,50,16,34,45,0.21089273650005272,0.7240072036800501
금리인하/NNG;단행했/VVX,-1,-0.553151622250792,169,56,113,145,0.2636942380799164,0.9123161730264028
금융시장안정/NNG;위한/VV,-1,-0.5559604066720689,59,19,40,62,0.21829952591422003,0.7613896629268064
통화완화/NNG;지속되/VVX,-1,-0.5586353307906956,17,5,12,23,0.15487147987584318,0.5443553645071971
자금이탈/NNG;나타나/VV,-1,-0.5586353307906956,17,5,12,37,0.15487147987584318,0.5443553645071971
경제/NNG;미칠/VV;악영향/NNG,-1,-0.5586353307906956,17,5,12,9,0.15487147987584318,0.5443553645071971
경기부양/NNG;나선/VV,-1,-0.5586353307906956,17,5,12,24,0.15487147987584318,0.5443553645071971
물가상승률/NNG;웃돌/VV,-1,-0.5586353307906956,17,5,12,15,0.15487147987584318,0.5443553645071971
정책금리인상/NNG;단행되/VVX,-1,-0.5586353307906956,17,5,12,18,0.15487147987584318,0.5443553645071971
경제성장/NNG;지속하/VVX,-1,-0.5586353307906956,17,5,12,15,0.15487147987584318,0.5443553645071971
경제/NNG;성장세/NNG;둔화되/VVX,-1,-0.5586353307906956,17,5,12,7,0.15487147987584318,0.5443553645071971
인플레이션압력/NNG;완화될/VVX,-1,-0.5734298701736549,42,13,29,23,0.1886653097413618,0.6925274761853136
금리인하/NNG;나섰/VV,-1,-0.5737331620439456,39,12,27,50,0.18439173291786165,0.6774502185288062
소비/NNG;늘어날/VV,-1,-0.5737331620439456,39,12,27,38,0.18439173291786165,0.6774502185288062
금융시장/NNG;안정/NNG;찾/VV,-1,-0.5737331620439456,39,12,27,47,0.18439173291786165,0.6774502185288062
불안요인/NNG;있/VV,-1,-0.5737331620439456,39,12,27,36,0.18439173291786165,0.6774502185288062
리스크/NNG;작용할/VVX,-1,-0.5743871771797672,51,16,35,91,0.1994625705872598,0.7342452671830754
금리인하/NNG;인해/VV,-1,-0.5756607623304392,57,18,39,61,0.2054261486469143,0.7590691362688707
금리인하/NNG;가능성/NNG;시사했/VVX,-1,-0.5763295198086508,60,19,41,40,0.20812776098558608,0.7705863255448883
리스크/NNG;확대될/VVX,-1,-0.5763313702277331,33,10,23,38,0.17437752676920906,0.645630734291602
경제지표/NNG;혼조세/NNG;보이/VV,-1,-0.5763313702277331,33,10,23,48,0.17437752676920906,0.645630734291602
물가안정/NNG;안정되/VVX,-1,-0.5792655899312004,30,9,21,58,0.1683857997359385,0.628939909463088
불확실성/NNG;계속되/VVX,-1,-0.5792655899312004,30,9,21,40,0.1683857997359385,0.628939909463088
금리/NNG;상승세/NNG;제한되/VVX,-1,-0.5839768202180347,27,8,19,44,0.1614841587902606,0.6117750239667643
금리인하/NNG;배경/NNG;설명했/VVX,-1,-0.5839768202180347,27,8,19,14,0.1614841587902606,0.6117750239667643
침체/NNG;인해/VV,-1,-0.5839768202180347,27,8,19,15,0.1614841587902606,0.6117750239667643
금리/NNG;하락세/NNG;이어지/VV,-1,-0.591322824650276,24,7,17,34,0.15337447406437063,0.594182378348459
기준금리인하/NNG;가능성/NNG;열/VV,-1,-0.591322824650276,24,7,17,34,0.15337447406437063,0.594182378348459
금리인하/NNG;지속될/VVX,-1,-0.591322824650276,24,7,17,15,0.15337447406437063,0.594182378348459
자산매입/NNG;줄이/VV,-1,-0.591322824650276,24,7,17,67,0.15337447406437063,0.594182378348459
금리/NNG;큰/VA;상승했/VVX,-1,-0.597953014901536,49,15,34,85,0.18491245288863703,0.7311444042372178
불안/NNG;진정시/VVX,-1,-0.6026654297111944,21,6,15,21,0.14360847321617987,0.5762194523737937
물가/NNG;영향/NNG;주/VV,-1,-0.6026654297111944,21,6,15,38,0.14360847321617987,0.5762194523737937
잠재성장률/NNG;하회하/VVX,-1,-0.6026654297111944,21,6,15,37,0.14360847321617987,0.5762194523737937
수출/NNG;증가세/NNG;보이/VV,-1,-0.6026654297111944,21,6,15,8,0.14360847321617987,0.5762194523737937
금리인하/NNG;가능성/NNG;남/VV,-1,-0.6026654297111944,21,6,15,25,0.14360847321617987,0.5762194523737937
기준금리인상/NNG;단행할/VVX,-1,-0.60283695178467,40,12,28,59,0.1715340359666145,0.6886381873823879
금리상승/NNG;영향/NNG;받/VV,-1,-0.6058503494095973,37,11,26,20,0.16613752984776547,0.6733073990337738
마이너스/NNG;돌아서/VV,-1,-0.6157715206116181,31,9,22,28,0.1532622747115637,0.6410091248311601
금리인하/NNG;예상했/VVX,-1,-0.6157715206116181,31,9,22,39,0.1532622747115637,0.6410091248311601
마이너스성장/NNG;할/VV,-1,-0.6157715206116181,31,9,22,16,0.1532622747115637,0.6410091248311601
금리인하/NNG;반대하/VVX,-1,-0.6202671645515518,18,5,13,23,0.13148717358204365,0.5579569949972626
유동성함정/NNG;빠지/VV;않/VX,-1,-0.6202671645515518,18,5,13,9,0.13148717358204365,0.5579569949972626
금융안정/NNG;유의할/VVX,-1,-0.6202671645515518,18,5,13,9,0.13148717358204365,0.5579569949972626
금리인하/NNG;예상된/VVX,-1,-0.6202671645515518,18,5,13,21,0.13148717358204365,0.5579569949972626
물가/NNG;안정세/NNG;유지할/VVX,-1,-0.6202671645515518,18,5,13,7,0.13148717358204365,0.5579569949972626
경제성장률/NNG;떨어지/VV,-1,-0.6202671645515518,18,5,13,33,0.13148717358204365,0.5579569949972626
금리인상/NNG;시작해/VVX,-1,-0.6202671645515518,18,5,13,17,0.13148717358204365,0.5579569949972626
변동성/NNG;제한된/VVX,-1,-0.6202671645515518,18,5,13,35,0.13148717358204365,0.5579569949972626
금리스프레드/NNG;확대되/VVX,-1,-0.6202671645515518,18,5,13,39,0.13148717358204365,0.5579569949972626
채권시장/NNG;강세/NNG;나타냈/VV,-1,-0.6202671645515518,18,5,13,13,0.13148717358204365,0.5579569949972626
금리/NNG;재할인율/NNG;인하했/VVX,-1,-0.6202671645515518,18,5,13,10,0.13148717358204365,0.5579569949972626
신용경색/NNG;따른/VV,-1,-0.6207392686982778,50,15,35,63,0.17435594635653845,0.7409992013946434
시장금리/NNG;급등했/VVX,-1,-0.623772454652662,28,8,20,20,0.14540950557072468,0.6240977302310721
기준금리/NNG;역전되/VVX,-1,-0.623772454652662,28,8,20,55,0.14540950557072468,0.6240977302310721
불안심리/NNG;확산되/VVX,-1,-0.623772454652662,28,8,20,48,0.14540950557072468,0.6240977302310721
침체/NNG;지속될/VVX,-1,-0.623772454652662,28,8,20,16,0.14540950557072468,0.6240977302310721
경기/NNG;부진할/VVX,-1,-0.6262439058064632,44,13,31,37,0.16499144920748124,0.7138831582019476
고용지표/NNG;호조/NNG;보이/VV,-1,-0.6262439058064632,44,13,31,56,0.16499144920748124,0.7138831582019476
물가/NNG;하락하/VVX,-1,-0.632160863655544,63,19,44,87,0.18048099609508547,0.796275540607911
리스크/NNG;따른/VV,-1,-0.6349294764764066,38,11,27,87,0.1537002193558725,0.6843901876543547
변동성/NNG;보였/VV,-1,-0.6349752038486731,25,7,18,21,0.13623784860518046,0.6067269439393835
수출부진/NNG;따른/VV,-1,-0.6411717560328122,35,10,25,26,0.14708063692202558,0.668781287026276
지정학적리스크/NNG;따른/VV,-1,-0.6411717560328122,35,10,25,50,0.14708063692202558,0.668781287026276
경기둔화/NNG;막/VV,-1,-0.6458919301685072,48,14,34,43,0.15962893111834187,0.7375688697180379
기준금리동결/NNG;결정했/VVX,-1,-0.6480901491828714,15,4,11,24,0.1158823597058949,0.5394800581826422
변동성/NNG;축소된/VVX,-1,-0.6480901491828714,15,4,11,46,0.1158823597058949,0.5394800581826422
금리/NNG;급락한/VAX;따른/VV,-1,-0.6480901491828714,15,4,11,12,0.1158823597058949,0.5394800581826422
금융위기/NNG;해결하/VVX,-1,-0.6480901491828714,15,4,11,15,0.1158823597058949,0.5394800581826422
투자심리/NNG;부정적/VAX;작용했/VVX,-1,-0.6480901491828714,15,4,11,10,0.1158823597058949,0.5394800581826422
성장/NNG;하방위험/NNG;작용할/VVX,-1,-0.6480901491828714,15,4,11,7,0.1158823597058949,0.5394800581826422
채권시장/NNG;우호적/VAX;작용하/VVX,-1,-0.6480901491828714,15,4,11,31,0.1158823597058949,0.5394800581826422
안전자산선호현상/NNG;약화시/VVX,-1,-0.6480901491828714,15,4,11,11,0.1158823597058949,0.5394800581826422
경제지표/NNG;개선된/VVX,-1,-0.6480901491828714,15,4,11,29,0.1158823597058949,0.5394800581826422
마이너스/NNG;진입하/VVX,-1,-0.6480901491828714,15,4,11,11,0.1158823597058949,0.5394800581826422
신용경색/NNG;발생하/VVX,-1,-0.6480901491828714,15,4,11,22,0.1158823597058949,0.5394800581826422
콜금리/NNG;인상하/VVX;않/VX,-1,-0.6480901491828714,15,4,11,10,0.1158823597058949,0.5394800581826422
물가안정/NNG;유지되/VVX,-1,-0.6492792178844842,32,9,23,54,0.1396143204984246,0.6526223156623406
금리인하/NNG;가능성/NNG;있/VV,-1,-0.6502307636628899,45,13,32,34,0.15438005883828732,0.7240125357542135
수출/NNG;위축될/VVX,-1,-0.6508449894337155,22,6,16,11,0.12531347053178113,0.5889423103590291
인플레이션리스크/NNG;남/VV,-1,-0.6508449894337155,22,6,16,12,0.12531347053178113,0.5889423103590291
통화완화정책/NNG;펴/VV,-1,-0.6508449894337155,22,6,16,15,0.12531347053178113,0.5889423103590291
금리인하/NNG;더불/VV,-1,-0.6508449894337155,22,6,16,18,0.12531347053178113,0.5889423103590291
유동성/NNG;조이/VV,-1,-0.6599326578591265,29,8,21,12,0.13109192293321062,0.6359382459089736
추경/NNG;따른/VV,-1,-0.6619093192335243,133,40,93,155,0.1902292137165877,0.9292836557087055
수출/NNG;증가했/VVX,-1,-0.6672130779612283,49,14,35,58,0.15006631644647275,0.7470674240065399
경제지표/NNG;악화되/VVX,-1,-0.6698870609636349,36,10,26,36,0.1352364914778802,0.6797462385666461
금리인하/NNG;단행하/VVX;않/VX,-1,-0.6698870609636349,36,10,26,50,0.1352364914778802,0.6797462385666461
성장세/NNG;유지하/VVX,-1,-0.6724966877114941,59,17,42,102,0.1559840769408445,0.7914710747927479
경기회복/NNG;무게/NNG;두/VV,-1,-0.6736871909688733,19,5,14,5,0.11200716112187761,0.5707954292618296
금리/NNG;계속/MAG;오를/VV,-1,-0.6736871909688733,19,5,14,7,0.11200716112187761,0.5707954292618296
경기회복/NNG;걸림돌/NNG;작용할/VVX,-1,-0.6736871909688733,19,5,14,11,0.11200716112187761,0.5707954292618296
금리인하/NNG;예상됨/VVX,-1,-0.6736871909688733,19,5,14,18,0.11200716112187761,0.5707954292618296
만장일치/NNG;기준금리/NNG;동결했/VVX,-1,-0.6736871909688733,19,5,14,33,0.11200716112187761,0.5707954292618296
투자심리/NNG;크/VA;위축되/VVX,-1,-0.6736871909688733,19,5,14,20,0.11200716112187761,0.5707954292618296
경기침체/NNG;지속되/VVX,-1,-0.6741100143350318,26,7,19,39,0.12123214383153127,0.6187589264249259
금리/NNG;내려/VV,-1,-0.6766793512992162,82,24,58,104,0.16793002814275226,0.8651915406115217
추경편성/NNG;따른/VV,-1,-0.6766793512992162,82,24,58,72,0.16793002814275226,0.8651915406115217
경제성장/NNG;촉진하/VVX,-1,-0.6767933058433573,69,20,49,40,0.16073067500379445,0.8284460595112909
신용경색/NNG;완화하/VVX,-1,-0.6798971410346993,33,9,24,28,0.12732830097817163,0.663828055773718
금리/NNG;하락세/NNG;예상된/VVX,-1,-0.6868789544521987,40,11,29,31,0.1318313403145115,0.7054416449146357
금리인하/NNG;단행된/VVX,-1,-0.6868789544521987,40,11,29,78,0.1318313403145115,0.7054416449146357
금리인하/NNG;가능성/NNG;배제하/VVX,-1,-0.6926156176614997,30,8,22,33,0.11837316733781551,0.6473564608893915
금리상승압력/NNG;작용할/VVX,-1,-0.6950896312568628,67,19,48,106,0.14971096207971374,0.8265373265615668
경제/NNG;부양할/VVX,-1,-0.7072162391613963,16,4,12,20,0.09541256895334196,0.5523387714399037
금리인하/NNG;지속되/VVX,-1,-0.7072162391613963,16,4,12,12,0.09541256895334196,0.5523387714399037
수출/NNG;부진할/VVX,-1,-0.7072162391613963,16,4,12,35,0.09541256895334196,0.5523387714399037
수출/NNG;감소세/NNG;지속되/VVX,-1,-0.7072162391613963,16,4,12,8,0.09541256895334196,0.5523387714399037
기준금리/NNG;인하돼/VVX,-1,-0.7072162391613963,16,4,12,9,0.09541256895334196,0.5523387714399037
성장경로/NNG;불확실성/NNG;높/VA;진/VX;판단된/VVX,-1,-0.7072162391613963,16,4,12,12,0.09541256895334196,0.5523387714399037
소비자물가상승률/NNG;머물/VV,-1,-0.7072162391613963,16,4,12,11,0.09541256895334196,0.5523387714399037
인플레이션/NNG;웃돌/VV,-1,-0.7072162391613963,16,4,12,14,0.09541256895334196,0.5523387714399037
주택가격하락/NNG;따른/VV,-1,-0.7089756978178727,27,7,20,33,0.10812813976459597,0.6303532582373325
소비/NNG;회복될/VVX,-1,-0.7194360506511746,20,5,15,18,0.0958595255541834,0.5830497163394496
잠재성장률/NNG;밑돌/VV,-1,-0.7194360506511746,20,5,15,37,0.0958595255541834,0.5830497163394496
불안/NNG;반영하/VVX,-1,-0.7194360506511746,20,5,15,13,0.0958595255541834,0.5830497163394496
고용지표/NNG;밑돌/VV,-1,-0.7194360506511746,20,5,15,16,0.0958595255541834,0.5830497163394496
경기침체/NNG;진행되/VVX,-1,-0.7194360506511746,20,5,15,5,0.0958595255541834,0.5830497163394496
금리/NNG;하향안정화되/VVX,-1,-0.7194360506511746,20,5,15,21,0.0958595255541834,0.5830497163394496
수출경쟁력/NNG;높이/VV,-1,-0.7194360506511746,20,5,15,21,0.0958595255541834,0.5830497163394496
시장금리/NNG;반영되/VVX,-1,-0.730275515755015,24,6,18,38,0.09628840259928753,0.6128415196535529
경기침체/NNG;인해/VV,-1,-0.7398912492455514,28,7,21,35,0.09669991197672642,0.6415665090573219
금리상승/NNG;예상되/VVX,-1,-0.7398912492455514,28,7,21,46,0.09669991197672642,0.6415665090573219
실업률/NNG;상승했/VVX,-1,-0.7398912492455514,28,7,21,33,0.09669991197672642,0.6415665090573219
경기회복/NNG;지속되/VVX,-1,-0.7425304419898501,39,10,29,59,0.10586376597211462,0.7105795215384129
캐리트레이드/NNG;청산/NNG;매물/NNG;나와/VV,-1,-0.7557769359721964,17,4,13,8,0.0792197553540449,0.5645808252124803
gdp/NNG;감소하/VVX,-1,-0.7557769359721964,17,4,13,38,0.0792197553540449,0.5645808252124803
경기회복/NNG;찬물/NNG;끼얹/VV,-1,-0.7557769359721964,17,4,13,29,0.0792197553540449,0.5645808252124803
실물경제/NNG;개선되/VVX,-1,-0.7557769359721964,17,4,13,6,0.0792197553540449,0.5645808252124803
소비/NNG;촉진하/VVX,-1,-0.7557769359721964,17,4,13,20,0.0792197553540449,0.5645808252124803
재정위기/NNG;지속되/VVX,-1,-0.7557769359721964,17,4,13,19,0.0792197553540449,0.5645808252124803
인플레이션압력/NNG;높이/VV,-1,-0.7557769359721964,17,4,13,27,0.0792197553540449,0.5645808252124803
금융위기/NNG;대처하/VVX,-1,-0.7559888245359964,36,9,27,14,0.09747356160255621,0.6953531713302882
불안/NNG;확산되/VVX,-1,-0.7559888245359964,36,9,27,58,0.09747356160255621,0.6953531713302882
금리상승/NNG;제한될/VVX,-1,-0.756331469074573,79,21,58,134,0.12295519689888083,0.8785267882489338
경기침체/NNG;대응하/VVX,-1,-0.758297829784293,21,5,16,16,0.08249357080225726,0.5948414906323984
신용등급/NNG;강등/NNG;따른/VV,-1,-0.758297829784293,21,5,16,38,0.08249357080225726,0.5948414906323984
설비투자/NNG;감소하/VVX,-1,-0.758297829784293,21,5,16,24,0.08249357080225726,0.5948414906323984
유동성함정/NNG;빠질/VV,-1,-0.758297829784293,21,5,16,7,0.08249357080225726,0.5948414906323984
성장률/NNG;나타내/VV,-1,-0.758297829784293,21,5,16,36,0.08249357080225726,0.5948414906323984
하방위험/NNG;커졌/VV,-1,-0.7624631721168403,25,6,19,12,0.08488323446117159,0.6241818678389993
유동성함정/NNG;빠지/VV,-1,-0.7624631721168403,25,6,19,4,0.08488323446117159,0.6241818678389993
유동성/NNG;확보하/VVX,-1,-0.7627003058854636,40,10,30,67,0.09783701162871929,0.7202455815122996
금리인하/NNG;압박하/VVX,-1,-0.7672119179959576,29,7,22,37,0.08673522909340646,0.6524417541977587
성장세/NNG;둔화됐/VVX,-1,-0.7672119179959576,29,7,22,25,0.08673522909340646,0.6524417541977587
금리/NNG;낮/VA;유지할/VVX,-1,-0.7672119179959576,29,7,22,44,0.08673522909340646,0.6524417541977587
실물경제/NNG;영향/NNG;미치/VV,-1,-0.7720426875484839,33,8,25,40,0.08823375308215024,0.6794962271432513
금융시장안정/NNG;위해/VV,-1,-0.7895869959456674,64,16,48,78,0.0997281677733328,0.8396180107550326
금리인하/NNG;여력/NNG;있/VV,-1,-0.7903483936105457,26,6,20,14,0.07514442944874979,0.6351896405970646
가계부채/NNG;늘어날/VV,-1,-0.7903483936105457,26,6,20,10,0.07514442944874979,0.6351896405970646
물가상승률/NNG;둔화될/VVX,-1,-0.7911488044037625,22,5,17,15,0.07141847347298298,0.6062547384923157
내수/NNG;위축되/VVX,-1,-0.7913027922277562,30,7,23,35,0.07804094744370173,0.6630120481449882
기준금리인하/NNG;인해/VV,-1,-0.7953484967948334,18,4,14,27,0.06639033136452181,0.5763617534894265
주택가격/NNG;떨어지/VV,-1,-0.7953484967948334,18,4,14,11,0.06639033136452181,0.5763617534894265
침체/NNG;이어질/VV,-1,-0.7954231501335711,38,9,29,38,0.08231211530164188,0.7148730025981292
통화정책/NNG;완화하/VVX,-1,-0.7954231501335711,38,9,29,49,0.08231211530164188,0.7148730025981292
유동성/NNG;지원하/VVX,-1,-0.7978431776267427,42,10,32,44,0.08395384931910267,0.7387597353933889
신용경색/NNG;완화되/VVX,-1,-0.800255136263983,46,11,35,30,0.08537119793220706,0.761223643901118
변동성/NNG;나타내/VV,-1,-0.8141276561330297,47,11,36,36,0.079766950514051,0.7695977767374601
기준금리/NNG;밑돌/VV,-1,-0.8274986940228524,19,4,15,36,0.056177085445126305,0.5877819407787436
금리상승압력/NNG;확대될/VVX,-1,-0.8274986940228524,19,4,15,10,0.056177085445126305,0.5877819407787436
수출/NNG;증가세/NNG;둔화되/VVX,-1,-0.8274986940228524,19,4,15,36,0.056177085445126305,0.5877819407787436
통화완화정책/NNG;지속될/VVX,-1,-0.8274986940228524,19,4,15,19,0.056177085445126305,0.5877819407787436
성장세/NNG;꺾이/VV,-1,-0.8274986940228524,19,4,15,13,0.056177085445126305,0.5877819407787436
인플레이션압력/NNG;커질/VV,-1,-0.8311999040661773,32,7,25,33,0.06379670137843908,0.6833342919834702
금리인하/NNG;이/VV,-1,-0.8369538583038768,61,14,47,54,0.07554598404469186,0.8399879455004233
고용지표/NNG;개선될/VVX,-1,-0.8438011243465986,15,3,12,19,0.04787360331675324,0.5573805490357463
성장률/NNG;유지할/VVX,-1,-0.8438011243465986,15,3,12,37,0.04787360331675324,0.5573805490357463
적자/NNG;내/VV,-1,-0.8438011243465986,15,3,12,13,0.04787360331675324,0.5573805490357463
물가/NNG;높이/VV,-1,-0.8438011243465986,15,3,12,16,0.04787360331675324,0.5573805490357463
신용경색/NNG;해소되/VVX,-1,-0.8438011243465986,15,3,12,17,0.04787360331675324,0.5573805490357463
채권시장/NNG;유입될/VVX,-1,-0.8438011243465986,15,3,12,31,0.04787360331675324,0.5573805490357463
경제지표/NNG;약화된/VVX,-1,-0.8438011243465986,15,3,12,11,0.04787360331675324,0.5573805490357463
금리/NNG;하향안정될/VVX,-1,-0.8438011243465986,15,3,12,24,0.04787360331675324,0.5573805490357463
경기후퇴/NNG;제한하/VVX,-1,-0.8438011243465986,15,3,12,15,0.04787360331675324,0.5573805490357463
안전자산선호심리/NNG;강해/VV,-1,-0.8438011243465986,15,3,12,19,0.04787360331675324,0.5573805490357463
성장세/NNG;약화되/VVX,-1,-0.8438011243465986,15,3,12,31,0.04787360331675324,0.5573805490357463
물가안정/NNG;하회할/VVX,-1,-0.8536329139128201,20,4,16,6,0.04799173014062069,0.5989073658762504
수출/NNG;이/VV,-1,-0.8536329139128201,20,4,16,18,0.04799173014062069,0.5989073658762504
성장세회복/NNG;지원하/VVX,-1,-0.8633512826819283,60,13,47,46,0.06279198873866979,0.8428446145800128
흑자/NNG;돌아섰/VV,-1,-0.8725061392943809,16,3,13,30,0.03938361875966179,0.5687325761193928
경제성장률/NNG;낮춰/VV,-1,-0.8725061392943809,16,3,13,14,0.03938361875966179,0.5687325761193928
불안/NNG;진정될/VVX,-1,-0.8725061392943809,16,3,13,14,0.03938361875966179,0.5687325761193928
기준금리/NNG;내린/VV;이/VV,-1,-0.8725061392943809,16,3,13,14,0.03938361875966179,0.5687325761193928
재고조정/NNG;진행되/VVX,-1,-0.8749394978377916,21,4,17,8,0.041380220787598364,0.6097819806205779
내수부진/NNG;심화되/VVX,-1,-0.8749394978377916,21,4,17,6,0.041380220787598364,0.6097819806205779
경기활성화/NNG;위한/VV,-1,-0.8749394978377916,21,4,17,35,0.041380220787598364,0.6097819806205779
기준금리/NNG;내려/VV,-1,-0.8751222380369135,44,9,35,51,0.05200362830642493,0.7675060224702992
정책금리/NNG;인하할/VVX,-1,-0.8845477818176334,72,15,57,53,0.05568114464939333,0.8920747441272288
고용지표/NNG;양호하/VVX,-1,-0.8946823510354753,17,3,14,28,0.03289754465869916,0.5798340023397016
성장/NNG;머물/VV,-1,-0.8946823510354753,17,3,14,16,0.03289754465869916,0.5798340023397016
인플레이션/NNG;잘/MAG;제어되/VVX,-1,-0.8946823510354753,17,3,14,13,0.03289754465869916,0.5798340023397016
성장/NNG;도모하/VVX,-1,-0.8946823510354753,17,3,14,19,0.03289754465869916,0.5798340023397016
경기부양책/NNG;고려하/VVX,-1,-0.8946823510354753,17,3,14,3,0.03289754465869916,0.5798340023397016
금리인하/NNG;시사했/VVX,-1,-0.904876925634883,28,5,23,27,0.03418019378070156,0.6691234300299094
기준금리/NNG;내린/VV,-1,-0.907403528878779,176,35,141,149,0.04903310825604853,0.9867784294589482
근원인플레이션율/NNG;하락하/VVX,-1,-0.9119829506090614,18,3,15,18,0.027868445865954293,0.5907264380942342
마이너스성장/NNG;하/VV,-1,-0.9119829506090614,18,3,15,19,0.027868445865954293,0.5907264380942342
마이너스성장/NNG;했/VV,-1,-0.9119829506090614,18,3,15,13,0.027868445865954293,0.5907264380942342
기준금리/NNG;인하함/VVX,-1,-0.9130630107048625,39,7,32,49,0.034811567842803474,0.7472617867039152
경제성장률/NNG;낮춘/VV,-1,-0.9152046055104933,29,5,24,26,0.03083061065311676,0.678856737573712
금리인하/NNG;단행함/VVX,-1,-0.9186684377935269,24,4,20,23,0.02790843428420537,0.6411513277510796
신용등급/NNG;하향조정할/VVX,-1,-0.9256264513103126,19,3,16,13,0.023912395752969707,0.6014355423355706
기준금리/NNG;내린/VV;뒤/NNG,-1,-0.9256264513103126,19,3,16,24,0.023912395752969707,0.6014355423355706
소비/NNG;회복세/NNG;이어지/VV,-1,-0.9256264513103126,19,3,16,8,0.023912395752969707,0.6014355423355706
가계부채/NNG;자본유출입/NNG;점검해/VVX,-1,-0.9256264513103126,19,3,16,11,0.023912395752969707,0.6014355423355706
경기하강/NNG;위험/NNG;남/VV,-1,-0.9256264513103126,19,3,16,13,0.023912395752969707,0.6014355423355706
금리인하/NNG;나선/VV,-1,-0.9285992441719656,25,4,21,41,0.024848925707642005,0.651236341123021
경기침체/NNG;이어질/VV,-1,-0.9346002242882948,37,6,31,25,0.025873299739809792,0.7405695386205972
유동성함정/NNG;빠진/VV,-1,-0.9365060223879977,20,3,17,8,0.020757494952626108,0.6119770538634559
가계대출/NNG;상회하/VVX,-1,-0.9365060223879977,20,3,17,23,0.020757494952626108,0.6119770538634559
기대인플레이션/NNG;낮추/VV,-1,-0.9365060223879977,20,3,17,9,0.020757494952626108,0.6119770538634559
금리/NNG;내려도/VV,-1,-0.936935062844547,26,4,22,22,0.022273939584920854,0.6611481885827472
재정지출확대/NNG;따른/VV,-1,-0.94397724146404,27,4,23,24,0.02009053575675454,0.6708905706922079
물가/NNG;고려하/VVX,-1,-0.9452772477500045,21,3,18,18,0.01820897862855746,0.6223604052684464
기준금리/NNG;만장일치/NNG;동결되/VVX,-1,-0.9452772477500045,21,3,18,31,0.01820897862855746,0.6223604052684464
인플레이션/NNG;완화됐/VVX,-1,-0.9502313353545794,15,2,13,5,0.0152121847543085,0.5709427928063272
기준금리인하/NNG;내린/VV,-1,-0.9502313353545794,15,2,13,6,0.0152121847543085,0.5709427928063272
불안요인/NNG;부각되/VVX,-1,-0.9502313353545794,15,2,13,29,0.0152121847543085,0.5709427928063272
기준금리/NNG;인상된/VVX;하/VV,-1,-0.9502313353545794,15,2,13,26,0.0152121847543085,0.5709427928063272
물가/NNG;억제하/VVX,-1,-0.9502313353545794,15,2,13,21,0.0152121847543085,0.5709427928063272
부양책/NNG;쏟/VV,-1,-0.9502313353545794,15,2,13,7,0.0152121847543085,0.5709427928063272
불안요인/NNG;작용했/VVX,-1,-0.9583058379634859,23,3,20,20,0.014403491567792274,0.6426713912478389
경기/NNG;부추기/VV,-1,-0.9585707175354381,16,2,14,4,0.012956393467299543,0.5816910674304847
불안/NNG;계속될/VVX,-1,-0.9585707175354381,16,2,14,6,0.012956393467299543,0.5816910674304847
경제지표/NNG;악화된/VVX,-1,-0.9585707175354381,16,2,14,12,0.012956393467299543,0.5816910674304847
경기침체/NNG;지속될/VVX,-1,-0.9631929481156667,24,3,21,16,0.012965483896041888,0.6526026669539425
소매판매/NNG;감소하/VVX,-1,-0.9650044573983264,17,2,15,35,0.011210899515842221,0.5923116003412329
투자심리/NNG;개선된/VVX,-1,-0.9650044573983264,17,2,15,24,0.011210899515842221,0.5923116003412329
경기후퇴/NNG;겪/VV,-1,-0.9650044573983264,17,2,15,5,0.011210899515842221,0.5923116003412329
경기둔화우려/NNG;반영하/VVX,-1,-0.9700584768072231,18,2,16,17,0.009834206316121783,0.60280744786018
금리인하/NNG;했/VV,-1,-0.9740937935917503,19,2,17,22,0.008729835516480586,0.6131789136332363
금리동결/NNG;주장했/VVX,-1,-0.9740937935917503,19,2,17,47,0.008729835516480586,0.6131789136332363
기준금리/NNG;하향조정하/VVX,-1,-0.9886343150618185,37,3,34,16,0.005237187327712937,0.7675978875091309
신용경색/NNG;풀리/VV,-1,-0.9905753045664442,16,1,15,8,0.003463980086235076,0.5930140191731561
수출/NNG;감소세/NNG;확대되/VVX,-1,-0.991649308576661,30,2,28,4,0.0038064574312674476,0.7183303319027908
수출/NNG;가/VV,-1,-0.9926071642936865,18,1,17,2,0.0029556888835258035,0.6137361531112432
소비자물가/NNG;큰/VA;영향/NNG;미치/VV,-1,-0.9926071642936865,18,1,17,2,0.0029556888835258035,0.6137361531112432
성장경로/NNG;하회할/VVX,-1,-0.9926071642936865,18,1,17,7,0.0029556888835258035,0.6137361531112432
하방리스크/NNG;커졌/VV,-1,-0.9928161500626814,32,2,30,32,0.0034646639047723462,0.735512343592435
경기위축/NNG;의미한/VVX,-1,-0.9933770856942923,19,1,18,13,0.0027626857874678023,0.6239289398733971
기준금리/NNG;인하하/VVX;했/VV,-1,-0.9996339597761754,15,0,15,6,0.0007627749584693897,0.5932538430877328
경상수지/NNG;줄어들/VV,-1,-0.9997205186579528,17,0,17,5,0.0007627749584693897,0.6139444420104267
침체/NNG;막/VV,-1,-1.0,25,0,25,23,0.0007627749584693897,0.6918374102020698
