word,label,polarity,count,pos_count,neg_count,neu_count,pos_score,neg_score
성장능력/NNG;괜찮/VA;경로이/VVX,1,1.0,34,34,0,0,0.7698183149571275,8.901813905619606e-05
금리/NNG;너무/MAG;낮/VA;아니/VCN;올리/VV,1,0.9999954513937679,32,32,0,0,0.7549761214553922,8.901813905619606e-05
금리인상/NNG;부동산가격/NNG;영향/NNG;주/VV;아니/VCN,1,0.9999930404772752,31,31,0,0,0.7473389454194236,8.901813905619606e-05
흑자/NNG;정부/NNG;가/VV,1,0.9999852135655873,28,28,0,0,0.7235763201964391,8.901813905619606e-05
경상수지/NNG;흑자/NNG;기조다/VVX,1,0.9999764020533277,25,25,0,0,0.698569968094746,8.901813905619606e-05
가계부채/NNG;문제/NNG;있/VA;정상/NNG;돌아가/VV,1,0.999969914337173,23,23,0,0,0.6812355989013017,8.901813905619606e-05
수출/NNG;높/VA;증가세/NNG;지속하/VVX,1,0.9999425808832134,16,16,0,1,0.616756107457991,8.901813905619606e-05
환율하락/NNG;예상하/VVX,1,0.9994632768333158,27,26,1,3,0.7070176390047063,0.00027145860111114846
수요압력/NNG;증대될/VVX,1,0.998895368503427,19,18,1,11,0.6357080723201627,0.000424658722686971
경기/NNG;부진해/VVX,1,0.9981287652750013,15,14,1,12,0.5973222904425914,0.0006282096353349278
금리/NNG;상승세/NNG;쉬/VV,1,0.9965510273534388,22,20,2,16,0.6541730525567434,0.001205200451591061
경기회복세/NNG;되/VV,1,0.9949955336835448,28,25,3,33,0.6983565594237303,0.001831803474811957
금융위기/NNG;극복/NNG;위한/VV,1,0.9946652196364094,19,17,2,10,0.6261382261017762,0.0017462743476897114
물가안정기조/NNG;유지될/VVX,1,0.9937987081485435,34,30,4,23,0.7392438243759649,0.0023837133279131515
금리/NNG;낮/VA;있/VV,1,0.9936311698661018,26,23,3,3,0.6809833682966123,0.0022532305407944792
금리인상/NNG;이뤄지지/VV,1,0.9916495939478953,24,21,3,25,0.6630889624499196,0.0028555657736282158
견실한/VAX;성장세/NNG;이/VV,1,0.9916495939478953,24,21,3,26,0.6630889624499196,0.0028555657736282158
성장경로/NNG;불확실성/NNG;상존하/VVX,1,0.9907072074247398,16,14,2,23,0.5971222327036434,0.002855212965232832
경제성장/NNG;가능할/VVX,1,0.9876107421232094,28,24,4,2,0.6894530525342734,0.004375316289061335
금리/NNG;상승세/NNG;지속하/VVX,1,0.9857876220279329,27,23,4,11,0.6806664668420142,0.004948074470016476
금리/NNG;올리/VV;못하/VX,1,0.98385551389727,20,17,3,16,0.6257986871913922,0.005162773151772859
불확실성/NNG;상존한/VVX,1,0.9817981419400967,48,40,8,18,0.8096105217988177,0.007526138342452603
콜금리/NNG;올렸/VV,1,0.9814973168041679,31,26,5,8,0.7062072982129607,0.0066730516580538485
잠재성장률/NNG;달성하/VVX,1,0.9803585200265019,19,16,3,4,0.6161697914534977,0.00617974532652063
경제위기/NNG;겪/VV,1,0.9774697516862236,24,20,4,11,0.6534862231480706,0.007517667620614286
금융완화/NNG;유지하/VVX,1,0.9767352082733758,123,100,23,107,0.9854716772699683,0.011707006480208625
동결/NNG;결정했/VVX,1,0.9757321806201551,18,15,3,28,0.606416361473571,0.007515323666126524
흑자/NNG;줄어들/VV,1,0.9732346604761941,23,19,4,23,0.6441513793999313,0.008807908895895595
성장경로/NNG;크/VA;벗어나/VV;않/VX,1,0.9732346604761941,23,19,4,26,0.6441513793999313,0.008807908895895595
잠재성장률/NNG;웃돌/VV,1,0.9719726129696782,28,23,5,12,0.6800952824109967,0.00974034932232681
물가상승압력/NNG;크/VA;않/VX;전망되/VVX,1,0.9719726129696782,28,23,5,20,0.6800952824109967,0.00974034932232681
통화정책/NNG;완화/NNG;유지해/VVX,1,0.9719726129696782,28,23,5,31,0.6800952824109967,0.00974034932232681
금리인상/NNG;배제할/VVX,1,0.969495812088722,17,14,3,7,0.5965331312990657,0.009304067503870752
통화정책/NNG;방향/NNG;조정/NNG;검토해/VVX;할/VX,1,0.969495812088722,17,14,3,3,0.5965331312990657,0.009304067503870752
인플레이션우려/NNG;상존해/VVX,1,0.9678632114536911,22,18,4,23,0.6346756462616405,0.010433425908091343
변동성/NNG;과도하/VVX,1,0.9609681852072265,21,17,4,15,0.6250538432533761,0.01250787341047836
경제/NNG;우려/NNG;커지/VV,1,0.9609174680702655,16,13,3,16,0.5865097174770126,0.01175203593752999
높/VA;변동성/NNG;지속될/VVX,1,0.9609174680702655,16,13,3,11,0.5865097174770126,0.01175203593752999
물가불안/NNG;따른/VV,1,0.9609174680702655,16,13,3,17,0.5865097174770126,0.01175203593752999
생산/NNG;감소하/VVX,1,0.9609174680702655,16,13,3,19,0.5865097174770126,0.01175203593752999
경기/NNG;상승세/NNG;이어질/VV,1,0.9609174680702655,16,13,3,7,0.5865097174770126,0.01175203593752999
콜금리/NNG;조정하/VVX,1,0.9609174680702655,16,13,3,10,0.5865097174770126,0.01175203593752999
기준금리/NNG;상향조정하/VVX,1,0.9505270853983259,38,30,8,17,0.736919938547073,0.01876773293921246
성장/NNG;될/VV,1,0.9499981169251126,51,40,11,10,0.8073300140252335,0.020785372173728806
경기/NNG;끌어내리/VV,1,0.9488625909329482,15,12,3,5,0.5763270408977679,0.015182261386825735
기준금리/NNG;인상했/VVX;금리인상/NNG,1,0.9488625909329482,15,12,3,4,0.5763270408977679,0.015182261386825735
투자심리/NNG;짓누르/VV,1,0.9488625909329482,15,12,3,11,0.5763270408977679,0.015182261386825735
소비/NNG;확대하/VVX,1,0.9488625909329482,15,12,3,4,0.5763270408977679,0.015182261386825735
성장세/NNG;약화될/VVX,1,0.9488625909329482,15,12,3,16,0.5763270408977679,0.015182261386825735
금리인하/NNG;시사하/VVX;않/VX,1,0.9488625909329482,15,12,3,11,0.5763270408977679,0.015182261386825735
신흥시장/NNG;경제/NNG;계속/MAG;호조/NNG;나타내/VV,1,0.9488625909329482,15,12,3,9,0.5763270408977679,0.015182261386825735
동결/NNG;이/VV;갔/VV,1,0.9488625909329482,15,12,3,13,0.5763270408977679,0.015182261386825735
인플레이션억제/NNG;위한/VV,1,0.945344326705668,50,39,11,18,0.800602002013448,0.022575584242314088
견조한/VAX;성장/NNG;지속할/VVX,1,0.9370245310347551,36,28,8,10,0.7203840199997721,0.02349313006682601
인플레이션갭/NNG;전환된/VVX,1,0.9316235992660131,27,21,6,13,0.6607107356128836,0.023453588927816314
대외불확실성/NNG;완화되/VVX,1,0.9276853477239742,47,36,11,39,0.7793661540542438,0.029313360751938133
기준금리/NNG;유지한/VVX,1,0.9237163349149944,66,50,16,52,0.8609253823752593,0.03422294200175945
국제원자재가격/NNG;상승하/VVX,1,0.9208865305316445,22,17,5,13,0.6236592923574719,0.02574601819652703
성장/NNG;기대된/VVX,1,0.9208865305316445,22,17,5,14,0.6236592923574719,0.02574601819652703
물가안정/NNG;있/VV,1,0.9208865305316445,22,17,5,19,0.6236592923574719,0.02574601819652703
물가안정기조/NNG;하/VV,1,0.9208865305316445,22,17,5,20,0.6236592923574719,0.02574601819652703
콜금리/NNG;올린/VV,1,0.9069174375139257,33,25,8,11,0.6941823780473098,0.03394939175647402
콜금리/NNG;경기회복/NNG;뒷받침하/VVX,1,0.9038675937590894,25,19,6,4,0.6414974796890701,0.03245005365591056
채권시장/NNG;강세/NNG;작용할/VVX,1,0.9038675937590894,25,19,6,15,0.6414974796890701,0.03245005365591056
높/VA;성장률/NNG;보이/VV,1,0.9033019567244733,17,13,4,5,0.5848251196522543,0.029765777224108725
투자심리/NNG;긍정적/VAX;작용했/VVX,1,0.9033019567244733,17,13,4,15,0.5848251196522543,0.029765777224108725
출구전략/NNG;지연될/VVX,1,0.9033019567244733,17,13,4,14,0.5848251196522543,0.029765777224108725
재정건전성/NNG;유지하/VVX,1,0.9033019567244733,17,13,4,13,0.5848251196522543,0.029765777224108725
부양책/NNG;따른/VV,1,0.9033019567244733,17,13,4,15,0.5848251196522543,0.029765777224108725
신용등급/NNG;강등당/VVX,1,0.9029995669207282,21,16,5,6,0.6136016839489316,0.031332819037222966
경기/NNG;상승세/NNG;따른/VV,1,0.9029995669207282,21,16,5,17,0.6136016839489316,0.031332819037222966
금리/NNG;인상되/VVX;않/VX,1,0.9029995669207282,21,16,5,27,0.6136016839489316,0.031332819037222966
경기/NNG;나아지/VV,1,0.8931637569020854,32,24,8,28,0.6850410345809174,0.03871938558010767
경기둔화우려/NNG;부각되/VVX,1,0.8892847035319702,28,21,7,23,0.6588395301700016,0.03866676998377417
신용등급/NNG;강등된/VVX,1,0.8892847035319702,28,21,7,23,0.6588395301700016,0.03866676998377417
물가/NNG;올리/VV,1,0.8892847035319702,28,21,7,17,0.6588395301700016,0.03866676998377417
물가/NNG;낮/VA;유지하/VVX,1,0.8849223165645212,24,18,6,12,0.6315571433792166,0.038612097657500184
부동산가격/NNG;잡/VV,1,0.8820000867324196,67,49,18,14,0.8518973159354345,0.05348603476658259
단기금리/NNG;상승/NNG;따른/VV,1,0.8800116322378926,20,15,5,15,0.6032933245147684,0.03855528087883617
금리인상/NNG;나타나/VV,1,0.8778708891142808,63,46,17,7,0.8360892840595939,0.05444624287943847
신흥시장/NNG;경제/NNG;호조/NNG;지속하/VVX,1,0.8769405361953997,31,23,8,13,0.6756738971968392,0.04435648269101783
내수/NNG;개선되/VVX,1,0.8769405361953997,31,23,8,43,0.6756738971968392,0.04435648269101783
성장률/NNG;나오/VV,1,0.8744777753881288,16,12,4,9,0.5741676577478292,0.03849622795156092
경기회복/NNG;시사하/VVX,1,0.8744777753881288,16,12,4,15,0.5741676577478292,0.03849622795156092
경기/NNG;과열되/VVX,1,0.8744777753881288,16,12,4,14,0.5741676577478292,0.03849622795156092
기준금리/NNG;인상됨/VVX,1,0.8744777753881288,16,12,4,6,0.5741676577478292,0.03849622795156092
인플레이션압력/NNG;커졌/VV,1,0.8744777753881288,16,12,4,10,0.5741676577478292,0.03849622795156092
재정적자/NNG;축소하/VVX,1,0.8744777753881288,16,12,4,17,0.5741676577478292,0.03849622795156092
기준금리인상/NNG;시기/NNG;늦춰질/VV,1,0.8744777753881288,16,12,4,19,0.5741676577478292,0.03849622795156092
재정/NNG;조기/NNG;집행하/VVX,1,0.8744777753881288,16,12,4,23,0.5741676577478292,0.03849622795156092
물가상승률/NNG;낮/VA;수준이/VVX,1,0.8744777753881288,16,12,4,11,0.5741676577478292,0.03849622795156092
기업실적호조/NNG;힘입/VV,1,0.8744777753881288,16,12,4,7,0.5741676577478292,0.03849622795156092
유동성/NNG;유지되/VVX,1,0.8744777753881288,16,12,4,12,0.5741676577478292,0.03849622795156092
불안/NNG;가시/VV;않/VX,1,0.8744777753881288,16,12,4,14,0.5741676577478292,0.03849622795156092
경기/NNG;상승세/NNG;지속되/VVX,1,0.8736713153183231,38,28,10,10,0.7167072737312844,0.04838205204294666
투자심리/NNG;고무시/VVX,1,0.8700093424930271,27,20,7,18,0.6490492656392742,0.04517072408023268
소비/NNG;개선되/VVX,1,0.8664741653264545,48,35,13,29,0.7679634730431792,0.05500142989967641
단기금리/NNG;올리/VV,1,0.8614325043124407,23,17,6,1,0.6213544834009143,0.04630368579625099
유럽재정위기/NNG;해결/NNG;위한/VV,1,0.8614325043124407,23,17,6,13,0.6213544834009143,0.04630368579625099
금융완화/NNG;줄여/VV,1,0.8614325043124407,23,17,6,33,0.6213544834009143,0.04630368579625099
금리/NNG;올리/VV;쉽/VA;않/VX,1,0.8614325043124407,23,17,6,25,0.6213544834009143,0.04630368579625099
투자심리/NNG;부정적/VAX;영향/NNG;미치/VV,1,0.8503659484964203,19,14,5,4,0.5926808735214045,0.047973416602558765
금리/NNG;하방경직성/NNG;강화되/VVX,1,0.8503659484964203,19,14,5,17,0.5926808735214045,0.047973416602558765
금리/NNG;상승/NNG;제한되/VVX,1,0.8503659484964203,19,14,5,11,0.5926808735214045,0.047973416602558765
경기/NNG;찬물/NNG;끼얹/VV,1,0.8467582427829659,26,19,7,14,0.6389910066971218,0.05307041082937907
금리/NNG;인상된/VVX,1,0.8440388433156387,43,31,12,57,0.7376787055896881,0.062444249184597296
금리인상/NNG;대비해/VVX,1,0.8351722040842107,29,21,8,28,0.6561795200109976,0.058981963462186995
경제여건/NNG;악화되/VVX,1,0.8350681361394452,15,11,4,8,0.5631221422526007,0.05065210557281102
경제/NNG;활력/NNG;회복하/VVX,1,0.8350681361394452,15,11,4,5,0.5631221422526007,0.05065210557281102
불안/NNG;야기할/VVX,1,0.8350681361394452,15,11,4,24,0.5631221422526007,0.05065210557281102
기준금리인상/NNG;결정하/VVX,1,0.8350681361394452,15,11,4,18,0.5631221422526007,0.05065210557281102
기준금리/NNG;상향조정해/VVX,1,0.8350681361394452,15,11,4,4,0.5631221422526007,0.05065210557281102
금융완화/NNG;유지한/VVX,1,0.8350681361394452,15,11,4,12,0.5631221422526007,0.05065210557281102
불안/NNG;초래하/VVX,1,0.8350681361394452,15,11,4,9,0.5631221422526007,0.05065210557281102
경기회복/NNG;가능할/VVX,1,0.8350681361394452,15,11,4,5,0.5631221422526007,0.05065210557281102
금리인하기대감/NNG;남/VV,1,0.8350681361394452,15,11,4,17,0.5631221422526007,0.05065210557281102
경기상승/NNG;이어지/VV,1,0.834037640569034,49,35,14,9,0.7653459654721374,0.06931029569627337
침체/NNG;빠지/VV;않/VX,1,0.8327330267286992,39,28,11,14,0.7140467133057038,0.06521857559108193
국제원자재가격/NNG;오르/VV,1,0.8327330267286992,39,28,11,5,0.7140467133057038,0.06521857559108193
금리인상/NNG;자제해/VVX,1,0.832288827575759,22,16,6,6,0.6108437626887944,0.05595388476153151
생산/NNG;증가했/VVX,1,0.832288827575759,22,16,6,15,0.6108437626887944,0.05595388476153151
기준금리인상/NNG;단행되/VVX,1,0.8259905595130548,32,23,9,29,0.672896055614698,0.06416995354125891
기준금리/NNG;동결한/VAX;배경/NNG;설명했/VVX,1,0.8259905595130548,32,23,9,15,0.672896055614698,0.06416995354125891
경기회복세/NNG;둔화될/VVX,1,0.8259905595130548,32,23,9,24,0.672896055614698,0.06416995354125891
금리상승/NNG;축소되/VVX,1,0.8259905595130548,32,23,9,33,0.672896055614698,0.06416995354125891
듀레이션/NNG;늘리/VV,1,0.8259905595130548,32,23,9,33,0.672896055614698,0.06416995354125891
인플레이션/NNG;억제될/VVX,1,0.818730730244071,25,18,7,19,0.6286259762456405,0.06269507044472622
물가안정/NNG;지키/VV,1,0.818730730244071,25,18,7,1,0.6286259762456405,0.06269507044472622
물가상승압력/NNG;이어질/VV,1,0.818730730244071,25,18,7,12,0.6286259762456405,0.06269507044472622
인플레이션기대심리/NNG;확산될/VVX,1,0.818730730244071,25,18,7,5,0.6286259762456405,0.06269507044472622
경제/NNG;반등하/VVX,1,0.812134143582709,18,13,5,22,0.5816834834332266,0.06034052946715269
물가목표/NNG;달성/NNG;위해/VV,1,0.812134143582709,18,13,5,21,0.5816834834332266,0.06034052946715269
금리동결/NNG;내리/VV,1,0.812134143582709,18,13,5,2,0.5816834834332266,0.06034052946715269
동결/NNG;가/VV,1,0.812134143582709,18,13,5,7,0.5816834834332266,0.06034052946715269
흑자/NNG;내/VV,1,0.812134143582709,18,13,5,21,0.5816834834332266,0.06034052946715269
부양책/NNG;발표하/VVX,1,0.812134143582709,18,13,5,3,0.5816834834332266,0.06034052946715269
금리인상/NNG;지속해/VVX,1,0.812134143582709,18,13,5,12,0.5816834834332266,0.06034052946715269
경제/NNG;위축시/VVX,1,0.812134143582709,18,13,5,14,0.5816834834332266,0.06034052946715269
기준금리/NNG;올리/VV;쉽/VA;않/VX,1,0.812134143582709,18,13,5,5,0.5816834834332266,0.06034052946715269
금리상승/NNG;기다리/VV,1,0.8085087315116548,28,20,8,23,0.6459943464824388,0.06844020446337251
경기둔화/NNG;나타나/VV,1,0.8085087315116548,28,20,8,16,0.6459943464824388,0.06844020446337251
내수/NNG;증가하/VVX,1,0.801102886147006,47,33,14,31,0.7487312142064178,0.08272742074664802
경기/NNG;위험요인/NNG;상존하/VVX,1,0.7985199217203174,50,35,15,21,0.7622603071475945,0.08543717702990924
콜금리/NNG;인하하/VVX,1,0.7962036532306076,21,15,6,9,0.5999595464578501,0.06810570626535462
경제성장률/NNG;하락할/VVX,1,0.7962036532306076,21,15,6,16,0.5999595464578501,0.06810570626535462
콜금리/NNG;위한/VV,1,0.7962036532306076,21,15,6,6,0.5999595464578501,0.06810570626535462
금리인상/NNG;미룰/VV,1,0.7962036532306076,21,15,6,24,0.5999595464578501,0.06810570626535462
생산/NNG;증가하/VVX,1,0.7903064864274116,37,26,11,33,0.6953214358130487,0.08147965752458665
콜금리/NNG;인상했/VVX,1,0.7897096034454612,68,47,21,31,0.8317293716698725,0.09777400952789526
금융완화/NNG;유지할/VVX,1,0.7850384571674052,24,17,7,22,0.6179011216509237,0.07444329788345606
금리인상/NNG;했/VV,1,0.7850384571674052,24,17,7,15,0.6179011216509237,0.07444329788345606
출구전략/NNG;시행되/VVX,1,0.7771617425279596,27,19,8,25,0.6354628427305122,0.07971291040909832
마이너스/NNG;보였/VV,1,0.7715941518658713,30,21,9,13,0.6526051984757198,0.08417000849399914
금리인상/NNG;신중하/VVX,1,0.7676738132188725,33,23,10,22,0.6692946275753499,0.08799727160782045
재정위기/NNG;인해/VV,1,0.7676738132188725,33,23,10,27,0.6692946275753499,0.08799727160782045
유가급락/NNG;따른/VV,1,0.7630817810485433,39,27,12,35,0.7012077409724911,0.09425826453586575
금리인하/NNG;중단할/VVX,1,0.7630780576534746,17,12,5,5,0.5701768835986146,0.07664610304152175
물가안정/NNG;웃돌/VV,1,0.7630780576534746,17,12,5,4,0.5701768835986146,0.07664610304152175
강한/VA;성장세/NNG;보일/VV,1,0.7630780576534746,17,12,5,13,0.5701768835986146,0.07664610304152175
대외불확실성/NNG;해소되/VVX,1,0.7630780576534746,17,12,5,13,0.5701768835986146,0.07664610304152175
신용스프레드/NNG;크/VA;확대되/VVX,1,0.7630780576534746,17,12,5,6,0.5701768835986146,0.07664610304152175
동결/NNG;하/VV,1,0.7630780576534746,17,12,5,20,0.5701768835986146,0.07664610304152175
경기/NNG;이동하/VVX,1,0.7630780576534746,17,12,5,3,0.5701768835986146,0.07664610304152175
gdp/NNG;감소했/VVX,1,0.7630780576534746,17,12,5,14,0.5701768835986146,0.07664610304152175
경제성장률/NNG;낮추/VV,1,0.7605268039350372,51,35,16,49,0.7586814432445772,0.10323228565182747
콜금리/NNG;인상하/VVX,1,0.7604175550141692,159,107,52,73,0.9561117498371595,0.13016360294769672
투자심리/NNG;회복될/VVX,1,0.7517752570273002,20,14,6,20,0.5886072502764466,0.08342917202300051
기준금리인상/NNG;신중할/VVX,1,0.7517752570273002,20,14,6,7,0.5886072502764466,0.08342917202300051
기준금리인상/NNG;시작될/VVX,1,0.7517752570273002,20,14,6,21,0.5886072502764466,0.08342917202300051
기준금리인상/NNG;시사했/VVX,1,0.7517752570273002,20,14,6,22,0.5886072502764466,0.08342917202300051
경기/NNG;바닥/NNG;확인하/VVX,1,0.7517752570273002,20,14,6,10,0.5886072502764466,0.08342917202300051
수출호조/NNG;이어지/VV,1,0.7517752570273002,20,14,6,11,0.5886072502764466,0.08342917202300051
성장률전망/NNG;낮췄/VV,1,0.7517752570273002,20,14,6,7,0.5886072502764466,0.08342917202300051
금리/NNG;동결됐/VVX,1,0.7517752570273002,20,14,6,32,0.5886072502764466,0.08342917202300051
인플레이션기대심리/NNG;높/VA;물가상승률/NNG;이어질/VV,1,0.7447537542472931,23,16,7,1,0.6067432679947674,0.08878581444933131
성장세/NNG;회복할/VVX,1,0.7404867043156513,26,18,8,31,0.6245273596875647,0.09314222588303188
물가/NNG;있/VV,1,0.737240257933705,41,28,13,20,0.706798746710874,0.10692903516657624
물가상승압력/NNG;커질/VV,1,0.7366512928416791,38,26,12,30,0.6913272310718228,0.10485815598101417
불확실성/NNG;해소하/VVX,1,0.7366512928416791,38,26,12,36,0.6913272310718228,0.10485815598101417
인플레이션/NNG;완화될/VVX,1,0.7364526375956075,35,24,11,11,0.6753412003873438,0.1025223714172336
불안요인/NNG;남/VV,1,0.7253375483704034,58,39,19,57,0.7801221221168961,0.12421391401485143
성장/NNG;이/VV;갈/VX,1,0.7207105222867833,52,35,17,50,0.7545903234167332,0.12249930022836197
불확실성/NNG;높/VA;상황이/VVX,1,0.712891525020203,43,29,14,34,0.7121144314034136,0.11937969580912224
경기/NNG;회복된/VVX,1,0.7101212703024424,40,27,13,18,0.6968635853423086,0.11814026382271575
수출/NNG;호조/NNG;지속하/VVX,1,0.7101212703024424,40,27,13,11,0.6968635853423086,0.11814026382271575
하방위험/NNG;있/VV,1,0.7073299063720229,37,25,12,42,0.6810854297985512,0.11676681707844826
불확실성/NNG;지속될/VVX,1,0.707133259186862,91,60,31,107,0.8734948835372691,0.14987171818836892
인플레이션기대심리/NNG;확산되/VVX,1,0.7045828871231026,34,23,11,17,0.6647970078477983,0.11522849332504233
확장/NNG;유지하/VVX,1,0.7019788806955767,31,21,10,3,0.6480197921863625,0.11348306018345926
금리상승/NNG;예상하/VVX,1,0.7019788806955767,31,21,10,46,0.6480197921863625,0.11348306018345926
기준금리동결/NNG;이/VV,1,0.7008918648842417,16,11,5,20,0.5579666636307299,0.09813145960076936
금리/NNG;속등했/VVX,1,0.7008918648842417,16,11,5,7,0.5579666636307299,0.09813145960076936
기준금리인하/NNG;가능할/VVX,1,0.7008918648842417,16,11,5,28,0.5579666636307299,0.09813145960076936
물가/NNG;압력/NNG;완화되/VVX,1,0.7008918648842417,16,11,5,7,0.5579666636307299,0.09813145960076936
물가/NNG;대응하/VVX,1,0.7008918648842417,16,11,5,12,0.5579666636307299,0.09813145960076936
재할인율/NNG;인하해/VVX,1,0.7008918648842417,16,11,5,10,0.5579666636307299,0.09813145960076936
금리인상/NNG;암시하/VVX,1,0.7008918648842417,16,11,5,8,0.5579666636307299,0.09813145960076936
금리인하/NNG;가능성/NNG;높여/VV,1,0.7008918648842417,16,11,5,11,0.5579666636307299,0.09813145960076936
경기/NNG;확장세/NNG;보이/VV,1,0.7008918648842417,16,11,5,10,0.5579666636307299,0.09813145960076936
동결/NNG;결정하/VVX,1,0.7008918648842417,16,11,5,8,0.5579666636307299,0.09813145960076936
경기회복/NNG;고유가/NNG;따른/VV,1,0.7008918648842417,16,11,5,7,0.5579666636307299,0.09813145960076936
실물경제/NNG;파급될/VVX,1,0.7008918648842417,16,11,5,2,0.5579666636307299,0.09813145960076936
금리인상/NNG;배경/NNG;설명했/VVX,1,0.7008918648842417,16,11,5,11,0.5579666636307299,0.09813145960076936
투자심리/NNG;냉각되/VVX,1,0.7008918648842417,16,11,5,6,0.5579666636307299,0.09813145960076936
하향안정/NNG;흐름/NNG;이/VV,1,0.7008918648842417,16,11,5,10,0.5579666636307299,0.09813145960076936
불안/NNG;대응하/VVX,1,0.7008918648842417,16,11,5,18,0.5579666636307299,0.09813145960076936
기준금리인상/NNG;가능성/NNG;있/VV,1,0.7008918648842417,16,11,5,6,0.5579666636307299,0.09813145960076936
금리인상/NNG;재개되/VVX,1,0.7008918648842417,16,11,5,7,0.5579666636307299,0.09813145960076936
성장세/NNG;인해/VV,1,0.7008918648842417,16,11,5,10,0.5579666636307299,0.09813145960076936
경기둔화/NNG;가능성/NNG;제기되/VVX,1,0.7008918648842417,16,11,5,15,0.5579666636307299,0.09813145960076936
경기둔화우려/NNG;확대되/VVX,1,0.7008918648842417,16,11,5,8,0.5579666636307299,0.09813145960076936
경제여건/NNG;개선되/VVX,1,0.7008918648842417,16,11,5,17,0.5579666636307299,0.09813145960076936
금리인상/NNG;가능성/NNG;높/VA;보이/VV,1,0.7008918648842417,16,11,5,18,0.5579666636307299,0.09813145960076936
성장/NNG;주도할/VVX,1,0.7008918648842417,16,11,5,11,0.5579666636307299,0.09813145960076936
인플레이션/NNG;인해/VV,1,0.6996681846094757,28,19,9,15,0.6307802592093933,0.1114710776880475
금리/NNG;동결함/VVX,1,0.6996681846094757,28,19,9,24,0.6307802592093933,0.1114710776880475
고용지표부진/NNG;따른/VV,1,0.6978842056121495,25,17,8,23,0.6131107051921212,0.10910606560382273
경제성장/NNG;미치/VV,1,0.6978842056121495,25,17,8,19,0.6131107051921212,0.10910606560382273
금리/NNG;높여/VV,1,0.6978842056121495,25,17,8,18,0.6131107051921212,0.10910606560382273
산업생산/NNG;감소해/VVX,1,0.6978842056121495,25,17,8,8,0.6131107051921212,0.10910606560382273
금리하락/NNG;동조화되/VVX,1,0.6978842056121495,25,17,8,27,0.6131107051921212,0.10910606560382273
금리/NNG;올릴/VV;필요/NNG;있/VA,1,0.6976375117671392,19,13,6,8,0.5766484365383444,0.10271606831617361
유동성/NNG;지속되/VVX,1,0.6976375117671392,19,13,6,14,0.5766484365383444,0.10271606831617361
물가안정/NNG;상단인/VVX,1,0.6976375117671392,19,13,6,12,0.5766484365383444,0.10271606831617361
주택시장/NNG;지원하/VVX,1,0.6976375117671392,19,13,6,7,0.5766484365383444,0.10271606831617361
기준금리인상/NNG;예상했/VVX,1,0.6976375117671392,19,13,6,22,0.5766484365383444,0.10271606831617361
신용등급/NNG;내렸/VV,1,0.6976375117671392,19,13,6,9,0.5766484365383444,0.10271606831617361
재정적자/NNG;달성하/VVX,1,0.6976375117671392,19,13,6,5,0.5766484365383444,0.10271606831617361
금리하락/NNG;이어졌/VV,1,0.6976375117671392,19,13,6,8,0.5766484365383444,0.10271606831617361
금리인상/NNG;배제하/VVX,1,0.6976375117671392,19,13,6,17,0.5766484365383444,0.10271606831617361
채권시장/NNG;부담/NNG;작용했/VVX,1,0.6976375117671392,19,13,6,12,0.5766484365383444,0.10271606831617361
경제지표/NNG;하회하/VVX,1,0.697000118991544,22,15,7,48,0.5950505269861086,0.10625709626646836
금리/NNG;끌어올렸/VV,1,0.697000118991544,22,15,7,12,0.5950505269861086,0.10625709626646836
안전자산선호심리/NNG;약화될/VVX,1,0.697000118991544,22,15,7,18,0.5950505269861086,0.10625709626646836
금리정상화/NNG;나설/VV,1,0.697000118991544,22,15,7,12,0.5950505269861086,0.10625709626646836
변동성/NNG;축소되/VVX,1,0.6900569998899502,45,30,15,65,0.717173137640572,0.13153441626827758
변동성/NNG;줄어들/VV,1,0.6889669012664665,59,39,20,43,0.7756922845184913,0.14285930239893416
성장률/NNG;하/VV,1,0.6853864087038912,42,28,14,35,0.70213349560687,0.13107714715953378
금리/NNG;올려서/VV,1,0.6803581021400682,39,26,13,39,0.6865526226673829,0.1306047866120982
금리/NNG;올린/VV,1,0.6780585539936614,170,110,60,141,0.9409599803965202,0.18053511918411935
금리인하/NNG;시사하/VVX,1,0.674452846783473,50,33,17,48,0.7362653345321997,0.14315021862299346
콜금리/NNG;올릴/VV,1,0.6731148810916736,61,40,21,14,0.779411082047069,0.1522829044834191
금리/NNG;내려갈/VV,1,0.6695607413153899,80,52,28,43,0.8375921756782007,0.1657804398335492
기준금리/NNG;인상함/VVX,1,0.6691234548858342,33,22,11,44,0.6538225467213775,0.1296128909896791
인플레이션압력/NNG;대응하/VVX,1,0.6691234548858342,33,22,11,9,0.6538225467213775,0.1296128909896791
불확실성/NNG;제거됐/VVX,1,0.6628597545861188,30,20,10,18,0.6367098713437553,0.12909237766549492
소비자물가/NNG;급등하/VVX,1,0.6628597545861188,30,20,10,9,0.6367098713437553,0.12909237766549492
금리인상/NNG;남/VV,1,0.6624007294424843,44,29,15,40,0.7071560643840706,0.14360997392600405
채권시장/NNG;우호적/VAX;작용할/VVX,1,0.6580283369128015,63,41,22,99,0.7829369278823344,0.16148192764038755
금리/NNG;하향안정되/VVX,1,0.6561233728869398,27,18,9,22,0.6191293212080814,0.1285548168868831
금융시장안정/NNG;도모하/VVX,1,0.6561233728869398,27,18,9,1,0.6191293212080814,0.1285548168868831
리스크/NNG;완화될/VVX,1,0.6561233728869398,27,18,9,28,0.6191293212080814,0.1285548168868831
불안/NNG;야기하/VVX,1,0.6561233728869398,27,18,9,20,0.6191293212080814,0.1285548168868831
내수/NNG;부진하/VVX,1,0.6561233728869398,27,18,9,27,0.6191293212080814,0.1285548168868831
경기둔화우려/NNG;지속될/VVX,1,0.6488801614524717,24,16,8,19,0.6011086284966238,0.12799969259366337
불안/NNG;심화될/VVX,1,0.6488801614524717,24,16,8,17,0.6011086284966238,0.12799969259366337
금리인상/NNG;나/VV,1,0.6488801614524717,24,16,8,24,0.6011086284966238,0.12799969259366337
변동성/NNG;키울/VV;있/VV,1,0.6488801614524717,24,16,8,27,0.6011086284966238,0.12799969259366337
금융시장/NNG;변동성/NNG;확대되/VVX,1,0.6488801614524717,24,16,8,11,0.6011086284966238,0.12799969259366337
경제/NNG;둔화시/VVX,1,0.6488801614524717,24,16,8,9,0.6011086284966238,0.12799969259366337
경기/NNG;두/VV,1,0.6488801614524717,24,16,8,6,0.6011086284966238,0.12799969259366337
침체/NNG;벗어나/VV,1,0.6436702661488711,65,42,23,50,0.7862789853738074,0.17045062623672513
성장속도/NNG;둔화되/VVX,1,0.6410935714476025,21,14,7,11,0.5826794625620179,0.12742647864058881
소비지출/NNG;증가하/VVX,1,0.6410935714476025,21,14,7,18,0.5826794625620179,0.12742647864058881
물가상승률/NNG;하회하/VVX,1,0.6410935714476025,21,14,7,11,0.5826794625620179,0.12742647864058881
수출/NNG;타격/NNG;입/VV,1,0.6410935714476025,21,14,7,33,0.5826794625620179,0.12742647864058881
경제성장/NNG;이루/VV,1,0.6410935714476025,21,14,7,8,0.5826794625620179,0.12742647864058881
듀레이션/NNG;축소되/VVX,1,0.6410935714476025,21,14,7,22,0.5826794625620179,0.12742647864058881
자본확충/NNG;위한/VV,1,0.6410935714476025,21,14,7,44,0.5826794625620179,0.12742647864058881
수입/NNG;늘어나/VV,1,0.6410935714476025,21,14,7,22,0.5826794625620179,0.12742647864058881
설비투자/NNG;증가하/VVX,1,0.6410729955739778,46,30,16,19,0.7119482802781012,0.15570721561293008
콜금리/NNG;올리/VV,1,0.6365511160443851,78,50,28,48,0.8235976693049316,0.18289701938998226
금융위기/NNG;한창이/VVX,1,0.6327245465926459,18,12,6,14,0.563877442639863,0.1268346393105237
금리동결/NNG;점쳤/VV,1,0.6327245465926459,18,12,6,15,0.563877442639863,0.1268346393105237
기준금리인상/NNG;필요하/VVX,1,0.6327245465926459,18,12,6,11,0.563877442639863,0.1268346393105237
금리하락/NNG;나타날/VV,1,0.6327245465926459,18,12,6,12,0.563877442639863,0.1268346393105237
실업률/NNG;내려가/VV,1,0.6327245465926459,18,12,6,10,0.563877442639863,0.1268346393105237
기준금리동결/NNG;인해/VV,1,0.6327245465926459,18,12,6,13,0.563877442639863,0.1268346393105237
물가안정기조/NNG;유지하/VVX,1,0.6327245465926459,18,12,6,14,0.563877442639863,0.1268346393105237
투자심리/NNG;자극하/VVX,1,0.6327245465926459,18,12,6,8,0.563877442639863,0.1268346393105237
금융완화/NNG;기조하/VVX,1,0.6327245465926459,18,12,6,10,0.563877442639863,0.1268346393105237
금리메리트/NNG;인해/VV,1,0.6327245465926459,18,12,6,18,0.563877442639863,0.1268346393105237
콜금리/NNG;하/VV,1,0.6327245465926459,18,12,6,2,0.563877442639863,0.1268346393105237
자산/NNG;늘리/VV,1,0.6327245465926459,18,12,6,14,0.563877442639863,0.1268346393105237
기준금리/NNG;낮/VA;수준이/VVX,1,0.6327245465926459,18,12,6,26,0.563877442639863,0.1268346393105237
경기/NNG;안정되/VVX,1,0.6237314295339527,15,10,5,10,0.5447420954752481,0.12622362992233033
경제회복세/NNG;지속되/VVX,1,0.6237314295339527,15,10,5,17,0.5447420954752481,0.12622362992233033
기준금리/NNG;머물/VV,1,0.6237314295339527,15,10,5,5,0.5447420954752481,0.12622362992233033
기준금리인상/NNG;진행될/VVX,1,0.6237314295339527,15,10,5,20,0.5447420954752481,0.12622362992233033
경제성장/NNG;달성하/VVX,1,0.6237314295339527,15,10,5,10,0.5447420954752481,0.12622362992233033
재정정책/NNG;유지하/VVX,1,0.6237314295339527,15,10,5,19,0.5447420954752481,0.12622362992233033
물가/NNG;상승세/NNG;가/VV,1,0.6237314295339527,15,10,5,7,0.5447420954752481,0.12622362992233033
성장/NNG;위협하/VVX,1,0.6237314295339527,15,10,5,7,0.5447420954752481,0.12622362992233033
금리인하/NNG;가능성/NNG;낮/VA;보임/VV,1,0.6237314295339527,15,10,5,25,0.5447420954752481,0.12622362992233033
부동산시장안정/NNG;위해/VV,1,0.6237314295339527,15,10,5,9,0.5447420954752481,0.12622362992233033
성장세/NNG;힘입/VV,1,0.6237314295339527,15,10,5,13,0.5447420954752481,0.12622362992233033
자금사정/NNG;나타내/VV,1,0.6237314295339527,15,10,5,7,0.5447420954752481,0.12622362992233033
금리/NNG;하방경직성/NNG;강화시/VVX,1,0.6237314295339527,15,10,5,13,0.5447420954752481,0.12622362992233033
불확실성/NNG;해소/NNG;받아들이/VV,1,0.6237314295339527,15,10,5,8,0.5447420954752481,0.12622362992233033
금리/NNG;하락하/VVX;스프레드/NNG,1,0.6237314295339527,15,10,5,7,0.5447420954752481,0.12622362992233033
동결/NNG;이/VV,1,0.6237314295339527,15,10,5,21,0.5447420954752481,0.12622362992233033
수출호조/NNG;지속되/VVX,1,0.6192966275133449,29,19,10,21,0.6248539190737893,0.14689291838533342
물가상승/NNG;인해/VV,1,0.6072019681789742,26,17,9,18,0.6068567853188865,0.1482984849662377
콜금리/NNG;인상된/VVX,1,0.6072019681789742,26,17,9,17,0.6068567853188865,0.1482984849662377
양적완화/NNG;지속되/VVX,1,0.6072019681789742,26,17,9,25,0.6068567853188865,0.1482984849662377
gdp/NNG;상회하/VVX,1,0.6072019681789742,26,17,9,18,0.6068567853188865,0.1482984849662377
성장세/NNG;지속되/VVX,1,0.6007679990739647,63,40,23,51,0.7688738912970907,0.19173366653676685
성장세/NNG;나타낼/VV,1,0.6007679990739647,63,40,23,49,0.7688738912970907,0.19173366653676685
경기회복세/NNG;둔화되/VVX,1,0.6005388943554497,34,22,12,24,0.6477583243253131,0.1616469051653754
견조한/VAX;성장/NNG;지속하/VVX,1,0.595863866707772,149,93,56,63,0.9122018908888401,0.23097508175759457
기준금리/NNG;인상한/VVX,1,0.5938960446724557,86,54,32,57,0.8317296640294005,0.21188497251198238
인플레이션/NNG;완화되/VVX;않/VX,1,0.5932266599164666,23,15,8,7,0.5883789602893018,0.15020080286227594
투자심리/NNG;호전됐/VVX,1,0.5932266599164666,23,15,8,9,0.5883789602893018,0.15020080286227594
경기회복/NNG;걸림돌/NNG;될/VV,1,0.5932266599164666,23,15,8,17,0.5883789602893018,0.15020080286227594
금리인상/NNG;시사하/VVX;않/VX,1,0.5932266599164666,23,15,8,18,0.5883789602893018,0.15020080286227594
고용지표/NNG;하회하/VVX,1,0.5932266599164666,23,15,8,19,0.5883789602893018,0.15020080286227594
기준금리/NNG;올라갈/VV,1,0.5932266599164666,23,15,8,9,0.5883789602893018,0.15020080286227594
gdp/NNG;성장했/VVX,1,0.5932266599164666,23,15,8,25,0.5883789602893018,0.15020080286227594
금리하락/NNG;이끌/VV,1,0.592732919684337,73,46,27,100,0.7979727150814243,0.20401598722933978
세계경제/NNG;회복세/NNG;이/VV,1,0.5882115521781028,39,25,14,8,0.6697080995170929,0.17361513690325522
기준금리/NNG;묶/VV,1,0.5869273586033361,31,20,11,25,0.6303277692946635,0.1640480396874385
경기/NNG;상승세/NNG;지속하/VVX,1,0.5869273586033361,31,20,11,4,0.6303277692946635,0.1640480396874385
경제성장률/NNG;떨어질/VV,1,0.5869273586033361,31,20,11,22,0.6303277692946635,0.1640480396874385
투자심리/NNG;개선시/VVX,1,0.5869273586033361,31,20,11,35,0.6303277692946635,0.1640480396874385
경제/NNG;확산될/VVX,1,0.5767285824752189,20,13,7,8,0.569425557216007,0.15283623388890052
경기/NNG;여건/NNG;개선되/VVX,1,0.5767285824752189,20,13,7,29,0.569425557216007,0.15283623388890052
경제성장/NNG;제약할/VVX,1,0.5767285824752189,20,13,7,1,0.569425557216007,0.15283623388890052
금리인상/NNG;단행하/VVX;어려울/VA,1,0.5767285824752189,20,13,7,9,0.569425557216007,0.15283623388890052
기준금리인상/NNG;예상하/VVX,1,0.5767285824752189,20,13,7,28,0.569425557216007,0.15283623388890052
기준금리/NNG;유지되/VVX,1,0.5767285824752189,20,13,7,18,0.569425557216007,0.15283623388890052
경기/NNG;꺾이/VV,1,0.5767285824752189,20,13,7,25,0.569425557216007,0.15283623388890052
마이너스/NNG;머물/VV,1,0.5767285824752189,20,13,7,16,0.569425557216007,0.15283623388890052
유동성흡수/NNG;위한/VV,1,0.5767285824752189,20,13,7,16,0.569425557216007,0.15283623388890052
경기둔화우려/NNG;커지/VV,1,0.5740891788916522,49,31,18,46,0.7104229413138465,0.19219040329823256
기준금리인상/NNG;이뤄질/VV,1,0.5740891788916522,49,31,18,41,0.7104229413138465,0.19219040329823256
성장동력/NNG;약화되/VVX,1,0.5712459605954316,28,18,10,4,0.6123520955617696,0.167066168672865
리스크관리/NNG;강화하/VVX,1,0.5699796756459976,54,34,20,31,0.7290898906270185,0.19966334477915804
불확실성/NNG;줄어들/VV,1,0.566236115497653,41,26,15,39,0.6745727775205982,0.1867860854313397
금리인상/NNG;진행되/VVX,1,0.566236115497653,41,26,15,51,0.6745727775205982,0.1867860854313397
금융위기/NNG;극복하/VVX,1,0.5647256407656354,64,40,24,52,0.762946943035404,0.2121962340195729
불확실성/NNG;해소된/VVX,1,0.5644140705937744,97,60,37,73,0.8457681936599253,0.23544620771784366
안전자산선호/NNG;따른/VV,1,0.5609761062623777,46,29,17,51,0.6951477803175031,0.19547209627628617
성장/NNG;기록하/VVX,1,0.5609761062623777,46,29,17,43,0.6951477803175031,0.19547209627628617
리스크/NNG;지속되/VVX,1,0.5584519307297147,33,21,12,16,0.6355845272739092,0.18004116244310808
성장/NNG;예상된/VVX,1,0.5574993137206168,51,32,19,37,0.7146090006223549,0.20298680060600224
시장금리/NNG;상승/NNG;제한하/VVX,1,0.5566442478019784,17,11,6,11,0.5499833056330671,0.1566120250261643
불확실성/NNG;해소됨/VVX,1,0.5566442478019784,17,11,6,13,0.5499833056330671,0.1566120250261643
경기/NNG;뒷받침하/VVX,1,0.5566442478019784,17,11,6,27,0.5499833056330671,0.1566120250261643
물가상승압력/NNG;있/VV,1,0.5566442478019784,17,11,6,17,0.5499833056330671,0.1566120250261643
재정위기/NNG;불거지/VV,1,0.5566442478019784,17,11,6,7,0.5499833056330671,0.1566120250261643
자산매입/NNG;늘리/VV,1,0.5566442478019784,17,11,6,30,0.5499833056330671,0.1566120250261643
기준금리/NNG;만장일치/NNG;동결했/VVX,1,0.5566442478019784,17,11,6,32,0.5499833056330671,0.1566120250261643
경기회복세/NNG;찬물/NNG;끼얹/VV,1,0.5566442478019784,17,11,6,16,0.5499833056330671,0.1566120250261643
경기회복세/NNG;지속됨/VVX,1,0.5566442478019784,17,11,6,5,0.5499833056330671,0.1566120250261643
물가/NNG;유지하/VVX,1,0.5566442478019784,17,11,6,14,0.5499833056330671,0.1566120250261643
변동성/NNG;나타날/VV,1,0.5566442478019784,17,11,6,16,0.5499833056330671,0.1566120250261643
경기/NNG;진정시/VVX,1,0.5566442478019784,17,11,6,3,0.5499833056330671,0.1566120250261643
기준금리/NNG;올려/VV,1,0.5551690962349802,56,35,21,41,0.7329245394790538,0.2095984996112697
통화정책/NNG;불확실성/NNG;완화되/VVX,1,0.5529013955968354,25,16,9,29,0.5938256509024372,0.17093396086467508
금리인상/NNG;미루/VV,1,0.550839712306705,38,24,14,28,0.6579207090245577,0.19050944587826446
경제성장률/NNG;하향조정하/VVX,1,0.5408454424650309,73,45,28,76,0.7835879225745325,0.23344746540113967
물가상승률/NNG;낮추/VV,1,0.5401758240708792,30,19,11,27,0.6176370158063251,0.1843554439994148
불안/NNG;잠재우/VV,1,0.5401758240708792,30,19,11,24,0.6176370158063251,0.1843554439994148
경기부양/NNG;따른/VV,1,0.5401758240708792,30,19,11,25,0.6176370158063251,0.1843554439994148
기준금리/NNG;인상한/VAX;이/VV,1,0.5333215776641067,35,22,13,14,0.6406501760111853,0.19494044304177002
변동성/NNG;키울/VV,1,0.5333215776641067,35,22,13,30,0.6406501760111853,0.19494044304177002
성장모멘텀/NNG;둔화되/VVX,1,0.5310074316137512,22,14,8,3,0.574725665918428,0.17601279359618635
금리인상/NNG;가능성/NNG;반영해/VVX,1,0.5310074316137512,22,14,8,20,0.574725665918428,0.17601279359618635
기준금리/NNG;상승할/VVX,1,0.5310074316137512,22,14,8,10,0.574725665918428,0.17601279359618635
금융시장/NNG;변동성/NNG;커질/VV,1,0.5310074316137512,22,14,8,25,0.574725665918428,0.17601279359618635
금리상승압력/NNG;작용했/VVX,1,0.5310074316137512,22,14,8,20,0.574725665918428,0.17601279359618635
리스크/NNG;반영하/VVX,1,0.5310074316137512,22,14,8,40,0.574725665918428,0.17601279359618635
기준금리인상/NNG;하/VV,1,0.5310074316137512,22,14,8,23,0.574725665918428,0.17601279359618635
인플레이션우려/NNG;따른/VV,1,0.5297730710937221,40,25,15,19,0.6627223136539474,0.2036602348397482
낮/VA;금리/NNG;유지할/VVX,1,0.5281514283196229,45,28,17,42,0.6837564612947798,0.21107207770031505
금리인상/NNG;인해/VV,1,0.5230525922171865,87,53,34,57,0.8130205540300597,0.2545346200204546
성장/NNG;따른/VV,1,0.5207875704432161,77,47,30,62,0.7884969235221317,0.24839782699633878
경기/NNG;회복세/NNG;보이/VV,1,0.5193957312352806,72,44,28,79,0.7746222186675029,0.24495936067503216
경기회복세/NNG;강화되/VVX,1,0.5188279050107578,27,17,10,19,0.5990747827828238,0.1897404409151244
금리인상/NNG;검토할/VVX,1,0.5188279050107578,27,17,10,12,0.5990747827828238,0.1897404409151244
경제둔화/NNG;따른/VV,1,0.5188279050107578,27,17,10,16,0.5990747827828238,0.1897404409151244
금리인상/NNG;결정했/VVX,1,0.5188279050107578,27,17,10,10,0.5990747827828238,0.1897404409151244
기준금리인상/NNG;지연될/VVX,1,0.5188279050107578,27,17,10,33,0.5990747827828238,0.1897404409151244
기준금리동결/NNG;예상하/VVX,1,0.5188279050107578,27,17,10,33,0.5990747827828238,0.1897404409151244
경제/NNG;안정시/VVX,1,0.5188279050107578,27,17,10,15,0.5990747827828238,0.1897404409151244
금리인상/NNG;되/VV,1,0.5188279050107578,27,17,10,21,0.5990747827828238,0.1897404409151244
금리인상/NNG;필요하/VVX,1,0.5183567794432284,109,66,43,76,0.851065811722972,0.2698991151427021
불확실성/NNG;완화된/VVX,1,0.5145312259155972,57,35,22,54,0.7261838375166292,0.23270937976800937
기준금리/NNG;인상됐/VVX,1,0.5132040846751271,32,20,12,34,0.6227427669019886,0.2002818094566444
큰/VA;변동성/NNG;보이/VV,1,0.5132040846751271,32,20,12,21,0.6227427669019886,0.2002818094566444
경제/NNG;성장세/NNG;지속하/VVX,1,0.5132040846751271,32,20,12,17,0.6227427669019886,0.2002818094566444
물가안정/NNG;위한/VV,1,0.5130057953771838,126,76,50,116,0.8699254785072347,0.279929404205398
금리인상/NNG;늦춰질/VV,1,0.51157868692207,47,29,18,44,0.6880994088897553,0.22227846648762667
금리인상/NNG;있/VV,1,0.5111833714412688,285,172,113,184,0.9058280363319471,0.2929251579856887
금리동결/NNG;예상하/VVX,1,0.5110436985671514,37,23,14,38,0.6455447187171889,0.2088340814772152
수출/NNG;줄어들/VV,1,0.5047780568476583,64,39,25,33,0.7467145214967719,0.24567451232244253
금리인상/NNG;가능하/VVX,1,0.5047780568476583,64,39,25,82,0.7467145214967719,0.24567451232244253
금리인상/NNG;가능성/NNG;부각될/VVX,1,0.5041715138647127,19,12,7,17,0.5549928563875537,0.18289389268919803
금리/NNG;큰/VA;상승할/VVX,1,0.5041715138647127,19,12,7,12,0.5549928563875537,0.18289389268919803
금리정상화/NNG;나서/VV,1,0.5041715138647127,19,12,7,26,0.5549928563875537,0.18289389268919803
금리상승/NNG;보였/VV,1,0.5041715138647127,19,12,7,8,0.5549928563875537,0.18289389268919803
물가/NNG;가/VV,1,0.5041715138647127,19,12,7,6,0.5549928563875537,0.18289389268919803
경제/NNG;악화하/VVX,1,0.5041715138647127,19,12,7,9,0.5549928563875537,0.18289389268919803
물가/NNG;끌어올릴/VV,1,0.5041715138647127,19,12,7,14,0.5549928563875537,0.18289389268919803
금융위기/NNG;진정되/VVX,1,0.5041715138647127,19,12,7,9,0.5549928563875537,0.18289389268919803
물가상승률/NNG;안정될/VVX,1,0.5041715138647127,19,12,7,17,0.5549928563875537,0.18289389268919803
불확실성/NNG;강조하/VVX,1,0.5041715138647127,19,12,7,11,0.5549928563875537,0.18289389268919803
금리인상/NNG;할/VV,1,0.5024444669933024,160,96,64,125,0.8897485162167659,0.2945689884000119
성장/NNG;유지하/VVX,1,0.4963892533842451,49,30,19,41,0.692289205381767,0.23292217907235946
내수/NNG;회복세/NNG;이/VV,1,0.4963892533842451,49,30,19,16,0.692289205381767,0.23292217907235946
금리/NNG;상승세/NNG;출발했/VVX,1,0.49400284998027955,66,40,26,43,0.7498074864042585,0.25387376922903365
경제/NNG;회복세/NNG;이/VV,1,0.4934727852014058,24,15,9,13,0.5798522192907005,0.1966046950623144
채권시장/NNG;호재/NNG;작용할/VVX,1,0.4934727852014058,24,15,9,15,0.5798522192907005,0.1966046950623144
불확실성/NNG;고려하/VVX,1,0.4934727852014058,24,15,9,23,0.5798522192907005,0.1966046950623144
금리인상/NNG;이루어지/VV,1,0.4934727852014058,24,15,9,8,0.5798522192907005,0.1966046950623144
인플레이션압력/NNG;가중될/VVX,1,0.4934727852014058,24,15,9,8,0.5798522192907005,0.1966046950623144
금리하락/NNG;되돌리/VV,1,0.4934727852014058,24,15,9,14,0.5798522192907005,0.1966046950623144
금융완화/NNG;크/VA;축소될/VVX,1,0.4934727852014058,24,15,9,11,0.5798522192907005,0.1966046950623144
정책금리/NNG;인상해/VVX,1,0.49119333542487964,39,24,15,28,0.6502835587871301,0.22181520487610037
금리인상우려/NNG;따른/VV,1,0.48984254858504017,29,18,11,22,0.6041644805687101,0.20681780857812265
내수회복/NNG;따른/VV,1,0.48984254858504017,29,18,11,17,0.6041644805687101,0.20681780857812265
산업생산/NNG;감소했/VVX,1,0.48984254858504017,29,18,11,29,0.6041644805687101,0.20681780857812265
경기/NNG;나아질/VV,1,0.48984254858504017,29,18,11,30,0.6041644805687101,0.20681780857812265
성장/NNG;기록할/VVX,1,0.48964812732322494,34,21,13,28,0.6276921649612105,0.21498169830368816
수출/NNG;늘어날/VV,1,0.48964812732322494,34,21,13,19,0.6276921649612105,0.21498169830368816
잠재성장률/NNG;밑도/VV,1,0.48964812732322494,34,21,13,20,0.6276921649612105,0.21498169830368816
금리인상/NNG;위한/VV,1,0.4886818119007945,90,54,36,146,0.8084907072874663,0.277608379223908
성장률/NNG;달성할/VVX,1,0.4866040964573879,56,34,22,41,0.7153319808908731,0.2469628572080123
성장률/NNG;하락하/VVX,1,0.48241780377036725,51,31,20,37,0.6963335943244778,0.24304711462306505
금리인상/NNG;필요할/VVX,1,0.478545206059811,75,45,30,22,0.7704713310578557,0.2716443337963451
기준금리/NNG;인상해/VVX,1,0.4757680004363829,187,111,76,158,0.889359916828749,0.3158227841652652
불확실성/NNG;대비해/VVX,1,0.4700662557981006,16,10,6,16,0.5344859693747617,0.19260967438292964
인플레이션압력/NNG;상존해/VVX,1,0.4700662557981006,16,10,6,4,0.5344859693747617,0.19260967438292964
리스크해소/NNG;의미하/VVX;아니/VCN,1,0.4700662557981006,16,10,6,5,0.5344859693747617,0.19260967438292964
불확실성/NNG;제거될/VVX,1,0.4700662557981006,16,10,6,5,0.5344859693747617,0.19260967438292964
금리인상/NNG;가능성/NNG;약화되/VVX,1,0.4700662557981006,16,10,6,13,0.5344859693747617,0.19260967438292964
불안/NNG;확대될/VVX,1,0.4700662557981006,16,10,6,10,0.5344859693747617,0.19260967438292964
경기회복/NNG;반영하/VVX,1,0.4700662557981006,16,10,6,16,0.5344859693747617,0.19260967438292964
콜금리/NNG;결정하/VVX,1,0.4700662557981006,16,10,6,7,0.5344859693747617,0.19260967438292964
소비자물가/NNG;선행하/VVX,1,0.4700662557981006,16,10,6,7,0.5344859693747617,0.19260967438292964
금리/NNG;웃도/VV,1,0.4700662557981006,16,10,6,12,0.5344859693747617,0.19260967438292964
인플레이션/NNG;나타날/VV,1,0.4700662557981006,16,10,6,16,0.5344859693747617,0.19260967438292964
연착륙/NNG;성공할/VVX,1,0.4700662557981006,16,10,6,15,0.5344859693747617,0.19260967438292964
듀레이션/NNG;중립/NNG;유지하/VVX,1,0.4700662557981006,16,10,6,28,0.5344859693747617,0.19260967438292964
경기침체/NNG;피할/VV,1,0.4700662557981006,16,10,6,8,0.5344859693747617,0.19260967438292964
기준금리/NNG;인상돼/VVX,1,0.4700662557981006,16,10,6,24,0.5344859693747617,0.19260967438292964
시장금리/NNG;반영된/VVX,1,0.4700662557981006,16,10,6,15,0.5344859693747617,0.19260967438292964
경제성장세/NNG;둔화하/VVX,1,0.4700662557981006,16,10,6,6,0.5344859693747617,0.19260967438292964
긴축정책/NNG;따른/VV,1,0.4700662557981006,16,10,6,10,0.5344859693747617,0.19260967438292964
금리인상/NNG;시도할/VVX,1,0.4700662557981006,16,10,6,15,0.5344859693747617,0.19260967438292964
경제/NNG;뒷받침하/VVX,1,0.4700662557981006,16,10,6,4,0.5344859693747617,0.19260967438292964
수출/NNG;급감했/VVX,1,0.4700662557981006,16,10,6,8,0.5344859693747617,0.19260967438292964
금리인상/NNG;가져올/VV,1,0.4700662557981006,16,10,6,14,0.5344859693747617,0.19260967438292964
금리/NNG;인상시/VVX,1,0.4700662557981006,16,10,6,9,0.5344859693747617,0.19260967438292964
유동성/NNG;늘/VV,1,0.4700662557981006,16,10,6,10,0.5344859693747617,0.19260967438292964
산업생산/NNG;줄/VV,1,0.4700662557981006,16,10,6,5,0.5344859693747617,0.19260967438292964
유동성/NNG;위축될/VVX,1,0.4700662557981006,16,10,6,13,0.5344859693747617,0.19260967438292964
금리인상/NNG;가능성/NNG;확대되/VVX,1,0.4700662557981006,16,10,6,6,0.5344859693747617,0.19260967438292964
동결/NNG;점쳤/VV,1,0.4700662557981006,16,10,6,21,0.5344859693747617,0.19260967438292964
실업률/NNG;개선되/VVX,1,0.4700662557981006,16,10,6,13,0.5344859693747617,0.19260967438292964
정책금리/NNG;인상된/VVX,1,0.4700662557981006,16,10,6,13,0.5344859693747617,0.19260967438292964
물가상승압력/NNG;작용할/VVX,1,0.46929539745420334,65,39,26,45,0.7395885266558923,0.26704876478494266
물가/NNG;안정세/NNG;보이/VV,1,0.46929539745420334,65,39,26,28,0.7395885266558923,0.26704876478494266
금리/NNG;오르/VV;않/VX,1,0.46893817928545567,36,22,14,48,0.6325018228156507,0.22859135761920527
마이너스/NNG;될/VV,1,0.46893817928545567,36,22,14,24,0.6325018228156507,0.22859135761920527
금리동결/NNG;예상된/VVX,1,0.46497960310476505,31,19,12,22,0.6091207214976186,0.22238029444402438
경기/NNG;호조/NNG;보이/VV,1,0.46497960310476505,31,19,12,17,0.6091207214976186,0.22238029444402438
물가안정/NNG;위해/VV,1,0.46465019676451513,171,101,70,131,0.8815627470571388,0.32211499172278835
금리인상/NNG;통한/VV,1,0.46377343446919816,60,36,24,62,0.7223951403110102,0.2645469441744322
금리인상/NNG;이/VV,1,0.4630391415347197,91,54,37,58,0.8020327195545417,0.2942603959515961
실업률/NNG;유지하/VVX,1,0.4627153197593934,21,13,8,17,0.5598750178595078,0.2055836608199299
금리/NNG;상승세/NNG;출발하/VVX,1,0.4627153197593934,21,13,8,23,0.5598750178595078,0.2055836608199299
재할인율/NNG;인하키/VVX,1,0.4627153197593934,21,13,8,1,0.5598750178595078,0.2055836608199299
경제/NNG;타격/NNG;입/VV,1,0.4627153197593934,21,13,8,19,0.5598750178595078,0.2055836608199299
금리인상/NNG;단행된/VVX;하/VV,1,0.4627153197593934,21,13,8,14,0.5598750178595078,0.2055836608199299
금리하락/NNG;견인했/VVX,1,0.4627153197593934,21,13,8,28,0.5598750178595078,0.2055836608199299
경기회복/NNG;확인되/VVX,1,0.4627153197593934,21,13,8,23,0.5598750178595078,0.2055836608199299
불확실성/NNG;확대됐/VVX,1,0.4627153197593934,21,13,8,17,0.5598750178595078,0.2055836608199299
금리인상/NNG;가능성/NNG;부각됨/VVX,1,0.4627153197593934,21,13,8,12,0.5598750178595078,0.2055836608199299
금융시장/NNG;출렁이/VV,1,0.46234443477598397,26,16,10,14,0.5848522702033694,0.21495784204079793
인플레이션/NNG;유발하/VVX;않/VX,1,0.46234443477598397,26,16,10,11,0.5848522702033694,0.21495784204079793
금리/NNG;유지될/VVX,1,0.46234443477598397,26,16,10,22,0.5848522702033694,0.21495784204079793
경제성장률/NNG;밑돌/VV,1,0.46234443477598397,26,16,10,22,0.5848522702033694,0.21495784204079793
리스크/NNG;존재한/VVX,1,0.46234443477598397,26,16,10,15,0.5848522702033694,0.21495784204079793
기준금리/NNG;유지했/VVX,1,0.46234443477598397,26,16,10,30,0.5848522702033694,0.21495784204079793
경제/NNG;위축되/VVX,1,0.46234443477598397,26,16,10,33,0.5848522702033694,0.21495784204079793
대외여건/NNG;개선되/VVX,1,0.46234443477598397,26,16,10,29,0.5848522702033694,0.21495784204079793
흑자/NNG;기록하/VVX,1,0.4573965484691638,43,26,17,31,0.6593390278590524,0.24539369808266476
기준금리/NNG;유지해/VVX,1,0.4573965484691638,43,26,17,39,0.6593390278590524,0.24539369808266476
경기/NNG;위축될/VVX,1,0.45064141107649713,50,30,20,19,0.6844344971672607,0.25910375560530724
금리/NNG;기준금리/NNG;하회하/VVX,1,0.45064141107649713,50,30,20,65,0.6844344971672607,0.25910375560530724
콜금리/NNG;인상될/VVX,1,0.4504744942044685,69,41,28,30,0.7455204912173299,0.28234702627170005
성장/NNG;둔화되/VVX,1,0.44929278659018657,95,56,39,73,0.8049933735504894,0.30577512179682154
경기회복/NNG;되/VV,1,0.44346472114207347,33,20,13,14,0.6139609827012996,0.23662968998715284
금리동결/NNG;예상되/VVX,1,0.44289847088698875,45,27,18,59,0.663672078450581,0.2561496367929823
금리인상/NNG;가능성/NNG;시사할/VVX,1,0.43622484620147284,28,17,11,27,0.5897547756906153,0.23141572977135863
금리/NNG;큰/VA;하락했/VVX,1,0.4336073329768315,73,43,30,85,0.7509847680674642,0.29658897608801377
변동성/NNG;확대시/VVX,1,0.43206680559121025,87,51,36,62,0.7833038998342186,0.31052736912537526
경제성장률/NNG;하향조정했/VVX,1,0.43206680559121025,87,51,36,71,0.7833038998342186,0.31052736912537526
지준율/NNG;인상했/VVX,1,0.4297078057213213,47,28,19,19,0.6678834095255407,0.26630855638483775
금리/NNG;인상됐/VVX,1,0.42943823782488577,23,14,9,16,0.5646875128948662,0.22530956529224808
인플레이션/NNG;잘/MAG;제어될/VVX,1,0.42943823782488577,23,14,9,18,0.5646875128948662,0.22530956529224808
불확실성/NNG;키울/VV,1,0.42943823782488577,23,14,9,23,0.5646875128948662,0.22530956529224808
부동산가격안정/NNG;위해/VV,1,0.42943823782488577,23,14,9,7,0.5646875128948662,0.22530956529224808
소비자물가/NNG;하락하/VVX,1,0.42943823782488577,23,14,9,21,0.5646875128948662,0.22530956529224808
수출호조/NNG;힘입/VV,1,0.42601138040438546,68,40,28,58,0.7350239472254206,0.29574273483662833
잠재성장률/NNG;웃도/VV,1,0.42468505573935733,35,21,14,18,0.618696837550704,0.2497446915436797
성장/NNG;유지할/VVX,1,0.42468505573935733,35,21,14,29,0.618696837550704,0.2497446915436797
견조한/VAX;성장세/NNG;보이/VV,1,0.42468505573935733,35,21,14,29,0.618696837550704,0.2497446915436797
내수/NNG;부진해/VVX,1,0.424380460313998,18,11,7,7,0.5389457045480361,0.21771379735271124
부동산가격/NNG;하락하/VVX,1,0.424380460313998,18,11,7,10,0.5389457045480361,0.21771379735271124
금리인상시기/NNG;앞당길/VV,1,0.424380460313998,18,11,7,6,0.5389457045480361,0.21771379735271124
경기회복/NNG;저해하/VVX,1,0.424380460313998,18,11,7,17,0.5389457045480361,0.21771379735271124
생산/NNG;줄/VV,1,0.424380460313998,18,11,7,13,0.5389457045480361,0.21771379735271124
기준금리인상/NNG;이/VV,1,0.424380460313998,18,11,7,9,0.5389457045480361,0.21771379735271124
경기불확실성/NNG;남/VV,1,0.424380460313998,18,11,7,13,0.5389457045480361,0.21771379735271124
금리인상지연/NNG;따른/VV,1,0.424380460313998,18,11,7,16,0.5389457045480361,0.21771379735271124
물가/NNG;시차/NNG;두/VV,1,0.424380460313998,18,11,7,19,0.5389457045480361,0.21771379735271124
물가상승률/NNG;상승할/VVX,1,0.424380460313998,18,11,7,20,0.5389457045480361,0.21771379735271124
대외불확실성/NNG;상존하/VVX,1,0.424380460313998,18,11,7,23,0.5389457045480361,0.21771379735271124
기준금리인상/NNG;통한/VV,1,0.424380460313998,18,11,7,11,0.5389457045480361,0.21771379735271124
기준금리인상/NNG;가능성/NNG;부각되/VVX,1,0.424380460313998,18,11,7,10,0.5389457045480361,0.21771379735271124
성장률/NNG;그친/VV,1,0.424380460313998,18,11,7,5,0.5389457045480361,0.21771379735271124
성장/NNG;둔화시/VVX,1,0.424380460313998,18,11,7,19,0.5389457045480361,0.21771379735271124
변동성/NNG;확대할/VVX;있/VV,1,0.424380460313998,18,11,7,8,0.5389457045480361,0.21771379735271124
물가/NNG;달성하/VVX,1,0.424380460313998,18,11,7,13,0.5389457045480361,0.21771379735271124
경제/NNG;침체될/VVX,1,0.424380460313998,18,11,7,9,0.5389457045480361,0.21771379735271124
동결/NNG;전망하/VVX,1,0.424380460313998,18,11,7,10,0.5389457045480361,0.21771379735271124
경제지표/NNG;양호하/VVX,1,0.419627177994188,42,25,17,38,0.6461973700775039,0.26407469547237655
경기회복/NNG;따른/VV,1,0.4181483178823684,298,173,125,267,0.8766648121703552,0.35954417403981376
콜금리/NNG;인상해/VVX,1,0.4176498071081325,49,29,20,22,0.6719775377890216,0.2759292805504681
금리인상/NNG;시작하/VVX,1,0.4176498071081325,49,29,20,43,0.6719775377890216,0.2759292805504681
금리인상/NNG;주장하/VVX,1,0.41738798823997914,63,37,26,56,0.7178622175937455,0.2949574793762252
금리인상시기/NNG;될/VV,1,0.4140478548361979,30,18,12,29,0.5945769101027479,0.24628157066885256
소비/NNG;이어지/VV,1,0.4140478548361979,30,18,12,19,0.5945769101027479,0.24628157066885256
수출/NNG;증가할/VVX,1,0.4140478548361979,30,18,12,26,0.5945769101027479,0.24628157066885256
금리하락/NNG;견인할/VVX,1,0.4140478548361979,30,18,12,48,0.5945769101027479,0.24628157066885256
경기회복세/NNG;진행되/VVX,1,0.4140478548361979,30,18,12,14,0.5945769101027479,0.24628157066885256
인플레이션/NNG;우려하/VVX,1,0.41327310243355586,114,66,48,53,0.8214250708809356,0.34088137776666816
금리/NNG;인상해/VVX,1,0.4107901793634572,311,180,131,252,0.8741983336094883,0.36495692713142525
성장률/NNG;달성하/VVX,1,0.40886231978836785,65,38,27,68,0.7210337661137785,0.3024118119279626
침체/NNG;빠지/VV,1,0.40815681576395213,37,22,15,31,0.6233357809275157,0.26187881548730846
경제/NNG;악영향/NNG;미치/VV,1,0.40815681576395213,37,22,15,26,0.6233357809275157,0.26187881548730846
선진국/NNG;경제/NNG;회복세/NNG;이/VV,1,0.40815681576395213,37,22,15,12,0.6233357809275157,0.26187881548730846
금리인하기대감/NNG;유지되/VVX,1,0.40815681576395213,37,22,15,54,0.6233357809275157,0.26187881548730846
경기회복세/NNG;지속되/VVX,1,0.40803598430129284,163,94,69,139,0.8585973508049012,0.3608225863562512
기준금리인하/NNG;나설/VV,1,0.4022696029674868,25,15,10,31,0.569460292353681,0.24263688524620336
내수/NNG;회복세/NNG;보이/VV,1,0.4022696029674868,25,15,10,27,0.569460292353681,0.24263688524620336
실업률/NNG;나타내/VV,1,0.4022696029674868,25,15,10,13,0.569460292353681,0.24263688524620336
경제회복/NNG;위한/VV,1,0.4022696029674868,25,15,10,17,0.569460292353681,0.24263688524620336
수익성/NNG;개선될/VVX,1,0.4022696029674868,25,15,10,18,0.569460292353681,0.24263688524620336
금리인하/NNG;기정사실화하/VVX,1,0.4022696029674868,25,15,10,27,0.569460292353681,0.24263688524620336
금리/NNG;고시됐/VVX,1,0.4022696029674868,25,15,10,5,0.569460292353681,0.24263688524620336
경기/NNG;회복세/NNG;지속하/VVX,1,0.4022696029674868,25,15,10,36,0.569460292353681,0.24263688524620336
금리/NNG;낮춰야/VV,1,0.4022696029674868,25,15,10,21,0.569460292353681,0.24263688524620336
금리인상/NNG;나올/VV,1,0.4022696029674868,25,15,10,18,0.569460292353681,0.24263688524620336
양적완화/NNG;확대하/VVX,1,0.4022696029674868,25,15,10,35,0.569460292353681,0.24263688524620336
기준금리/NNG;인상되/VVX,1,0.4016311789088205,224,129,95,182,0.8688699608006546,0.3707739419920635
금리/NNG;동결해/VVX,1,0.39585347133876647,76,44,32,51,0.7458544938925071,0.322680507505138
시장금리/NNG;하락했/VVX,1,0.3950054647008727,32,19,13,22,0.5993282412356941,0.25981008617916795
수출증가율/NNG;둔화될/VVX,1,0.3950054647008727,32,19,13,16,0.5993282412356941,0.25981008617916795
성장률/NNG;나타낼/VV,1,0.3950054647008727,32,19,13,24,0.5993282412356941,0.25981008617916795
금리/NNG;올린다는/VV,1,0.3950054647008727,32,19,13,26,0.5993282412356941,0.25981008617916795
기준금리인상/NNG;있/VV,1,0.3944318212940814,46,27,19,43,0.6547777950314312,0.2842334090120899
안전자산선호심리/NNG;강화되/VVX,1,0.3944318212940814,46,27,19,65,0.6547777950314312,0.2842334090120899
금리동결/NNG;따른/VV,1,0.3944318212940814,46,27,19,42,0.6547777950314312,0.2842334090120899
불확실성/NNG;확대될/VVX,1,0.3934969910672417,39,23,16,45,0.6278825066629435,0.27316197058515373
금리/NNG;유지했/VVX,1,0.3934969910672417,39,23,16,24,0.6278825066629435,0.27316197058515373
정책금리/NNG;유지하/VVX,1,0.3934969910672417,39,23,16,27,0.6278825066629435,0.27316197058515373
gdp/NNG;증가하/VVX,1,0.3934969910672417,39,23,16,42,0.6278825066629435,0.27316197058515373
불안/NNG;인해/VV,1,0.3902299991886544,62,36,26,47,0.7063051070455905,0.30965989551333983
물가/NNG;상승한/VVX,1,0.38925294483950923,20,12,8,25,0.5434393420351544,0.23880523249169017
경기침체/NNG;우려하/VVX,1,0.38925294483950923,20,12,8,11,0.5434393420351544,0.23880523249169017
금리인상/NNG;부담/NNG;덜/VV,1,0.38925294483950923,20,12,8,12,0.5434393420351544,0.23880523249169017
대외불확실성/NNG;확대되/VVX,1,0.38925294483950923,20,12,8,23,0.5434393420351544,0.23880523249169017
정책금리/NNG;동결된/VVX,1,0.38925294483950923,20,12,8,16,0.5434393420351544,0.23880523249169017
불확실성/NNG;큰/VA;상황이/VVX,1,0.38925294483950923,20,12,8,19,0.5434393420351544,0.23880523249169017
경기회복/NNG;인해/VV,1,0.38925294483950923,20,12,8,15,0.5434393420351544,0.23880523249169017
적자폭/NNG;확대되/VVX,1,0.38925294483950923,20,12,8,14,0.5434393420351544,0.23880523249169017
금리인상시기/NNG;늦추/VV,1,0.38925294483950923,20,12,8,19,0.5434393420351544,0.23880523249169017
투자심리/NNG;짓눌렀/VV,1,0.38925294483950923,20,12,8,16,0.5434393420351544,0.23880523249169017
금리상승압력/NNG;지속되/VVX,1,0.38925294483950923,20,12,8,14,0.5434393420351544,0.23880523249169017
경제/NNG;부정적/VAX;영향/NNG;미치/VV,1,0.38925294483950923,20,12,8,19,0.5434393420351544,0.23880523249169017
기준금리/NNG;인상되/VVX;않/VX,1,0.38925294483950923,20,12,8,28,0.5434393420351544,0.23880523249169017
인플레이션기대심리/NNG;차단하/VVX,1,0.38925294483950923,20,12,8,11,0.5434393420351544,0.23880523249169017
경제활성화/NNG;위한/VV,1,0.38925294483950923,20,12,8,28,0.5434393420351544,0.23880523249169017
불안요인/NNG;해소되/VVX,1,0.38925294483950923,20,12,8,20,0.5434393420351544,0.23880523249169017
금리인하/NNG;검토할/VVX,1,0.38925294483950923,20,12,8,19,0.5434393420351544,0.23880523249169017
금리/NNG;올리/VV;않/VX,1,0.3873392585750062,241,138,103,210,0.8646599890370477,0.38167564434990464
국제유가상승/NNG;따른/VV,1,0.3869192774010355,55,32,23,47,0.6835901254868617,0.3020464570638412
물가안정/NNG;두/VV,1,0.3869192774010355,55,32,23,52,0.6835901254868617,0.3020464570638412
유가상승/NNG;따른/VV,1,0.3864718497652617,161,92,69,117,0.8495579967755145,0.37577486380382985
성장/NNG;가능할/VVX,1,0.3836317059276524,119,68,51,93,0.8161841781541077,0.3634274569985531
금리인상/NNG;시사할/VVX,1,0.38350436979666935,48,28,20,35,0.6589135264821955,0.2934861442429244
인플레이션/NNG;유발할/VVX,1,0.38040062446495093,41,24,17,36,0.6323398009784842,0.28370333719748675
금리인상/NNG;가능성/NNG;있/VV,1,0.38040062446495093,41,24,17,53,0.6323398009784842,0.28370333719748675
인플레이션압력/NNG;가중시/VVX,1,0.3797260610915614,27,16,11,15,0.5742070115037515,0.2580280442995115
유동성/NNG;넘쳐나/VV,1,0.3797260610915614,27,16,11,17,0.5742070115037515,0.2580280442995115
성장세/NNG;확대되/VVX,1,0.3797260610915614,27,16,11,30,0.5742070115037515,0.2580280442995115
유동성/NNG;과도하/VVX,1,0.3797260610915614,27,16,11,13,0.5742070115037515,0.2580280442995115
수출/NNG;잘/MAG;되/VV,1,0.3797260610915614,27,16,11,16,0.5742070115037515,0.2580280442995115
금융위기/NNG;이전/NNG;회복하/VVX,1,0.3797260610915614,27,16,11,20,0.5742070115037515,0.2580280442995115
성장률/NNG;둔화되/VVX,1,0.3792346842165897,73,42,31,69,0.7326463904285402,0.32960302277528464
불확실성/NNG;있/VV,1,0.3754561214002017,160,91,69,134,0.844809239791441,0.3834249916119417
생산/NNG;증가할/VVX,1,0.3748957070605501,15,9,6,8,0.5166260106790396,0.23478170408244536
실물경제/NNG;제약하/VVX,1,0.3748957070605501,15,9,6,4,0.5166260106790396,0.23478170408244536
경기과열/NNG;진정시/VVX,1,0.3748957070605501,15,9,6,7,0.5166260106790396,0.23478170408244536
통화정책완화/NNG;조정/NNG;필요할/VVX,1,0.3748957070605501,15,9,6,42,0.5166260106790396,0.23478170408244536
금리스프레드/NNG;확대될/VVX,1,0.3748957070605501,15,9,6,9,0.5166260106790396,0.23478170408244536
안전자산선호현상/NNG;약화될/VVX,1,0.3748957070605501,15,9,6,13,0.5166260106790396,0.23478170408244536
수출/NNG;호조/NNG;보였/VV,1,0.3748957070605501,15,9,6,11,0.5166260106790396,0.23478170408244536
성장세/NNG;구가하/VVX,1,0.3748957070605501,15,9,6,16,0.5166260106790396,0.23478170408244536
만장일치/NNG;기준금리/NNG;동결하/VVX,1,0.3748957070605501,15,9,6,31,0.5166260106790396,0.23478170408244536
금리/NNG;낮/VA;머물/VV,1,0.3748957070605501,15,9,6,8,0.5166260106790396,0.23478170408244536
기준금리/NNG;낮/VA;유지할/VVX,1,0.3748957070605501,15,9,6,17,0.5166260106790396,0.23478170408244536
경기회복/NNG;자신하/VVX,1,0.3748957070605501,15,9,6,7,0.5166260106790396,0.23478170408244536
고용지표/NNG;하회했/VVX,1,0.3748957070605501,15,9,6,10,0.5166260106790396,0.23478170408244536
자금이탈/NNG;이어지/VV,1,0.3748957070605501,15,9,6,9,0.5166260106790396,0.23478170408244536
금리/NNG;크/VA;하/VV,1,0.3748957070605501,15,9,6,9,0.5166260106790396,0.23478170408244536
성장률/NNG;되/VV,1,0.3748957070605501,15,9,6,13,0.5166260106790396,0.23478170408244536
정치적/VAX;불확실성/NNG;따른/VV,1,0.3748957070605501,15,9,6,16,0.5166260106790396,0.23478170408244536
금리/NNG;안정화되/VVX,1,0.3748957070605501,15,9,6,7,0.5166260106790396,0.23478170408244536
긴축정책/NNG;내놓/VV,1,0.3748957070605501,15,9,6,12,0.5166260106790396,0.23478170408244536
기준금리동결/NNG;점쳤/VV,1,0.3748957070605501,15,9,6,16,0.5166260106790396,0.23478170408244536
정책금리인상/NNG;단행하/VVX,1,0.3748957070605501,15,9,6,19,0.5166260106790396,0.23478170408244536
물가/NNG;책임지/VV,1,0.3748957070605501,15,9,6,6,0.5166260106790396,0.23478170408244536
경기둔화/NNG;심화되/VVX,1,0.3748957070605501,15,9,6,7,0.5166260106790396,0.23478170408244536
선진국/NNG;경기/NNG;회복되/VVX,1,0.3748957070605501,15,9,6,6,0.5166260106790396,0.23478170408244536
성장률/NNG;낮/VA;질/VX;있/VV,1,0.3748957070605501,15,9,6,12,0.5166260106790396,0.23478170408244536
안전자산선호심리/NNG;자극하/VVX,1,0.3748957070605501,15,9,6,19,0.5166260106790396,0.23478170408244536
수출/NNG;높/VA;신장세/NNG;유지하/VVX,1,0.3748957070605501,15,9,6,4,0.5166260106790396,0.23478170408244536
견조한/VAX;성장세/NNG;보일/VV,1,0.3748957070605501,15,9,6,11,0.5166260106790396,0.23478170408244536
채권시장/NNG;국채가격/NNG;올랐/VV,1,0.37275425817222074,75,43,32,66,0.7352939807981254,0.3358227294190499
투자심리/NNG;위축되/VVX,1,0.37234508416817924,169,96,73,103,0.8473961972477891,0.3873896897340335
성장/NNG;예상되/VVX,1,0.370633239881218,109,62,47,60,0.7983554291506197,0.3664222935203595
경기부진/NNG;따른/VV,1,0.36862316983051757,43,25,18,62,0.6367091679400751,0.29359448112053427
금리인상/NNG;선반영하/VVX,1,0.36862316983051757,43,25,18,51,0.6367091679400751,0.29359448112053427
성장/NNG;이/VV;가/VX,1,0.36862316983051757,43,25,18,30,0.6367091679400751,0.29359448112053427
산업생산/NNG;증가해/VVX,1,0.36862316983051757,43,25,18,29,0.6367091679400751,0.29359448112053427
유럽재정위기/NNG;따른/VV,1,0.36862316983051757,43,25,18,36,0.6367091679400751,0.29359448112053427
생산/NNG;늘/VV,1,0.36401028279156145,36,21,15,16,0.6086342179927153,0.2836537212769156
금리하락압력/NNG;지속될/VVX,1,0.36401028279156145,36,21,15,39,0.6086342179927153,0.2836537212769156
금리인상/NNG;지연될/VVX,1,0.36305067306534244,104,59,45,74,0.7880950705843682,0.3681041155874526
신용경색/NNG;지속되/VVX,1,0.3615491452596393,22,13,9,6,0.5479900617805036,0.25684152951759365
수출부진/NNG;이어지/VV,1,0.3615491452596393,22,13,9,38,0.5479900617805036,0.25684152951759365
성장세/NNG;회복하/VVX,1,0.3615491452596393,22,13,9,22,0.5479900617805036,0.25684152951759365
자산매입/NNG;축소할/VVX,1,0.3615491452596393,22,13,9,27,0.5479900617805036,0.25684152951759365
주택시장냉각/NNG;따른/VV,1,0.3615491452596393,22,13,9,12,0.5479900617805036,0.25684152951759365
마이너스/NNG;떨어졌/VV,1,0.3615491452596393,22,13,9,17,0.5479900617805036,0.25684152951759365
실질금리/NNG;마이너스인/VVX,1,0.3615491452596393,22,13,9,20,0.5479900617805036,0.25684152951759365
금리인상/NNG;예상된/VVX,1,0.3613237945644414,70,40,30,42,0.7187078871570134,0.3370311257847836
낮/VA;금리/NNG;유지하/VVX,1,0.3607415125982898,29,17,12,17,0.578931900939862,0.2718481316176394
인플레이션/NNG;위험/NNG;상존해/VVX,1,0.3607415125982898,29,17,12,14,0.578931900939862,0.2718481316176394
불확실성/NNG;해소되/VVX;않/VX,1,0.360694830405186,79,45,34,69,0.7402989006469143,0.3476582700067728
금리상승/NNG;되돌리/VV,1,0.3579669993397674,45,26,19,52,0.6409912678208757,0.3029122511801779
기준금리/NNG;인상하/VVX;않/VX,1,0.357371097079795,115,65,50,93,0.8009357227289036,0.37901431068208025
하방위험/NNG;작용할/VVX,1,0.35575985481937344,54,31,23,28,0.6707238595699377,0.3185695323035904
물가상승압력/NNG;커지/VV,1,0.35575985481937344,54,31,23,45,0.6707238595699377,0.3185695323035904
경기둔화/NNG;인해/VV,1,0.35512143806018637,63,36,27,36,0.6975975146460305,0.33181788629751446
인플레이션우려/NNG;완화되/VVX,1,0.3512218364839441,38,22,16,28,0.6131902141862875,0.2942781056034879
금리/NNG;올리/VV;어려울/VA,1,0.3512218364839441,38,22,16,9,0.6131902141862875,0.2942781056034879
금리인상/NNG;이뤄질/VV,1,0.35120081142404547,190,107,83,153,0.84515924108285,0.4056225600898045
성장세/NNG;이/VV,1,0.3502658404167509,183,103,80,138,0.8430857516324728,0.4054906575379423
불확실성/NNG;이어질/VV,1,0.3482711319139289,47,27,20,39,0.6451862244842107,0.3117213034191626
양적완화/NNG;축소할/VVX,1,0.3482711319139289,47,27,20,81,0.6451862244842107,0.3117213034191626
물가/NNG;하/VV,1,0.34454057076110245,31,18,13,30,0.5836338621827201,0.284382048271481
금융시장/NNG;불안해/VVX,1,0.34454057076110245,31,18,13,27,0.5836338621827201,0.284382048271481
경기/NNG;부양해/VVX,1,0.34454057076110245,31,18,13,21,0.5836338621827201,0.284382048271481
세계경제/NNG;회복되/VVX,1,0.34454057076110245,31,18,13,31,0.5836338621827201,0.284382048271481
신용등급/NNG;유지하/VVX,1,0.34454057076110245,31,18,13,15,0.5836338621827201,0.284382048271481
금리인상/NNG;진행될/VVX,1,0.34341227611869063,76,43,33,67,0.7269686897602465,0.35513082973837107
채권시장강세/NNG;지지하/VVX,1,0.34341227611869063,76,43,33,81,0.7269686897602465,0.35513082973837107
원자재가격/NNG;하락하/VVX,1,0.34200011751413406,67,38,29,46,0.7039998977023519,0.34501213521085633
수출/NNG;증가해/VVX,1,0.3398324759207294,40,23,17,22,0.6176800553427221,0.3041968107286847
유동성확보/NNG;위한/VV,1,0.3398324759207294,40,23,17,12,0.6176800553427221,0.3041968107286847
불확실성/NNG;해소/NNG;따른/VV,1,0.3391986790949453,24,14,10,30,0.55259954961112,0.27253577607085816
세계경제/NNG;위험요인/NNG;작용할/VVX,1,0.3391986790949453,24,14,10,8,0.55259954961112,0.27253577607085816
마이너스/NNG;이/VV,1,0.3391986790949453,24,14,10,19,0.55259954961112,0.27253577607085816
소비/NNG;증가했/VVX,1,0.3391986790949453,24,14,10,18,0.55259954961112,0.27253577607085816
하방위험/NNG;커지/VV,1,0.3391986790949453,24,14,10,26,0.55259954961112,0.27253577607085816
금리동결/NNG;이/VV;갈/VX,1,0.3389303066515883,17,10,7,15,0.5206301625583224,0.2569245294585946
리스크/NNG;노출될/VVX,1,0.3389303066515883,17,10,7,27,0.5206301625583224,0.2569245294585946
gdp/NNG;하락하/VVX,1,0.3389303066515883,17,10,7,3,0.5206301625583224,0.2569245294585946
양적완화/NNG;종료된/VVX,1,0.3389303066515883,17,10,7,19,0.5206301625583224,0.2569245294585946
근원소비자물가/NNG;상승해/VVX,1,0.3389303066515883,17,10,7,21,0.5206301625583224,0.2569245294585946
금리정상화/NNG;진행될/VVX,1,0.3389303066515883,17,10,7,13,0.5206301625583224,0.2569245294585946
금리인하기대감/NNG;강화되/VVX,1,0.3389303066515883,17,10,7,19,0.5206301625583224,0.2569245294585946
유가하락/NNG;이끌/VV,1,0.3389303066515883,17,10,7,13,0.5206301625583224,0.2569245294585946
변동성/NNG;따른/VV,1,0.3389303066515883,17,10,7,16,0.5206301625583224,0.2569245294585946
물가상승률/NNG;상승하/VVX,1,0.3389303066515883,17,10,7,18,0.5206301625583224,0.2569245294585946
정책금리인상/NNG;단행될/VVX,1,0.3389303066515883,17,10,7,10,0.5206301625583224,0.2569245294585946
고용지표/NNG;부진할/VVX,1,0.3389303066515883,17,10,7,8,0.5206301625583224,0.2569245294585946
금리/NNG;최저치/NNG;경신했/VVX,1,0.3389303066515883,17,10,7,13,0.5206301625583224,0.2569245294585946
기준금리인상/NNG;시작할/VVX,1,0.3389303066515883,17,10,7,17,0.5206301625583224,0.2569245294585946
경기/NNG;부정적/VAX;영향/NNG;줄/VV,1,0.3389303066515883,17,10,7,10,0.5206301625583224,0.2569245294585946
물가상승/NNG;이끌/VV,1,0.3389303066515883,17,10,7,16,0.5206301625583224,0.2569245294585946
금리인상/NNG;무게/NNG;두/VV,1,0.3389303066515883,17,10,7,5,0.5206301625583224,0.2569245294585946
서비스업생산/NNG;증가하/VVX,1,0.3389303066515883,17,10,7,6,0.5206301625583224,0.2569245294585946
변동성/NNG;인해/VV,1,0.3389303066515883,17,10,7,12,0.5206301625583224,0.2569245294585946
경상수지흑자/NNG;유지되/VVX,1,0.3389303066515883,17,10,7,14,0.5206301625583224,0.2569245294585946
금리인상/NNG;그치/VV,1,0.3389303066515883,17,10,7,16,0.5206301625583224,0.2569245294585946
변동성확대/NNG;작용할/VVX,1,0.3389303066515883,17,10,7,14,0.5206301625583224,0.2569245294585946
경기둔화우려/NNG;해소되/VVX,1,0.3389303066515883,17,10,7,8,0.5206301625583224,0.2569245294585946
금리인상/NNG;힘/NNG;실/VV,1,0.3389303066515883,17,10,7,15,0.5206301625583224,0.2569245294585946
경기회복/NNG;지연시/VVX,1,0.3389303066515883,17,10,7,16,0.5206301625583224,0.2569245294585946
실업률/NNG;떨어졌/VV,1,0.3389303066515883,17,10,7,17,0.5206301625583224,0.2569245294585946
불확실성/NNG;사라졌/VV,1,0.3389303066515883,17,10,7,18,0.5206301625583224,0.2569245294585946
경기/NNG;악영향/NNG;미칠/VV,1,0.3389303066515883,17,10,7,17,0.5206301625583224,0.2569245294585946
금리/NNG;유지키/VVX,1,0.3389303066515883,17,10,7,5,0.5206301625583224,0.2569245294585946
저성장/NNG;탈피하/VVX,1,0.3389303066515883,17,10,7,11,0.5206301625583224,0.2569245294585946
물가안정/NNG;도모하/VVX,1,0.3389303066515883,17,10,7,12,0.5206301625583224,0.2569245294585946
경제/NNG;성장해/VVX,1,0.3389303066515883,17,10,7,15,0.5206301625583224,0.2569245294585946
금리상승/NNG;확대되/VVX,1,0.33800154929558346,78,44,34,84,0.7295340354119093,0.3607716622684538
금리상승/NNG;제한할/VVX,1,0.33800154929558346,78,44,34,51,0.7295340354119093,0.3607716622684538
리스크/NNG;커지/VV,1,0.3362256477941834,98,55,43,76,0.7678201415471086,0.38122886474090134
채권시장/NNG;부담/NNG;작용할/VVX,1,0.33362593762480164,60,34,26,61,0.6816606235452602,0.3404368525207204
콜금리/NNG;인상할/VVX,1,0.3329157730756511,154,86,68,70,0.8244099666554727,0.41238717522128304
출구전략/NNG;시행하/VVX,1,0.33283349896669434,80,45,35,46,0.7320082621305344,0.36623363416087
기준금리/NNG;인상된/VVX,1,0.3319399518454269,100,56,44,83,0.7693229910285743,0.38567636924111715
금리/NNG;하락세/NNG;재개될/VVX,1,0.331254499183683,51,29,22,47,0.6533137485454017,0.32802330751638875
주택가격/NNG;하락하/VVX,1,0.331254499183683,51,29,22,25,0.6533137485454017,0.32802330751638875
금리/NNG;유지한/VVX,1,0.3305507141383428,33,19,14,25,0.588308910341965,0.2958519562569262
불확실성/NNG;이어지/VV,1,0.3305507141383428,33,19,14,52,0.588308910341965,0.2958519562569262
성장/NNG;촉진하/VVX,1,0.3296163302881072,42,24,18,13,0.6221017179853826,0.31350234124972
경제성장/NNG;둔화하/VVX,1,0.3296163302881072,42,24,18,20,0.6221017179853826,0.31350234124972
기준금리/NNG;인상했/VVX,1,0.3295534474532502,415,232,183,273,0.8438625024347317,0.4253165878191737
신용등급/NNG;강등하/VVX,1,0.32718400835113504,62,35,27,47,0.6851157089985389,0.3471444109166994
콜금리/NNG;동결하/VVX,1,0.3258202090520872,93,52,41,38,0.7549912903351005,0.38371912288231724
리스크/NNG;상존하/VVX,1,0.3237333112953311,53,30,23,34,0.6572455136065762,0.33560196362335937
기준금리/NNG;올린/VV,1,0.3209683551995566,153,85,68,100,0.8187595472872076,0.42066072427367013
금리인상/NNG;카드/NNG;꺼내/VV,1,0.32080799322561515,26,15,11,15,0.5572593213839971,0.286409967097813
경기/NNG;바닥/NNG;쳤/VV,1,0.32080799322561515,26,15,11,7,0.5572593213839971,0.286409967097813
경기침체/NNG;우려/NNG;커지/VV,1,0.32080799322561515,26,15,11,14,0.5572593213839971,0.286409967097813
유동성/NNG;흡수할/VVX,1,0.32080799322561515,26,15,11,30,0.5572593213839971,0.286409967097813
양적완화/NNG;할/VV,1,0.32080799322561515,26,15,11,24,0.5572593213839971,0.286409967097813
고용지표/NNG;개선된/VVX,1,0.32080799322561515,26,15,11,15,0.5572593213839971,0.286409967097813
금리/NNG;인상할/VVX;필요/NNG;있/VA,1,0.32080799322561515,26,15,11,18,0.5572593213839971,0.286409967097813
금리/NNG;상승세/NNG;제한될/VVX,1,0.32080799322561515,26,15,11,41,0.5572593213839971,0.286409967097813
동결/NNG;이어질/VV,1,0.32039278072466093,44,25,19,39,0.6264528885499061,0.3222708020056776
수입/NNG;감소하/VVX,1,0.3183424555322574,35,20,15,33,0.5929516310577702,0.30643188791543385
경제성장세/NNG;둔화되/VVX,1,0.3183424555322574,35,20,15,28,0.5929516310577702,0.30643188791543385
고용지표/NNG;상회하/VVX,1,0.3183424555322574,35,20,15,11,0.5929516310577702,0.30643188791543385
양적완화/NNG;축소하/VVX,1,0.316763410130678,55,31,24,90,0.6610887066298587,0.3428459320880556
불확실성/NNG;존재하/VVX,1,0.31542409944509364,66,37,29,56,0.6917444131502021,0.35981287826542896
인플레이션압력/NNG;선제적/VAX;대응하/VVX,1,0.3118006677809326,19,11,8,6,0.5248609042477416,0.27520990215323676
유동성/NNG;풍부한/VAX;상황이/VVX,1,0.3118006677809326,19,11,8,29,0.5248609042477416,0.27520990215323676
고용/NNG;상황/NNG;개선되/VVX,1,0.3118006677809326,19,11,8,23,0.5248609042477416,0.27520990215323676
글로벌/NNG;경기/NNG;둔화되/VVX,1,0.3118006677809326,19,11,8,13,0.5248609042477416,0.27520990215323676
금리인상/NNG;가능성/NNG;반영했/VVX,1,0.3118006677809326,19,11,8,16,0.5248609042477416,0.27520990215323676
물가상승압력/NNG;나타날/VV,1,0.3118006677809326,19,11,8,6,0.5248609042477416,0.27520990215323676
금리하락압력/NNG;작용하/VVX,1,0.3118006677809326,19,11,8,21,0.5248609042477416,0.27520990215323676
불확실성/NNG;언급하/VVX,1,0.3118006677809326,19,11,8,18,0.5248609042477416,0.27520990215323676
경제성장/NNG;있/VV,1,0.3118006677809326,19,11,8,9,0.5248609042477416,0.27520990215323676
기준금리인상/NNG;늦춰질/VV,1,0.3118006677809326,19,11,8,12,0.5248609042477416,0.27520990215323676
경제성장/NNG;도모하/VVX,1,0.3118006677809326,19,11,8,8,0.5248609042477416,0.27520990215323676
유동성/NNG;사정/NNG;원활하/VVX,1,0.3118006677809326,19,11,8,8,0.5248609042477416,0.27520990215323676
기준금리인상/NNG;인해/VV,1,0.3118006677809326,19,11,8,22,0.5248609042477416,0.27520990215323676
소비자물가지수/NNG;올라/VV,1,0.3118006677809326,19,11,8,12,0.5248609042477416,0.27520990215323676
성장/NNG;하방리스크/NNG;작용할/VVX,1,0.3118006677809326,19,11,8,9,0.5248609042477416,0.27520990215323676
부양책/NNG;나오/VV;않/VX,1,0.3118006677809326,19,11,8,13,0.5248609042477416,0.27520990215323676
대외불확실성/NNG;남/VV,1,0.3118006677809326,19,11,8,20,0.5248609042477416,0.27520990215323676
경상수지흑자/NNG;유지하/VVX,1,0.3118006677809326,19,11,8,20,0.5248609042477416,0.27520990215323676
양적완화/NNG;가능성/NNG;열/VV,1,0.3118006677809326,19,11,8,20,0.5248609042477416,0.27520990215323676
금리동결/NNG;결정하/VVX,1,0.3118006677809326,19,11,8,20,0.5248609042477416,0.27520990215323676
원자재가격/NNG;급등하/VVX,1,0.3118006677809326,19,11,8,20,0.5248609042477416,0.27520990215323676
재정지출/NNG;줄어들/VV,1,0.3118006677809326,19,11,8,5,0.5248609042477416,0.27520990215323676
금리/NNG;치솟/VV,1,0.3111666904904551,121,67,54,95,0.7885418030489388,0.4140512229546477
성장/NNG;지속되/VVX,1,0.3102802444063797,57,32,25,31,0.664842951668103,0.349784225589168
금리인상/NNG;늦출/VV,1,0.3102802444063797,57,32,25,37,0.664842951668103,0.349784225589168
경기침체/NNG;빠질/VV,1,0.30758857002370377,37,21,16,28,0.59755604605741,0.31625915220401063
고용/NNG;늘어나/VV,1,0.30758857002370377,37,21,16,36,0.59755604605741,0.31625915220401063
양적완화/NNG;나서/VV,1,0.30758857002370377,37,21,16,51,0.59755604605741,0.31625915220401063
콜금리/NNG;인상되/VVX,1,0.30758857002370377,37,21,16,20,0.59755604605741,0.31625915220401063
경제성장률/NNG;높이/VV,1,0.30758857002370377,37,21,16,28,0.59755604605741,0.31625915220401063
리스크/NNG;존재하/VVX,1,0.30758857002370377,37,21,16,19,0.59755604605741,0.31625915220401063
통화완화/NNG;유지하/VVX,1,0.30758857002370377,37,21,16,19,0.59755604605741,0.31625915220401063
성장/NNG;견인할/VVX,1,0.30758857002370377,37,21,16,25,0.59755604605741,0.31625915220401063
금리/NNG;상승세/NNG;이어졌/VV,1,0.3054159631840627,28,16,12,28,0.5619565605758773,0.2988469953210896
글로벌/NNG;경기회복/NNG;따른/VV,1,0.3054159631840627,28,16,12,31,0.5619565605758773,0.2988469953210896
성장경로/NNG;불확실성/NNG;높/VA;판단된/VVX,1,0.3054159631840627,28,16,12,43,0.5619565605758773,0.2988469953210896
경기선행지수/NNG;반등하/VVX,1,0.3054159631840627,28,16,12,15,0.5619565605758773,0.2988469953210896
금리/NNG;동결했/VVX,1,0.3041758831052144,257,142,115,215,0.8324346205674152,0.4438979114243097
금리/NNG;동결될/VVX,1,0.301092011529164,205,113,92,135,0.8270531196388056,0.444031242682305
경기회복세/NNG;이어지/VV,1,0.29856267210249454,61,34,27,59,0.6720835377705657,0.3628407848634901
경기/NNG;개선된/VVX,1,0.29803605726804383,39,22,17,57,0.6021161214281988,0.32544299219507494
출구전략/NNG;따른/VV,1,0.29803605726804383,39,22,17,49,0.6021161214281988,0.32544299219507494
금리인상/NNG;이루어질/VV,1,0.29803605726804383,39,22,17,21,0.6021161214281988,0.32544299219507494
수출/NNG;의존하/VVX,1,0.2973476558593806,50,28,22,46,0.6390599593159987,0.3459330184570593
경기회복/NNG;기대감/NNG;커지/VV,1,0.2923430441150938,30,17,13,34,0.5666771082874943,0.3101304796864154
기준금리인상/NNG;나서/VV,1,0.2923430441150938,30,17,13,50,0.5666771082874943,0.3101304796864154
대외불확실성/NNG;따른/VV,1,0.29118160708455454,100,55,45,93,0.7521255218388894,0.4126683981895244
경기/NNG;둔화하/VVX,1,0.2910907854473359,76,42,34,45,0.7067121172943187,0.38782836718885444
자산매입/NNG;확대하/VVX,1,0.2906608302910956,21,12,9,20,0.529285592453306,0.2907333595105112
금융시장/NNG;안정/NNG;위해/VV,1,0.2906608302910956,21,12,9,15,0.529285592453306,0.2907333595105112
경제지표/NNG;둔화될/VVX,1,0.2906608302910956,21,12,9,5,0.529285592453306,0.2907333595105112
높/VA;물가오름세/NNG;지속될/VVX,1,0.2906608302910956,21,12,9,11,0.529285592453306,0.2907333595105112
통화긴축/NNG;단행할/VVX,1,0.2906608302910956,21,12,9,13,0.529285592453306,0.2907333595105112
금리인상/NNG;해야/VV,1,0.2906608302910956,21,12,9,15,0.529285592453306,0.2907333595105112
경제/NNG;위협할/VVX,1,0.2906608302910956,21,12,9,17,0.529285592453306,0.2907333595105112
노동시장/NNG;개선되/VVX,1,0.2894866121738626,41,23,18,68,0.6066260587747275,0.33407108974763544
경기회복/NNG;둔화되/VVX,1,0.2894866121738626,41,23,18,33,0.6066260587747275,0.33407108974763544
듀레이션/NNG;확대하/VVX,1,0.2848876147345014,54,30,24,36,0.6470715095057344,0.35993292298759244
경기과열/NNG;막/VV,1,0.2848876147345014,54,30,24,50,0.6470715095057344,0.35993292298759244
금리/NNG;하락세/NNG;이/VV,1,0.28178282678408273,43,24,19,39,0.6110804540049634,0.3422144463896636
채권시장/NNG;강세/NNG;보임/VV,1,0.28178282678408273,43,24,19,67,0.6110804540049634,0.3422144463896636
불확실성/NNG;존재한/VVX,1,0.28178282678408273,43,24,19,29,0.6110804540049634,0.3422144463896636
대외불확실성/NNG;커지/VV,1,0.28109738105476123,32,18,14,23,0.5714069633834032,0.32047320484202346
경기둔화/NNG;심화될/VVX,1,0.28109738105476123,32,18,14,11,0.5714069633834032,0.32047320484202346
경기회복세/NNG;이어질/VV,1,0.28109738105476123,32,18,14,26,0.5714069633834032,0.32047320484202346
잠재성장률/NNG;상회하/VVX,1,0.28109738105476123,32,18,14,26,0.5714069633834032,0.32047320484202346
경제/NNG;호조/NNG;보이/VV,1,0.28109738105476123,32,18,14,15,0.5714069633834032,0.32047320484202346
침체/NNG;빠질/VV,1,0.27932180782750216,56,31,25,35,0.6509540946018488,0.3664960847467528
채권시장/NNG;약세/NNG;보임/VV,1,0.2790616985113683,82,45,37,88,0.7146311678381658,0.40257409883375145
금리인상/NNG;가능성/NNG;열/VV,1,0.2782099326164411,187,102,85,202,0.8132745518284857,0.45898949779123
기준금리인상/NNG;따른/VV,1,0.2767168159483404,156,85,71,92,0.8007271244886998,0.45337174198711344
투자심리/NNG;위축된/VVX,1,0.2753837732139488,84,46,38,71,0.7171005807862668,0.4071952513478667
성장/NNG;이루/VV,1,0.2747982986605664,45,25,20,20,0.6154743754637828,0.3499310580457719
기준금리/NNG;동결한/VVX,1,0.27413136660220183,58,32,26,58,0.6547527741688512,0.37280009671266173
금리변동성/NNG;확대시/VVX,1,0.27374520353539356,23,13,10,20,0.5338665255042673,0.3042242291804426
마이너스/NNG;수준이/VVX,1,0.27374520353539356,23,13,10,18,0.5338665255042673,0.3042242291804426
경기회복/NNG;맞물려/VV,1,0.27374520353539356,23,13,10,21,0.5338665255042673,0.3042242291804426
성장률/NNG;낮추/VV,1,0.27374520353539356,23,13,10,68,0.5338665255042673,0.3042242291804426
경기/NNG;둔화할/VVX,1,0.27374520353539356,23,13,10,13,0.5338665255042673,0.3042242291804426
변동성/NNG;보일/VV,1,0.27131524835738885,34,19,15,29,0.5761329977475786,0.33003700548328774
리스크/NNG;해소되/VVX;않/VX,1,0.27131524835738885,34,19,15,22,0.5761329977475786,0.33003700548328774
금리인상/NNG;단행될/VVX,1,0.2707441972317921,336,183,153,266,0.8187114616013578,0.4695759118093884
경제성장률/NNG;둔화될/VVX,1,0.2692856753912005,101,55,46,44,0.7440174497407462,0.4280789066443191
불확실성/NNG;고조되/VVX,1,0.26471733843572687,62,34,28,56,0.6620944882197445,0.3847078478442334
콜금리/NNG;동결되/VVX,1,0.26272240933881097,36,20,16,15,0.5808432576605927,0.3389466447252496
금리인상/NNG;빨라질/VA;있/VV,1,0.2625951652733687,49,27,22,40,0.6240635793136587,0.3642670381633507
동결/NNG;예상했/VVX,1,0.2625951652733687,49,27,22,31,0.6240635793136587,0.3642670381633507
경제/NNG;살아나/VV,1,0.2625951652733687,49,27,22,39,0.6240635793136587,0.3642670381633507
신용등급/NNG;강등되/VVX,1,0.26042781118886826,64,35,29,43,0.6656361125813237,0.3903440675370541
인플레이션기대심리/NNG;억제하/VVX,1,0.2599105117672005,25,14,11,17,0.5385675605742417,0.31617868366641616
물가/NNG;상승시/VVX,1,0.2599105117672005,25,14,11,14,0.5385675605742417,0.31617868366641616
경기둔화/NNG;대응하/VVX,1,0.2599105117672005,25,14,11,18,0.5385675605742417,0.31617868366641616
불확실성/NNG;줄이/VV,1,0.2599105117672005,25,14,11,28,0.5385675605742417,0.31617868366641616
경기회복/NNG;뒷받침할/VVX,1,0.2599105117672005,25,14,11,35,0.5385675605742417,0.31617868366641616
경기선행지수/NNG;비/VV,1,0.2599105117672005,25,14,11,11,0.5385675605742417,0.31617868366641616
경기회복/NNG;저해할/VVX,1,0.2599105117672005,25,14,11,23,0.5385675605742417,0.31617868366641616
소비/NNG;증가할/VVX,1,0.2599105117672005,25,14,11,18,0.5385675605742417,0.31617868366641616
정책금리인상/NNG;따른/VV,1,0.25722295138942286,51,28,23,23,0.6282514908918679,0.37095928214204466
금리인상/NNG;가능성/NNG;시사하/VVX,1,0.25321284249019027,98,53,45,62,0.7321352787342397,0.43602150359144626
불확실성/NNG;완화될/VVX,1,0.25255075108178127,68,37,31,71,0.6724589019993934,0.4010480138512526
정책금리/NNG;인상될/VVX,1,0.25225582445096517,53,29,24,37,0.632364144372999,0.37737342661554096
금리인상/NNG;따른/VV,1,0.2518087721380484,687,371,316,593,0.8101056014064053,0.48390503027346926
불확실성/NNG;커지/VV,1,0.2501392130022655,230,124,106,212,0.8068901273738182,0.48370405392704546
금리인상우려/NNG;완화되/VVX,1,0.25003508022082466,85,46,39,73,0.7081055640195469,0.4245802263502923
성장/NNG;추구하/VVX,1,0.2496142235758796,16,9,7,16,0.4990432947567115,0.299495057942279
물가상승압력/NNG;인해/VV,1,0.2496142235758796,16,9,7,7,0.4990432947567115,0.299495057942279
물가/NNG;잡/VV;위한/VV,1,0.2496142235758796,16,9,7,11,0.4990432947567115,0.299495057942279
부동산가격/NNG;안정되/VVX,1,0.2496142235758796,16,9,7,8,0.4990432947567115,0.299495057942279
견조한/VAX;성장세/NNG;지속할/VVX,1,0.2496142235758796,16,9,7,12,0.4990432947567115,0.299495057942279
수출/NNG;크/VA;증가하/VVX,1,0.2496142235758796,16,9,7,5,0.4990432947567115,0.299495057942279
금리상승/NNG;되돌렸/VV,1,0.2496142235758796,16,9,7,18,0.4990432947567115,0.299495057942279
경기침체/NNG;극복하/VVX,1,0.2496142235758796,16,9,7,7,0.4990432947567115,0.299495057942279
금리상승/NNG;두드러졌/VV,1,0.2496142235758796,16,9,7,12,0.4990432947567115,0.299495057942279
리스크관리/NNG;필요하/VVX,1,0.2496142235758796,16,9,7,10,0.4990432947567115,0.299495057942279
경제/NNG;장기추세/NNG;성장/NNG;이/VV,1,0.2496142235758796,16,9,7,13,0.4990432947567115,0.299495057942279
취업자수/NNG;늘/VV,1,0.2496142235758796,16,9,7,8,0.4990432947567115,0.299495057942279
경제/NNG;확장세/NNG;지속하/VVX,1,0.2496142235758796,16,9,7,7,0.4990432947567115,0.299495057942279
부동산가격/NNG;상승세/NNG;둔화되/VVX,1,0.2496142235758796,16,9,7,5,0.4990432947567115,0.299495057942279
금리/NNG;낮추/VV;않/VX,1,0.2496142235758796,16,9,7,16,0.4990432947567115,0.299495057942279
경제지표/NNG;회복세/NNG;보이/VV,1,0.2496142235758796,16,9,7,17,0.4990432947567115,0.299495057942279
기준금리/NNG;인하/NNG;거듭/MAG;해/VV,1,0.2496142235758796,16,9,7,8,0.4990432947567115,0.299495057942279
투자심리/NNG;자극했/VVX,1,0.2496142235758796,16,9,7,17,0.4990432947567115,0.299495057942279
경기회복/NNG;촉진하/VVX,1,0.2496142235758796,16,9,7,12,0.4990432947567115,0.299495057942279
통화정책/NNG;완화될/VVX,1,0.2496142235758796,16,9,7,10,0.4990432947567115,0.299495057942279
물가상승/NNG;유발하/VVX;않/VX,1,0.2496142235758796,16,9,7,5,0.4990432947567115,0.299495057942279
인플레이션/NNG;하/VV,1,0.2496142235758796,16,9,7,13,0.4990432947567115,0.299495057942279
인플레이션압력/NNG;완화된/VVX,1,0.2496142235758796,16,9,7,11,0.4990432947567115,0.299495057942279
설비투자/NNG;감소했/VVX,1,0.2496142235758796,16,9,7,21,0.4990432947567115,0.299495057942279
생산자/NNG;물가/NNG;오르/VV,1,0.2496142235758796,16,9,7,6,0.4990432947567115,0.299495057942279
고용부진/NNG;지속되/VVX,1,0.2496142235758796,16,9,7,8,0.4990432947567115,0.299495057942279
자본확충/NNG;나설/VV,1,0.2496142235758796,16,9,7,4,0.4990432947567115,0.299495057942279
정책금리/NNG;올린/VV,1,0.2496142235758796,16,9,7,12,0.4990432947567115,0.299495057942279
불확실성/NNG;높여/VV,1,0.2496142235758796,16,9,7,13,0.4990432947567115,0.299495057942279
유동성/NNG;통제하/VVX,1,0.2496142235758796,16,9,7,14,0.4990432947567115,0.299495057942279
경기불확실성/NNG;완화되/VVX,1,0.2496142235758796,16,9,7,17,0.4990432947567115,0.299495057942279
재정적자/NNG;메우/VV,1,0.2496142235758796,16,9,7,11,0.4990432947567115,0.299495057942279
기준금리/NNG;올랐/VV,1,0.2496142235758796,16,9,7,11,0.4990432947567115,0.299495057942279
금리인상/NNG;가능성/NNG;낮춰/VV,1,0.2496142235758796,16,9,7,6,0.4990432947567115,0.299495057942279
수출/NNG;영향/NNG;받/VV,1,0.2496142235758796,16,9,7,12,0.4990432947567115,0.299495057942279
유동성/NNG;줄/VV,1,0.2496142235758796,16,9,7,17,0.4990432947567115,0.299495057942279
투자심리/NNG;부정적/VAX;영향/NNG;미쳤/VV,1,0.24838758301932695,27,15,12,31,0.5433563775765786,0.3269425716170095
경기/NNG;후퇴하/VVX,1,0.24838758301932695,27,15,12,13,0.5433563775765786,0.3269425716170095
인플레율억제/NNG;두/VV,1,0.24838758301932695,27,15,12,19,0.5433563775765786,0.3269425716170095
정책금리/NNG;인하될/VVX,1,0.24838758301932695,27,15,12,17,0.5433563775765786,0.3269425716170095
재정위기/NNG;해결/NNG;위한/VV,1,0.24838758301932695,27,15,12,26,0.5433563775765786,0.3269425716170095
불확실성/NNG;커질/VV;있/VV,1,0.24838758301932695,27,15,12,34,0.5433563775765786,0.3269425716170095
성장/NNG;뒷받침하/VVX,1,0.24838758301932695,27,15,12,17,0.5433563775765786,0.3269425716170095
부동산가격/NNG;상승하/VVX,1,0.24838758301932695,27,15,12,16,0.5433563775765786,0.3269425716170095
금리/NNG;하락세/NNG;보이/VV,1,0.2483094697680004,40,22,18,45,0.5901749128991083,0.35517281688026825
경기회복/NNG;발목/NNG;잡/VV,1,0.2483094697680004,40,22,18,17,0.5901749128991083,0.35517281688026825
금리인상/NNG;더불/VV,1,0.2483094697680004,40,22,18,32,0.5901749128991083,0.35517281688026825
금리하락/NNG;견인하/VVX,1,0.2483094697680004,40,22,18,46,0.5901749128991083,0.35517281688026825
성장세/NNG;둔화될/VVX,1,0.2441990980415174,89,48,41,50,0.7129198562256097,0.4328110857501312
금리인상/NNG;예상했/VVX,1,0.24334951681224481,57,31,26,57,0.6403538538040794,0.3894590815304463
기준금리인하/NNG;예상하/VVX,1,0.24219584046928233,42,23,19,25,0.5947785485112934,0.3626280275392076
기준금리/NNG;유지하/VVX,1,0.24212701026533145,571,307,264,540,0.8055648545903575,0.49121323203177447
성장률/NNG;기록할/VVX,1,0.24076657668378743,179,96,83,126,0.7934227760820847,0.4852084437480648
기준금리/NNG;동결함/VVX,1,0.23933404681957926,59,32,27,76,0.6442269571849408,0.3951684294126144
투자심리/NNG;회복되/VVX,1,0.23905167500331692,76,41,35,99,0.6850626361670908,0.4204686678017031
콜금리/NNG;유지될/VVX,1,0.2386414050770762,29,16,13,5,0.5482049556603145,0.3367627350283562
성장률/NNG;될/VV,1,0.2386414050770762,29,16,13,29,0.5482049556603145,0.3367627350283562
기준금리동결/NNG;전망했/VVX,1,0.2386414050770762,29,16,13,19,0.5482049556603145,0.3367627350283562
물가상승압력/NNG;완화되/VVX,1,0.2386414050770762,29,16,13,18,0.5482049556603145,0.3367627350283562
불안/NNG;해소하/VVX,1,0.2386414050770762,29,16,13,20,0.5482049556603145,0.3367627350283562
재정긴축/NNG;따른/VV,1,0.2386414050770762,29,16,13,29,0.5482049556603145,0.3367627350283562
적자/NNG;돌아섰/VV,1,0.2386414050770762,29,16,13,16,0.5482049556603145,0.3367627350283562
금리인하기대/NNG;강화되/VVX,1,0.2386414050770762,29,16,13,25,0.5482049556603145,0.3367627350283562
정책금리/NNG;인상하/VVX,1,0.23683758600605342,170,91,79,104,0.7883116100723632,0.4861146883087473
경제/NNG;성장했/VVX,1,0.2366638813104427,44,24,20,15,0.5993307150788537,0.3697150314363091
불안심리/NNG;완화되/VVX,1,0.2366638813104427,44,24,20,39,0.5993307150788537,0.3697150314363091
금리/NNG;동결한/VVX,1,0.2316296487495304,46,25,21,36,0.6038251283223599,0.37647453531876546
신용등급/NNG;강등했/VVX,1,0.2316296487495304,46,25,21,57,0.6038251283223599,0.37647453531876546
성장/NNG;달성할/VVX,1,0.2316296487495304,46,25,21,48,0.6038251283223599,0.37647453531876546
기준금리인상/NNG;단행될/VVX,1,0.2316296487495304,46,25,21,53,0.6038251283223599,0.37647453531876546
수출/NNG;부정적/VAX;영향/NNG;미칠/VV,1,0.2315045282646051,18,10,8,16,0.5033239767650467,0.3138967487860443
금리/NNG;계속/MAG;올릴/VV,1,0.2315045282646051,18,10,8,8,0.5033239767650467,0.3138967487860443
부동산가격/NNG;오르/VV,1,0.2315045282646051,18,10,8,19,0.5033239767650467,0.3138967487860443
경기/NNG;불확실성/NNG;상존하/VVX,1,0.2315045282646051,18,10,8,14,0.5033239767650467,0.3138967487860443
금리/NNG;상승한/VAX;스프레드/NNG;확대된/VVX,1,0.2315045282646051,18,10,8,17,0.5033239767650467,0.3138967487860443
인플레이션우려/NNG;부각되/VVX,1,0.2315045282646051,18,10,8,3,0.5033239767650467,0.3138967487860443
기준금리인하/NNG;기대/NNG;약화되/VVX,1,0.2315045282646051,18,10,8,20,0.5033239767650467,0.3138967487860443
수익성/NNG;높이/VV,1,0.2315045282646051,18,10,8,10,0.5033239767650467,0.3138967487860443
연방기금금리/NNG;올리/VV,1,0.2315045282646051,18,10,8,39,0.5033239767650467,0.3138967487860443
금리인하/NNG;가능성/NNG;낮/VA;보이/VV,1,0.2315045282646051,18,10,8,18,0.5033239767650467,0.3138967487860443
주택가격/NNG;상승세/NNG;둔화되/VVX,1,0.2315045282646051,18,10,8,5,0.5033239767650467,0.3138967487860443
경기/NNG;침체/NNG;빠질/VV,1,0.2315045282646051,18,10,8,16,0.5033239767650467,0.3138967487860443
경기회복/NNG;위해서/VV,1,0.2315045282646051,18,10,8,26,0.5033239767650467,0.3138967487860443
신용위험/NNG;나타내/VV,1,0.2315045282646051,18,10,8,3,0.5033239767650467,0.3138967487860443
수출/NNG;부정적/VAX;영향/NNG;줄/VV,1,0.2315045282646051,18,10,8,13,0.5033239767650467,0.3138967487860443
유동성/NNG;환수하/VVX,1,0.2315045282646051,18,10,8,13,0.5033239767650467,0.3138967487860443
경제/NNG;불확실성/NNG;커지/VV,1,0.2315045282646051,18,10,8,18,0.5033239767650467,0.3138967487860443
경제성장/NNG;발목/NNG;잡/VV,1,0.23028895683127404,31,17,14,19,0.5530893492247891,0.345819268002487
금리하락/NNG;작용했/VVX,1,0.23028895683127404,31,17,14,25,0.5530893492247891,0.345819268002487
금리메리트/NNG;남/VV,1,0.23028895683127404,31,17,14,37,0.5530893492247891,0.345819268002487
경기/NNG;하강할/VVX,1,0.23028895683127404,31,17,14,9,0.5530893492247891,0.345819268002487
경제과열/NNG;막/VV,1,0.23028895683127404,31,17,14,5,0.5530893492247891,0.345819268002487
인플레이션억제/NNG;위해/VV,1,0.22898003978872938,101,54,47,61,0.7254941473701737,0.45487006900611504
금리/NNG;인상한/VVX,1,0.22898003978872938,101,54,47,78,0.7254941473701737,0.45487006900611504
불확실성/NNG;인해/VV,1,0.22889753715786276,150,80,70,168,0.7744741792370922,0.4856640692933892
금리인상/NNG;될/VV,1,0.22780430960437736,84,45,39,54,0.6962982533856154,0.4376486593489223
기준금리/NNG;인하하/VVX;않/VX,1,0.22702448730654257,48,26,22,41,0.6082563602620615,0.3829401097506892
수출/NNG;회복되/VVX,1,0.22702448730654257,48,26,22,41,0.6082563602620615,0.3829401097506892
침체/NNG;겪/VV,1,0.22553048517525287,67,36,31,45,0.6588768962112882,0.4161169859440158
금리인상/NNG;단행해/VVX,1,0.22526750275192953,86,46,40,45,0.6988987229013907,0.441637489116912
경제/NNG;성장하/VVX,1,0.22386976244390544,171,91,80,144,0.7823182960021698,0.49580742204790856
금융시장/NNG;불안하/VVX,1,0.2230490979139328,33,18,15,22,0.5579892267568832,0.3542462250608605
적자/NNG;줄이/VV,1,0.2230490979139328,33,18,15,26,0.5579892267568832,0.3542462250608605
금리/NNG;올리/VV,1,0.21996815577621143,1242,661,581,1030,0.7948827207468259,0.5079197595433322
성장/NNG;지속할/VVX,1,0.2196964829315804,71,38,33,40,0.6656864947735962,0.42560783970175375
내수/NNG;회복되/VVX,1,0.2196964829315804,71,38,33,41,0.6656864947735962,0.42560783970175375
불안/NNG;지속될/VVX,1,0.2196964829315804,71,38,33,49,0.6656864947735962,0.42560783970175375
금리인상/NNG;하/VV,1,0.21919418872260255,177,94,83,131,0.7821562474678452,0.5006007589799383
금리/NNG;인상함/VVX,1,0.21888414483860075,52,28,24,13,0.6169112998850473,0.3950967250013849
수출/NNG;부진하/VVX,1,0.21888414483860075,52,28,24,48,0.6169112998850473,0.3950967250013849
금융위기/NNG;대응하/VVX,1,0.21888414483860075,52,28,24,19,0.6169112998850473,0.3950967250013849
금리/NNG;상승세/NNG;진정될/VVX,1,0.21750570833975824,20,11,9,43,0.5079070226231989,0.3262281162799003
금리상단/NNG;제한하/VVX,1,0.21750570833975824,20,11,9,34,0.5079070226231989,0.3262281162799003
금리/NNG;인상한/VVX;해도/VV,1,0.21750570833975824,20,11,9,12,0.5079070226231989,0.3262281162799003
신용등급/NNG;강등됐/VVX,1,0.21750570833975824,20,11,9,8,0.5079070226231989,0.3262281162799003
금리인상/NNG;검토하/VVX,1,0.21750570833975824,20,11,9,13,0.5079070226231989,0.3262281162799003
경기/NNG;성장세/NNG;둔화되/VVX,1,0.21750570833975824,20,11,9,15,0.5079070226231989,0.3262281162799003
gdp/NNG;낮추/VV,1,0.21750570833975824,20,11,9,19,0.5079070226231989,0.3262281162799003
변동성확대/NNG;예상되/VVX,1,0.21750570833975824,20,11,9,9,0.5079070226231989,0.3262281162799003
경제/NNG;성장세/NNG;이/VV;가/VX,1,0.21750570833975824,20,11,9,21,0.5079070226231989,0.3262281162799003
금리/NNG;동결키/VVX,1,0.21750570833975824,20,11,9,16,0.5079070226231989,0.3262281162799003
금리/NNG;하락세/NNG;예상됨/VVX,1,0.21750570833975824,20,11,9,11,0.5079070226231989,0.3262281162799003
자산/NNG;매각할/VVX,1,0.21750570833975824,20,11,9,9,0.5079070226231989,0.3262281162799003
기준금리인상/NNG;가능성/NNG;열려/VV,1,0.21750570833975824,20,11,9,9,0.5079070226231989,0.3262281162799003
금융위기/NNG;터지/VV,1,0.21750570833975824,20,11,9,9,0.5079070226231989,0.3262281162799003
금리인상/NNG;뒷받침할/VVX,1,0.21750570833975824,20,11,9,20,0.5079070226231989,0.3262281162799003
금리인상/NNG;가능성/NNG;불거지/VV,1,0.21750570833975824,20,11,9,9,0.5079070226231989,0.3262281162799003
저성장/NNG;성장잠재력/NNG;훼손되/VVX;않/VX,1,0.21750570833975824,20,11,9,28,0.5079070226231989,0.3262281162799003
경상수지흑자/NNG;따른/VV,1,0.21750570833975824,20,11,9,38,0.5079070226231989,0.3262281162799003
금리인상/NNG;가능성/NNG;커졌/VV,1,0.21750570833975824,20,11,9,20,0.5079070226231989,0.3262281162799003
지정학적리스크/NNG;확대되/VVX,1,0.21750570833975824,20,11,9,19,0.5079070226231989,0.3262281162799003
불확실성/NNG;감안해/VVX,1,0.21750570833975824,20,11,9,26,0.5079070226231989,0.3262281162799003
동결/NNG;예상한/VVX,1,0.21750570833975824,20,11,9,19,0.5079070226231989,0.3262281162799003
불안/NNG;보이/VV,1,0.21750570833975824,20,11,9,11,0.5079070226231989,0.3262281162799003
금리인상/NNG;우려하/VVX,1,0.21750570833975824,20,11,9,6,0.5079070226231989,0.3262281162799003
소비자물가상승률/NNG;둔화되/VVX,1,0.21750570833975824,20,11,9,9,0.5079070226231989,0.3262281162799003
수출/NNG;하/VV,1,0.21750570833975824,20,11,9,16,0.5079070226231989,0.3262281162799003
인플레이션압력/NNG;줄어들/VV,1,0.21750570833975824,20,11,9,12,0.5079070226231989,0.3262281162799003
경기개선/NNG;따른/VV,1,0.2169916538768033,73,39,34,55,0.6689615519076844,0.43013689338571215
금리/NNG;올라갈/VV,1,0.2169916538768033,73,39,34,65,0.6689615519076844,0.43013689338571215
불안심리/NNG;해소되/VVX,1,0.2167109412968229,35,19,16,17,0.5628873667867706,0.36214521793375204
자금이탈/NNG;지속되/VVX,1,0.2167109412968229,35,19,16,23,0.5628873667867706,0.36214521793375204
경제/NNG;안정되/VVX,1,0.2167109412968229,35,19,16,29,0.5628873667867706,0.36214521793375204
인플레이션압력/NNG;완화되/VVX,1,0.21526216783617813,54,29,25,28,0.6211276387013864,0.40083105152182413
금리인상/NNG;이어질/VV,1,0.2125932910152446,117,62,55,67,0.7383084349334251,0.4791222639709434
불확실성/NNG;지속되/VVX,1,0.21252277806864273,170,90,80,140,0.7762378498188066,0.5038107703673602
금리인상/NNG;이어지/VV,1,0.21189231602228964,56,30,26,37,0.6252659158127286,0.4063595878241251
금리인하/NNG;나서/VV;않/VX,1,0.21111326842005562,37,20,17,26,0.5677691876363603,0.36959454295879146
임금/NNG;상승하/VVX,1,0.21111326842005562,37,20,17,28,0.5677691876363603,0.36959454295879146
자산/NNG;줄이/VV,1,0.21111326842005562,37,20,17,41,0.5677691876363603,0.36959454295879146
금리/NNG;올려야/VV,1,0.21006051608683673,238,126,112,222,0.7880195364056695,0.5140993280740346
금리인상/NNG;단행하/VVX;않/VX,1,0.2087461157434356,58,31,27,47,0.6293237612264528,0.41169686779484943
금리인상/NNG;마무리되/VVX,1,0.2063788563657587,22,12,10,18,0.5127119585269894,0.33707338156089767
가계대출/NNG;늘/VV,1,0.2063788563657587,22,12,10,13,0.5127119585269894,0.33707338156089767
마이너스/NNG;벗어나/VV;못하/VX,1,0.2063788563657587,22,12,10,13,0.5127119585269894,0.33707338156089767
기준금리/NNG;인상하/VVX;어려울/VA,1,0.2063788563657587,22,12,10,26,0.5127119585269894,0.33707338156089767
양적완화/NNG;단행할/VVX,1,0.2063788563657587,22,12,10,15,0.5127119585269894,0.33707338156089767
인플레이션압력/NNG;따른/VV,1,0.2063788563657587,22,12,10,11,0.5127119585269894,0.33707338156089767
금리동결/NNG;전망했/VVX,1,0.2063788563657587,22,12,10,12,0.5127119585269894,0.33707338156089767
물가상승압력/NNG;완화하/VVX,1,0.2063788563657587,22,12,10,6,0.5127119585269894,0.33707338156089767
근원소비자물가/NNG;상승하/VVX,1,0.2063788563657587,22,12,10,10,0.5127119585269894,0.33707338156089767
기준금리인상/NNG;가능성/NNG;시사했/VVX,1,0.2063788563657587,22,12,10,23,0.5127119585269894,0.33707338156089767
금리변동성/NNG;확대되/VVX,1,0.20613075899908817,39,21,18,48,0.5726223362770715,0.37665543791962447
경기회복/NNG;기대/NNG;커지/VV,1,0.20613075899908817,39,21,18,36,0.5726223362770715,0.37665543791962447
경기/NNG;회복될/VVX,1,0.20603329648678081,104,55,49,98,0.7187741777236376,0.4728863576485936
금리인상/NNG;주장했/VVX,1,0.2057991971637898,60,32,28,47,0.6332992293757518,0.4168554673268972
리스크/NNG;있/VV,1,0.19795807667038945,66,35,31,40,0.6447173485316512,0.43136224338744594
금리동결/NNG;예상했/VVX,1,0.19795807667038945,66,35,31,45,0.6447173485316512,0.43136224338744594
불확실성/NNG;상존하/VVX,1,0.1977841786486143,135,71,64,120,0.7481781622912047,0.5007660927964827
유동성/NNG;줄이/VV,1,0.19763562790080313,43,23,20,46,0.5822023141451124,0.3897965750373383
자산가격/NNG;상승하/VVX,1,0.19733526038000226,24,13,11,16,0.5176761805838894,0.34681159498438735
불안/NNG;확산될/VVX,1,0.19733526038000226,24,13,11,23,0.5176761805838894,0.34681159498438735
불확실성/NNG;우려하/VVX,1,0.19733526038000226,24,13,11,11,0.5176761805838894,0.34681159498438735
가계부채증가/NNG;따른/VV,1,0.19733526038000226,24,13,11,20,0.5176761805838894,0.34681159498438735
세계경제/NNG;미국/NNG;선진국/NNG;회복세/NNG;이/VV,1,0.19733526038000226,24,13,11,11,0.5176761805838894,0.34681159498438735
마이너스/NNG;나타낼/VV,1,0.19733526038000226,24,13,11,4,0.5176761805838894,0.34681159498438735
gdp갭/NNG;마이너스/NNG;유지하/VVX,1,0.19733526038000226,24,13,11,23,0.5176761805838894,0.34681159498438735
gdp/NNG;증가할/VVX,1,0.19733526038000226,24,13,11,31,0.5176761805838894,0.34681159498438735
소비/NNG;제약하/VVX,1,0.19733526038000226,24,13,11,41,0.5176761805838894,0.34681159498438735
채권시장/NNG;강세/NNG;이/VV,1,0.19733526038000226,24,13,11,22,0.5176761805838894,0.34681159498438735
금리동결/NNG;주장하/VVX,1,0.19733526038000226,24,13,11,8,0.5176761805838894,0.34681159498438735
신용스프레드/NNG;확대된/VVX,1,0.19733526038000226,24,13,11,31,0.5176761805838894,0.34681159498438735
경기둔화/NNG;이어질/VV,1,0.19733526038000226,24,13,11,21,0.5176761805838894,0.34681159498438735
수출/NNG;영향/NNG;미치/VV,1,0.19733526038000226,24,13,11,12,0.5176761805838894,0.34681159498438735
유동성/NNG;공급했/VVX,1,0.1937012612850013,95,50,45,84,0.6994158627643577,0.47211849358882385
투자심리/NNG;위축됐/VVX,1,0.19200923913702117,97,51,46,55,0.7016998128254492,0.4753270164004414
금리/NNG;유지하/VVX,1,0.19188910523587466,164,86,78,154,0.763099447064501,0.5170476353375872
금리하락/NNG;작용할/VVX,1,0.19064571489670668,47,25,22,35,0.5915611767487093,0.4018550847079557
투자심리/NNG;냉각시/VVX,1,0.19064571489670668,47,25,22,39,0.5915611767487093,0.4018550847079557
유동성/NNG;줄어들/VV,1,0.19064571489670668,47,25,22,33,0.5915611767487093,0.4018550847079557
신용등급/NNG;강등될/VVX,1,0.19064571489670668,47,25,22,34,0.5915611767487093,0.4018550847079557
금리인상/NNG;단행하/VVX,1,0.1904437867901969,282,148,134,204,0.7795996554751331,0.5298138927086846
금리/NNG;변동성/NNG;확대될/VVX,1,0.1898493777146366,26,14,12,12,0.5227507834113692,0.3556982794097882
실업률/NNG;하/VV,1,0.1898493777146366,26,14,12,29,0.5227507834113692,0.3556982794097882
연착륙/NNG;유도하/VVX,1,0.1898493777146366,26,14,12,18,0.5227507834113692,0.3556982794097882
성장세/NNG;둔화할/VVX,1,0.1898493777146366,26,14,12,24,0.5227507834113692,0.3556982794097882
금리인상/NNG;가능성/NNG;언급하/VVX,1,0.1898493777146366,26,14,12,22,0.5227507834113692,0.3556982794097882
완화적/VAX;통화정책/NNG;지속될/VVX,1,0.1898493777146366,26,14,12,22,0.5227507834113692,0.3556982794097882
금리상승/NNG;대비해/VVX,1,0.1898493777146366,26,14,12,28,0.5227507834113692,0.3556982794097882
실업률/NNG;웃돌/VV,1,0.1898493777146366,26,14,12,23,0.5227507834113692,0.3556982794097882
추경/NNG;통한/VV,1,0.1898493777146366,26,14,12,27,0.5227507834113692,0.3556982794097882
성장/NNG;지속하/VVX,1,0.18929425300772174,74,39,35,44,0.6587276000976744,0.44873795580800263
불확실성/NNG;해소될/VVX,1,0.18929425300772174,74,39,35,61,0.6587276000976744,0.44873795580800263
금리/NNG;동결하/VVX,1,0.1890825457282339,427,224,203,324,0.7793125068615783,0.5311157716337889
금리/NNG;올라/VV,1,0.18877834501304358,101,53,48,90,0.706040961960471,0.4814833841663329
금리인상/NNG;지속될/VVX,1,0.18691115332512953,151,79,72,88,0.7537237583361318,0.5159930159416842
금리상승/NNG;제한하/VVX,1,0.18572993648475,130,68,62,115,0.7377223624853693,0.5062754498329998
물가/NNG;안정될/VVX,1,0.1855404777488776,78,41,37,39,0.6652093233184634,0.4566911417200872
물가/NNG;상승세/NNG;둔화되/VVX,1,0.18355764120013074,28,15,13,17,0.5278972476042737,0.3639114033557896
재고조정/NNG;마무리되/VVX,1,0.18355764120013074,28,15,13,19,0.5278972476042737,0.3639114033557896
경기부양/NNG;하/VV,1,0.18355764120013074,28,15,13,21,0.5278972476042737,0.3639114033557896
기준금리/NNG;역전된/VVX,1,0.18355764120013074,28,15,13,24,0.5278972476042737,0.3639114033557896
성장세/NNG;확대될/VVX,1,0.18355764120013074,28,15,13,14,0.5278972476042737,0.3639114033557896
gdp/NNG;성장하/VVX,1,0.18355764120013074,28,15,13,27,0.5278972476042737,0.3639114033557896
금융시장/NNG;안정될/VVX,1,0.18355764120013074,28,15,13,18,0.5278972476042737,0.3639114033557896
경기회복세/NNG;보이/VV,1,0.18355764120013074,28,15,13,26,0.5278972476042737,0.3639114033557896
인플레이션압력/NNG;높일/VV,1,0.18355764120013074,28,15,13,16,0.5278972476042737,0.3639114033557896
침체/NNG;보이/VV,1,0.18355764120013074,28,15,13,4,0.5278972476042737,0.3639114033557896
동결/NNG;전망했/VVX,1,0.18355764120013074,28,15,13,16,0.5278972476042737,0.3639114033557896
성장률/NNG;그칠/VV,1,0.18217349362279944,53,28,25,48,0.6050848354068604,0.4183171730855085
기준금리/NNG;인상될/VVX,1,0.18182292471481287,658,344,314,575,0.7755376644871766,0.5365461417726507
금리/NNG;하락/NNG;압력/NNG;받/VV,1,0.17975840250945252,55,29,26,78,0.6094392717839493,0.42343563120779415
재정위기/NNG;겪/VV,1,0.17890430432755977,86,45,41,105,0.6771409401313301,0.47130507870790145
글로벌/NNG;경기회복/NNG;의심/NNG;걷히/VV,1,0.17820055330104156,30,16,14,14,0.53308494391279,0.3715784442542093
경제지표/NNG;부진하/VVX;나오/VV,1,0.17820055330104156,30,16,14,45,0.53308494391279,0.3715784442542093
금리인상/NNG;멈추/VV,1,0.17820055330104156,30,16,14,24,0.53308494391279,0.3715784442542093
기준금리인하/NNG;기대하/VVX,1,0.17820055330104156,30,16,14,40,0.53308494391279,0.3715784442542093
불확실성/NNG;증대되/VVX,1,0.17820055330104156,30,16,14,36,0.53308494391279,0.3715784442542093
금리인상/NNG;예상하/VVX,1,0.17752500388603298,117,61,56,107,0.7205783764517836,0.5029686615853126
금리인상/NNG;계속될/VVX,1,0.17750851529892975,57,30,27,20,0.6137120886145565,0.4283898361969782
경기/NNG;회복되/VVX,1,0.17661737489920726,372,194,178,276,0.7727938533731933,0.5404266789072567
기준금리/NNG;오를/VV,1,0.17540537513403565,59,31,28,57,0.6179011138642521,0.43318945678266185
금리인상/NNG;예상되/VVX,1,0.17485758365077553,148,77,71,125,0.7455340272277069,0.5232593002914052
금리역전/NNG;따른/VV,1,0.17358794765508523,32,17,15,28,0.5382892835852683,0.3787929579731019
금융안정/NNG;위해/VV,1,0.17358794765508523,32,17,15,24,0.5382892835852683,0.3787929579731019
고용지표/NNG;부진하/VVX,1,0.17343311141102125,61,32,29,56,0.6220045980740735,0.43784293245466915
성장/NNG;보이/VV,1,0.17343311141102125,61,32,29,54,0.6220045980740735,0.43784293245466915
성장세/NNG;보일/VV,1,0.17185192823231676,96,50,46,70,0.6901870187128385,0.4874233525420612
기준금리/NNG;올리/VV,1,0.17014300042966846,427,222,205,432,0.7693698083391132,0.5452590634161842
금리인상/NNG;반영하/VVX,1,0.16982815550438324,65,34,31,49,0.6299497630321599,0.44674028826852474
금리/NNG;올린다고/VV,1,0.16982815550438324,65,34,31,55,0.6299497630321599,0.44674028826852474
변동성/NNG;확대하/VVX,1,0.16957729404114752,34,18,16,29,0.5434903500215046,0.38562507974419885
금리상승/NNG;작용했/VVX,1,0.16957729404114752,34,18,16,35,0.5434903500215046,0.38562507974419885
경기후퇴/NNG;막/VV,1,0.16957729404114752,34,18,16,6,0.5434903500215046,0.38562507974419885
실업률/NNG;낮추/VV,1,0.16957729404114752,34,18,16,39,0.5434903500215046,0.38562507974419885
장단기금리스프레드/NNG;축소되/VVX,1,0.16957729404114752,34,18,16,14,0.5434903500215046,0.38562507974419885
경제/NNG;미치/VV;부정적/VAX,1,0.1681731675228717,67,35,32,66,0.6337896379552033,0.4509966064449934
금리인하/NNG;결정하/VVX,1,0.16605967327728144,36,19,17,25,0.5486718814439041,0.39212838417109996
물가/NNG;끌어올리/VV,1,0.16605967327728144,36,19,17,35,0.5486718814439041,0.39212838417109996
수출/NNG;개선되/VVX,1,0.16605967327728144,36,19,17,62,0.5486718814439041,0.39212838417109996
유동성/NNG;증가하/VVX,1,0.16605967327728144,36,19,17,29,0.5486718814439041,0.39212838417109996
기준금리인상/NNG;가능성/NNG;반영했/VVX,1,0.16579453900396746,166,86,80,122,0.7501434835840834,0.5364096669207807
부양책/NNG;내놓/VV,1,0.1639851414222777,170,88,82,152,0.7508231880186644,0.5388955128916311
금리/NNG;상승세/NNG;재개되/VVX,1,0.162950435101491,38,20,18,61,0.5538205083065106,0.39834448830376973
신용등급/NNG;강등할/VVX,1,0.162950435101491,38,20,18,38,0.5538205083065106,0.39834448830376973
불확실성/NNG;남/VV,1,0.16168901802412816,365,189,176,344,0.7648227204993201,0.5515377271271421
금리하락/NNG;제한하/VVX,1,0.16103831101265387,77,40,37,75,0.6516482305712473,0.47055202088815673
수출/NNG;늘/VV,1,0.16051216295059034,116,60,56,50,0.7105965861915374,0.5136726070021622
금리/NNG;올라가/VV,1,0.16045892830451547,149,77,72,142,0.7384313454119293,0.5338519676946231
안전자산선호현상/NNG;강화돼/VVX,1,0.16018281057232553,40,21,19,17,0.5589251760609802,0.404306214430684
물가/NNG;잡/VV;위해/VV,1,0.15979507088831935,79,41,38,51,0.6549525119565635,0.4741458940321551
단기금리/NNG;상승하/VVX,1,0.1586014593854086,81,42,39,60,0.6581686216254625,0.4776419564456651
금리동결/NNG;유지할/VVX,1,0.1577034429114379,42,22,20,23,0.5639767036598446,0.41003980958833336
변동성/NNG;커졌/VV,1,0.1577034429114379,42,22,20,39,0.5639767036598446,0.41003980958833336
인플레이션우려/NNG;커지/VV,1,0.1577034429114379,42,22,20,26,0.5639767036598446,0.41003980958833336
금리상승/NNG;요인이/VVX,1,0.1577034429114379,42,22,20,32,0.5639767036598446,0.41003980958833336
불확실성/NNG;상존해/VVX,1,0.1577034429114379,42,22,20,27,0.5639767036598446,0.41003980958833336
안전자산선호/NNG;확대되/VVX,1,0.15762757187046517,15,8,7,21,0.4726134197167965,0.34366748901658745
gdp/NNG;성장할/VVX,1,0.15762757187046517,15,8,7,12,0.4726134197167965,0.34366748901658745
흑자/NNG;돌아서/VV,1,0.15762757187046517,15,8,7,10,0.4726134197167965,0.34366748901658745
금리/NNG;상승/NNG;작용할/VVX,1,0.15762757187046517,15,8,7,14,0.4726134197167965,0.34366748901658745
물가안정/NNG;추구하/VVX,1,0.15762757187046517,15,8,7,9,0.4726134197167965,0.34366748901658745
시장금리/NNG;상승/NNG;제한되/VVX,1,0.15762757187046517,15,8,7,9,0.4726134197167965,0.34366748901658745
동결/NNG;되/VV,1,0.15762757187046517,15,8,7,7,0.4726134197167965,0.34366748901658745
경기회복/NNG;부담/NNG;될/VV,1,0.15762757187046517,15,8,7,6,0.4726134197167965,0.34366748901658745
경기/NNG;떠받치/VV,1,0.15762757187046517,15,8,7,11,0.4726134197167965,0.34366748901658745
금리/NNG;인상할/VVX;가능성/NNG;낮/VA,1,0.15762757187046517,15,8,7,20,0.4726134197167965,0.34366748901658745
불안/NNG;반영해/VVX,1,0.15762757187046517,15,8,7,8,0.4726134197167965,0.34366748901658745
통화정책/NNG;불확실성/NNG;완화될/VVX,1,0.15762757187046517,15,8,7,11,0.4726134197167965,0.34366748901658745
금리인하/NNG;가능성/NNG;반영했/VVX,1,0.15762757187046517,15,8,7,8,0.4726134197167965,0.34366748901658745
인플레이션/NNG;차단하/VVX,1,0.15762757187046517,15,8,7,11,0.4726134197167965,0.34366748901658745
풍부한/VAX;유동성/NNG;인해/VV,1,0.15762757187046517,15,8,7,16,0.4726134197167965,0.34366748901658745
선진국/NNG;경기회복/NNG;따른/VV,1,0.15762757187046517,15,8,7,14,0.4726134197167965,0.34366748901658745
투자심리/NNG;긍정적/VAX;영향/NNG;미치/VV,1,0.15762757187046517,15,8,7,9,0.4726134197167965,0.34366748901658745
시장금리/NNG;미치/VV;영향력/NNG,1,0.15762757187046517,15,8,7,8,0.4726134197167965,0.34366748901658745
세계경제/NNG;미칠/VV;영향/NNG,1,0.15762757187046517,15,8,7,8,0.4726134197167965,0.34366748901658745
기준금리/NNG;오른/VV,1,0.15762757187046517,15,8,7,16,0.4726134197167965,0.34366748901658745
흑자/NNG;돌아설/VV,1,0.15762757187046517,15,8,7,20,0.4726134197167965,0.34366748901658745
환율하락/NNG;용인하/VVX,1,0.15762757187046517,15,8,7,11,0.4726134197167965,0.34366748901658745
연방기금금리/NNG;선물시장/NNG;반영된/VVX,1,0.15762757187046517,15,8,7,12,0.4726134197167965,0.34366748901658745
물가/NNG;상승세/NNG;지속되/VVX,1,0.15762757187046517,15,8,7,14,0.4726134197167965,0.34366748901658745
불안/NNG;증폭시/VVX,1,0.15762757187046517,15,8,7,16,0.4726134197167965,0.34366748901658745
불확실성/NNG;하/VV,1,0.15762757187046517,15,8,7,8,0.4726134197167965,0.34366748901658745
금리인상/NNG;진행된/VVX,1,0.15762757187046517,15,8,7,7,0.4726134197167965,0.34366748901658745
소비/NNG;투자/NNG;늘어나/VV,1,0.15762757187046517,15,8,7,5,0.4726134197167965,0.34366748901658745
부동산가격안정/NNG;위한/VV,1,0.15762757187046517,15,8,7,8,0.4726134197167965,0.34366748901658745
인플레이션/NNG;낮추/VV,1,0.15762757187046517,15,8,7,11,0.4726134197167965,0.34366748901658745
금리인상/NNG;피할/VV,1,0.15762757187046517,15,8,7,8,0.4726134197167965,0.34366748901658745
금리상승/NNG;되돌려/VV,1,0.15762757187046517,15,8,7,22,0.4726134197167965,0.34366748901658745
기준금리인상/NNG;가능성/NNG;제기되/VVX,1,0.15762757187046517,15,8,7,8,0.4726134197167965,0.34366748901658745
경제/NNG;회생시/VVX,1,0.15762757187046517,15,8,7,9,0.4726134197167965,0.34366748901658745
금리인하/NNG;베팅/NNG;하/VV,1,0.15762757187046517,15,8,7,20,0.4726134197167965,0.34366748901658745
변동성/NNG;줄이/VV,1,0.15546919613996635,44,23,21,50,0.5689674422829758,0.4155665327601196
성장률/NNG;둔화될/VVX,1,0.15528102985922998,87,45,42,82,0.6672951615481362,0.48757172470099047
수출부진/NNG;지속되/VVX,1,0.15160130591012577,48,25,23,40,0.5787420750535263,0.4260660832155882
금리인하기대/NNG;약화되/VVX,1,0.15160130591012577,48,25,23,77,0.5787420750535263,0.4260660832155882
불확실성/NNG;키우/VV,1,0.14991445712376983,50,26,24,44,0.5835162006685258,0.43106545579631717
물가안정/NNG;유지될/VVX,1,0.14991445712376983,50,26,24,24,0.5835162006685258,0.43106545579631717
경기둔화/NNG;시사하/VVX,1,0.14895419658247122,17,9,8,6,0.4776171750906989,0.3535272319397818
글로벌/NNG;금융시장불안/NNG;따른/VV,1,0.14895419658247122,17,9,8,11,0.4776171750906989,0.3535272319397818
성장률/NNG;마이너스/NNG;기록할/VVX,1,0.14895419658247122,17,9,8,8,0.4776171750906989,0.3535272319397818
금리인상/NNG;가능성/NNG;반영되/VVX,1,0.14895419658247122,17,9,8,18,0.4776171750906989,0.3535272319397818
금리상승압력/NNG;제한될/VVX,1,0.14895419658247122,17,9,8,12,0.4776171750906989,0.3535272319397818
인플레이션/NNG;잘/MAG;통제되/VVX,1,0.14895419658247122,17,9,8,11,0.4776171750906989,0.3535272319397818
금리상승/NNG;유발할/VVX,1,0.14895419658247122,17,9,8,14,0.4776171750906989,0.3535272319397818
동결/NNG;결정되/VVX,1,0.14895419658247122,17,9,8,17,0.4776171750906989,0.3535272319397818
단기금리/NNG;상승했/VVX,1,0.14895419658247122,17,9,8,25,0.4776171750906989,0.3535272319397818
금리상승/NNG;확대될/VVX,1,0.14895419658247122,17,9,8,19,0.4776171750906989,0.3535272319397818
성장/NNG;저해하/VVX,1,0.14895419658247122,17,9,8,15,0.4776171750906989,0.3535272319397818
경기회복/NNG;있/VV,1,0.14895419658247122,17,9,8,18,0.4776171750906989,0.3535272319397818
유동성/NNG;보유하/VVX,1,0.14895419658247122,17,9,8,8,0.4776171750906989,0.3535272319397818
기준금리동결/NNG;이어질/VV,1,0.14895419658247122,17,9,8,24,0.4776171750906989,0.3535272319397818
완화적/VAX;통화정책/NNG;유지될/VVX,1,0.14895419658247122,17,9,8,11,0.4776171750906989,0.3535272319397818
완전고용/NNG;근접했/VVX,1,0.14895419658247122,17,9,8,10,0.4776171750906989,0.3535272319397818
경제/NNG;압박하/VVX,1,0.14895419658247122,17,9,8,13,0.4776171750906989,0.3535272319397818
마이너스/NNG;행진/NNG;이/VV,1,0.14895419658247122,17,9,8,11,0.4776171750906989,0.3535272319397818
경제/NNG;미치/VV;긍정적/VAX,1,0.14895419658247122,17,9,8,5,0.4776171750906989,0.3535272319397818
금리인상/NNG;예상한/VVX,1,0.14895419658247122,17,9,8,26,0.4776171750906989,0.3535272319397818
금리인상/NNG;염두/NNG;두/VV,1,0.14895419658247122,17,9,8,9,0.4776171750906989,0.3535272319397818
양적완화/NNG;종료/NNG;따른/VV,1,0.14895419658247122,17,9,8,18,0.4776171750906989,0.3535272319397818
양적완화/NNG;이/VV,1,0.14895419658247122,17,9,8,18,0.4776171750906989,0.3535272319397818
금리/NNG;올리/VV;힘들/VA,1,0.14895419658247122,17,9,8,6,0.4776171750906989,0.3535272319397818
유가상승/NNG;인해/VV,1,0.14895419658247122,17,9,8,14,0.4776171750906989,0.3535272319397818
경제/NNG;개선된/VVX,1,0.14895419658247122,17,9,8,30,0.4776171750906989,0.3535272319397818
하방리스크/NNG;커지/VV,1,0.14895419658247122,17,9,8,32,0.4776171750906989,0.3535272319397818
건설투자/NNG;감소했/VVX,1,0.14895419658247122,17,9,8,3,0.4776171750906989,0.3535272319397818
경기둔화/NNG;반영해/VVX,1,0.14895419658247122,17,9,8,9,0.4776171750906989,0.3535272319397818
금리/NNG;하락세/NNG;두드러졌/VV,1,0.14895419658247122,17,9,8,14,0.4776171750906989,0.3535272319397818
경기/NNG;냉각되/VVX,1,0.14895419658247122,17,9,8,9,0.4776171750906989,0.3535272319397818
금리인상/NNG;나설지/VV,1,0.14895419658247122,17,9,8,10,0.4776171750906989,0.3535272319397818
금리상승압력/NNG;작용하/VVX,1,0.1483640532448749,52,27,25,40,0.5882096973866379,0.4359121690609434
고용/NNG;감소했/VVX,1,0.14693302581075374,54,28,26,15,0.5928195195609587,0.4406149769012413
소비/NNG;위축될/VVX,1,0.14693302581075374,54,28,26,29,0.5928195195609587,0.4406149769012413
금리인상/NNG;가능할/VVX,1,0.1447083716936286,111,57,54,95,0.6964765486020225,0.5200156515196234
성장세/NNG;이어지/VV,1,0.14437326718808308,58,30,28,47,0.6017786456142303,0.44961811244231226
취업자수/NNG;증가하/VVX,1,0.14437326718808308,58,30,28,66,0.6017786456142303,0.44961811244231226
성장/NNG;달성하/VVX,1,0.14322155295925842,60,31,29,51,0.6061243348717731,0.4539307950298555
원자재가격/NNG;상승하/VVX,1,0.14322155295925842,60,31,29,40,0.6061243348717731,0.4539307950298555
유가하락/NNG;따른/VV,1,0.14243541367344403,199,102,97,169,0.7473729011548599,0.5606113977843241
재정확대/NNG;통한/VV,1,0.14235369251573826,19,10,9,18,0.4829060423054597,0.3622927349495409
자산/NNG;증가하/VVX,1,0.14235369251573826,19,10,9,25,0.4829060423054597,0.3622927349495409
신흥시장/NNG;성장세약화/NNG;영향/NNG;받/VV,1,0.14235369251573826,19,10,9,23,0.4829060423054597,0.3622927349495409
자산매입/NNG;연장하/VVX,1,0.14235369251573826,19,10,9,13,0.4829060423054597,0.3622927349495409
물가/NNG;높/VA;유지하/VVX,1,0.14235369251573826,19,10,9,8,0.4829060423054597,0.3622927349495409
콜금리/NNG;올려/VV,1,0.14235369251573826,19,10,9,13,0.4829060423054597,0.3622927349495409
국제원자재가격/NNG;상승/NNG;따른/VV,1,0.14235369251573826,19,10,9,6,0.4829060423054597,0.3622927349495409
유동성/NNG;관리/NNG;강화하/VVX,1,0.14235369251573826,19,10,9,7,0.4829060423054597,0.3622927349495409
적자/NNG;지속되/VVX,1,0.14235369251573826,19,10,9,17,0.4829060423054597,0.3622927349495409
성장/NNG;나타내/VV,1,0.14235369251573826,19,10,9,8,0.4829060423054597,0.3622927349495409
고용/NNG;회복되/VVX,1,0.14235369251573826,19,10,9,22,0.4829060423054597,0.3622927349495409
유동성/NNG;잡/VV,1,0.14235369251573826,19,10,9,16,0.4829060423054597,0.3622927349495409
금융시장/NNG;충격/NNG;주/VV,1,0.14235369251573826,19,10,9,22,0.4829060423054597,0.3622927349495409
채권시장/NNG;호재/NNG;작용하/VVX,1,0.14235369251573826,19,10,9,8,0.4829060423054597,0.3622927349495409
내수/NNG;성장기여/VVX,1,0.14235369251573826,19,10,9,7,0.4829060423054597,0.3622927349495409
금리/NNG;하락세/NNG;재개되/VVX,1,0.14235369251573826,19,10,9,7,0.4829060423054597,0.3622927349495409
금리인하기대감/NNG;확산되/VVX,1,0.14235369251573826,19,10,9,14,0.4829060423054597,0.3622927349495409
금리인상/NNG;미뤄질/VV,1,0.14235369251573826,19,10,9,27,0.4829060423054597,0.3622927349495409
경제/NNG;침체/NNG;벗어나/VV,1,0.14235369251573826,19,10,9,21,0.4829060423054597,0.3622927349495409
경상수지적자/NNG;줄이/VV,1,0.14235369251573826,19,10,9,12,0.4829060423054597,0.3622927349495409
유가상승/NNG;제한됐/VVX,1,0.14235369251573826,19,10,9,13,0.4829060423054597,0.3622927349495409
변동성/NNG;제한될/VVX,1,0.14235369251573826,19,10,9,22,0.4829060423054597,0.3622927349495409
물가/NNG;크/VA;오르/VV,1,0.14235369251573826,19,10,9,8,0.4829060423054597,0.3622927349495409
실업률/NNG;하락했/VVX,1,0.13841029106328873,70,36,34,63,0.6264731956585363,0.4737961419282881
주택시장침체/NNG;따른/VV,1,0.13841029106328873,70,36,34,22,0.6264731956585363,0.4737961419282881
동결/NNG;예상된/VVX,1,0.1371989358443353,21,11,10,13,0.4883827773442829,0.37027235054966723
경제/NNG;침체되/VVX,1,0.1371989358443353,21,11,10,26,0.4883827773442829,0.37027235054966723
경기/NNG;호전되/VVX,1,0.1371989358443353,21,11,10,33,0.4883827773442829,0.37027235054966723
수출/NNG;둔화하/VVX,1,0.1371989358443353,21,11,10,10,0.4883827773442829,0.37027235054966723
금리/NNG;인하할/VVX;없/VA,1,0.1371989358443353,21,11,10,10,0.4883827773442829,0.37027235054966723
재정/NNG;투입하/VVX,1,0.1371989358443353,21,11,10,25,0.4883827773442829,0.37027235054966723
불안/NNG;남/VV,1,0.1371989358443353,21,11,10,17,0.4883827773442829,0.37027235054966723
변동성/NNG;크/VA;확대됐/VVX,1,0.1371989358443353,21,11,10,10,0.4883827773442829,0.37027235054966723
소비자물가/NNG;안정세/NNG;보이/VV,1,0.1371989358443353,21,11,10,13,0.4883827773442829,0.37027235054966723
신용경색/NNG;나타나/VV,1,0.1371989358443353,21,11,10,7,0.4883827773442829,0.37027235054966723
금리인상시기/NNG;앞당겨질/VV,1,0.1371989358443353,21,11,10,30,0.4883827773442829,0.37027235054966723
정책금리/NNG;유지할/VVX,1,0.1371989358443353,21,11,10,19,0.4883827773442829,0.37027235054966723
성장/NNG;제약하/VVX,1,0.1371989358443353,21,11,10,16,0.4883827773442829,0.37027235054966723
금리상승/NNG;동조화되/VVX,1,0.1371989358443353,21,11,10,18,0.4883827773442829,0.37027235054966723
유가강세/NNG;견인했/VVX,1,0.1371989358443353,21,11,10,4,0.4883827773442829,0.37027235054966723
기준금리인상/NNG;가능성/NNG;시사하/VVX,1,0.1371989358443353,21,11,10,12,0.4883827773442829,0.37027235054966723
자산매입/NNG;축소하/VVX,1,0.1371989358443353,21,11,10,40,0.4883827773442829,0.37027235054966723
불안요인/NNG;작용하/VVX,1,0.13681691315295108,74,38,36,59,0.6339622781411421,0.4810191126060546
경기침체/NNG;막/VV,1,0.1355413035081512,139,71,68,64,0.718041106971694,0.5462311773832313
침체/NNG;따른/VV,1,0.1353612073706174,78,40,38,33,0.6410813696827306,0.4878649230554347
기준금리/NNG;동결하/VVX,1,0.13528227845781382,755,386,369,749,0.7502826556614065,0.5710592095486315
경제/NNG;회복세/NNG;보일/VV,1,0.13309059699099945,23,12,11,25,0.49397934494053536,0.377661291531332
인플레이션압력/NNG;낮추/VV,1,0.13309059699099945,23,12,11,16,0.49397934494053536,0.377661291531332
불안심리/NNG;진정되/VVX,1,0.13309059699099945,23,12,11,26,0.49397934494053536,0.377661291531332
채권시장/NNG;강세/NNG;보일/VV,1,0.13309059699099945,23,12,11,17,0.49397934494053536,0.377661291531332
고용/NNG;호조/NNG;보이/VV,1,0.13309059699099945,23,12,11,8,0.49397934494053536,0.377661291531332
수출/NNG;품목인/VVX,1,0.13309059699099945,23,12,11,21,0.49397934494053536,0.377661291531332
기준금리/NNG;낮춰야/VV,1,0.13309059699099945,23,12,11,16,0.49397934494053536,0.377661291531332
경제성장/NNG;둔화시/VVX,1,0.13309059699099945,23,12,11,17,0.49397934494053536,0.377661291531332
경제지표/NNG;혼조세/NNG;나타내/VV,1,0.13309059699099945,23,12,11,14,0.49397934494053536,0.377661291531332
잠재성장률/NNG;부합하/VVX,1,0.13309059699099945,23,12,11,25,0.49397934494053536,0.377661291531332
성장/NNG;했/VV,1,0.13309059699099945,23,12,11,19,0.49397934494053536,0.377661291531332
디플레이션/NNG;벗어나/VV,1,0.13309059699099945,23,12,11,33,0.49397934494053536,0.377661291531332
수출증가율/NNG;둔화되/VVX,1,0.13309059699099945,23,12,11,23,0.49397934494053536,0.377661291531332
성장/NNG;하/VV,1,0.13073461165862743,157,80,77,93,0.7265149572593176,0.5581098085580917
장단기금리차/NNG;축소될/VVX,1,0.12976223901920192,25,13,12,14,0.49964666351592174,0.38458890729108475
경제성장률/NNG;하락하/VVX,1,0.12976223901920192,25,13,12,28,0.49964666351592174,0.38458890729108475
지준율/NNG;올리/VV,1,0.12976223901920192,25,13,12,9,0.49964666351592174,0.38458890729108475
소비자물가/NNG;미치/VV,1,0.12976223901920192,25,13,12,18,0.49964666351592174,0.38458890729108475
금리하락압력/NNG;우세할/VVX,1,0.12976223901920192,25,13,12,32,0.49964666351592174,0.38458890729108475
경제체질/NNG;개선하/VVX,1,0.12976223901920192,25,13,12,20,0.49964666351592174,0.38458890729108475
수출증가율/NNG;기록하/VVX,1,0.12976223901920192,25,13,12,10,0.49964666351592174,0.38458890729108475
gdp/NNG;감소할/VVX,1,0.12976223901920192,25,13,12,16,0.49964666351592174,0.38458890729108475
근원인플레이션/NNG;개선됐/VVX,1,0.12976223901920192,25,13,12,0,0.49964666351592174,0.38458890729108475
재정/NNG;풀/VV,1,0.12976223901920192,25,13,12,19,0.49964666351592174,0.38458890729108475
금리인상/NNG;시작된/VVX,1,0.12976223901920192,25,13,12,18,0.49964666351592174,0.38458890729108475
불확실성/NNG;증폭되/VVX,1,0.12702926268880899,27,14,13,27,0.505348379520745,0.3911441632517332
금리/NNG;재할인율/NNG;인하했/VVX,1,0.12702926268880899,27,14,13,1,0.505348379520745,0.3911441632517332
금리인상/NNG;단행되/VVX;않/VX,1,0.12702926268880899,27,14,13,26,0.505348379520745,0.3911441632517332
불안/NNG;확대되/VVX,1,0.12702926268880899,27,14,13,23,0.505348379520745,0.3911441632517332
성장/NNG;기대되/VVX,1,0.12702926268880899,27,14,13,30,0.505348379520745,0.3911441632517332
금리인상/NNG;계속할/VVX,1,0.12702926268880899,27,14,13,7,0.505348379520745,0.3911441632517332
단기금리/NNG;오르/VV,1,0.12702926268880899,27,14,13,13,0.505348379520745,0.3911441632517332
금리인상/NNG;나서/VV,1,0.1252704721570379,234,119,115,251,0.7422680466978148,0.5765781809964883
금리상승/NNG;막/VV,1,0.12475973646657668,29,15,14,25,0.5110569518627278,0.39739018574378154
경기회복/NNG;둔화될/VVX,1,0.12475973646657668,29,15,14,28,0.5110569518627278,0.39739018574378154
성장/NNG;보였/VV,1,0.12475973646657668,29,15,14,19,0.5110569518627278,0.39739018574378154
경기불확실성/NNG;인해/VV,1,0.12475973646657668,29,15,14,25,0.5110569518627278,0.39739018574378154
경기/NNG;침체될/VVX,1,0.12475973646657668,29,15,14,13,0.5110569518627278,0.39739018574378154
금리인상/NNG;단행되/VVX,1,0.12360667346044263,124,63,61,117,0.6988505147561175,0.544689187936435
금리/NNG;최저치/NNG;경신하/VVX,1,0.1228568874835767,31,16,15,32,0.5167511099328609,0.4033729706080202
재정지출/NNG;확대하/VVX,1,0.1228568874835767,31,16,15,22,0.5167511099328609,0.4033729706080202
통화완화정책/NNG;따른/VV,1,0.1228568874835767,31,16,15,23,0.5167511099328609,0.4033729706080202
경제성장률/NNG;낮췄/VV,1,0.1228568874835767,31,16,15,32,0.5167511099328609,0.4033729706080202
경제/NNG;회복시/VVX,1,0.1228568874835767,31,16,15,21,0.5167511099328609,0.4033729706080202
적자/NNG;기록할/VVX,1,0.1228568874835767,31,16,15,32,0.5167511099328609,0.4033729706080202
재정지출/NNG;줄이/VV,1,0.12124814973773734,33,17,16,11,0.5224141559737618,0.40912681112061355
경제성장/NNG;위한/VV,1,0.12124814973773734,33,17,16,26,0.5224141559737618,0.40912681112061355
경기하강/NNG;막/VV,1,0.12124814973773734,33,17,16,17,0.5224141559737618,0.40912681112061355
금리상승압력/NNG;가중시/VVX,1,0.12124814973773734,33,17,16,31,0.5224141559737618,0.40912681112061355
금리인상/NNG;나설/VV,1,0.12059415886152047,526,267,259,443,0.7419367888843649,0.5818165216002729
마이너스/NNG;벗어나/VV,1,0.11987807014441332,35,18,17,20,0.5280328022060448,0.41467779904457025
경기회복/NNG;힘입/VV,1,0.11987807014441332,35,18,17,28,0.5280328022060448,0.41467779904457025
경제지표부진/NNG;따른/VV,1,0.11987807014441332,35,18,17,30,0.5280328022060448,0.41467779904457025
금리인상/NNG;단행한/VVX,1,0.11987807014441332,35,18,17,22,0.5280328022060448,0.41467779904457025
경제성장세/NNG;둔화될/VVX,1,0.11987807014441332,35,18,17,17,0.5280328022060448,0.41467779904457025
시장금리/NNG;하/VV,1,0.11987807014441332,35,18,17,38,0.5280328022060448,0.41467779904457025
성장률/NNG;기록하/VVX,1,0.11913366462402308,148,75,73,91,0.7148610271833902,0.5622468968160539
금리/NNG;낮/VA;수준이/VVX,1,0.11870357338404336,37,19,18,28,0.5335963558412502,0.4200461505087037
유동성/NNG;조절하/VVX,1,0.11870357338404336,37,19,18,21,0.5335963558412502,0.4200461505087037
리스크/NNG;인해/VV,1,0.11769071766891037,39,20,19,46,0.5390961359268788,0.42524779136081187
경제성장/NNG;뒷받침하/VVX,1,0.11769071766891037,39,20,19,16,0.5390961359268788,0.42524779136081187
불확실성/NNG;확대된/VVX,1,0.11769071766891037,39,20,19,29,0.5390961359268788,0.42524779136081187
물가안정기조/NNG;유지되/VVX,1,0.11745872715308425,158,80,78,71,0.7194773859036917,0.5678023741604801
수출/NNG;타격/NNG;받/VV,1,0.11681242053359742,41,21,20,34,0.5445250480730791,0.4302954623428873
금리/NNG;내려간/VV,1,0.11681242053359742,41,21,20,53,0.5445250480730791,0.4302954623428873
물가/NNG;오르/VV;않/VX,1,0.11681242053359742,41,21,20,36,0.5445250480730791,0.4302954623428873
인플레이션/NNG;대응하/VVX,1,0.11681242053359742,41,21,20,16,0.5445250480730791,0.4302954623428873
금리인상/NNG;지연되/VVX,1,0.11681242053359742,41,21,20,36,0.5445250480730791,0.4302954623428873
실업률/NNG;치솟/VV,1,0.11681242053359742,41,21,20,27,0.5445250480730791,0.4302954623428873
인플레이션압력/NNG;증가하/VVX,1,0.11681242053359742,41,21,20,16,0.5445250480730791,0.4302954623428873
불확실성/NNG;해소되/VVX,1,0.11648437816034063,235,119,116,262,0.7372966590648594,0.5830151818032083
경제지표/NNG;부진한/VAX;모습/NNG;보이/VV,1,0.11604683200916677,43,22,21,54,0.5498772688319999,0.4351995049447025
물가/NNG;치솟/VV,1,0.11604683200916677,43,22,21,17,0.5498772688319999,0.4351995049447025
금리상승/NNG;나타날/VV,1,0.11537614971353483,45,23,22,31,0.55514800760696,0.43996843008857117
경제성장/NNG;이끌/VV,1,0.11537614971353483,45,23,22,37,0.55514800760696,0.43996843008857117
금리/NNG;하락세/NNG;보임/VV,1,0.11537614971353483,45,23,22,26,0.55514800760696,0.43996843008857117
성장/NNG;있/VV,1,0.11537614971353483,45,23,22,48,0.55514800760696,0.43996843008857117
안전자산선호현상/NNG;강화됐/VVX,1,0.11537614971353483,45,23,22,14,0.55514800760696,0.43996843008857117
소비/NNG;늘리/VV,1,0.11537614971353483,45,23,22,40,0.55514800760696,0.43996843008857117
소비심리/NNG;개선되/VVX,1,0.11537614971353483,45,23,22,43,0.55514800760696,0.43996843008857117
인플레이션기대심리/NNG;낮추/VV,1,0.11537614971353483,45,23,22,49,0.55514800760696,0.43996843008857117
금리인상/NNG;서두르/VV;않/VX,1,0.11478574174160716,47,24,23,73,0.5603333242831657,0.4446093361269284
금리/NNG;인상했/VVX,1,0.11428888176690233,332,168,164,192,0.7382483444993452,0.5863698788388637
불확실성/NNG;커질/VV,1,0.1137992780771353,51,26,25,44,0.5704353630890007,0.4535302142370499
기준금리/NNG;동결해/VVX,1,0.11301236996357455,55,28,27,42,0.580164182711042,0.46200076179853217
금리하락/NNG;제한될/VVX,1,0.11301236996357455,55,28,27,47,0.580164182711042,0.46200076179853217
투자심리/NNG;악화시/VVX,1,0.11209355015510214,61,31,30,47,0.5940326069404277,0.4739253063612766
금리인하/NNG;가능할/VVX,1,0.11183837204562463,63,32,31,66,0.598459010069662,0.4777034198896835
장단기금리차/NNG;확대되/VVX,1,0.11183837204562463,63,32,31,68,0.598459010069662,0.4777034198896835
성장세/NNG;유지할/VVX,1,0.11138408107363151,67,34,33,33,0.6070155238091417,0.4849791528899913
소비/NNG;늘어나/VV,1,0.11138408107363151,67,34,33,59,0.6070155238091417,0.4849791528899913
경기회복/NNG;지연되/VVX,1,0.11117968940472323,69,35,34,47,0.611145774525431,0.48848106937148617
수출/NNG;호조/NNG;보이/VV,1,0.11063273572024634,75,38,37,59,0.6229486894447717,0.4984664227620226
수출/NNG;늘어나/VV,1,0.11063273572024634,75,38,37,58,0.6229486894447717,0.4984664227620226
물가상승/NNG;따른/VV,1,0.11063273572024634,75,38,37,71,0.6229486894447717,0.4984664227620226
금리/NNG;낮/VA;유지하/VVX,1,0.11030762782396919,79,40,39,59,0.630333541231692,0.5047074945353328
물가/NNG;상승할/VVX,1,0.11030762782396919,79,40,39,81,0.630333541231692,0.5047074945353328
불확실성/NNG;높이/VV,1,0.11015324464096632,81,41,40,58,0.633883235432465,0.5077083037372528
금리/NNG;올려도/VV,1,0.1094291617219243,91,46,45,74,0.650245469675484,0.5215771546680501
금리/NNG;인상될/VVX,1,0.10891281828525812,426,215,211,326,0.7351719044890342,0.5903149157599578
기준금리/NNG;낮추/VV,1,0.10745182266898601,119,60,59,92,0.6849164397941784,0.5515891472371072
금리/NNG;인상할/VVX,1,0.10207545777590976,1672,841,831,1235,0.7311611408632562,0.5952646380298224
경제/NNG;성장할/VVX,1,0.09121657483427281,142,71,71,103,0.6948746459184381,0.5782539834126321
물가/NNG;안정되/VVX,1,0.08964054059894266,110,55,55,88,0.6651000758279225,0.5552371785092679
기준금리/NNG;동결했/VVX,1,0.08636039297447162,537,268,269,545,0.7217984300790614,0.6065646036810275
소비/NNG;증가하/VVX,1,0.08619105924008164,82,41,41,44,0.6231126877348253,0.5238124523597403
리스크/NNG;완화되/VVX,1,0.08584221841856965,80,40,40,72,0.6194269069301946,0.5210799490883676
성장세/NNG;보였/VV,1,0.08584221841856965,80,40,40,55,0.6194269069301946,0.5210799490883676
재정위기/NNG;따른/VV,1,0.08384937793660918,70,35,35,72,0.5994897295846181,0.5063356283518217
금리상승/NNG;따른/VV,1,0.08344243202115886,297,148,149,315,0.7198109580773798,0.6084584623730089
변동성/NNG;커질/VV,1,0.08264372821620114,259,129,130,197,0.7185655405406317,0.6083829057779974
물가/NNG;잡/VV,1,0.08148455631222262,215,107,108,149,0.7145475647584743,0.6063938788741573
금리인상/NNG;중단될/VVX,1,0.08139724475077514,60,30,30,32,0.5769417613327287,0.4897020687564867
성장률/NNG;높이/VV,1,0.0808460430550959,58,29,29,56,0.5721095926032865,0.4861394167764705
실물경제/NNG;미치/VV;영향/NNG,1,0.0808460430550959,58,29,29,47,0.5721095926032865,0.4861394167764705
경제/NNG;침체/NNG;빠질/VV,1,0.0808460430550959,58,29,29,29,0.5721095926032865,0.4861394167764705
자산/NNG;매각하/VVX,1,0.08027332754097571,56,28,28,39,0.5671685362747838,0.48249646130216706
금리인상/NNG;결정하/VVX,1,0.08027332754097571,56,28,28,52,0.5671685362747838,0.48249646130216706
경기둔화우려/NNG;따른/VV,1,0.07967854575645528,54,27,27,41,0.5621182141015008,0.478772598861654
금리인하/NNG;가능성/NNG;반영하/VVX,1,0.07906113868325604,52,26,26,23,0.5569583627458687,0.47496728706036656
기준금리인상/NNG;단행하/VVX,1,0.0784205411712775,50,25,25,45,0.5516888407258035,0.471080049166446
경기/NNG;부진하/VVX,1,0.0777561824273274,48,24,24,30,0.5463096354809258,0.4671104788424578
금리인상/NNG;나서/VV;않/VX,1,0.0777561824273274,48,24,24,46,0.5463096354809258,0.4671104788424578
금리인하/NNG;가능하/VVX,1,0.0777561824273274,48,24,24,30,0.5463096354809258,0.4671104788424578
고용/NNG;늘/VV,1,0.0777561824273274,48,24,24,40,0.5463096354809258,0.4671104788424578
물가/NNG;급등하/VVX,1,0.07706748656044238,46,23,23,30,0.5408208705323718,0.463058245014357
출구전략/NNG;시행할/VVX,1,0.07635387318600828,44,22,22,26,0.5352228127075915,0.4589230968667491
성장세/NNG;둔화하/VVX,1,0.07635387318600828,44,22,22,22,0.5352228127075915,0.4589230968667491
유가상승/NNG;부추겼/VV,1,0.07635387318600828,44,22,22,18,0.5352228127075915,0.4589230968667491
신용등급/NNG;하향조정하/VVX,1,0.07635387318600828,44,22,22,40,0.5352228127075915,0.4589230968667491
물가안정/NNG;하/VV,1,0.07635387318600828,44,22,22,31,0.5352228127075915,0.4589230968667491
환율급등/NNG;따른/VV,1,0.07635387318600828,44,22,22,31,0.5352228127075915,0.4589230968667491
정책금리/NNG;올릴/VV,1,0.07561475809068474,42,21,21,44,0.5295158793981244,0.45470486895155066
자본확충/NNG;위해/VV,1,0.07561475809068474,42,21,21,60,0.5295158793981244,0.45470486895155066
성장/NNG;할/VV,1,0.07491159629037858,129,64,65,70,0.6754800140078935,0.5808673664344703
금리/NNG;올릴/VV;없/VA,1,0.07484955395992254,40,20,20,28,0.5237006458148307,0.45040348639509425
물가/NNG;올라가/VV,1,0.07484955395992254,40,20,20,17,0.5237006458148307,0.45040348639509425
경제지표/NNG;호조/NNG;보였/VV,1,0.07405767116958484,38,19,19,36,0.5177778522014939,0.44601897018655934
기준금리동결/NNG;예상했/VVX,1,0.07405767116958484,38,19,19,33,0.5177778522014939,0.44601897018655934
유동성/NNG;회수하/VVX,1,0.07405767116958484,38,19,19,34,0.5177778522014939,0.44601897018655934
침체/NNG;벗어나/VV;못하/VX,1,0.07405767116958484,38,19,19,17,0.5177778522014939,0.44601897018655934
금리인상/NNG;의미하/VVX,1,0.07405767116958484,38,19,19,17,0.5177778522014939,0.44601897018655934
물가상승압력/NNG;지속되/VVX,1,0.07405767116958484,38,19,19,19,0.5177778522014939,0.44601897018655934
금리인하기대/NNG;유지될/VVX,1,0.07405767116958484,38,19,19,52,0.5177778522014939,0.44601897018655934
금리/NNG;상승세/NNG;나타나/VV,1,0.07239150477344358,34,17,17,18,0.5056134136695719,0.43700113222667925
금리인상/NNG;우려/NNG;완화되/VVX,1,0.07239150477344358,34,17,17,21,0.5056134136695719,0.43700113222667925
리스크/NNG;부각될/VVX,1,0.07239150477344358,34,17,17,39,0.5056134136695719,0.43700113222667925
불안/NNG;계속되/VVX,1,0.07239150477344358,34,17,17,21,0.5056134136695719,0.43700113222667925
금리인하/NNG;지지하/VVX,1,0.07151603841505216,32,16,16,16,0.49937413786399654,0.4323683800982752
수출호조/NNG;따른/VV,1,0.07151603841505216,32,16,16,16,0.49937413786399654,0.4323683800982752
금리/NNG;크/VA;상승했/VVX,1,0.07151603841505216,32,16,16,19,0.49937413786399654,0.4323683800982752
금리/NNG;상승세/NNG;이어지/VV,1,0.07151603841505216,32,16,16,23,0.49937413786399654,0.4323683800982752
경제/NNG;연착륙할/VVX,1,0.07151603841505216,32,16,16,10,0.49937413786399654,0.4323683800982752
리스크/NNG;남/VV,1,0.0709577717715153,109,54,55,64,0.6533115926641959,0.5662853394034459
금리/NNG;인상하/VVX;않/VX,1,0.07076755103963506,200,99,101,132,0.7056058046748871,0.6118473070697136
경제/NNG;회복세/NNG;지속하/VVX,1,0.07061152993793329,30,15,15,35,0.49303205365736025,0.42765364436651593
금리상승압력/NNG;가중될/VVX,1,0.07061152993793329,30,15,15,9,0.49303205365736025,0.42765364436651593
기준금리인상/NNG;시사하/VVX,1,0.07061152993793329,30,15,15,18,0.49303205365736025,0.42765364436651593
경기/NNG;반등하/VVX,1,0.07061152993793329,30,15,15,36,0.49303205365736025,0.42765364436651593
경기/NNG;부양할/VVX;있/VV,1,0.07061152993793329,30,15,15,9,0.49303205365736025,0.42765364436651593
유동성/NNG;따른/VV,1,0.07061152993793329,30,15,15,18,0.49303205365736025,0.42765364436651593
큰/VA;금리/NNG;상승세/NNG;보였/VV,1,0.07061152993793329,30,15,15,23,0.49303205365736025,0.42765364436651593
기준금리/NNG;동결될/VVX,1,0.07040271614728866,610,302,308,542,0.7120897671079387,0.6179223921050448
경기둔화/NNG;반영하/VVX,1,0.06967739235123038,28,14,14,20,0.4865888300180147,0.4228575060179875
금리인상/NNG;가능성/NNG;열려/VV,1,0.06967739235123038,28,14,14,41,0.4865888300180147,0.4228575060179875
수입/NNG;줄어들/VV,1,0.06967739235123038,28,14,14,20,0.4865888300180147,0.4228575060179875
소매판매/NNG;증가해/VVX,1,0.06967739235123038,28,14,14,45,0.4865888300180147,0.4228575060179875
금리하락/NNG;예상된/VVX,1,0.06967739235123038,28,14,14,17,0.4865888300180147,0.4228575060179875
변동성/NNG;커질/VA;있/VV,1,0.06967739235123038,28,14,14,29,0.4865888300180147,0.4228575060179875
리스크/NNG;감수하/VVX,1,0.06967739235123038,28,14,14,16,0.4865888300180147,0.4228575060179875
자산매입/NNG;유지하/VVX,1,0.06967739235123038,28,14,14,47,0.4865888300180147,0.4228575060179875
금융완화/NNG;유지되/VVX,1,0.06967739235123038,28,14,14,13,0.4865888300180147,0.4228575060179875
잠재성장률/NNG;높이/VV,1,0.06967739235123038,28,14,14,26,0.4865888300180147,0.4228575060179875
성장/NNG;이끌/VV,1,0.06942722895367459,103,51,52,69,0.6451667802868526,0.5609473695677228
금리/NNG;낮/VA;유지되/VVX,1,0.06871304249058174,26,13,13,29,0.48004634071744556,0.4179806740878153
소비심리/NNG;살아나/VV,1,0.06871304249058174,26,13,13,15,0.48004634071744556,0.4179806740878153
경제지표/NNG;상회하/VVX,1,0.06871304249058174,26,13,13,18,0.48004634071744556,0.4179806740878153
유동성/NNG;인해/VV,1,0.06871304249058174,26,13,13,19,0.48004634071744556,0.4179806740878153
유동성/NNG;흡수해/VVX,1,0.06871304249058174,26,13,13,23,0.48004634071744556,0.4179806740878153
금융시장변동성/NNG;확대되/VVX,1,0.06871304249058174,26,13,13,29,0.48004634071744556,0.4179806740878153
금리인하/NNG;반영하/VVX,1,0.06871304249058174,26,13,13,39,0.48004634071744556,0.4179806740878153
자산가격상승/NNG;따른/VV,1,0.06871304249058174,26,13,13,16,0.48004634071744556,0.4179806740878153
시장금리/NNG;상승할/VVX,1,0.06829980802914726,99,49,50,98,0.6393125498723832,0.5571173287095867
불안/NNG;심화되/VVX,1,0.06771790226922425,24,12,12,15,0.47340666986292385,0.41302399083971575
실물경제/NNG;영향/NNG;주/VV,1,0.06771790226922425,24,12,12,16,0.47340666986292385,0.41302399083971575
물가상승률/NNG;밑돌/VV,1,0.06771790226922425,24,12,12,27,0.47340666986292385,0.41302399083971575
기준금리/NNG;동결키/VVX,1,0.06771790226922425,24,12,12,17,0.47340666986292385,0.41302399083971575
경제/NNG;성장세/NNG;이/VV;갈/VX,1,0.06771790226922425,24,12,12,15,0.47340666986292385,0.41302399083971575
인플레이션/NNG;나타나/VV,1,0.06771790226922425,24,12,12,10,0.47340666986292385,0.41302399083971575
금융시장/NNG;흔들/VV,1,0.06771790226922425,24,12,12,20,0.47340666986292385,0.41302399083971575
큰/VA;변동성/NNG;보였/VV,1,0.06771790226922425,24,12,12,12,0.47340666986292385,0.41302399083971575
견조한/VAX;성장세/NNG;지속하/VVX,1,0.06771790226922425,24,12,12,11,0.47340666986292385,0.41302399083971575
기준금리/NNG;낮/VA;유지하/VVX,1,0.06771790226922425,24,12,12,15,0.47340666986292385,0.41302399083971575
성장/NNG;이어질/VV,1,0.06771790226922425,24,12,12,14,0.47340666986292385,0.41302399083971575
인플레이션/NNG;걱정하/VVX,1,0.06771790226922425,24,12,12,14,0.47340666986292385,0.41302399083971575
경제위기/NNG;극복하/VVX,1,0.06771790226922425,24,12,12,12,0.47340666986292385,0.41302399083971575
자산/NNG;팔/VV,1,0.06771790226922425,24,12,12,27,0.47340666986292385,0.41302399083971575
금융위기/NNG;발생했/VVX,1,0.06771790226922425,24,12,12,12,0.47340666986292385,0.41302399083971575
지준율/NNG;인상할/VVX,1,0.06771790226922425,24,12,12,16,0.47340666986292385,0.41302399083971575
변동성/NNG;확대시/VVX;있/VV,1,0.06771790226922425,24,12,12,25,0.47340666986292385,0.41302399083971575
주택시장/NNG;둔화되/VVX,1,0.06771790226922425,24,12,12,14,0.47340666986292385,0.41302399083971575
금리인상/NNG;가능성/NNG;시사했/VVX,1,0.06770127143049609,97,48,49,68,0.6362531359610916,0.555118045057262
환율급락/NNG;따른/VV,1,0.06669139999039264,22,11,11,12,0.4666721169532367,0.4079884368042688
유동성확보/NNG;위해/VV,1,0.06669139999039264,22,11,11,10,0.4666721169532367,0.4079884368042688
경제/NNG;성장세/NNG;보이/VV,1,0.06669139999039264,22,11,11,18,0.4666721169532367,0.4079884368042688
심리지표/NNG;개선되/VVX,1,0.06669139999039264,22,11,11,22,0.4666721169532367,0.4079884368042688
더블딥/NNG;빠지/VV,1,0.06669139999039264,22,11,11,18,0.4666721169532367,0.4079884368042688
불확실성/NNG;가중시/VVX,1,0.06669139999039264,22,11,11,11,0.4666721169532367,0.4079884368042688
통화긴축/NNG;중단할/VVX,1,0.06669139999039264,22,11,11,14,0.4666721169532367,0.4079884368042688
변동성/NNG;제한되/VVX,1,0.0656329717181301,20,10,10,21,0.45984520139066026,0.40287513563658484
투자심리/NNG;회복됐/VVX,1,0.0656329717181301,20,10,10,9,0.45984520139066026,0.40287513563658484
수입/NNG;늘리/VV,1,0.0656329717181301,20,10,10,12,0.45984520139066026,0.40287513563658484
금리인상/NNG;가능성/NNG;시사함/VVX,1,0.0656329717181301,20,10,10,16,0.45984520139066026,0.40287513563658484
소비자물가/NNG;안정되/VVX,1,0.0656329717181301,20,10,10,6,0.45984520139066026,0.40287513563658484
물가/NNG;상회하/VVX,1,0.0656329717181301,20,10,10,18,0.45984520139066026,0.40287513563658484
경제성장/NNG;지속되/VVX,1,0.0656329717181301,20,10,10,12,0.45984520139066026,0.40287513563658484
설비투자/NNG;늘어나/VV,1,0.0656329717181301,20,10,10,12,0.45984520139066026,0.40287513563658484
연방기금금리/NNG;유지했/VVX,1,0.0656329717181301,20,10,10,9,0.45984520139066026,0.40287513563658484
성장/NNG;둔화할/VVX,1,0.0656329717181301,20,10,10,8,0.45984520139066026,0.40287513563658484
금리/NNG;크/VA;오를/VV,1,0.0656329717181301,20,10,10,10,0.45984520139066026,0.40287513563658484
생산/NNG;차질/NNG;빚/VV,1,0.0656329717181301,20,10,10,11,0.45984520139066026,0.40287513563658484
금리인상/NNG;재개할/VVX,1,0.0656329717181301,20,10,10,14,0.45984520139066026,0.40287513563658484
기준금리인하/NNG;기대감/NNG;약화되/VVX,1,0.0656329717181301,20,10,10,19,0.45984520139066026,0.40287513563658484
투자심리/NNG;호전되/VVX,1,0.0656329717181301,20,10,10,15,0.45984520139066026,0.40287513563658484
경기/NNG;둔화될/VVX,1,0.06542137767385658,158,78,80,92,0.6887344397934471,0.6036637141871892
금리인상/NNG;그칠/VV,1,0.0650508318412939,89,44,45,80,0.6230946767021532,0.5465379679705413
금리/NNG;인상되/VVX,1,0.06471072858045557,154,76,78,104,0.6862685814236974,0.6023610567836176
경제/NNG;긍정적/VAX;작용할/VVX,1,0.06454206270291452,18,9,9,16,0.4529286663807955,0.3976853587523275
지정학적리스크/NNG;인해/VV,1,0.06454206270291452,18,9,9,20,0.4529286663807955,0.3976853587523275
임금인상/NNG;요구하/VVX,1,0.06454206270291452,18,9,9,14,0.4529286663807955,0.3976853587523275
침체/NNG;빠져들/VV,1,0.06454206270291452,18,9,9,13,0.4529286663807955,0.3976853587523275
물가/NNG;오른/VV,1,0.06454206270291452,18,9,9,19,0.4529286663807955,0.3976853587523275
경상수지/NNG;개선되/VVX,1,0.06454206270291452,18,9,9,8,0.4529286663807955,0.3976853587523275
투자심리/NNG;억누르/VV,1,0.06454206270291452,18,9,9,11,0.4529286663807955,0.3976853587523275
투자심리/NNG;안정되/VVX,1,0.06454206270291452,18,9,9,14,0.4529286663807955,0.3976853587523275
변동성/NNG;장세/NNG;예상되/VVX,1,0.06454206270291452,18,9,9,14,0.4529286663807955,0.3976853587523275
리스크/NNG;지적했/VVX,1,0.06454206270291452,18,9,9,13,0.4529286663807955,0.3976853587523275
채권시장/NNG;긍정적/VAX;작용할/VVX,1,0.06454206270291452,18,9,9,21,0.4529286663807955,0.3976853587523275
채권시장/NNG;이탈하/VVX,1,0.06454206270291452,18,9,9,15,0.4529286663807955,0.3976853587523275
물가상승/NNG;주도했/VVX,1,0.06454206270291452,18,9,9,9,0.4529286663807955,0.3976853587523275
채권시장/NNG;큰/VA;영향/NNG;미치/VV,1,0.06454206270291452,18,9,9,15,0.4529286663807955,0.3976853587523275
경제/NNG;부정적/VAX;영향/NNG;줄/VV,1,0.06454206270291452,18,9,9,29,0.4529286663807955,0.3976853587523275
취업자수/NNG;증가해/VVX,1,0.06454206270291452,18,9,9,12,0.4529286663807955,0.3976853587523275
리스크/NNG;고려하/VVX,1,0.06454206270291452,18,9,9,13,0.4529286663807955,0.3976853587523275
경기/NNG;부정적/VAX;영향/NNG;미칠/VV,1,0.06454206270291452,18,9,9,19,0.4529286663807955,0.3976853587523275
소비/NNG;살아날/VV,1,0.06454206270291452,18,9,9,10,0.4529286663807955,0.3976853587523275
금리하락/NNG;두드러졌/VV,1,0.06454206270291452,18,9,9,20,0.4529286663807955,0.3976853587523275
금리인하/NNG;기대했/VVX,1,0.06454206270291452,18,9,9,6,0.4529286663807955,0.3976853587523275
수입/NNG;감소했/VVX,1,0.06454206270291452,18,9,9,15,0.4529286663807955,0.3976853587523275
금리/NNG;하락세/NNG;보인/VV,1,0.06454206270291452,18,9,9,13,0.4529286663807955,0.3976853587523275
설비투자/NNG;부진하/VVX,1,0.06454206270291452,18,9,9,10,0.4529286663807955,0.3976853587523275
금리인하/NNG;단행한/VVX,1,0.06454206270291452,18,9,9,18,0.4529286663807955,0.3976853587523275
금리상승압력/NNG;가중되/VVX,1,0.06454206270291452,18,9,9,15,0.4529286663807955,0.3976853587523275
성장/NNG;해야/VV,1,0.06454206270291452,18,9,9,6,0.4529286663807955,0.3976853587523275
금리동결/NNG;결정했/VVX,1,0.06454206270291452,18,9,9,13,0.4529286663807955,0.3976853587523275
기준금리/NNG;인하되/VVX;않/VX,1,0.06454206270291452,18,9,9,18,0.4529286663807955,0.3976853587523275
성장률전망/NNG;상향했/VVX,1,0.06454206270291452,18,9,9,9,0.4529286663807955,0.3976853587523275
불확실성/NNG;해/VV,1,0.06454206270291452,18,9,9,10,0.4529286663807955,0.3976853587523275
불안심리/NNG;자극할/VVX,1,0.06454206270291452,18,9,9,18,0.4529286663807955,0.3976853587523275
시장금리/NNG;하락할/VVX,1,0.06454206270291452,18,9,9,7,0.4529286663807955,0.3976853587523275
세계경제/NNG;회복세/NNG;보이/VV,1,0.06454206270291452,18,9,9,18,0.4529286663807955,0.3976853587523275
고용창출/NNG;감소해/VVX,1,0.06454206270291452,18,9,9,4,0.4529286663807955,0.3976853587523275
공공요금/NNG;인상되/VVX,1,0.06454206270291452,18,9,9,1,0.4529286663807955,0.3976853587523275
금리상승/NNG;있/VV,1,0.06454206270291452,18,9,9,7,0.4529286663807955,0.3976853587523275
인플레이션/NNG;완화하/VVX,1,0.06454206270291452,18,9,9,9,0.4529286663807955,0.3976853587523275
성장/NNG;가능하/VVX,1,0.06431834300771544,87,43,44,69,0.6195665684007836,0.5442429066194576
단기금리/NNG;안정되/VVX,1,0.06341812885776954,16,8,8,11,0.4459254821509107,0.39242052969901564
유동성/NNG;축소될/VVX,1,0.06341812885776954,16,8,8,13,0.4459254821509107,0.39242052969901564
통화정책불확실성/NNG;해소되/VVX,1,0.06341812885776954,16,8,8,15,0.4459254821509107,0.39242052969901564
성장률/NNG;부진했/VVX,1,0.06341812885776954,16,8,8,10,0.4459254821509107,0.39242052969901564
국제금융시장/NNG;불안해/VVX,1,0.06341812885776954,16,8,8,7,0.4459254821509107,0.39242052969901564
기대인플레이션/NNG;자극할/VVX,1,0.06341812885776954,16,8,8,3,0.4459254821509107,0.39242052969901564
경제/NNG;침체/NNG;빠지/VV,1,0.06341812885776954,16,8,8,11,0.4459254821509107,0.39242052969901564
설비투자/NNG;회복되/VVX,1,0.06341812885776954,16,8,8,12,0.4459254821509107,0.39242052969901564
금리인하기대감/NNG;확대되/VVX,1,0.06341812885776954,16,8,8,7,0.4459254821509107,0.39242052969901564
실업률/NNG;하락해/VVX,1,0.06341812885776954,16,8,8,16,0.4459254821509107,0.39242052969901564
경기회복세/NNG;나타나/VV,1,0.06341812885776954,16,8,8,32,0.4459254821509107,0.39242052969901564
정책금리/NNG;위한/VV,1,0.06341812885776954,16,8,8,11,0.4459254821509107,0.39242052969901564
재정위기/NNG;해결하/VVX,1,0.06341812885776954,16,8,8,10,0.4459254821509107,0.39242052969901564
경제/NNG;미치/VV;악영향/NNG,1,0.06341812885776954,16,8,8,14,0.4459254821509107,0.39242052969901564
기준금리인하/NNG;이/VV,1,0.06341812885776954,16,8,8,19,0.4459254821509107,0.39242052969901564
재정지출/NNG;통한/VV,1,0.06341812885776954,16,8,8,14,0.4459254821509107,0.39242052969901564
양적완화/NNG;유지할/VVX,1,0.06341812885776954,16,8,8,20,0.4459254821509107,0.39242052969901564
금융위기/NNG;제외하/VVX,1,0.06341812885776954,16,8,8,21,0.4459254821509107,0.39242052969901564
시장금리/NNG;하/VV;있/VV,1,0.06341812885776954,16,8,8,22,0.4459254821509107,0.39242052969901564
수출둔화/NNG;따른/VV,1,0.06341812885776954,16,8,8,11,0.4459254821509107,0.39242052969901564
성장/NNG;보인/VV,1,0.06341812885776954,16,8,8,9,0.4459254821509107,0.39242052969901564
수출/NNG;회복세/NNG;보이/VV,1,0.06341812885776954,16,8,8,17,0.4459254821509107,0.39242052969901564
불안요인/NNG;완화되/VVX,1,0.06341812885776954,16,8,8,16,0.4459254821509107,0.39242052969901564
성장/NNG;벗어나/VV,1,0.06341812885776954,16,8,8,9,0.4459254821509107,0.39242052969901564
가계부채/NNG;급증하/VVX,1,0.06341812885776954,16,8,8,24,0.4459254821509107,0.39242052969901564
물가상승률/NNG;끌어올리/VV,1,0.06341812885776954,16,8,8,8,0.4459254821509107,0.39242052969901564
경제성장률/NNG;둔화하/VVX,1,0.06341812885776954,16,8,8,13,0.4459254821509107,0.39242052969901564
기준금리동결/NNG;유지될/VVX,1,0.06341812885776954,16,8,8,19,0.4459254821509107,0.39242052969901564
리스크/NNG;대비하/VVX,1,0.06341812885776954,16,8,8,27,0.4459254821509107,0.39242052969901564
흑자/NNG;따른/VV,1,0.06341812885776954,16,8,8,11,0.4459254821509107,0.39242052969901564
물가/NNG;감안해/VVX,1,0.06341812885776954,16,8,8,15,0.4459254821509107,0.39242052969901564
기준금리/NNG;동결되/VVX,1,0.060362537996258236,268,132,136,331,0.7051722965724417,0.6243775205541173
경기회복세/NNG;지속될/VVX,1,0.06016721383510082,77,38,39,72,0.6004127251794126,0.5318290700395757
소비자물가지수/NNG;상승해/VVX,1,0.06016721383510082,77,38,39,31,0.6004127251794126,0.5318290700395757
경기/NNG;개선될/VVX,1,0.0582466921264948,73,36,37,85,0.5920144936898781,0.5264140621018507
기준금리인상/NNG;나설/VV,1,0.0582466921264948,73,36,37,86,0.5920144936898781,0.5264140621018507
금리인상/NNG;단행된/VVX,1,0.057222530457156084,71,35,36,39,0.5876510020735705,0.5236084078269413
경제지표/NNG;호조/NNG;보인/VV,1,0.057222530457156084,71,35,36,54,0.5876510020735705,0.5236084078269413
금리인상/NNG;단행할/VVX,1,0.05696680647988894,604,297,307,432,0.7037612178974683,0.6273864949192027
경기선행지수/NNG;하락하/VVX,1,0.05503381138809327,67,33,34,37,0.5785870794413355,0.517799661842279
경제성장/NNG;위해/VV,1,0.0513539399692875,61,30,31,38,0.5641237245739386,0.5085934145113881
금리/NNG;인상하/VVX,1,0.05112346092894082,924,453,471,696,0.7000959482551046,0.6314726174036527
금리/NNG;오른/VV,1,0.05070074505943989,253,124,129,244,0.6986118289189726,0.6306679775032947
기준금리/NNG;인상하/VVX,1,0.048528867910792695,770,377,393,638,0.6984602006840821,0.6332809581606276
금리인하/NNG;필요하/VVX,1,0.047104633762592885,55,27,28,46,0.5485768000875881,0.4988055992487543
성장/NNG;그칠/VV,1,0.047104633762592885,55,27,28,49,0.5485768000875881,0.4988055992487543
자산/NNG;투자하/VVX,1,0.04553820276669307,53,26,27,43,0.5431445330927049,0.49541817412070716
금리/NNG;동결된/VVX,1,0.04553820276669307,53,26,27,40,0.5431445330927049,0.49541817412070716
경기침체/NNG;따른/VV,1,0.044693205836285,133,65,68,44,0.6606144679647895,0.6035865917609555
금리/NNG;올려/VV,1,0.04432082329575726,174,85,89,129,0.6823418914976905,0.6239034965161397
양적완화/NNG;유지하/VVX,1,0.04388606087251934,51,25,26,70,0.5375835273756447,0.4919709512467187
경기/NNG;개선되/VVX,1,0.04319511454940361,170,83,87,197,0.6801923337830024,0.6233416454215577
금리상승/NNG;제한되/VVX,1,0.04315713434508606,129,63,66,140,0.6565163580365049,0.6016902740136617
금리/NNG;올렸/VV,1,0.04294275221571753,254,124,130,165,0.693749395526769,0.6360869614212826
금리인상/NNG;시사했/VVX,1,0.04225918470230039,88,43,45,84,0.6088424405978277,0.5590018312148984
물가/NNG;미치/VV,1,0.038860661820132814,119,58,61,91,0.6450362617276658,0.5962759937215056
글로벌/NNG;경기둔화/NNG;따른/VV,1,0.03833031236214146,45,22,23,28,0.5201002701973623,0.4812949662397843
경기/NNG;둔화되/VVX,1,0.03748642592531337,304,148,156,213,0.691275833840803,0.6407803509872991
금리/NNG;올릴/VV,1,0.03641300827351057,1192,580,612,963,0.6907553442594366,0.64167496345205
성장/NNG;이/VV,1,0.036242918877055885,43,21,22,26,0.5139943992709985,0.4776360134297428
재할인율/NNG;인하했/VVX,1,0.036242918877055885,43,21,22,19,0.5139943992709985,0.4776360134297428
재할인율/NNG;인하하/VVX,1,0.036242918877055885,43,21,22,34,0.5139943992709985,0.4776360134297428
기준금리/NNG;유지될/VVX,1,0.036242918877055885,43,21,22,32,0.5139943992709985,0.4776360134297428
실업률/NNG;떨어지/VV,1,0.036242918877055885,43,21,22,36,0.5139943992709985,0.4776360134297428
경제성장/NNG;따른/VV,1,0.036242918877055885,43,21,22,36,0.5139943992709985,0.4776360134297428
금리/NNG;하락세/NNG;보였/VV,1,0.03580870323634544,78,38,40,69,0.5889396993289984,0.5477557042381338
소비자물가/NNG;상승했/VVX,1,0.03580870323634544,78,38,40,52,0.5889396993289984,0.5477557042381338
성장/NNG;둔화될/VVX,1,0.034353115231365416,76,37,39,45,0.5846287552713613,0.5453323937143422
유가하락/NNG;힘입/VV,1,0.03401501168659116,41,20,21,19,0.5077422563041221,0.4739344278423903
금리급락/NNG;따른/VV,1,0.03401501168659116,41,20,21,38,0.5077422563041221,0.4739344278423903
금융위기/NNG;거치/VV,1,0.03401501168659116,41,20,21,53,0.5077422563041221,0.4739344278423903
불안/NNG;지속되/VVX,1,0.033801452774154805,109,53,56,73,0.631618420793244,0.5898143368097606
리스크/NNG;완화하/VVX,1,0.03162891462982653,39,19,20,14,0.5013381835320606,0.47019624612310523
금리인상/NNG;전망하/VVX,1,0.03162891462982653,39,19,20,35,0.5013381835320606,0.47019624612310523
재정정책/NNG;통한/VV,1,0.03162891462982653,39,19,20,27,0.5013381835320606,0.47019624612310523
금리인상/NNG;점치/VV,1,0.03162891462982653,39,19,20,18,0.5013381835320606,0.47019624612310523
경기회복/NNG;나타나/VV,1,0.0290632670906259,37,18,19,38,0.49477523095229964,0.46642886453722027
안전자산선호심리/NNG;약화되/VVX,1,0.0290632670906259,37,18,19,46,0.49477523095229964,0.46642886453722027
경제/NNG;견조하/VVX,1,0.0290632670906259,37,18,19,18,0.49477523095229964,0.46642886453722027
금리인상/NNG;늦추/VV,1,0.0290632670906259,37,18,19,47,0.49477523095229964,0.46642886453722027
유가급등/NNG;따른/VV,1,0.02786171701600737,68,33,35,35,0.5662111113213435,0.5350565349664665
소비자물가/NNG;상승하/VVX,1,0.027806251938939264,99,48,51,79,0.6160340495045112,0.5822026587340045
유가하락/NNG;인해/VV,1,0.02629197110029602,35,17,18,29,0.4880447242843436,0.4626413842053367
기준금리/NNG;인상할/VVX,1,0.02560768606563868,1209,585,624,949,0.6837931588073458,0.6490885985580208
콜금리/NNG;유지하/VVX,1,0.024149360300943945,64,31,33,29,0.5562638785705446,0.5295740880377082
성장세/NNG;보이/VV,1,0.023961428636826154,182,88,94,140,0.671961780319344,0.6399612263859936
양적완화/NNG;줄이/VV,1,0.023282753688942615,33,16,17,48,0.4811356649491995,0.45884507188826934
경기회복/NNG;지원하/VVX,1,0.023282753688942615,33,16,17,46,0.4811356649491995,0.45884507188826934
안전자산선호/NNG;강화되/VVX,1,0.023282753688942615,33,16,17,63,0.4811356649491995,0.45884507188826934
콜금리/NNG;인하할/VVX,1,0.023282753688942615,33,16,17,26,0.4811356649491995,0.45884507188826934
경제/NNG;회복되/VVX,1,0.02241869752658343,178,86,92,167,0.6697775246362443,0.6398519507144101
소비/NNG;회복되/VVX,1,0.022156469737030893,62,30,32,33,0.5510961609751092,0.5267493946442482
양적완화정책/NNG;따른/VV,1,0.01999516935004375,31,15,16,16,0.4740338822081675,0.4550539846929602
채권시장/NNG;국채가격/NNG;오른/VV,1,0.01950210517832862,255,123,132,138,0.6787044443292478,0.652172353043114
성장률/NNG;유지하/VVX,1,0.017860569056226794,58,28,30,48,0.5403566191587517,0.520939802788657
채권시장/NNG;국채가격/NNG;떨어진/VV,1,0.017860569056226794,58,28,30,24,0.5403566191587517,0.520939802788657
기준금리/NNG;낮춰/VV,1,0.017860569056226794,58,28,30,32,0.5403566191587517,0.520939802788657
추경/NNG;편성할/VVX,1,0.016377769686017674,29,14,15,34,0.4667208111462868,0.45128583161036845
기준금리/NNG;인상된/VVX;하/VV,1,0.016377769686017674,29,14,15,12,0.4667208111462868,0.45128583161036845
성장률/NNG;하향조정하/VVX,1,0.016377769686017674,29,14,15,37,0.4667208111462868,0.45128583161036845
유동성/NNG;억제하/VVX,1,0.016377769686017674,29,14,15,19,0.4667208111462868,0.45128583161036845
리스크/NNG;작용하/VVX,1,0.016377769686017674,29,14,15,22,0.4667208111462868,0.45128583161036845
경제/NNG;타격/NNG;줄/VV,1,0.016377769686017674,29,14,15,23,0.4667208111462868,0.45128583161036845
내수/NNG;부양/NNG;위해/VV,1,0.016377769686017674,29,14,15,26,0.4667208111462868,0.45128583161036845
취업자수/NNG;증가했/VVX,1,0.016377769686017674,29,14,15,32,0.4667208111462868,0.45128583161036845
추경/NNG;하/VV,1,0.016377769686017674,29,14,15,31,0.4667208111462868,0.45128583161036845
금리/NNG;오르/VV,1,0.015568330352312643,590,284,306,489,0.6772497386014157,0.6559128826217103
경기선행지수/NNG;상승하/VVX,1,0.01309051634784697,54,26,28,36,0.5290532950157777,0.5149297109051668
경제/NNG;악영향/NNG;미칠/VV,1,0.01309051634784697,54,26,28,35,0.5290532950157777,0.5149297109051668
금리인하/NNG;기대하/VVX,1,0.013073676066807538,106,51,55,81,0.615833126263738,0.5994130497200812
성장률/NNG;둔화할/VVX,1,0.012364003181737138,27,13,14,14,0.45917169100275973,0.4475631842007318
소비/NNG;줄/VV,1,0.012364003181737138,27,13,14,20,0.45917169100275973,0.4475631842007318
경기/NNG;살아날/VV,1,0.012364003181737138,27,13,14,37,0.45917169100275973,0.4475631842007318
높/VA;변동성/NNG;보일/VV,1,0.012364003181737138,27,13,14,22,0.45917169100275973,0.4475631842007318
인플레이션/NNG;자극할/VVX,1,0.012364003181737138,27,13,14,17,0.45917169100275973,0.4475631842007318
금리인하기대/NNG;약화될/VVX,1,0.012364003181737138,27,13,14,20,0.45917169100275973,0.4475631842007318
물가/NNG;자극할/VVX,1,0.012364003181737138,27,13,14,15,0.45917169100275973,0.4475631842007318
물가/NNG;안정된/VVX,1,0.011987049580506781,79,38,41,74,0.5773623153206934,0.5631899958749044
채권시장/NNG;약세/NNG;보일/VV,1,0.007866123307663786,25,12,13,5,0.4513528387102919,0.44391521365678505
경제지표/NNG;개선되/VVX;모습/NNG,1,0.007866123307663786,25,12,13,36,0.4513528387102919,0.44391521365678505
자산/NNG;보유하/VVX,1,0.007866123307663786,25,12,13,29,0.4513528387102919,0.44391521365678505
성장률/NNG;둔화하/VVX,1,0.007866123307663786,25,12,13,20,0.4513528387102919,0.44391521365678505
경기부양책/NNG;쓰/VV,1,0.007866123307663786,25,12,13,17,0.4513528387102919,0.44391521365678505
인플레이션우려/NNG;완화된/VVX,1,0.007866123307663786,25,12,13,11,0.4513528387102919,0.44391521365678505
유동성/NNG;있/VV,1,0.007866123307663786,25,12,13,15,0.4513528387102919,0.44391521365678505
불확실성/NNG;완화됐/VVX,1,0.007866123307663786,25,12,13,22,0.4513528387102919,0.44391521365678505
금리인상/NNG;기대하/VVX,1,0.007866123307663786,25,12,13,26,0.4513528387102919,0.44391521365678505
투자심리/NNG;개선됐/VVX,1,0.007866123307663786,25,12,13,36,0.4513528387102919,0.44391521365678505
기준금리/NNG;동결됨/VVX,1,0.007866123307663786,25,12,13,28,0.4513528387102919,0.44391521365678505
원자재가격/NNG;오르/VV,1,0.007866123307663786,25,12,13,14,0.4513528387102919,0.44391521365678505
기업실적/NNG;개선되/VVX,1,0.007866123307663786,25,12,13,17,0.4513528387102919,0.44391521365678505
금리/NNG;인하된/VVX,1,0.007866123307663786,25,12,13,21,0.4513528387102919,0.44391521365678505
투자심리/NNG;위축시/VVX,1,0.00768365434687146,267,128,139,225,0.6713447637305742,0.660522856889057
통화정책/NNG;완화할/VVX,1,0.004837311774794406,48,23,25,46,0.5109581578599758,0.50558981889671
자산/NNG;매입하/VVX,1,0.004837311774794406,48,23,25,57,0.5109581578599758,0.50558981889671
산업생산/NNG;증가했/VVX,1,0.004837311774794406,48,23,25,55,0.5109581578599758,0.50558981889671
동결/NNG;이/VV;갈/VX,1,0.002765869953519795,23,11,12,17,0.4432173965266961,0.44038024149064114
금리인상/NNG;지연시/VVX,1,0.002765869953519795,23,11,12,27,0.4432173965266961,0.44038024149064114
기대인플레이션/NNG;상승하/VVX,1,0.002765869953519795,23,11,12,29,0.4432173965266961,0.44038024149064114
적자/NNG;전환했/VVX,1,0.002765869953519795,23,11,12,11,0.4432173965266961,0.44038024149064114
인플레이션압력/NNG;가중되/VVX,1,0.002765869953519795,23,11,12,15,0.4432173965266961,0.44038024149064114
물가/NNG;하락했/VVX,1,0.002765869953519795,23,11,12,20,0.4432173965266961,0.44038024149064114
성장세/NNG;나타냈/VV,1,0.002765869953519795,23,11,12,24,0.4432173965266961,0.44038024149064114
불안요인/NNG;되/VV,1,0.002765869953519795,23,11,12,19,0.4432173965266961,0.44038024149064114
기준금리/NNG;유지할/VVX,1,0.001900036161895713,138,66,72,125,0.6376091489745261,0.6346249124571773
수출/NNG;둔화되/VVX,-1,-0.0010662778407223295,67,32,35,34,0.5485713414325417,0.5492504936470608
추경/NNG;편성하/VVX,-1,-0.0015907955456294642,44,21,23,42,0.49805857681860116,0.4991982400071467
경기선행지수/NNG;하락했/VVX,-1,-0.0015907955456294642,44,21,23,16,0.49805857681860116,0.4991982400071467
금리/NNG;낮춰/VV,-1,-0.0025444202929655324,88,42,46,65,0.5831120495571194,0.5855613273217241
물가상승/NNG;작용할/VVX,-1,-0.0031002774010767675,21,10,11,9,0.43469846205746565,0.4370095834828592
금리역전/NNG;해소되/VVX,-1,-0.0031002774010767675,21,10,11,7,0.43469846205746565,0.4370095834828592
흑자/NNG;전환되/VVX,-1,-0.0031002774010767675,21,10,11,16,0.43469846205746565,0.4370095834828592
경제성장률/NNG;하향조정할/VVX,-1,-0.0031002774010767675,21,10,11,18,0.43469846205746565,0.4370095834828592
경기둔화우려/NNG;완화되/VVX,-1,-0.0031002774010767675,21,10,11,17,0.43469846205746565,0.4370095834828592
금리/NNG;올리/VV;못할/VX,-1,-0.0031002774010767675,21,10,11,20,0.43469846205746565,0.4370095834828592
경기부양/NNG;나섰/VV,-1,-0.0031002774010767675,21,10,11,24,0.43469846205746565,0.4370095834828592
성장/NNG;구가하/VVX,-1,-0.0031002774010767675,21,10,11,13,0.43469846205746565,0.4370095834828592
경제성장률/NNG;마이너스/NNG;기록할/VVX,-1,-0.0031002774010767675,21,10,11,6,0.43469846205746565,0.4370095834828592
기준금리동결/NNG;지속될/VVX,-1,-0.0031002774010767675,21,10,11,23,0.43469846205746565,0.4370095834828592
경제지표/NNG;호조/NNG;보임/VV,-1,-0.0031002774010767675,21,10,11,16,0.43469846205746565,0.4370095834828592
침체/NNG;가/VV,-1,-0.0031002774010767675,21,10,11,9,0.43469846205746565,0.4370095834828592
금리인상/NNG;막/VV,-1,-0.0031002774010767675,21,10,11,19,0.43469846205746565,0.4370095834828592
채권시장/NNG;국채가격/NNG;하락했/VVX,-1,-0.0031002774010767675,21,10,11,31,0.43469846205746565,0.4370095834828592
금리상승/NNG;이어졌/VV,-1,-0.0031002774010767675,21,10,11,14,0.43469846205746565,0.4370095834828592
기준금리인상/NNG;선반영하/VVX,-1,-0.0031002774010767675,21,10,11,19,0.43469846205746565,0.4370095834828592
금리메리트/NNG;부각되/VVX,-1,-0.0031002774010767675,21,10,11,30,0.43469846205746565,0.4370095834828592
금리/NNG;크/VA;올랐/VV,-1,-0.0031002774010767675,21,10,11,17,0.43469846205746565,0.4370095834828592
금리변동성/NNG;커지/VV,-1,-0.0031002774010767675,21,10,11,22,0.43469846205746565,0.4370095834828592
동결/NNG;주장하/VVX,-1,-0.0031002774010767675,21,10,11,9,0.43469846205746565,0.4370095834828592
채권시장/NNG;우호적/VAX;지속될/VVX,-1,-0.0031002774010767675,21,10,11,19,0.43469846205746565,0.4370095834828592
수출/NNG;기록하/VVX,-1,-0.0031002774010767675,21,10,11,14,0.43469846205746565,0.4370095834828592
마이너스/NNG;떨어지/VV,-1,-0.0031002774010767675,21,10,11,11,0.43469846205746565,0.4370095834828592
금리/NNG;상승하/VVX;모습/NNG;보였/VV,-1,-0.0031002774010767675,21,10,11,13,0.43469846205746565,0.4370095834828592
금리인하기대감/NNG;커지/VV,-1,-0.0031002774010767675,21,10,11,43,0.43469846205746565,0.4370095834828592
경기회복세/NNG;유지되/VVX,-1,-0.0031002774010767675,21,10,11,12,0.43469846205746565,0.4370095834828592
기준금리인하/NNG;단행될/VVX,-1,-0.0036053608833546136,65,31,34,50,0.5433077733200283,0.5467479862759916
성장/NNG;지속될/VVX,-1,-0.005150950162963741,42,20,22,36,0.49133091288295055,0.495971766990131
수출/NNG;감소세/NNG;지속하/VVX,-1,-0.005150950162963741,42,20,22,36,0.49133091288295055,0.495971766990131
경제지표/NNG;개선되/VVX,-1,-0.0073646334833424865,166,79,87,168,0.6462678153307414,0.655264947451524
금리/NNG;동결할/VVX,-1,-0.0080339602833005,509,242,267,334,0.6615932560131826,0.6717017565723121
금리상승압력/NNG;커질/VV,-1,-0.008982655864294142,40,19,21,53,0.48440153912949546,0.49273617748612625
안전자산선호현상/NNG;약화되/VVX,-1,-0.008982655864294142,40,19,21,34,0.48440153912949546,0.49273617748612625
금리인하/NNG;할/VV,-1,-0.009001667657969725,82,39,43,57,0.5702375487264643,0.580071128594192
금리인상/NNG;지속되/VVX,-1,-0.009068815032577726,61,29,32,27,0.5323469100934949,0.5415997621270081
투자심리/NNG;지지했/VVX,-1,-0.009965393282952872,19,9,10,3,0.42569751890303376,0.43387351488197995
성장세/NNG;기록할/VVX,-1,-0.009965393282952872,19,9,10,14,0.42569751890303376,0.43387351488197995
시장금리/NNG;미치/VV;영향/NNG,-1,-0.009965393282952872,19,9,10,12,0.42569751890303376,0.43387351488197995
유동성/NNG;풀리/VV,-1,-0.009965393282952872,19,9,10,12,0.42569751890303376,0.43387351488197995
채권시장/NNG;강세모멘텀/NNG;작용할/VVX,-1,-0.009965393282952872,19,9,10,7,0.42569751890303376,0.43387351488197995
성장/NNG;전망하/VVX,-1,-0.009965393282952872,19,9,10,17,0.42569751890303376,0.43387351488197995
불확실성/NNG;제거된/VVX,-1,-0.009965393282952872,19,9,10,16,0.42569751890303376,0.43387351488197995
가계부채/NNG;문제/NNG;해결하/VVX,-1,-0.009965393282952872,19,9,10,10,0.42569751890303376,0.43387351488197995
단기금리/NNG;오를/VV,-1,-0.009965393282952872,19,9,10,9,0.42569751890303376,0.43387351488197995
금리/NNG;고점/NNG;확인하/VVX,-1,-0.009965393282952872,19,9,10,7,0.42569751890303376,0.43387351488197995
수익성/NNG;악화될/VVX,-1,-0.009965393282952872,19,9,10,26,0.42569751890303376,0.43387351488197995
성장/NNG;그치/VV,-1,-0.009965393282952872,19,9,10,38,0.42569751890303376,0.43387351488197995
변동성/NNG;작용할/VVX,-1,-0.009965393282952872,19,9,10,17,0.42569751890303376,0.43387351488197995
수출/NNG;통한/VV,-1,-0.009965393282952872,19,9,10,21,0.42569751890303376,0.43387351488197995
gdp갭/NNG;마이너스/NNG;지속될/VVX,-1,-0.009965393282952872,19,9,10,18,0.42569751890303376,0.43387351488197995
디레버리징/NNG;따른/VV,-1,-0.009965393282952872,19,9,10,12,0.42569751890303376,0.43387351488197995
금리/NNG;유지되/VVX,-1,-0.009965393282952872,19,9,10,12,0.42569751890303376,0.43387351488197995
마이너스/NNG;나타냈/VV,-1,-0.009965393282952872,19,9,10,15,0.42569751890303376,0.43387351488197995
유동성/NNG;흡수하/VVX,-1,-0.011160506262391734,160,76,84,147,0.6412958820513477,0.6551759339355421
금리인하/NNG;있/VV,-1,-0.011328027622284242,80,38,42,55,0.5657042362155232,0.5781417618833328
마이너스/NNG;기록할/VVX,-1,-0.012014782690650927,59,28,31,42,0.5266398554269842,0.5389578625037036
금리인상/NNG;지속할/VVX,-1,-0.012644892070364566,99,47,52,57,0.5919618572869838,0.6065712545775177
물가상승률/NNG;둔화되/VVX,-1,-0.013124535363090883,38,18,20,35,0.4772545658147296,0.4895021320169996
경기활성화/NNG;위해/VV,-1,-0.013124535363090883,38,18,20,33,0.4772545658147296,0.4895021320169996
침체/NNG;이어지/VV,-1,-0.013124535363090883,38,18,20,18,0.4772545658147296,0.4895021320169996
불확실성/NNG;해소됐/VVX,-1,-0.013750213365142705,78,37,41,59,0.561044832315837,0.5761628367848575
금리인하/NNG;예상하/VVX,-1,-0.013750213365142705,78,37,41,52,0.561044832315837,0.5761628367848575
금리인상/NNG;시사하/VVX,-1,-0.01491056608182717,192,91,101,140,0.6490407203175653,0.6680777389389255
경기회복/NNG;이어지/VV,-1,-0.017623809829760417,36,17,19,21,0.4698701905866724,0.4862824934554325
유동성/NNG;늘어나/VV,-1,-0.017623809829760417,36,17,19,22,0.4698701905866724,0.4862824934554325
기준금리인하/NNG;단행했/VVX,-1,-0.017623809829760417,36,17,19,19,0.4698701905866724,0.4862824934554325
양적완화/NNG;줄일/VV,-1,-0.01817410704679645,17,8,9,30,0.4160639628374033,0.4310708401673369
경제/NNG;성장률/NNG;기록할/VVX,-1,-0.01817410704679645,17,8,9,10,0.4160639628374033,0.4310708401673369
성장/NNG;주도하/VVX,-1,-0.01817410704679645,17,8,9,35,0.4160639628374033,0.4310708401673369
금리인상/NNG;실시할/VVX,-1,-0.01817410704679645,17,8,9,19,0.4160639628374033,0.4310708401673369
경제/NNG;회복/NNG;보이/VV,-1,-0.01817410704679645,17,8,9,12,0.4160639628374033,0.4310708401673369
금리인상우려/NNG;완화된/VVX,-1,-0.01817410704679645,17,8,9,11,0.4160639628374033,0.4310708401673369
금리/NNG;기준금리/NNG;밑도/VV,-1,-0.01817410704679645,17,8,9,6,0.4160639628374033,0.4310708401673369
경제상황/NNG;악화될/VVX,-1,-0.01817410704679645,17,8,9,15,0.4160639628374033,0.4310708401673369
불확실성/NNG;부각될/VVX,-1,-0.01817410704679645,17,8,9,26,0.4160639628374033,0.4310708401673369
경제성장/NNG;지지하/VVX,-1,-0.01817410704679645,17,8,9,14,0.4160639628374033,0.4310708401673369
경제성장률/NNG;끌어올리/VV,-1,-0.01817410704679645,17,8,9,25,0.4160639628374033,0.4310708401673369
기준금리인상/NNG;가능성/NNG;반영하/VVX,-1,-0.01817410704679645,17,8,9,14,0.4160639628374033,0.4310708401673369
금리인상/NNG;중단해/VVX,-1,-0.01817410704679645,17,8,9,4,0.4160639628374033,0.4310708401673369
불안심리/NNG;자극하/VVX,-1,-0.01817410704679645,17,8,9,28,0.4160639628374033,0.4310708401673369
기준금리/NNG;인하할/VVX;가능성/NNG;낮/VA,-1,-0.01817410704679645,17,8,9,16,0.4160639628374033,0.4310708401673369
경제위기/NNG;극복/NNG;위한/VV,-1,-0.01817410704679645,17,8,9,5,0.4160639628374033,0.4310708401673369
불안/NNG;커질/VV,-1,-0.01817410704679645,17,8,9,13,0.4160639628374033,0.4310708401673369
기준금리인하/NNG;반영하/VVX,-1,-0.01817410704679645,17,8,9,20,0.4160639628374033,0.4310708401673369
금리/NNG;하락세/NNG;지속됨/VVX,-1,-0.01817410704679645,17,8,9,17,0.4160639628374033,0.4310708401673369
금리인상/NNG;나설/VV;가능성/NNG;낮/VA,-1,-0.01817410704679645,17,8,9,7,0.4160639628374033,0.4310708401673369
성장률/NNG;올라갈/VV,-1,-0.01817410704679645,17,8,9,13,0.4160639628374033,0.4310708401673369
디플레이션/NNG;겪/VV,-1,-0.01817410704679645,17,8,9,4,0.4160639628374033,0.4310708401673369
수출여건/NNG;개선되/VVX,-1,-0.01817410704679645,17,8,9,17,0.4160639628374033,0.4310708401673369
출구전략/NNG;있/VV,-1,-0.01817410704679645,17,8,9,10,0.4160639628374033,0.4310708401673369
금리상승압력/NNG;높일/VV,-1,-0.01817410704679645,17,8,9,24,0.4160639628374033,0.4310708401673369
성장률/NNG;그쳤/VV,-1,-0.01817410704679645,17,8,9,16,0.4160639628374033,0.4310708401673369
추경/NNG;편성되/VVX,-1,-0.01817410704679645,17,8,9,17,0.4160639628374033,0.4310708401673369
경기/NNG;침체하/VVX,-1,-0.01817410704679645,17,8,9,10,0.4160639628374033,0.4310708401673369
금리인상/NNG;가능성/NNG;인해/VV,-1,-0.01817410704679645,17,8,9,4,0.4160639628374033,0.4310708401673369
금리/NNG;하락할/VVX;가능성/NNG,-1,-0.01817410704679645,17,8,9,6,0.4160639628374033,0.4310708401673369
금리/NNG;하락세/NNG;지속하/VVX,-1,-0.01817410704679645,17,8,9,24,0.4160639628374033,0.4310708401673369
경기/NNG;수출/NNG;호조/NNG;보이/VV,-1,-0.01817410704679645,17,8,9,5,0.4160639628374033,0.4310708401673369
성장률/NNG;상향조정되/VVX,-1,-0.01817410704679645,17,8,9,20,0.4160639628374033,0.4310708401673369
단기금리/NNG;하락했/VVX,-1,-0.01817410704679645,17,8,9,11,0.4160639628374033,0.4310708401673369
경기회복/NNG;이어질/VV,-1,-0.01817410704679645,17,8,9,13,0.4160639628374033,0.4310708401673369
양적완화/NNG;끝나/VV,-1,-0.01817410704679645,17,8,9,12,0.4160639628374033,0.4310708401673369
리스크관리/NNG;강화할/VVX,-1,-0.01817410704679645,17,8,9,8,0.4160639628374033,0.4310708401673369
금리인상/NNG;걸릴/VV,-1,-0.01817410704679645,17,8,9,18,0.4160639628374033,0.4310708401673369
경기회복세/NNG;뒷받침하/VVX,-1,-0.01817410704679645,17,8,9,12,0.4160639628374033,0.4310708401673369
금융시장불안/NNG;지속되/VVX,-1,-0.01817410704679645,17,8,9,12,0.4160639628374033,0.4310708401673369
금리인상/NNG;가능성/NNG;배제하/VVX,-1,-0.018400485928735222,55,26,29,63,0.5147435542195623,0.5335511017049231
산업생산/NNG;증가하/VVX,-1,-0.01890697922909812,74,35,39,40,0.5513339810301009,0.5720574508049874
금리하락/NNG;확대되/VVX,-1,-0.01890697922909812,74,35,39,52,0.5513339810301009,0.5720574508049874
인플레이션/NNG;따른/VV,-1,-0.02187207306795036,53,25,28,33,0.5085403255306645,0.5307927816202226
듀레이션/NNG;축소하/VVX,-1,-0.022538904462535925,34,16,18,29,0.4622233968890975,0.4830928610678675
물가안정/NNG;강조하/VVX,-1,-0.022538904462535925,34,16,18,22,0.4622233968890975,0.4830928610678675
경제/NNG;회복할/VVX,-1,-0.022538904462535925,34,16,18,19,0.4622233968890975,0.4830928610678675
금리/NNG;높이/VV,-1,-0.022538904462535925,34,16,18,30,0.4622233968890975,0.4830928610678675
시장금리/NNG;급등하/VVX,-1,-0.02617982445669853,87,41,46,44,0.5677216329807084,0.5976903796182723
불확실성/NNG;커졌/VV,-1,-0.02617982445669853,87,41,46,77,0.5677216329807084,0.5976903796182723
금리/NNG;안정되/VVX,-1,-0.02617982445669853,87,41,46,66,0.5677216329807084,0.5976903796182723
변동성/NNG;확대된/VVX,-1,-0.02617982445669853,87,41,46,83,0.5677216329807084,0.5976903796182723
금리하락/NNG;제한되/VVX,-1,-0.027146412934543895,104,49,55,111,0.5890479965604827,0.6213425285887291
성장세/NNG;나타내/VV,-1,-0.027534383909458615,68,32,36,49,0.535729175308632,0.5655391798918757
시장금리/NNG;급락하/VVX,-1,-0.02794307367303539,32,15,17,20,0.4542821188290305,0.479952268702995
불확실성/NNG;증가하/VVX,-1,-0.02794307367303539,32,15,17,29,0.4542821188290305,0.479952268702995
리스크/NNG;꼽/VV,-1,-0.02794307367303539,32,15,17,46,0.4542821188290305,0.479952268702995
금리인상/NNG;나선/VV,-1,-0.02794307367303539,32,15,17,27,0.4542821188290305,0.479952268702995
gdp갭/NNG;마이너스/NNG;지속할/VVX,-1,-0.02794307367303539,32,15,17,13,0.4542821188290305,0.479952268702995
대외불확실성/NNG;인해/VV,-1,-0.02794307367303539,32,15,17,28,0.4542821188290305,0.479952268702995
기준금리/NNG;내려갈/VV,-1,-0.02794307367303539,32,15,17,29,0.4542821188290305,0.479952268702995
경제/NNG;경착륙할/VVX,-1,-0.02794307367303539,32,15,17,16,0.4542821188290305,0.479952268702995
경기둔화/NNG;지속될/VVX,-1,-0.02794307367303539,32,15,17,18,0.4542821188290305,0.479952268702995
양적완화/NNG;가능성/NNG;시사하/VVX,-1,-0.028259651002465414,15,7,8,8,0.4055566215554281,0.42874483561640675
금리/NNG;추세적/VAX;상승하/VVX,-1,-0.028259651002465414,15,7,8,13,0.4055566215554281,0.42874483561640675
경제/NNG;성장세/NNG;지속할/VVX,-1,-0.028259651002465414,15,7,8,7,0.4055566215554281,0.42874483561640675
수출액/NNG;줄/VV,-1,-0.028259651002465414,15,7,8,7,0.4055566215554281,0.42874483561640675
경기/NNG;회복세/NNG;이/VV,-1,-0.028259651002465414,15,7,8,15,0.4055566215554281,0.42874483561640675
불확실성/NNG;확대시/VVX,-1,-0.028259651002465414,15,7,8,20,0.4055566215554281,0.42874483561640675
금융안정리스크/NNG;있/VV,-1,-0.028259651002465414,15,7,8,6,0.4055566215554281,0.42874483561640675
안전자산선호/NNG;자극하/VVX,-1,-0.028259651002465414,15,7,8,9,0.4055566215554281,0.42874483561640675
금리/NNG;최고치/NNG;기록하/VVX,-1,-0.028259651002465414,15,7,8,10,0.4055566215554281,0.42874483561640675
gdp갭/NNG;플러스/NNG;전환되/VVX,-1,-0.028259651002465414,15,7,8,10,0.4055566215554281,0.42874483561640675
실업률/NNG;유지할/VVX,-1,-0.028259651002465414,15,7,8,7,0.4055566215554281,0.42874483561640675
자산/NNG;사들이/VV,-1,-0.028259651002465414,15,7,8,14,0.4055566215554281,0.42874483561640675
투자심리/NNG;부담/NNG;주/VV,-1,-0.028259651002465414,15,7,8,12,0.4055566215554281,0.42874483561640675
리스크/NNG;발생할/VVX,-1,-0.028259651002465414,15,7,8,16,0.4055566215554281,0.42874483561640675
적자/NNG;줄/VV,-1,-0.028259651002465414,15,7,8,13,0.4055566215554281,0.42874483561640675
성장률/NNG;둔화된/VVX,-1,-0.028259651002465414,15,7,8,11,0.4055566215554281,0.42874483561640675
금리인하기대/NNG;확산되/VVX,-1,-0.028259651002465414,15,7,8,9,0.4055566215554281,0.42874483561640675
고용지표/NNG;개선됐/VVX,-1,-0.028259651002465414,15,7,8,9,0.4055566215554281,0.42874483561640675
성장/NNG;이어지/VV,-1,-0.028259651002465414,15,7,8,15,0.4055566215554281,0.42874483561640675
금리인하/NNG;제약하/VVX,-1,-0.028259651002465414,15,7,8,5,0.4055566215554281,0.42874483561640675
금리동결/NNG;결정되/VVX,-1,-0.028259651002465414,15,7,8,8,0.4055566215554281,0.42874483561640675
기준금리/NNG;내리/VV;동결/NNG,-1,-0.028259651002465414,15,7,8,16,0.4055566215554281,0.42874483561640675
리스크/NNG;회피하/VVX,-1,-0.028259651002465414,15,7,8,13,0.4055566215554281,0.42874483561640675
금리상승/NNG;커질/VV,-1,-0.028259651002465414,15,7,8,14,0.4055566215554281,0.42874483561640675
투자심리/NNG;크/VA;위축됐/VVX,-1,-0.028259651002465414,15,7,8,12,0.4055566215554281,0.42874483561640675
정책금리/NNG;하회하/VVX,-1,-0.028259651002465414,15,7,8,21,0.4055566215554281,0.42874483561640675
잠재성장률/NNG;못/MAG;미치/VV,-1,-0.028259651002465414,15,7,8,12,0.4055566215554281,0.42874483561640675
긴축정책/NNG;시행할/VVX,-1,-0.028259651002465414,15,7,8,7,0.4055566215554281,0.42874483561640675
금리/NNG;떨어질/VV;있/VV,-1,-0.028259651002465414,15,7,8,10,0.4055566215554281,0.42874483561640675
금리/NNG;상승세/NNG;나타날/VV,-1,-0.028259651002465414,15,7,8,12,0.4055566215554281,0.42874483561640675
인플레이션압력/NNG;있/VV,-1,-0.028259651002465414,15,7,8,7,0.4055566215554281,0.42874483561640675
기준금리인상/NNG;이어지/VV,-1,-0.028259651002465414,15,7,8,10,0.4055566215554281,0.42874483561640675
금리인상/NNG;실시하/VVX,-1,-0.028259651002465414,15,7,8,28,0.4055566215554281,0.42874483561640675
불안/NNG;떨/VV,-1,-0.028259651002465414,15,7,8,19,0.4055566215554281,0.42874483561640675
자산매입프로그램/NNG;유지하/VVX,-1,-0.028259651002465414,15,7,8,7,0.4055566215554281,0.42874483561640675
불안/NNG;증폭되/VVX,-1,-0.028259651002465414,15,7,8,9,0.4055566215554281,0.42874483561640675
양적완화정책/NNG;유지하/VVX,-1,-0.028259651002465414,15,7,8,13,0.4055566215554281,0.42874483561640675
경기부양책/NNG;내놓/VV;않/VX,-1,-0.028259651002465414,15,7,8,5,0.4055566215554281,0.42874483561640675
주택가격/NNG;하/VV,-1,-0.028259651002465414,15,7,8,10,0.4055566215554281,0.42874483561640675
수출/NNG;증가세/NNG;유지되/VVX,-1,-0.028259651002465414,15,7,8,12,0.4055566215554281,0.42874483561640675
유동성확대/NNG;따른/VV,-1,-0.028259651002465414,15,7,8,28,0.4055566215554281,0.42874483561640675
경기/NNG;급락하/VVX,-1,-0.028259651002465414,15,7,8,18,0.4055566215554281,0.42874483561640675
경제/NNG;악화될/VVX,-1,-0.028259651002465414,15,7,8,15,0.4055566215554281,0.42874483561640675
세계경제/NNG;회복세/NNG;지속할/VVX,-1,-0.028259651002465414,15,7,8,19,0.4055566215554281,0.42874483561640675
경제성장/NNG;기여하/VVX,-1,-0.028259651002465414,15,7,8,4,0.4055566215554281,0.42874483561640675
금리동결/NNG;이어질/VV,-1,-0.029471503061825888,49,23,26,60,0.49558038111185304,0.525187338429161
기준금리/NNG;인하된/VVX,-1,-0.02961491116370052,119,56,63,98,0.6027220480575473,0.6389131166117934
정책금리/NNG;동결될/VVX,-1,-0.03068371796530789,66,31,35,51,0.5302327015914616,0.5632740928160876
시장금리/NNG;상승하/VVX,-1,-0.03204916589432272,166,78,88,141,0.629948457452134,0.6710341554058693
안전자산선호현상/NNG;강화되/VVX,-1,-0.03364888157764334,47,22,25,43,0.4888017994435472,0.5223509827406454
금리인하기대/NNG;커지/VV,-1,-0.03392954872937137,30,14,16,35,0.4460046020852837,0.47688410794830627
장단기/NNG;금리/NNG;역전되/VVX,-1,-0.03392954872937137,30,14,16,26,0.4460046020852837,0.47688410794830627
물가/NNG;상승했/VVX,-1,-0.03392954872937137,30,14,16,30,0.4460046020852837,0.47688410794830627
경기/NNG;악화되/VVX,-1,-0.033987750603701294,64,30,34,50,0.524580039839972,0.5609651062151094
금리인하/NNG;요구하/VVX,-1,-0.03811842778701058,45,21,24,33,0.4818061312403552,0.5195009976351569
인플레이션/NNG;억제하/VVX,-1,-0.03902788980404881,203,95,108,120,0.634845601599993,0.685760931353377
기준금리/NNG;인하할/VVX,-1,-0.03949354500740998,894,418,476,618,0.6401666507284455,0.6921535772979697
경제성장/NNG;둔화되/VVX,-1,-0.04003903794164876,77,36,41,59,0.5441740403490627,0.5890083640313135
금리/NNG;유지할/VVX,-1,-0.040432412023447495,109,51,58,97,0.5862126397832705,0.6350103582787938
성장세/NNG;둔화되/VVX,-1,-0.040432412023447495,109,51,58,64,0.5862126397832705,0.6350103582787938
성장세/NNG;유지될/VVX,-1,-0.040619018409040586,28,13,15,24,0.4373355228086141,0.47391736302010995
하방리스크/NNG;작용할/VVX,-1,-0.040619018409040586,28,13,15,14,0.4373355228086141,0.47391736302010995
디플레이션/NNG;우려/NNG;커지/VV,-1,-0.040619018409040586,28,13,15,26,0.4373355228086141,0.47391736302010995
소비심리/NNG;회복되/VVX,-1,-0.040619018409040586,28,13,15,23,0.4373355228086141,0.47391736302010995
장단기금리스프레드/NNG;확대되/VVX,-1,-0.040619018409040586,28,13,15,14,0.4373355228086141,0.47391736302010995
마이너스/NNG;보이/VV,-1,-0.040619018409040586,28,13,15,31,0.4373355228086141,0.47391736302010995
신용경색/NNG;인해/VV,-1,-0.040619018409040586,28,13,15,14,0.4373355228086141,0.47391736302010995
금리/NNG;인상돼/VVX,-1,-0.040619018409040586,28,13,15,14,0.4373355228086141,0.47391736302010995
인플레이션/NNG;억제되/VVX,-1,-0.040619018409040586,28,13,15,20,0.4373355228086141,0.47391736302010995
불확실성/NNG;작용하/VVX,-1,-0.040619018409040586,28,13,15,28,0.4373355228086141,0.47391736302010995
금리/NNG;상승세/NNG;진정되/VVX,-1,-0.040619018409040586,28,13,15,23,0.4373355228086141,0.47391736302010995
신용경색/NNG;우려/NNG;완화되/VVX,-1,-0.040619018409040586,28,13,15,15,0.4373355228086141,0.47391736302010995
유동성/NNG;축소되/VVX,-1,-0.040619018409040586,28,13,15,16,0.4373355228086141,0.47391736302010995
경상수지흑자/NNG;줄어들/VV,-1,-0.040619018409040586,28,13,15,25,0.4373355228086141,0.47391736302010995
경기둔화/NNG;이어지/VV,-1,-0.040619018409040586,28,13,15,13,0.4373355228086141,0.47391736302010995
물가/NNG;안정시/VVX,-1,-0.04125252891009634,124,58,66,89,0.5995734747004322,0.6505505761517699
경기/NNG;부양하/VVX,-1,-0.0424217017685421,257,120,137,227,0.6371527635203953,0.692945066144066
내수/NNG;살아나/VV,-1,-0.04291757435257615,43,20,23,43,0.47457645593296893,0.5166454506696775
물가안정/NNG;안정되/VVX,-1,-0.04291757435257615,43,20,23,45,0.47457645593296893,0.5166454506696775
유동성/NNG;공급하/VVX,-1,-0.04366217127046057,448,209,239,314,0.637282694305322,0.6948099720964107
금리하락/NNG;따른/VV,-1,-0.043680984333769324,152,71,81,163,0.6160903648291579,0.6717299229129292
경제/NNG;둔화되/VVX,-1,-0.04454808237487917,195,91,104,97,0.6296358963558997,0.687691782449153
금리인상/NNG;가능성/NNG;제기되/VVX,-1,-0.04496445856411324,58,27,31,69,0.506619909055279,0.5537946197444766
변동성/NNG;높일/VV,-1,-0.04809122282356315,41,19,22,30,0.4670922064832548,0.5137938498413477
연방기금금리/NNG;동결하/VVX,-1,-0.04817079211049213,26,12,14,19,0.42820013318200867,0.4710882821193301
불확실성/NNG;완화하/VVX,-1,-0.04817079211049213,26,12,14,13,0.42820013318200867,0.4710882821193301
성장둔화/NNG;따른/VV,-1,-0.04817079211049213,26,12,14,27,0.42820013318200867,0.4710882821193301
금리/NNG;상승세/NNG;보임/VV,-1,-0.04817079211049213,26,12,14,39,0.42820013318200867,0.4710882821193301
물가/NNG;안정세/NNG;유지하/VVX,-1,-0.04817079211049213,26,12,14,11,0.42820013318200867,0.4710882821193301
경제성장률/NNG;웃돌/VV,-1,-0.04817079211049213,26,12,14,6,0.42820013318200867,0.4710882821193301
완화적/VAX;통화정책/NNG;유지할/VVX,-1,-0.04817079211049213,26,12,14,27,0.42820013318200867,0.4710882821193301
지정학적리스크/NNG;부각되/VVX,-1,-0.04817079211049213,26,12,14,33,0.42820013318200867,0.4710882821193301
불확실성/NNG;걷히/VV,-1,-0.04817079211049213,26,12,14,20,0.42820013318200867,0.4710882821193301
스태그플레이션/NNG;빠질/VV,-1,-0.04817079211049213,26,12,14,9,0.42820013318200867,0.4710882821193301
가계대출/NNG;크/VA;상회하/VVX,-1,-0.04817079211049213,26,12,14,16,0.42820013318200867,0.4710882821193301
경기둔화/NNG;우려/NNG;커지/VV,-1,-0.04817079211049213,26,12,14,25,0.42820013318200867,0.4710882821193301
리스크/NNG;완화된/VVX,-1,-0.04817079211049213,26,12,14,24,0.42820013318200867,0.4710882821193301
금리인상/NNG;중단하/VVX,-1,-0.049033320363819244,56,26,30,33,0.5002731367409539,0.5513318715824979
경제/NNG;위협하/VVX,-1,-0.049033320363819244,56,26,30,42,0.5002731367409539,0.5513318715824979
소비/NNG;줄이/VV,-1,-0.049033320363819244,56,26,30,34,0.5002731367409539,0.5513318715824979
금리인상/NNG;가능성/NNG;반영하/VVX,-1,-0.049033320363819244,56,26,30,75,0.5002731367409539,0.5513318715824979
투자심리/NNG;위축될/VVX,-1,-0.049834782113472254,71,33,38,55,0.5283799272289693,0.5832430421879586
경제/NNG;부정적/VAX;영향/NNG;미칠/VV,-1,-0.049834782113472254,71,33,38,53,0.5283799272289693,0.5832430421879586
금리하락압력/NNG;작용할/VVX,-1,-0.05334082084698444,54,25,29,37,0.49373048507875517,0.5488383029925665
금융시장불안/NNG;따른/VV,-1,-0.05369377080246296,39,18,21,15,0.459328101002831,0.5109574195767337
경기둔화/NNG;따른/VV,-1,-0.053759992914525045,183,85,98,186,0.6206210179474606,0.6904715960417667
기준금리/NNG;동결할/VVX,-1,-0.054477252691362166,677,314,363,491,0.6297551137605513,0.7016417430019531
기준금리/NNG;낮춘/VV,-1,-0.05654321791927974,82,38,44,54,0.542237578867527,0.606641382611341
불안/NNG;고조되/VVX,-1,-0.0567999767521119,24,11,13,24,0.41849517035190736,0.4684426652492064
경기/NNG;회복되/VVX;않/VX,-1,-0.0567999767521119,24,11,13,12,0.41849517035190736,0.4684426652492064
경기선행지수/NNG;상승했/VVX,-1,-0.0567999767521119,24,11,13,16,0.41849517035190736,0.4684426652492064
디플레이션/NNG;막/VV,-1,-0.0567999767521119,24,11,13,23,0.41849517035190736,0.4684426652492064
마이너스/NNG;전환되/VVX,-1,-0.0567999767521119,24,11,13,27,0.41849517035190736,0.4684426652492064
경기회복/NNG;위한/VV,-1,-0.05768229957394322,110,51,59,89,0.5763264001937783,0.646253395703975
기준금리/NNG;올릴/VV,-1,-0.05855538897348711,430,199,231,430,0.6268995389290772,0.7041945207860847
유가상승/NNG;견인했/VVX,-1,-0.05979184682659866,37,17,20,35,0.45125269197912476,0.5081494402248639
경제지표/NNG;호전되/VVX,-1,-0.05979184682659866,37,17,20,36,0.45125269197912476,0.5081494402248639
불안요인/NNG;될/VV,-1,-0.05979184682659866,37,17,20,29,0.45125269197912476,0.5081494402248639
테이퍼링/NNG;따른/VV,-1,-0.05979184682659866,37,17,20,30,0.45125269197912476,0.5081494402248639
금융완화/NNG;유지될/VVX,-1,-0.05979184682659866,37,17,20,15,0.45125269197912476,0.5081494402248639
기준금리인상/NNG;단행했/VVX,-1,-0.05979184682659866,37,17,20,28,0.45125269197912476,0.5081494402248639
금리인상/NNG;지속하/VVX,-1,-0.05979184682659866,37,17,20,20,0.45125269197912476,0.5081494402248639
소비/NNG;위축되/VVX,-1,-0.05986088016862956,80,37,43,56,0.5372180193534705,0.6050375792278326
금리/NNG;인하한/VVX,-1,-0.06105224953061561,65,30,35,51,0.5111729616239264,0.5770819534627205
금리인하/NNG;단행할/VVX,-1,-0.06277980390932103,392,181,211,212,0.6239301630750739,0.7068232032939443
기준금리/NNG;낮췄/VV,-1,-0.06516775498283622,63,29,34,48,0.5050929003403991,0.5749462027877487
경제/NNG;타격/NNG;받/VV,-1,-0.06646806208077283,35,16,19,28,0.44282636627364175,0.5053856672142317
금리/NNG;인상하/VVX;어려울/VA,-1,-0.06646806208077283,35,16,19,30,0.44282636627364175,0.5053856672142317
외화유동성/NNG;공급하/VVX,-1,-0.06646806208077283,35,16,19,5,0.44282636627364175,0.5053856672142317
경기/NNG;호전될/VVX,-1,-0.06646806208077283,35,16,19,38,0.44282636627364175,0.5053856672142317
금리인상/NNG;유지하/VVX,-1,-0.06646806208077283,35,16,19,15,0.44282636627364175,0.5053856672142317
금리인상/NNG;전망했/VVX,-1,-0.06646806208077283,35,16,19,33,0.44282636627364175,0.5053856672142317
금리인상/NNG;점쳤/VV,-1,-0.06646806208077283,35,16,19,12,0.44282636627364175,0.5053856672142317
양적완화/NNG;축소될/VVX,-1,-0.06680487113086575,22,10,12,24,0.40807426042169687,0.46603902712138795
양적완화/NNG;인해/VV,-1,-0.06680487113086575,22,10,12,35,0.40807426042169687,0.46603902712138795
경제전망/NNG;악화되/VVX,-1,-0.06680487113086575,22,10,12,6,0.40807426042169687,0.46603902712138795
경제성장/NNG;저해하/VVX,-1,-0.06680487113086575,22,10,12,13,0.40807426042169687,0.46603902712138795
경제/NNG;미칠/VV;부정적/VAX,-1,-0.06680487113086575,22,10,12,36,0.40807426042169687,0.46603902712138795
경제/NNG;과열되/VVX,-1,-0.06680487113086575,22,10,12,14,0.40807426042169687,0.46603902712138795
경제/NNG;나아지/VV,-1,-0.06680487113086575,22,10,12,26,0.40807426042169687,0.46603902712138795
경제/NNG;둔화할/VVX,-1,-0.06680487113086575,22,10,12,12,0.40807426042169687,0.46603902712138795
통화완화/NNG;나설/VV,-1,-0.06680487113086575,22,10,12,28,0.40807426042169687,0.46603902712138795
고용지표/NNG;호조/NNG;보였/VV,-1,-0.06680487113086575,22,10,12,10,0.40807426042169687,0.46603902712138795
인플레이션/NNG;제어하/VVX,-1,-0.06680487113086575,22,10,12,17,0.40807426042169687,0.46603902712138795
물가상승/NNG;이어질/VV,-1,-0.06680487113086575,22,10,12,23,0.40807426042169687,0.46603902712138795
물가상승/NNG;이어지/VV,-1,-0.06680487113086575,22,10,12,23,0.40807426042169687,0.46603902712138795
투자심리/NNG;얼어붙/VV,-1,-0.06796548810424663,48,22,26,48,0.4727992739556087,0.5412174981295822
수출/NNG;늘리/VV,-1,-0.06796548810424663,48,22,26,27,0.4727992739556087,0.5412174981295822
정책금리/NNG;인상되/VVX,-1,-0.06796548810424663,48,22,26,39,0.4727992739556087,0.5412174981295822
경기상승/NNG;따른/VV,-1,-0.06796548810424663,48,22,26,22,0.4727992739556087,0.5412174981295822
성장세/NNG;지속될/VVX,-1,-0.07067302146721555,74,34,40,50,0.5212716450141766,0.5999574572170293
실업률/NNG;하락하/VVX,-1,-0.07183178368218313,113,52,61,123,0.5701822084557953,0.6577803300556425
금리인하/NNG;나서/VV,-1,-0.07327917874457479,174,80,94,132,0.6046732555388724,0.6996017346960697
양적완화/NNG;내놓/VV,-1,-0.07352212985368223,46,21,25,56,0.4653331227177628,0.5386492911645154
기준금리인상/NNG;예상되/VVX,-1,-0.07352212985368223,46,21,25,45,0.4653331227177628,0.5386492911645154
기준금리인상/NNG;반영하/VVX,-1,-0.07382625379698193,33,15,18,19,0.43399854141932415,0.5026848497520952
내수/NNG;부양하/VVX,-1,-0.07382625379698193,33,15,18,16,0.43399854141932415,0.5026848497520952
인플레이션압력/NNG;커지/VV,-1,-0.07406463874855862,59,27,32,48,0.4923659573898815,0.5705629732688541
동결/NNG;유지하/VVX,-1,-0.07406463874855862,59,27,32,60,0.4923659573898815,0.5705629732688541
적자/NNG;기록하/VVX,-1,-0.07406463874855862,59,27,32,45,0.4923659573898815,0.5705629732688541
경기부양/NNG;위해/VV,-1,-0.07409770613824695,730,335,395,557,0.6159380848462971,0.7138081198868214
수출/NNG;악영향/NNG;미칠/VV,-1,-0.07861254557688158,20,9,11,9,0.3967235602807832,0.4639529986522579
리스크/NNG;줄/VV,-1,-0.07861254557688158,20,9,11,18,0.3967235602807832,0.4639529986522579
경기부양책/NNG;필요하/VVX,-1,-0.07861254557688158,20,9,11,7,0.3967235602807832,0.4639529986522579
금융시장/NNG;흔들리/VV,-1,-0.07861254557688158,20,9,11,14,0.3967235602807832,0.4639529986522579
성장모멘텀/NNG;불확실성/NNG;해소되/VVX;않/VX,-1,-0.07861254557688158,20,9,11,1,0.3967235602807832,0.4639529986522579
금리하락/NNG;지지하/VVX,-1,-0.07861254557688158,20,9,11,48,0.3967235602807832,0.4639529986522579
금리하락/NNG;주도했/VVX,-1,-0.07861254557688158,20,9,11,13,0.3967235602807832,0.4639529986522579
마이너스/NNG;하락하/VVX,-1,-0.07861254557688158,20,9,11,10,0.3967235602807832,0.4639529986522579
인플레이션우려/NNG;고조되/VVX,-1,-0.07861254557688158,20,9,11,6,0.3967235602807832,0.4639529986522579
글로벌/NNG;금융시장/NNG;안정되/VVX,-1,-0.07861254557688158,20,9,11,21,0.3967235602807832,0.4639529986522579
금리인하기대/NNG;소멸되/VVX,-1,-0.07861254557688158,20,9,11,30,0.3967235602807832,0.4639529986522579
적자/NNG;확대되/VVX,-1,-0.07861254557688158,20,9,11,11,0.3967235602807832,0.4639529986522579
신용등급/NNG;하향조정될/VVX,-1,-0.07861254557688158,20,9,11,13,0.3967235602807832,0.4639529986522579
성장세/NNG;보인/VV,-1,-0.07861254557688158,20,9,11,21,0.3967235602807832,0.4639529986522579
금리인상/NNG;대비하/VVX,-1,-0.07861254557688158,20,9,11,22,0.3967235602807832,0.4639529986522579
금리/NNG;횡보하/VVX,-1,-0.07861254557688158,20,9,11,13,0.3967235602807832,0.4639529986522579
출구전략/NNG;시행해/VVX,-1,-0.07861254557688158,20,9,11,9,0.3967235602807832,0.4639529986522579
불안/NNG;완화될/VVX,-1,-0.07861254557688158,20,9,11,14,0.3967235602807832,0.4639529986522579
금리동결/NNG;이/VV,-1,-0.07861254557688158,20,9,11,13,0.3967235602807832,0.4639529986522579
금리인하/NNG;대응할/VVX,-1,-0.07861254557688158,20,9,11,25,0.3967235602807832,0.4639529986522579
강한/VA;성장세/NNG;보이/VV,-1,-0.07861254557688158,20,9,11,8,0.3967235602807832,0.4639529986522579
경제성장/NNG;하/VV,-1,-0.07861254557688158,20,9,11,18,0.3967235602807832,0.4639529986522579
불확실성/NNG;작용할/VVX,-1,-0.07861254557688158,20,9,11,27,0.3967235602807832,0.4639529986522579
경기부양책/NNG;따른/VV,-1,-0.07888823940467515,57,26,31,42,0.4856982668620126,0.5683205022354576
가계부채/NNG;늘어나/VV,-1,-0.07949312123794317,44,20,24,40,0.4575868832297943,0.5360788156108408
경제성장률/NNG;상향조정했/VVX,-1,-0.07949312123794317,44,20,24,50,0.4575868832297943,0.5360788156108408
경기침체/NNG;겪/VV,-1,-0.07949312123794317,44,20,24,44,0.4575868832297943,0.5360788156108408
경제/NNG;둔화하/VVX,-1,-0.07949312123794317,44,20,24,35,0.4575868832297943,0.5360788156108408
경기/NNG;하강하/VVX,-1,-0.08199896846429344,31,14,17,19,0.42470366144142524,0.5000693726479721
재정/NNG;통한/VV,-1,-0.08199896846429344,31,14,17,22,0.42470366144142524,0.5000693726479721
금리/NNG;하락세/NNG;이끌/VV,-1,-0.08199896846429344,31,14,17,40,0.42470366144142524,0.5000693726479721
실업률/NNG;기록하/VVX,-1,-0.08199896846429344,31,14,17,28,0.42470366144142524,0.5000693726479721
물가상승/NNG;막/VV,-1,-0.08199896846429344,31,14,17,20,0.42470366144142524,0.5000693726479721
수출/NNG;둔화될/VVX,-1,-0.08199896846429344,31,14,17,13,0.42470366144142524,0.5000693726479721
통화정책/NNG;불확실성/NNG;해소되/VVX,-1,-0.08199896846429344,31,14,17,14,0.42470366144142524,0.5000693726479721
금리인상/NNG;지지하/VVX,-1,-0.08299993422068186,68,31,37,71,0.5038733098375744,0.5944842117041857
유동성/NNG;풀/VV,-1,-0.08399537266317747,55,25,30,38,0.4788112884415616,0.5660481624275654
금리인하/NNG;주장했/VVX,-1,-0.08399537266317747,55,25,30,49,0.4788112884415616,0.5660481624275654
경제/NNG;확산되/VVX,-1,-0.08593586711273005,42,19,23,26,0.44953240474715095,0.533514784794403
기준금리동결/NNG;예상되/VVX,-1,-0.08593586711273005,42,19,23,49,0.44953240474715095,0.533514784794403
고용지표호조/NNG;따른/VV,-1,-0.08593586711273005,42,19,23,48,0.44953240474715095,0.533514784794403
투자심리/NNG;개선될/VVX,-1,-0.08593586711273005,42,19,23,29,0.44953240474715095,0.533514784794403
투자심리/NNG;개선되/VVX,-1,-0.08612743577057402,79,36,43,91,0.5199200806167814,0.6172904438064212
불확실성/NNG;완화되/VVX,-1,-0.08809660726867385,160,73,87,177,0.5895468087192575,0.7027379603411895
콜금리/NNG;동결할/VVX,-1,-0.08828138511337069,114,52,62,37,0.5604438900043058,0.6682960428749706
불안요인/NNG;상존하/VVX,-1,-0.08941604061652919,53,24,29,31,0.4716901986202143,0.5637495788726803
인플레이션/NNG;막/VV,-1,-0.08941604061652919,53,24,29,36,0.4716901986202143,0.5637495788726803
금리인상/NNG;가능성/NNG;커지/VV,-1,-0.08941604061652919,53,24,29,38,0.4716901986202143,0.5637495788726803
금리/NNG;상승세/NNG;예상된/VVX,-1,-0.09115839725023533,29,13,16,23,0.4148553584421474,0.49756604719560044
금융안정/NNG;유의해/VVX,-1,-0.09115839725023533,29,13,16,10,0.4148553584421474,0.49756604719560044
물가/NNG;상승해/VVX,-1,-0.09115839725023533,29,13,16,21,0.4148553584421474,0.49756604719560044
출구전략/NNG;나서/VV,-1,-0.09115839725023533,29,13,16,19,0.4148553584421474,0.49756604719560044
기준금리인하/NNG;나서/VV,-1,-0.09115839725023533,29,13,16,27,0.4148553584421474,0.49756604719560044
금융위기/NNG;인해/VV,-1,-0.09224325075167306,64,29,35,45,0.4913724144824109,0.5906284385998257
성장/NNG;보일/VV,-1,-0.09224325075167306,64,29,35,42,0.4913724144824109,0.5906284385998257
물가상승/NNG;예상되/VVX,-1,-0.09285862598931094,18,8,10,19,0.38411922967174894,0.462283445261783
마이너스/NNG;축소되/VVX,-1,-0.09285862598931094,18,8,10,20,0.38411922967174894,0.462283445261783
경기부양책/NNG;시행할/VVX,-1,-0.09285862598931094,18,8,10,4,0.38411922967174894,0.462283445261783
소매판매/NNG;부진하/VVX,-1,-0.09285862598931094,18,8,10,11,0.38411922967174894,0.462283445261783
고용/NNG;줄어들/VV,-1,-0.09285862598931094,18,8,10,10,0.38411922967174894,0.462283445261783
정책금리/NNG;유지될/VVX,-1,-0.09285862598931094,18,8,10,8,0.38411922967174894,0.462283445261783
재정정책/NNG;필요하/VVX,-1,-0.09285862598931094,18,8,10,21,0.38411922967174894,0.462283445261783
물가상승압력/NNG;확대될/VVX,-1,-0.09285862598931094,18,8,10,23,0.38411922967174894,0.462283445261783
인플레이션/NNG;우려/NNG;커지/VV,-1,-0.09285862598931094,18,8,10,11,0.38411922967174894,0.462283445261783
금리인하/NNG;마무리되/VVX,-1,-0.09285862598931094,18,8,10,13,0.38411922967174894,0.462283445261783
소비자물가지수/NNG;상승할/VVX,-1,-0.09285862598931094,18,8,10,9,0.38411922967174894,0.462283445261783
통화완화/NNG;지속될/VVX,-1,-0.09285862598931094,18,8,10,20,0.38411922967174894,0.462283445261783
금리/NNG;상승할/VVX;전망/NNG,-1,-0.09285862598931094,18,8,10,15,0.38411922967174894,0.462283445261783
내수/NNG;확대하/VVX,-1,-0.09285862598931094,18,8,10,11,0.38411922967174894,0.462283445261783
금리인상/NNG;반영해/VVX,-1,-0.09285862598931094,18,8,10,17,0.38411922967174894,0.462283445261783
양적완화정책/NNG;펴/VV,-1,-0.09285862598931094,18,8,10,19,0.38411922967174894,0.462283445261783
금리/NNG;낮/VA;유지될/VVX,-1,-0.09285862598931094,18,8,10,19,0.38411922967174894,0.462283445261783
경기회복/NNG;낙관하/VVX,-1,-0.09285862598931094,18,8,10,12,0.38411922967174894,0.462283445261783
높/VA;금리/NNG;주/VV,-1,-0.09285862598931094,18,8,10,8,0.38411922967174894,0.462283445261783
경기회복/NNG;확신하/VVX,-1,-0.09285862598931094,18,8,10,18,0.38411922967174894,0.462283445261783
외환위기/NNG;직후인/VVX,-1,-0.09285862598931094,18,8,10,7,0.38411922967174894,0.462283445261783
부양책/NNG;쓰/VV,-1,-0.09285862598931094,18,8,10,23,0.38411922967174894,0.462283445261783
물가/NNG;밑돌/VV,-1,-0.09285862598931094,18,8,10,13,0.38411922967174894,0.462283445261783
통화긴축/NNG;나설/VV,-1,-0.09285862598931094,18,8,10,15,0.38411922967174894,0.462283445261783
주택시장침체/NNG;지속되/VVX,-1,-0.09285862598931094,18,8,10,10,0.38411922967174894,0.462283445261783
금리인상/NNG;유지되/VVX,-1,-0.09285862598931094,18,8,10,11,0.38411922967174894,0.462283445261783
기준금리인상/NNG;시작하/VVX,-1,-0.09285862598931094,18,8,10,13,0.38411922967174894,0.462283445261783
인플레이션/NNG;미치/VV,-1,-0.09285862598931094,18,8,10,17,0.38411922967174894,0.462283445261783
금융시장/NNG;충격/NNG;받/VV,-1,-0.09285862598931094,18,8,10,11,0.38411922967174894,0.462283445261783
대외불확실성/NNG;지속되/VVX,-1,-0.09292006529947594,40,18,22,28,0.4411351682736848,0.5309672839795987
금리인상/NNG;시작할/VVX,-1,-0.09292006529947594,40,18,22,63,0.4411351682736848,0.5309672839795987
소비/NNG;살아나/VV,-1,-0.09292006529947594,40,18,22,36,0.4411351682736848,0.5309672839795987
환율상승/NNG;따른/VV,-1,-0.0935828562603328,99,45,54,71,0.5417078928990178,0.6528922861039136
장단기금리차/NNG;축소되/VVX,-1,-0.09442264472102979,75,34,41,72,0.5087359883273865,0.6141920617242195
금리/NNG;상승압력/NNG;받/VV,-1,-0.09508493448620925,121,55,66,136,0.5619800338688428,0.6793798208326798
침체/NNG;빠진/VV,-1,-0.09518520584593859,51,23,28,32,0.4643176622713529,0.5614289239670004
금리/NNG;동결되/VVX,-1,-0.09711498191975565,97,44,53,70,0.5371611022376989,0.6520406079089304
경제성장/NNG;둔화될/VVX,-1,-0.09884558765756002,73,33,40,54,0.5028913871614062,0.6125772419946153
양적완화축소/NNG;따른/VV,-1,-0.09884558765756002,73,33,40,99,0.5028913871614062,0.6125772419946153
금융시장/NNG;안정된/VVX,-1,-0.10053129108054981,38,17,21,25,0.4323523816340654,0.5284479786966549
금리인하/NNG;카드/NNG;꺼내/VV,-1,-0.10053129108054981,38,17,21,26,0.4323523816340654,0.5284479786966549
성장/NNG;둔화하/VVX,-1,-0.10053129108054981,38,17,21,25,0.4323523816340654,0.5284479786966549
금융시장/NNG;변동성/NNG;확대될/VVX,-1,-0.10053129108054981,38,17,21,41,0.4323523816340654,0.5284479786966549
금리인상/NNG;기정사실화하/VVX,-1,-0.10053129108054981,38,17,21,16,0.4323523816340654,0.5284479786966549
경제지표/NNG;부진했/VVX,-1,-0.10053129108054981,38,17,21,62,0.4323523816340654,0.5284479786966549
인플레이션/NNG;상승할/VVX,-1,-0.10134390598202703,49,22,27,31,0.4566732425033329,0.5590909814945505
불안/NNG;가중되/VVX,-1,-0.10153279171977792,27,12,15,22,0.4043377404872561,0.4952070747012518
재정위기/NNG;확산되/VVX,-1,-0.10153279171977792,27,12,15,36,0.4043377404872561,0.4952070747012518
금리인상/NNG;뒷받침하/VVX,-1,-0.10153279171977792,27,12,15,15,0.4043377404872561,0.4952070747012518
유동성/NNG;늘리/VV,-1,-0.10153279171977792,27,12,15,13,0.4043377404872561,0.4952070747012518
소비자물가/NNG;상승할/VVX,-1,-0.10247936460152052,60,27,33,39,0.47806199554503165,0.58662012341077
리스크/NNG;작용할/VVX,-1,-0.10347047402886012,71,32,39,71,0.4968686731226545,0.6109191834970883
금리/NNG;인하해/VVX,-1,-0.10627470944651096,186,84,102,119,0.5847127947151998,0.7230121912507895
변동성/NNG;보이/VV,-1,-0.10794068683249702,47,21,26,46,0.448732644219489,0.556741216300978
경기/NNG;바닥/NNG;찍/VV,-1,-0.10794068683249702,47,21,26,20,0.448732644219489,0.556741216300978
경제성장률/NNG;둔화되/VVX,-1,-0.10802920999751653,58,26,32,38,0.4710730927762602,0.5845635660086992
금리/NNG;내려야/VV,-1,-0.108235725162523,102,46,56,61,0.5356460538323574,0.6649710069359729
불확실성/NNG;부각되/VVX,-1,-0.10831314373853307,69,31,38,63,0.4906595463270721,0.6092184427531365
경제성장률/NNG;상향조정하/VVX,-1,-0.10887592868676121,36,16,20,29,0.42313037504682877,0.5259703496833065
성장/NNG;힘입/VV,-1,-0.10887592868676121,36,16,20,16,0.42313037504682877,0.5259703496833065
고용/NNG;증가해/VVX,-1,-0.10887592868676121,36,16,20,26,0.42313037504682877,0.5259703496833065
물가상승압력/NNG;지속될/VVX,-1,-0.10887592868676121,36,16,20,29,0.42313037504682877,0.5259703496833065
경제지표/NNG;호조/NNG;나타내/VV,-1,-0.10887592868676121,36,16,20,36,0.42313037504682877,0.5259703496833065
재정지출/NNG;늘리/VV,-1,-0.10887592868676121,36,16,20,36,0.42313037504682877,0.5259703496833065
금리인하/NNG;가능성/NNG;부각되/VVX,-1,-0.11053583399371614,16,7,9,18,0.36974912302571256,0.4611608103013991
물가/NNG;고공행진/NNG;이/VV,-1,-0.11053583399371614,16,7,9,4,0.36974912302571256,0.4611608103013991
소비/NNG;투자/NNG;이어지/VV,-1,-0.11053583399371614,16,7,9,9,0.36974912302571256,0.4611608103013991
금리상승/NNG;크/VA;나타났/VV,-1,-0.11053583399371614,16,7,9,4,0.36974912302571256,0.4611608103013991
투자심리/NNG;긍정적/VAX;작용할/VVX,-1,-0.11053583399371614,16,7,9,16,0.36974912302571256,0.4611608103013991
경기확장/NNG;밑돌/VV,-1,-0.11053583399371614,16,7,9,12,0.36974912302571256,0.4611608103013991
경기회복세/NNG;약화되/VVX,-1,-0.11053583399371614,16,7,9,18,0.36974912302571256,0.4611608103013991
인플레이션/NNG;잘/MAG;통제될/VVX,-1,-0.11053583399371614,16,7,9,5,0.36974912302571256,0.4611608103013991
소비/NNG;회복세/NNG;이/VV,-1,-0.11053583399371614,16,7,9,5,0.36974912302571256,0.4611608103013991
금리인상/NNG;가능성/NNG;높였/VV,-1,-0.11053583399371614,16,7,9,28,0.36974912302571256,0.4611608103013991
금리상승/NNG;제한됐/VVX,-1,-0.11053583399371614,16,7,9,23,0.36974912302571256,0.4611608103013991
기준금리/NNG;하/VV,-1,-0.11053583399371614,16,7,9,18,0.36974912302571256,0.4611608103013991
채권시장/NNG;국채가격/NNG;떨어졌/VV,-1,-0.11053583399371614,16,7,9,8,0.36974912302571256,0.4611608103013991
경기회복세/NNG;지속하/VVX,-1,-0.11053583399371614,16,7,9,16,0.36974912302571256,0.4611608103013991
물가/NNG;뛰/VV,-1,-0.11053583399371614,16,7,9,22,0.36974912302571256,0.4611608103013991
불확실성/NNG;증대된/VVX,-1,-0.11053583399371614,16,7,9,13,0.36974912302571256,0.4611608103013991
물가상승압력/NNG;가중되/VVX,-1,-0.11053583399371614,16,7,9,11,0.36974912302571256,0.4611608103013991
변동성/NNG;나타냈/VV,-1,-0.11053583399371614,16,7,9,19,0.36974912302571256,0.4611608103013991
완화정책/NNG;내놓/VV,-1,-0.11053583399371614,16,7,9,17,0.36974912302571256,0.4611608103013991
경기회복/NNG;기대하/VVX;어렵/VA,-1,-0.11053583399371614,16,7,9,25,0.36974912302571256,0.4611608103013991
변동성/NNG;보인/VV,-1,-0.11053583399371614,16,7,9,25,0.36974912302571256,0.4611608103013991
시장금리/NNG;미치/VV;영향/NNG;제한적/VAX,-1,-0.11053583399371614,16,7,9,8,0.36974912302571256,0.4611608103013991
경제/NNG;살아날/VV,-1,-0.11053583399371614,16,7,9,9,0.36974912302571256,0.4611608103013991
인플레이션기대심리/NNG;자극하/VVX,-1,-0.11053583399371614,16,7,9,11,0.36974912302571256,0.4611608103013991
리스크/NNG;평가하/VVX,-1,-0.11053583399371614,16,7,9,7,0.36974912302571256,0.4611608103013991
채권시장/NNG;약세/NNG;보이/VV,-1,-0.11053583399371614,16,7,9,19,0.36974912302571256,0.4611608103013991
금리/NNG;조정/NNG;받/VV,-1,-0.11053583399371614,16,7,9,20,0.36974912302571256,0.4611608103013991
금리/NNG;올라야/VV,-1,-0.11053583399371614,16,7,9,10,0.36974912302571256,0.4611608103013991
단기금리/NNG;상승압력/NNG;받/VV,-1,-0.11053583399371614,16,7,9,7,0.36974912302571256,0.4611608103013991
경제성장률/NNG;낮출/VV,-1,-0.11053583399371614,16,7,9,24,0.36974912302571256,0.4611608103013991
만장일치/NNG;동결이/VVX,-1,-0.11053583399371614,16,7,9,26,0.36974912302571256,0.4611608103013991
금리/NNG;상승세/NNG;보인/VV,-1,-0.11053583399371614,16,7,9,18,0.36974912302571256,0.4611608103013991
소비자물가/NNG;전이되/VVX,-1,-0.11053583399371614,16,7,9,7,0.36974912302571256,0.4611608103013991
물가안정/NNG;위해서/VV,-1,-0.11053583399371614,16,7,9,14,0.36974912302571256,0.4611608103013991
경기부양/NNG;나서/VV,-1,-0.11121264842089618,111,50,61,83,0.5426948879420359,0.6777908298430628
경기/NNG;살아나/VV,-1,-0.11121264842089618,111,50,61,111,0.5426948879420359,0.6777908298430628
정책금리/NNG;내리/VV,-1,-0.11343187585806036,25,11,14,13,0.39299205066308995,0.4930311911980889
인플레이션압력/NNG;억제하/VVX,-1,-0.11343187585806036,25,11,14,16,0.39299205066308995,0.4930311911980889
금리인상/NNG;준비하/VVX,-1,-0.11343187585806036,25,11,14,26,0.39299205066308995,0.4930311911980889
경기/NNG;회복세/NNG;보일/VV,-1,-0.11343187585806036,25,11,14,14,0.39299205066308995,0.4930311911980889
변동성/NNG;장세/NNG;이어질/VV,-1,-0.11343187585806036,25,11,14,23,0.39299205066308995,0.4930311911980889
금리인상/NNG;가능성/NNG;남/VV,-1,-0.11343187585806036,25,11,14,21,0.39299205066308995,0.4930311911980889
생산/NNG;늘리/VV,-1,-0.11343187585806036,25,11,14,21,0.39299205066308995,0.4930311911980889
인플레이션우려/NNG;완화됐/VVX,-1,-0.11343187585806036,25,11,14,8,0.39299205066308995,0.4930311911980889
인플레이션기대/NNG;억제하/VVX,-1,-0.11343187585806036,25,11,14,11,0.39299205066308995,0.4930311911980889
주택가격/NNG;하락했/VVX,-1,-0.11343187585806036,25,11,14,15,0.39299205066308995,0.4930311911980889
금리/NNG;올린다/VV,-1,-0.11343187585806036,25,11,14,12,0.39299205066308995,0.4930311911980889
불안/NNG;진정되/VVX,-1,-0.11390584226837708,56,25,31,55,0.46384204674689195,0.5824752573289238
수익성/NNG;개선되/VVX,-1,-0.1150334660360689,45,20,25,29,0.44046673570244,0.5543858487075864
경기회복/NNG;지연될/VVX,-1,-0.1150334660360689,45,20,25,35,0.44046673570244,0.5543858487075864
금리인하/NNG;주장하/VVX,-1,-0.1150334660360689,45,20,25,43,0.44046673570244,0.5543858487075864
자산/NNG;축소하/VVX,-1,-0.11808808208683752,34,15,19,43,0.4134009860840907,0.523549950629971
변동성/NNG;크/VA;확대되/VVX,-1,-0.11808808208683752,34,15,19,41,0.4134009860840907,0.523549950629971
경기/NNG;회복시/VVX,-1,-0.11808808208683752,34,15,19,29,0.4134009860840907,0.523549950629971
경기회복/NNG;지속될/VVX,-1,-0.11808808208683752,34,15,19,32,0.4134009860840907,0.523549950629971
금리/NNG;하락세/NNG;이어질/VV,-1,-0.12014425642210114,54,24,30,62,0.45635115927524583,0.5803580197843566
불확실성/NNG;따른/VV,-1,-0.12348309401723778,190,85,105,162,0.5732809931342098,0.7340163878080685
기준금리/NNG;인하될/VVX,-1,-0.12411192895948375,672,300,372,450,0.5799008420464633,0.743440476860678
변동성/NNG;확대될/VVX,-1,-0.12633929712201697,388,173,215,388,0.5782682508010345,0.7447074589222248
금리하락/NNG;인해/VV,-1,-0.12728760165017872,23,10,13,19,0.3805956383119222,0.4910849552487193
저성장/NNG;지속되/VVX,-1,-0.12728760165017872,23,10,13,26,0.3805956383119222,0.4910849552487193
글로벌/NNG;신용경색/NNG;따른/VV,-1,-0.12728760165017872,23,10,13,8,0.3805956383119222,0.4910849552487193
큰/VA;금리/NNG;하락세/NNG;보임/VV,-1,-0.12728760165017872,23,10,13,30,0.3805956383119222,0.4910849552487193
고용지표개선/NNG;따른/VV,-1,-0.12728760165017872,23,10,13,20,0.3805956383119222,0.4910849552487193
투자심리/NNG;위축돼/VVX,-1,-0.12728760165017872,23,10,13,18,0.3805956383119222,0.4910849552487193
인플레이션/NNG;하락하/VVX,-1,-0.12728760165017872,23,10,13,21,0.3805956383119222,0.4910849552487193
금융위기/NNG;촉발된/VVX,-1,-0.12728760165017872,23,10,13,6,0.3805956383119222,0.4910849552487193
금리인하/NNG;나올/VV,-1,-0.12728760165017872,23,10,13,12,0.3805956383119222,0.4910849552487193
안전자산선호현상/NNG;약화됐/VVX,-1,-0.12728760165017872,23,10,13,12,0.3805956383119222,0.4910849552487193
경제성장률/NNG;머물/VV,-1,-0.12728760165017872,23,10,13,25,0.3805956383119222,0.4910849552487193
물가상승압력/NNG;높일/VV,-1,-0.12728760165017872,23,10,13,10,0.3805956383119222,0.4910849552487193
하방위험/NNG;상존하/VVX,-1,-0.12728760165017872,23,10,13,18,0.3805956383119222,0.4910849552487193
성장률/NNG;상회하/VVX,-1,-0.12728760165017872,23,10,13,24,0.3805956383119222,0.4910849552487193
경기회복/NNG;위해/VV,-1,-0.12803546681410305,159,71,88,123,0.561350264581214,0.7254150552441537
수출/NNG;감소할/VVX,-1,-0.12833945980601158,32,14,18,17,0.4030764585214938,0.5212046768781678
마이너스/NNG;유지하/VVX,-1,-0.12833945980601158,32,14,18,21,0.4030764585214938,0.5212046768781678
물가/NNG;영향/NNG;미칠/VV,-1,-0.12833945980601158,32,14,18,8,0.4030764585214938,0.5212046768781678
경기/NNG;상승기조/NNG;이/VV,-1,-0.12833945980601158,32,14,18,8,0.4030764585214938,0.5212046768781678
금리인하/NNG;단행되/VVX;않/VX,-1,-0.12833945980601158,32,14,18,17,0.4030764585214938,0.5212046768781678
유동성/NNG;공급할/VVX,-1,-0.1297345933502383,130,58,72,91,0.5453135192777917,0.7071286658346749
부양책/NNG;나올/VV,-1,-0.13025470661290994,61,27,34,39,0.46375542073845216,0.6020053225999873
투자심리/NNG;안정시/VVX,-1,-0.13025470661290994,61,27,34,38,0.46375542073845216,0.6020053225999873
경기회복/NNG;진행되/VVX,-1,-0.13025470661290994,61,27,34,37,0.46375542073845216,0.6020053225999873
양적완화/NNG;나설/VV,-1,-0.13025470661290994,61,27,34,59,0.46375542073845216,0.6020053225999873
기준금리/NNG;동결된/VVX,-1,-0.13069922414731505,148,66,82,100,0.5547915228748324,0.7208312670121587
기준금리/NNG;동결됐/VVX,-1,-0.13310216315300627,70,31,39,95,0.47746755544219516,0.6234046579968691
인플레이션/NNG;완화되/VVX,-1,-0.1338769299822723,50,22,28,20,0.4405035304347306,0.5760499842319248
성장세/NNG;이어질/VV,-1,-0.13537228880070296,79,35,44,51,0.48980760674103135,0.6424776677702854
금리/NNG;인하될/VVX,-1,-0.1356463276194455,232,103,129,98,0.5694658371591257,0.7473817101565465
실업률/NNG;상승하/VVX,-1,-0.13650593049839954,59,26,33,45,0.45644926549528053,0.600105215546256
금리/NNG;인하할/VVX,-1,-0.13800459908115115,982,435,547,523,0.5697153591301982,0.7513087353552155
변동성/NNG;확대되/VVX,-1,-0.13870469369103622,341,151,190,294,0.5691656354562609,0.7516551342272633
경제/NNG;부양하/VVX,-1,-0.13873226609060418,68,30,38,28,0.47081634991189936,0.6218074086770912
내수/NNG;살리/VV,-1,-0.1398538399985234,30,13,17,30,0.39204211421692525,0.5189550174506564
금리인상/NNG;결정할/VVX,-1,-0.1398538399985234,30,13,17,34,0.39204211421692525,0.5189550174506564
물가상승률/NNG;하락하/VVX,-1,-0.1398538399985234,30,13,17,31,0.39204211421692525,0.5189550174506564
개인소비지출/NNG;가격지수/NNG;상승해/VVX,-1,-0.1398538399985234,30,13,17,8,0.39204211421692525,0.5189550174506564
금리인상/NNG;신중해/VVX,-1,-0.1398538399985234,30,13,17,33,0.39204211421692525,0.5189550174506564
금리상승/NNG;나타나/VV,-1,-0.1398538399985234,30,13,17,32,0.39204211421692525,0.5189550174506564
경제회복/NNG;위해/VV,-1,-0.14006514479003251,39,17,22,30,0.4133234284019308,0.547361269314764
경기후퇴/NNG;따른/VV,-1,-0.14006514479003251,39,17,22,22,0.4133234284019308,0.547361269314764
소매판매/NNG;증가하/VVX,-1,-0.14147603407254117,48,21,27,56,0.4320936397512594,0.5738668409044817
인플레이션/NNG;잡/VV,-1,-0.14285221949495652,95,42,53,63,0.5056280387105996,0.673415927147205
성장률전망/NNG;낮추/VV,-1,-0.14372224515835996,21,9,12,12,0.36682772583919004,0.489424017667033
원자재가격/NNG;급락하/VVX,-1,-0.14372224515835996,21,9,12,17,0.36682772583919004,0.489424017667033
물가/NNG;안정됐/VVX,-1,-0.14372224515835996,21,9,12,17,0.36682772583919004,0.489424017667033
가계부채/NNG;따른/VV,-1,-0.14372224515835996,21,9,12,9,0.36682772583919004,0.489424017667033
기준금리인상/NNG;가능성/NNG;커지/VV,-1,-0.14372224515835996,21,9,12,11,0.36682772583919004,0.489424017667033
소비위축/NNG;따른/VV,-1,-0.14372224515835996,21,9,12,4,0.36682772583919004,0.489424017667033
소비/NNG;진작시/VVX,-1,-0.14372224515835996,21,9,12,22,0.36682772583919004,0.489424017667033
경제성장률/NNG;유지하/VVX,-1,-0.14372224515835996,21,9,12,23,0.36682772583919004,0.489424017667033
불안/NNG;있/VV,-1,-0.14372224515835996,21,9,12,23,0.36682772583919004,0.489424017667033
기준금리/NNG;내려도/VV,-1,-0.14372224515835996,21,9,12,5,0.36682772583919004,0.489424017667033
경제성장/NNG;유지하/VVX,-1,-0.14372224515835996,21,9,12,13,0.36682772583919004,0.489424017667033
안전자산선호심리/NNG;완화되/VVX,-1,-0.14372224515835996,21,9,12,22,0.36682772583919004,0.489424017667033
물가/NNG;올라갈/VV,-1,-0.14372224515835996,21,9,12,14,0.36682772583919004,0.489424017667033
불확실성/NNG;반영하/VVX,-1,-0.14372224515835996,21,9,12,22,0.36682772583919004,0.489424017667033
금리인하/NNG;단행하/VVX,-1,-0.14408022673082999,224,99,125,120,0.5627364774397473,0.7513554482123285
불확실성/NNG;확대되/VVX,-1,-0.14732771408655,129,57,72,127,0.5326533052853246,0.7159199975885001
금리/NNG;크/VA;상승하/VVX,-1,-0.14965051097855087,46,20,26,36,0.42331564258765647,0.5716701132155091
고용/NNG;늘리/VV,-1,-0.14965051097855087,46,20,26,38,0.42331564258765647,0.5716701132155091
신용등급/NNG;하향조정했/VVX,-1,-0.15001414575207572,37,16,21,23,0.4033137569594055,0.5450634193155286
금리인상/NNG;나섰/VV,-1,-0.15001414575207572,37,16,21,38,0.4033137569594055,0.5450634193155286
gdp/NNG;증가했/VVX,-1,-0.15015424714430836,55,24,31,62,0.44102503157397754,0.5961995302903457
시장금리/NNG;큰/VA;상승하/VVX,-1,-0.15015424714430836,55,24,31,23,0.44102503157397754,0.5961995302903457
금리/NNG;낮췄/VV,-1,-0.15015424714430836,55,24,31,42,0.44102503157397754,0.5961995302903457
수출/NNG;미치/VV,-1,-0.15086694828891778,64,28,36,56,0.4568421190840996,0.6184824543908979
정책금리/NNG;인상할/VVX,-1,-0.15157087789788048,118,52,66,100,0.521857343210775,0.7075192313723679
정책금리/NNG;올리/VV,-1,-0.15219251759951857,91,40,51,60,0.49497180305668853,0.6719224309127189
가계부채/NNG;증가하/VVX,-1,-0.1529287847212183,28,12,16,18,0.38014562053052087,0.5168242322689903
시장금리/NNG;상승압력/NNG;받/VV,-1,-0.1529287847212183,28,12,16,15,0.38014562053052087,0.5168242322689903
금리인하/NNG;가능성/NNG;높이/VV,-1,-0.1529287847212183,28,12,16,17,0.38014562053052087,0.5168242322689903
물가/NNG;상승세/NNG;지속될/VVX,-1,-0.1529287847212183,28,12,16,13,0.38014562053052087,0.5168242322689903
경기/NNG;바닥/NNG;다지/VV,-1,-0.1529287847212183,28,12,16,18,0.38014562053052087,0.5168242322689903
투자심리/NNG;줬/VV,-1,-0.1529287847212183,28,12,16,30,0.38014562053052087,0.5168242322689903
수입/NNG;의존하/VVX,-1,-0.1529287847212183,28,12,16,11,0.38014562053052087,0.5168242322689903
금리인상/NNG;중단할/VVX,-1,-0.1551619766769997,150,66,84,95,0.5385869168892683,0.7355866846671149
금리인상/NNG;신중할/VVX,-1,-0.1574259884631385,62,27,35,39,0.44949111085157223,0.6167557124578027
기준금리/NNG;내려야/VV,-1,-0.1574259884631385,62,27,35,39,0.44949111085157223,0.6167557124578027
자금이탈/NNG;따른/VV,-1,-0.15763777975972837,53,23,30,28,0.4328630476550505,0.5941978353483488
정책금리/NNG;인상했/VVX,-1,-0.15763777975972837,53,23,30,41,0.4328630476550505,0.5941978353483488
불확실성/NNG;제거되/VVX,-1,-0.15848223270536976,44,19,25,39,0.41412804895049915,0.569464729276132
리스크/NNG;해소되/VVX,-1,-0.1610122348672708,35,15,20,28,0.3926977388143491,0.5428048595389945
통화정책/NNG;완화/NNG;유지하/VVX,-1,-0.1610122348672708,35,15,20,19,0.3926977388143491,0.5428048595389945
성장/NNG;위해서/VV,-1,-0.1610122348672708,35,15,20,58,0.3926977388143491,0.5428048595389945
채권시장/NNG;강세/NNG;보였/VV,-1,-0.1610122348672708,35,15,20,35,0.3926977388143491,0.5428048595389945
산업생산/NNG;감소하/VVX,-1,-0.1610122348672708,35,15,20,19,0.3926977388143491,0.5428048595389945
소비/NNG;미치/VV,-1,-0.1610122348672708,35,15,20,24,0.3926977388143491,0.5428048595389945
원자재가격/NNG;하락/NNG;따른/VV,-1,-0.1610122348672708,35,15,20,50,0.3926977388143491,0.5428048595389945
기준금리/NNG;올려야/VV,-1,-0.1635535974538438,69,30,39,60,0.45743711612309657,0.6355970546892346
금리인하/NNG;단행해/VVX,-1,-0.1635535974538438,69,30,39,29,0.45743711612309657,0.6355970546892346
경기/NNG;상승하/VVX,-1,-0.16366773223149056,19,8,11,15,0.3512116617861629,0.48811390398663684
경제지표호조/NNG;힘입/VV,-1,-0.16366773223149056,19,8,11,19,0.3512116617861629,0.48811390398663684
금융시장변동성/NNG;확대될/VVX,-1,-0.16366773223149056,19,8,11,20,0.3512116617861629,0.48811390398663684
신용등급/NNG;떨어지/VV,-1,-0.16366773223149056,19,8,11,2,0.3512116617861629,0.48811390398663684
불안/NNG;키우/VV,-1,-0.16366773223149056,19,8,11,10,0.3512116617861629,0.48811390398663684
성장/NNG;예상했/VVX,-1,-0.16366773223149056,19,8,11,18,0.3512116617861629,0.48811390398663684
경기진작/NNG;위해/VV,-1,-0.16366773223149056,19,8,11,19,0.3512116617861629,0.48811390398663684
성장/NNG;예상하/VVX,-1,-0.16366773223149056,19,8,11,22,0.3512116617861629,0.48811390398663684
회복속도/NNG;둔화되/VVX,-1,-0.16366773223149056,19,8,11,15,0.3512116617861629,0.48811390398663684
소비자물가/NNG;이/VV,-1,-0.16366773223149056,19,8,11,9,0.3512116617861629,0.48811390398663684
경제지표/NNG;호조/NNG;보일/VV,-1,-0.16366773223149056,19,8,11,19,0.3512116617861629,0.48811390398663684
성장률/NNG;상향조정했/VVX,-1,-0.16366773223149056,19,8,11,15,0.3512116617861629,0.48811390398663684
기준금리/NNG;인상한/VAX;결정했/VVX,-1,-0.16366773223149056,19,8,11,6,0.3512116617861629,0.48811390398663684
경기/NNG;하/VV,-1,-0.16366773223149056,19,8,11,20,0.3512116617861629,0.48811390398663684
경기/NNG;미치/VV;부정적/VAX,-1,-0.16366773223149056,19,8,11,15,0.3512116617861629,0.48811390398663684
유가하락/NNG;견인했/VVX,-1,-0.16366773223149056,19,8,11,11,0.3512116617861629,0.48811390398663684
인플레이션/NNG;유발하/VVX,-1,-0.16366773223149056,19,8,11,18,0.3512116617861629,0.48811390398663684
경기/NNG;유지하/VVX,-1,-0.16366773223149056,19,8,11,26,0.3512116617861629,0.48811390398663684
경제/NNG;성장세/NNG;유지하/VVX,-1,-0.16366773223149056,19,8,11,5,0.3512116617861629,0.48811390398663684
안전자산선호현상/NNG;약화시/VVX,-1,-0.16366773223149056,19,8,11,7,0.3512116617861629,0.48811390398663684
금리/NNG;상승세/NNG;보이/VV,-1,-0.16435579466042083,60,26,34,52,0.4418755758546882,0.614986922215608
실물경제/NNG;미칠/VV,-1,-0.16563119022205963,51,22,29,25,0.42436556825525124,0.5921664948329624
지준율인상/NNG;따른/VV,-1,-0.16796917931364586,26,11,15,22,0.36718094450766786,0.5148383374246763
경제상황/NNG;악화되/VVX,-1,-0.16796917931364586,26,11,15,5,0.36718094450766786,0.5148383374246763
주택시장/NNG;안정되/VVX,-1,-0.16796917931364586,26,11,15,6,0.36718094450766786,0.5148383374246763
금리/NNG;하락세/NNG;이어졌/VV,-1,-0.16796917931364586,26,11,15,28,0.36718094450766786,0.5148383374246763
금리상승/NNG;견인하/VVX,-1,-0.16796917931364586,26,11,15,16,0.36718094450766786,0.5148383374246763
양적완화/NNG;하/VV,-1,-0.1680708936972849,42,18,24,32,0.40448046042656727,0.567256036918518
소비자물가지수/NNG;상승했/VVX,-1,-0.1700275204308188,67,29,38,42,0.4503135867509152,0.6340808023660892
성장률/NNG;끌어올리/VV,-1,-0.17169477344114237,58,25,33,44,0.43397603506780713,0.6131767812446728
양적완화/NNG;실시하/VVX,-1,-0.17326986586373205,33,14,19,35,0.38136890304915166,0.540597522128409
금리상승/NNG;억제하/VVX,-1,-0.17326986586373205,33,14,19,16,0.38136890304915166,0.540597522128409
흑자/NNG;기록할/VVX,-1,-0.17326986586373205,33,14,19,24,0.38136890304915166,0.540597522128409
신용경색/NNG;심화되/VVX,-1,-0.17326986586373205,33,14,19,11,0.38136890304915166,0.540597522128409
장단기금리차/NNG;확대될/VVX,-1,-0.17326986586373205,33,14,19,31,0.38136890304915166,0.540597522128409
시장금리/NNG;상승했/VVX,-1,-0.17326986586373205,33,14,19,31,0.38136890304915166,0.540597522128409
기준금리/NNG;인상한/VAX;있/VV,-1,-0.17326986586373205,33,14,19,15,0.38136890304915166,0.540597522128409
금리인하/NNG;이어질/VV,-1,-0.1741993968709611,49,21,28,14,0.41549987455445075,0.5901079236661135
금리인하기대/NNG;선반영하/VVX,-1,-0.1741993968709611,49,21,28,63,0.41549987455445075,0.5901079236661135
경제/NNG;둔화될/VVX,-1,-0.17480323508709883,99,43,56,62,0.48921579300946116,0.6956671578123914
금리인상/NNG;가능성/NNG;부각되/VVX,-1,-0.17683879085544807,65,28,37,55,0.4429436661750446,0.6325172567699263
경기부양책/NNG;나올/VV,-1,-0.1785392229615671,40,17,23,24,0.39431111597790924,0.5650497441852815
견조한/VAX;성장세/NNG;이/VV,-1,-0.1785392229615671,40,17,23,27,0.39431111597790924,0.5650497441852815
금리급등/NNG;따른/VV,-1,-0.17983987730567386,97,42,55,80,0.4838347622907146,0.6952018286598988
물가/NNG;상승하/VVX,-1,-0.17985731184124365,159,69,90,113,0.5245995963334771,0.7538022432151885
금융시장/NNG;안정되/VVX,-1,-0.1811909517143393,72,31,41,67,0.4512718655220694,0.6502256137686716
성장세회복/NNG;이어지/VV,-1,-0.1811909517143393,72,31,41,47,0.4512718655220694,0.6502256137686716
금리인상/NNG;단행했/VVX,-1,-0.18247552108865095,201,87,114,100,0.5321851386992107,0.7688496897581931
경기/NNG;살리/VV,-1,-0.18334262934569523,127,55,72,107,0.5066223622670357,0.7332323039558876
지준율/NNG;인상하/VVX,-1,-0.18341997862564163,47,20,27,45,0.40622706171157474,0.5880246699362938
소매판매/NNG;증가했/VVX,-1,-0.18341997862564163,47,20,27,52,0.40622706171157474,0.5880246699362938
경제/NNG;개선되/VVX,-1,-0.18505389231265368,95,41,54,110,0.4782982179396034,0.6946934542287414
금리인상/NNG;시점/NNG;앞당겨질/VV,-1,-0.18554071374435777,24,10,14,15,0.35286384313120106,0.5130256665764069
듀레이션확대/NNG;지속하/VVX,-1,-0.18554071374435777,24,10,14,27,0.35286384313120106,0.5130256665764069
경기회복/NNG;확인하/VVX,-1,-0.18554071374435777,24,10,14,17,0.35286384313120106,0.5130256665764069
실업률/NNG;상승할/VVX,-1,-0.18554071374435777,24,10,14,13,0.35286384313120106,0.5130256665764069
성장률/NNG;개선되/VVX,-1,-0.18554071374435777,24,10,14,25,0.35286384313120106,0.5130256665764069
물가/NNG;하회하/VVX,-1,-0.18554071374435777,24,10,14,21,0.35286384313120106,0.5130256665764069
금리인상/NNG;자제할/VVX,-1,-0.18554071374435777,24,10,14,11,0.35286384313120106,0.5130256665764069
불확실성/NNG;사라지/VV,-1,-0.18554071374435777,24,10,14,17,0.35286384313120106,0.5130256665764069
유동성/NNG;위기/NNG;겪/VV,-1,-0.18706150958230983,31,13,18,24,0.36918965059464537,0.5384540703638373
불안요인/NNG;잠재해/VVX,-1,-0.18706150958230983,31,13,18,11,0.36918965059464537,0.5384540703638373
투자심리/NNG;살아나/VV,-1,-0.18706150958230983,31,13,18,21,0.36918965059464537,0.5384540703638373
소비/NNG;둔화되/VVX,-1,-0.18706150958230983,31,13,18,24,0.36918965059464537,0.5384540703638373
기준금리인상/NNG;가능성/NNG;열/VV,-1,-0.18706150958230983,31,13,18,27,0.36918965059464537,0.5384540703638373
수출/NNG;부진했/VVX,-1,-0.18706150958230983,31,13,18,25,0.36918965059464537,0.5384540703638373
잠재성장률/NNG;하회하/VVX,-1,-0.18706150958230983,31,13,18,27,0.36918965059464537,0.5384540703638373
불안/NNG;완화되/VVX,-1,-0.18787300071491597,70,30,40,50,0.44414848297327125,0.6488692557344705
물가상승/NNG;억제하/VVX,-1,-0.18787300071491597,70,30,40,52,0.44414848297327125,0.6488692557344705
금리인상/NNG;하/VV;않/VX,-1,-0.18787300071491597,70,30,40,53,0.44414848297327125,0.6488692557344705
불안요인/NNG;작용할/VVX,-1,-0.18791820154428607,86,37,49,82,0.46607625744084685,0.6809679233313756
경기/NNG;둔화시/VVX,-1,-0.1885866445213623,17,7,10,18,0.3330137243595981,0.4872290774547158
불확실성/NNG;확산되/VVX,-1,-0.1885866445213623,17,7,10,17,0.3330137243595981,0.4872290774547158
소비자물가/NNG;기록하/VVX,-1,-0.1885866445213623,17,7,10,23,0.3330137243595981,0.4872290774547158
금리/NNG;인하한/VAX;있/VV,-1,-0.1885866445213623,17,7,10,5,0.3330137243595981,0.4872290774547158
경제지표/NNG;악화하/VVX,-1,-0.1885866445213623,17,7,10,14,0.3330137243595981,0.4872290774547158
기준금리/NNG;올라가/VV,-1,-0.1885866445213623,17,7,10,15,0.3330137243595981,0.4872290774547158
기준금리인하/NNG;예상된/VVX,-1,-0.1885866445213623,17,7,10,12,0.3330137243595981,0.4872290774547158
고용/NNG;감소해/VVX,-1,-0.1885866445213623,17,7,10,12,0.3330137243595981,0.4872290774547158
인플레이션/NNG;둔화되/VVX,-1,-0.1885866445213623,17,7,10,13,0.3330137243595981,0.4872290774547158
경제성장률/NNG;상승할/VVX,-1,-0.1885866445213623,17,7,10,5,0.3330137243595981,0.4872290774547158
금리인상행진/NNG;중단할/VVX,-1,-0.1885866445213623,17,7,10,11,0.3330137243595981,0.4872290774547158
금리/NNG;내려서/VV,-1,-0.1885866445213623,17,7,10,19,0.3330137243595981,0.4872290774547158
기준금리/NNG;올려도/VV,-1,-0.1885866445213623,17,7,10,19,0.3330137243595981,0.4872290774547158
기준금리인상/NNG;지속할/VVX,-1,-0.1885866445213623,17,7,10,4,0.3330137243595981,0.4872290774547158
양적완화/NNG;나올/VV,-1,-0.1885866445213623,17,7,10,22,0.3330137243595981,0.4872290774547158
안전자산선호/NNG;강화시/VVX,-1,-0.1885866445213623,17,7,10,15,0.3330137243595981,0.4872290774547158
생산/NNG;늘릴/VV,-1,-0.1885866445213623,17,7,10,7,0.3330137243595981,0.4872290774547158
경기둔화/NNG;가능성/NNG;커지/VV,-1,-0.1885866445213623,17,7,10,6,0.3330137243595981,0.4872290774547158
큰/VA;금리/NNG;상승세/NNG;보임/VV,-1,-0.1885866445213623,17,7,10,10,0.3330137243595981,0.4872290774547158
기준금리/NNG;유지됐/VVX,-1,-0.1885866445213623,17,7,10,12,0.3330137243595981,0.4872290774547158
안전자산선호현상/NNG;강화될/VVX,-1,-0.1885866445213623,17,7,10,10,0.3330137243595981,0.4872290774547158
경기/NNG;꺾일/VV,-1,-0.1885866445213623,17,7,10,6,0.3330137243595981,0.4872290774547158
시장금리하락/NNG;견인하/VVX,-1,-0.1885866445213623,17,7,10,18,0.3330137243595981,0.4872290774547158
금리하락압력/NNG;작용했/VVX,-1,-0.1885866445213623,17,7,10,10,0.3330137243595981,0.4872290774547158
고용지표/NNG;악화되/VVX,-1,-0.1885866445213623,17,7,10,3,0.3330137243595981,0.4872290774547158
금리동결/NNG;인해/VV,-1,-0.1885866445213623,17,7,10,22,0.3330137243595981,0.4872290774547158
경제/NNG;호전되/VVX,-1,-0.1885866445213623,17,7,10,21,0.3330137243595981,0.4872290774547158
금리/NNG;큰/VA;하락하/VVX,-1,-0.18872438672856218,132,57,75,104,0.5059615347774631,0.7404786010651911
과잉유동성/NNG;흡수하/VVX,-1,-0.19004012154480865,38,16,22,14,0.38354363068081926,0.5628518024544539
물가/NNG;자극하/VVX,-1,-0.19004012154480865,38,16,22,22,0.38354363068081926,0.5628518024544539
침체/NNG;빠져/VV,-1,-0.19004012154480865,38,16,22,27,0.38354363068081926,0.5628518024544539
금리/NNG;하락세/NNG;제한되/VVX,-1,-0.19004012154480865,38,16,22,30,0.38354363068081926,0.5628518024544539
경제/NNG;회복세/NNG;보이/VV,-1,-0.19081434499608996,116,50,66,98,0.4937608555928046,0.7257601141904537
소비/NNG;늘/VV,-1,-0.19112056060384242,77,33,44,41,0.4523106179412881,0.665256329166925
기준금리/NNG;올리/VV;않/VX,-1,-0.19160575091612775,61,26,35,76,0.427397653298411,0.6292473846187894
정책금리/NNG;동결했/VVX,-1,-0.1933864701876321,45,19,26,30,0.39650053741364094,0.5859193476211128
물가/NNG;올랐/VV,-1,-0.1933864701876321,45,19,26,23,0.39650053741364094,0.5859193476211128
금리/NNG;낮출/VV,-1,-0.1941522379907139,144,62,82,117,0.5083970481734578,0.752467133202904
금리인상/NNG;시작될/VVX,-1,-0.1966516549799483,52,22,30,52,0.4083296786369203,0.6075059707680625
성장세/NNG;지속할/VVX,-1,-0.1966516549799483,52,22,30,23,0.4083296786369203,0.6075059707680625
경제지표/NNG;부진하/VVX,-1,-0.1976682897906623,75,32,43,64,0.4454309219547644,0.6641067227320052
콜금리/NNG;동결될/VVX,-1,-0.199289629858866,105,45,60,30,0.4788478687888746,0.7163409166705955
시장금리/NNG;큰/VA;하락하/VVX,-1,-0.19964030066266603,59,25,34,28,0.41918204666067577,0.6275405456083804
물가/NNG;안정돼/VVX,-1,-0.20227156475638874,66,28,38,38,0.42915615263279305,0.6460021048131498
성장/NNG;미치/VV,-1,-0.2027520185238667,29,12,17,24,0.3559797091249965,0.5363874336784884
경제/NNG;악화되/VVX,-1,-0.2027520185238667,29,12,17,20,0.3559797091249965,0.5363874336784884
듀레이션/NNG;줄이/VV,-1,-0.2027520185238667,29,12,17,47,0.3559797091249965,0.5363874336784884
금리/NNG;상승세/NNG;이/VV,-1,-0.2027520185238667,29,12,17,46,0.3559797091249965,0.5363874336784884
수익성/NNG;악화되/VVX,-1,-0.2027520185238667,29,12,17,37,0.3559797091249965,0.5363874336784884
적자/NNG;냈/VV,-1,-0.2027520185238667,29,12,17,15,0.3559797091249965,0.5363874336784884
큰/VA;금리/NNG;하락세/NNG;보였/VV,-1,-0.2027520185238667,29,12,17,21,0.3559797091249965,0.5363874336784884
성장모멘텀/NNG;약화되/VVX,-1,-0.2027520185238667,29,12,17,21,0.3559797091249965,0.5363874336784884
성장잠재력/NNG;높이/VV,-1,-0.2027520185238667,29,12,17,31,0.3559797091249965,0.5363874336784884
경제지표/NNG;부진할/VVX,-1,-0.2027520185238667,29,12,17,20,0.3559797091249965,0.5363874336784884
물가/NNG;올라/VV,-1,-0.20276658912271817,36,15,21,37,0.3720826222322499,0.560668199875205
기준금리인하/NNG;단행할/VVX,-1,-0.20276658912271817,36,15,21,25,0.3720826222322499,0.560668199875205
콜금리/NNG;동결했/VVX,-1,-0.20276658912271817,36,15,21,23,0.3720826222322499,0.560668199875205
금리상승/NNG;이어지/VV,-1,-0.20276658912271817,36,15,21,31,0.3720826222322499,0.560668199875205
금리상승/NNG;이어질/VV,-1,-0.20276658912271817,36,15,21,37,0.3720826222322499,0.560668199875205
자산매입/NNG;줄이/VV,-1,-0.2042127287295148,43,18,25,48,0.3862640924154149,0.5837945307763702
금리인상/NNG;반대하/VVX,-1,-0.2042127287295148,43,18,25,33,0.3862640924154149,0.5837945307763702
유가하락/NNG;부추겼/VV,-1,-0.2061568954658589,50,21,29,24,0.3990290786234068,0.6055381293024427
기준금리/NNG;올렸/VV,-1,-0.20640877021836035,145,62,83,116,0.5001763868709006,0.7594311742349651
금리동결/NNG;이어지/VV,-1,-0.2064582361653624,22,9,13,15,0.3367936209803135,0.5114155502400739
인플레이션/NNG;밑돌/VV,-1,-0.2064582361653624,22,9,13,17,0.3367936209803135,0.5114155502400739
경기둔화/NNG;예상되/VVX,-1,-0.2064582361653624,22,9,13,17,0.3367936209803135,0.5114155502400739
연방기금금리/NNG;인상될/VVX,-1,-0.2064582361653624,22,9,13,9,0.3367936209803135,0.5114155502400739
실업률/NNG;높/VA;유지하/VVX,-1,-0.2064582361653624,22,9,13,13,0.3367936209803135,0.5114155502400739
금리인상/NNG;대응할/VVX,-1,-0.2064582361653624,22,9,13,21,0.3367936209803135,0.5114155502400739
경기/NNG;우려/NNG;커지/VV,-1,-0.2064582361653624,22,9,13,20,0.3367936209803135,0.5114155502400739
금리/NNG;폭등하/VVX,-1,-0.2064582361653624,22,9,13,15,0.3367936209803135,0.5114155502400739
성장세/NNG;둔화된/VVX,-1,-0.2064582361653624,22,9,13,10,0.3367936209803135,0.5114155502400739
고용/NNG;줄/VV,-1,-0.2064582361653624,22,9,13,8,0.3367936209803135,0.5114155502400739
내수회복/NNG;힘입/VV,-1,-0.2064582361653624,22,9,13,7,0.3367936209803135,0.5114155502400739
성장/NNG;하방위험/NNG;남/VV,-1,-0.2064582361653624,22,9,13,25,0.3367936209803135,0.5114155502400739
흑자/NNG;유지하/VVX,-1,-0.2064582361653624,22,9,13,27,0.3367936209803135,0.5114155502400739
신용등급/NNG;강등이/VVX,-1,-0.2064582361653624,22,9,13,5,0.3367936209803135,0.5114155502400739
내수부진/NNG;지속되/VVX,-1,-0.2064582361653624,22,9,13,22,0.3367936209803135,0.5114155502400739
근원인플레이션율/NNG;상승하/VVX,-1,-0.2064582361653624,22,9,13,10,0.3367936209803135,0.5114155502400739
경기둔화우려/NNG;지속되/VVX,-1,-0.2064582361653624,22,9,13,24,0.3367936209803135,0.5114155502400739
변동성/NNG;줄/VV,-1,-0.2064582361653624,22,9,13,16,0.3367936209803135,0.5114155502400739
양적완화/NNG;따른/VV,-1,-0.20654489487331584,138,59,79,175,0.4967689780730533,0.7544719356280672
마이너스/NNG;돌아섰/VV,-1,-0.2081719910448232,57,24,33,22,0.4106400963673959,0.625785325393316
금리/NNG;인하하/VVX;않/VX,-1,-0.2105692354975447,108,46,62,54,0.47394305238836604,0.7258816671484314
경제지표/NNG;호조/NNG;보이/VV,-1,-0.21106875068447306,129,55,74,115,0.48866919851490964,0.7492180992172524
금리/NNG;오를/VV,-1,-0.21272518820748965,351,149,202,341,0.5140184619036526,0.7908188243774289
유동성/NNG;공급해/VVX,-1,-0.21500458824479174,92,39,53,66,0.45554856362494994,0.7042157997762392
유동성/NNG;떨어지/VV,-1,-0.2160387898078221,41,17,24,35,0.37544940573257457,0.5816525918735664
시장금리/NNG;오를/VV,-1,-0.2160387898078221,41,17,24,29,0.37544940573257457,0.5816525918735664
경제/NNG;회복하/VVX,-1,-0.21638842765660882,48,20,28,79,0.38928724427023753,0.6035325576563005
경기회복/NNG;기대하/VVX,-1,-0.21638842765660882,48,20,28,28,0.38928724427023753,0.6035325576563005
금리/NNG;낮추/VV,-1,-0.21685516389790416,288,122,166,240,0.5106793206141468,0.7925081929898398
신용스프레드/NNG;축소될/VVX,-1,-0.21696575879227886,34,14,20,24,0.3598077955827864,0.5585046149398035
금리/NNG;상승세/NNG;재개될/VVX,-1,-0.21696575879227886,34,14,20,59,0.3598077955827864,0.5585046149398035
금리/NNG;상승세/NNG;제한되/VVX,-1,-0.21696575879227886,34,14,20,37,0.3598077955827864,0.5585046149398035
임금/NNG;오르/VV,-1,-0.21696575879227886,34,14,20,27,0.3598077955827864,0.5585046149398035
경기부진/NNG;지속되/VVX,-1,-0.21696575879227886,34,14,20,27,0.3598077955827864,0.5585046149398035
양적완화/NNG;통한/VV,-1,-0.21696575879227886,34,14,20,27,0.3598077955827864,0.5585046149398035
양적완화/NNG;지속하/VVX,-1,-0.21696575879227886,34,14,20,24,0.3598077955827864,0.5585046149398035
기준금리/NNG;인하한/VVX,-1,-0.21725804587444908,55,23,32,61,0.4017437730035687,0.6239812436307448
정책금리/NNG;동결할/VVX,-1,-0.21827402954841324,62,26,36,23,0.41305772858979417,0.6429225501540938
경제/NNG;회복될/VVX,-1,-0.21924485382046222,69,29,40,55,0.423381099705409,0.6603347617169073
금리인하/NNG;가능성/NNG;열려/VV,-1,-0.21924485382046222,69,29,40,60,0.423381099705409,0.6603347617169073
금리/NNG;크/VA;하락하/VVX,-1,-0.22007306462022203,76,32,44,70,0.432820979789569,0.6762326284401068
경제지표개선/NNG;따른/VV,-1,-0.2208368442872446,27,11,16,23,0.3414994857374691,0.5344099142417414
채권시장/NNG;부담/NNG;되/VV,-1,-0.2208368442872446,27,11,16,20,0.3414994857374691,0.5344099142417414
소비/NNG;하/VV,-1,-0.2208368442872446,27,11,16,15,0.3414994857374691,0.5344099142417414
금리/NNG;인하함/VVX,-1,-0.2208368442872446,27,11,16,14,0.3414994857374691,0.5344099142417414
인플레이션/NNG;통제하/VVX,-1,-0.2208368442872446,27,11,16,18,0.3414994857374691,0.5344099142417414
경제/NNG;침체/NNG;빠지/VV;않/VX,-1,-0.2208368442872446,27,11,16,13,0.3414994857374691,0.5344099142417414
듀레이션확대/NNG;유지하/VVX,-1,-0.2208368442872446,27,11,16,11,0.3414994857374691,0.5344099142417414
양적완화/NNG;종료되/VVX,-1,-0.2208368442872446,27,11,16,42,0.3414994857374691,0.5344099142417414
물가/NNG;두/VV,-1,-0.2208368442872446,27,11,16,15,0.3414994857374691,0.5344099142417414
수출/NNG;감소해/VVX,-1,-0.2208368442872446,27,11,16,6,0.3414994857374691,0.5344099142417414
양적완화정책/NNG;시행하/VVX,-1,-0.2208368442872446,27,11,16,7,0.3414994857374691,0.5344099142417414
경기안정/NNG;위한/VV,-1,-0.2208368442872446,27,11,16,16,0.3414994857374691,0.5344099142417414
경제회복/NNG;지원하/VVX,-1,-0.22090857603862546,15,6,9,6,0.3110589688864204,0.48684713522897344
완화정책/NNG;펴/VV,-1,-0.22090857603862546,15,6,9,10,0.3110589688864204,0.48684713522897344
리스크/NNG;대비해/VVX,-1,-0.22090857603862546,15,6,9,30,0.3110589688864204,0.48684713522897344
금리/NNG;상승할/VVX;매수/NNG,-1,-0.22090857603862546,15,6,9,11,0.3110589688864204,0.48684713522897344
경기침체/NNG;우려/NNG;완화시/VVX,-1,-0.22090857603862546,15,6,9,5,0.3110589688864204,0.48684713522897344
물가안정/NNG;책임지/VV,-1,-0.22090857603862546,15,6,9,11,0.3110589688864204,0.48684713522897344
불확실성/NNG;사라진/VV,-1,-0.22090857603862546,15,6,9,12,0.3110589688864204,0.48684713522897344
유가하락/NNG;의한/VV,-1,-0.22090857603862546,15,6,9,10,0.3110589688864204,0.48684713522897344
금융위기/NNG;이전/NNG;회복했/VVX,-1,-0.22090857603862546,15,6,9,22,0.3110589688864204,0.48684713522897344
금융위기/NNG;지속되/VVX,-1,-0.22090857603862546,15,6,9,5,0.3110589688864204,0.48684713522897344
금융시장/NNG;안정세/NNG;보이/VV,-1,-0.22090857603862546,15,6,9,3,0.3110589688864204,0.48684713522897344
정책금리/NNG;낮/VA;수준이/VVX,-1,-0.22090857603862546,15,6,9,6,0.3110589688864204,0.48684713522897344
듀레이션/NNG;살펴본/VV,-1,-0.22090857603862546,15,6,9,5,0.3110589688864204,0.48684713522897344
생산자물가지수/NNG;상승했/VVX,-1,-0.22090857603862546,15,6,9,18,0.3110589688864204,0.48684713522897344
금리상승/NNG;지속되/VVX,-1,-0.22090857603862546,15,6,9,20,0.3110589688864204,0.48684713522897344
금리인하/NNG;가능성/NNG;높였/VV,-1,-0.22090857603862546,15,6,9,8,0.3110589688864204,0.48684713522897344
고용률/NNG;상승하/VVX,-1,-0.22090857603862546,15,6,9,20,0.3110589688864204,0.48684713522897344
금리상승/NNG;키웠/VV,-1,-0.22090857603862546,15,6,9,11,0.3110589688864204,0.48684713522897344
경기회복/NNG;예상하/VVX,-1,-0.22090857603862546,15,6,9,9,0.3110589688864204,0.48684713522897344
자산/NNG;매입할/VVX,-1,-0.22090857603862546,15,6,9,17,0.3110589688864204,0.48684713522897344
유동성/NNG;제공하/VVX,-1,-0.22090857603862546,15,6,9,17,0.3110589688864204,0.48684713522897344
통화정책/NNG;완화해/VVX,-1,-0.22090857603862546,15,6,9,14,0.3110589688864204,0.48684713522897344
성장률/NNG;상향조정하/VVX,-1,-0.22090857603862546,15,6,9,24,0.3110589688864204,0.48684713522897344
시장금리상승/NNG;압력/NNG;작용할/VVX,-1,-0.22090857603862546,15,6,9,8,0.3110589688864204,0.48684713522897344
성장률/NNG;낮췄/VV,-1,-0.22090857603862546,15,6,9,21,0.3110589688864204,0.48684713522897344
시장금리/NNG;올라갈/VV,-1,-0.22090857603862546,15,6,9,13,0.3110589688864204,0.48684713522897344
성장/NNG;전망했/VVX,-1,-0.22090857603862546,15,6,9,12,0.3110589688864204,0.48684713522897344
임금/NNG;상승했/VVX,-1,-0.22090857603862546,15,6,9,11,0.3110589688864204,0.48684713522897344
유동성/NNG;나타내/VV,-1,-0.22090857603862546,15,6,9,4,0.3110589688864204,0.48684713522897344
민간소비/NNG;회복되/VVX,-1,-0.22090857603862546,15,6,9,7,0.3110589688864204,0.48684713522897344
기준금리인하/NNG;가능성/NNG;배제하/VVX,-1,-0.22090857603862546,15,6,9,8,0.3110589688864204,0.48684713522897344
경기부양/NNG;나설/VV,-1,-0.22114667623392015,90,38,52,94,0.4493635114229367,0.7036633332295882
경기부양책/NNG;내놓/VV,-1,-0.22282221258607726,144,61,83,93,0.4880959623959377,0.7670111071348077
물가/NNG;오르/VV,-1,-0.22334429578183312,201,85,116,202,0.501985859256159,0.7897046392231752
신용스프레드/NNG;확대되/VVX,-1,-0.2260989905634686,116,49,67,92,0.46974377534683553,0.743278848794096
금리/NNG;하락세/NNG;예상된/VVX,-1,-0.22696571281036748,53,22,31,18,0.3924605102964966,0.6221276266464288
안전자산선호/NNG;약화되/VVX,-1,-0.22696571281036748,53,22,31,56,0.3924605102964966,0.6221276266464288
고용/NNG;증가하/VVX,-1,-0.22698019879971387,60,25,35,56,0.40454295323084816,0.6413002610386459
듀레이션/NNG;유지하/VVX,-1,-0.22698019879971387,60,25,35,40,0.40454295323084816,0.6413002610386459
경기/NNG;악화될/VVX,-1,-0.22717773948780273,67,28,39,48,0.41551309999097064,0.6589648239484283
금리/NNG;하회하/VVX,-1,-0.22738781899820126,74,31,43,70,0.4255128976487768,0.6751223206477999
소비자물가/NNG;올라/VV,-1,-0.22745061119368426,46,19,27,19,0.37905382819694744,0.6014895480094574
경기/NNG;회복하/VVX,-1,-0.22745061119368426,46,19,27,40,0.37905382819694744,0.6014895480094574
금리인상/NNG;시작되/VVX,-1,-0.22745061119368426,46,19,27,56,0.37905382819694744,0.6014895480094574
금리인상/NNG;유지할/VVX,-1,-0.22745061119368426,46,19,27,38,0.37905382819694744,0.6014895480094574
국제유가하락/NNG;따른/VV,-1,-0.22745061119368426,46,19,27,55,0.37905382819694744,0.6014895480094574
내수/NNG;부양/NNG;위한/VV,-1,-0.22903881876941,39,16,23,21,0.3639728013847998,0.5794954590612115
성장세/NNG;유지되/VVX,-1,-0.22903881876941,39,16,23,31,0.3639728013847998,0.5794954590612115
기준금리인상/NNG;위한/VV,-1,-0.22903881876941,39,16,23,57,0.3639728013847998,0.5794954590612115
경기둔화/NNG;우려하/VVX,-1,-0.22903881876941,39,16,23,15,0.3639728013847998,0.5794954590612115
수입/NNG;늘/VV,-1,-0.22903881876941,39,16,23,41,0.3639728013847998,0.5794954590612115
기준금리/NNG;위한/VV,-1,-0.22903881876941,39,16,23,40,0.3639728013847998,0.5794954590612115
금리동결/NNG;지속될/VVX,-1,-0.22903881876941,39,16,23,35,0.3639728013847998,0.5794954590612115
소비자물가/NNG;오르/VV,-1,-0.22903881876941,39,16,23,20,0.3639728013847998,0.5794954590612115
민간소비/NNG;증가하/VVX,-1,-0.23193748253604296,20,8,12,19,0.3183923453803633,0.5100352007558776
흑자/NNG;이/VV,-1,-0.23193748253604296,20,8,12,12,0.3183923453803633,0.5100352007558776
주택가격/NNG;상승했/VVX,-1,-0.23193748253604296,20,8,12,32,0.3183923453803633,0.5100352007558776
기준금리/NNG;인하한/VAX;이/VV,-1,-0.23193748253604296,20,8,12,12,0.3183923453803633,0.5100352007558776
물가상승압력/NNG;완화시/VVX,-1,-0.23193748253604296,20,8,12,13,0.3183923453803633,0.5100352007558776
불안/NNG;부각되/VVX,-1,-0.23193748253604296,20,8,12,13,0.3183923453803633,0.5100352007558776
소비/NNG;둔화될/VVX,-1,-0.23193748253604296,20,8,12,18,0.3183923453803633,0.5100352007558776
성장/NNG;견인했/VVX,-1,-0.23193748253604296,20,8,12,17,0.3183923453803633,0.5100352007558776
금리인하/NNG;확신하/VVX,-1,-0.23193748253604296,20,8,12,18,0.3183923453803633,0.5100352007558776
침체/NNG;진입했/VVX,-1,-0.23193748253604296,20,8,12,2,0.3183923453803633,0.5100352007558776
경기침체/NNG;빠져/VV,-1,-0.23193748253604296,20,8,12,6,0.3183923453803633,0.5100352007558776
금리/NNG;내려왔/VV,-1,-0.23193748253604296,20,8,12,12,0.3183923453803633,0.5100352007558776
경기부진/NNG;이어지/VV,-1,-0.23193748253604296,20,8,12,19,0.3183923453803633,0.5100352007558776
경기/NNG;위축시/VVX,-1,-0.23193748253604296,20,8,12,21,0.3183923453803633,0.5100352007558776
금리인상중단/NNG;시사하/VVX,-1,-0.23193748253604296,20,8,12,10,0.3183923453803633,0.5100352007558776
소비/NNG;감소할/VVX,-1,-0.23193748253604296,20,8,12,6,0.3183923453803633,0.5100352007558776
양적완화/NNG;확대할/VVX,-1,-0.23193748253604296,20,8,12,21,0.3183923453803633,0.5100352007558776
하방압력/NNG;받/VV,-1,-0.23295908668103193,32,13,19,36,0.3465658849019979,0.556365851730255
변동성/NNG;높이/VV,-1,-0.23295908668103193,32,13,19,31,0.3465658849019979,0.556365851730255
금리인하/NNG;결정했/VVX,-1,-0.23295908668103193,32,13,19,13,0.3465658849019979,0.556365851730255
금리인상/NNG;멈출/VV,-1,-0.23295908668103193,32,13,19,28,0.3465658849019979,0.556365851730255
리스크/NNG;줄이/VV,-1,-0.23295908668103193,32,13,19,59,0.3465658849019979,0.556365851730255
신용경색/NNG;해소하/VVX,-1,-0.23295908668103193,32,13,19,11,0.3465658849019979,0.556365851730255
금융위기/NNG;따른/VV,-1,-0.23297844970231374,100,42,58,60,0.45182968598629,0.7253826846264055
물가/NNG;오를/VV,-1,-0.23442084705278532,126,53,73,100,0.47065754379523833,0.7579165340860611
동결/NNG;예상하/VVX,-1,-0.2394702462577737,44,18,26,34,0.36826859379097504,0.599408949753532
인플레이션/NNG;발생할/VVX,-1,-0.24200497289759115,25,10,15,17,0.3254258403196012,0.5325315517596947
경제활성화/NNG;위해/VV,-1,-0.24200497289759115,25,10,15,33,0.3254258403196012,0.5325315517596947
금리인하기대/NNG;유지되/VVX,-1,-0.24200497289759115,25,10,15,72,0.3254258403196012,0.5325315517596947
마이너스/NNG;보일/VV,-1,-0.24200497289759115,25,10,15,17,0.3254258403196012,0.5325315517596947
금리인상/NNG;우려/NNG;커지/VV,-1,-0.24200497289759115,25,10,15,12,0.3254258403196012,0.5325315517596947
가계부채/NNG;증가세/NNG;점검해/VVX,-1,-0.24200497289759115,25,10,15,15,0.3254258403196012,0.5325315517596947
정책금리/NNG;인하했/VVX,-1,-0.24200497289759115,25,10,15,19,0.3254258403196012,0.5325315517596947
투자심리/NNG;회복시/VVX,-1,-0.24200497289759115,25,10,15,25,0.3254258403196012,0.5325315517596947
정책금리/NNG;결정하/VVX,-1,-0.24200497289759115,25,10,15,13,0.3254258403196012,0.5325315517596947
원자재가격/NNG;상승/NNG;따른/VV,-1,-0.24310128025893152,70,29,41,75,0.41014061748042485,0.6727238898647484
금리상승/NNG;작용할/VVX,-1,-0.24310128025893152,70,29,41,48,0.41014061748042485,0.6727238898647484
침체/NNG;지속되/VVX,-1,-0.24437172494532933,63,26,37,32,0.3988944609015731,0.6560457088768384
기준금리/NNG;낮출/VV,-1,-0.2483061311909972,108,45,63,63,0.4485444875265564,0.7439027133094783
금리인하/NNG;예상되/VVX,-1,-0.249798453107692,75,31,44,38,0.41285918223239454,0.6868993585063331
수입/NNG;증가하/VVX,-1,-0.25117191758113677,30,12,18,31,0.33215963035811397,0.5542549331128558
시장금리상승/NNG;따른/VV,-1,-0.25117191758113677,30,12,18,17,0.33215963035811397,0.5542549331128558
수입/NNG;늘어난/VV,-1,-0.25117191758113677,30,12,18,19,0.33215963035811397,0.5542549331128558
금리인상/NNG;가능성/NNG;따른/VV,-1,-0.25117191758113677,30,12,18,36,0.33215963035811397,0.5542549331128558
경제/NNG;나아질/VV,-1,-0.25117191758113677,30,12,18,10,0.33215963035811397,0.5542549331128558
물가상승압력/NNG;완화될/VVX,-1,-0.25117191758113677,30,12,18,20,0.33215963035811397,0.5542549331128558
소비자물가지수/NNG;상승하/VVX,-1,-0.2526028677861065,42,17,25,47,0.3568590432038928,0.5972899326064985
금리인하/NNG;가능성/NNG;배제할/VVX,-1,-0.2537243474195531,61,25,36,68,0.3901003590462329,0.6544923838772247
금리/NNG;내릴/VV,-1,-0.25533080324334056,471,195,276,321,0.48192099553696444,0.8113244977116069
채권시장/NNG;부담/NNG;될/VV,-1,-0.2557380302169856,80,33,47,51,0.4154910276234946,0.7000973446060256
금리상승/NNG;작용하/VVX,-1,-0.25658682246379605,54,22,32,54,0.37681662405379734,0.6360848603685423
침체/NNG;지속될/VVX,-1,-0.2594980106544025,35,14,21,9,0.3385956641724705,0.575138765322915
시장금리/NNG;반영되/VVX,-1,-0.2594980106544025,35,14,21,27,0.3385956641724705,0.575138765322915
변동성/NNG;커지/VV,-1,-0.26220444371338414,191,79,112,172,0.4719192916147185,0.8062668488570076
리스크/NNG;확대되/VVX,-1,-0.2636537286372095,59,24,35,70,0.380949062371496,0.652873301346611
대외여건/NNG;악화될/VVX,-1,-0.26386649388257566,18,7,11,8,0.29680728736767065,0.5089029616500372
변동성/NNG;지속되/VVX,-1,-0.26386649388257566,18,7,11,11,0.29680728736767065,0.5089029616500372
변동성/NNG;크/VA;확대될/VVX,-1,-0.26386649388257566,18,7,11,16,0.29680728736767065,0.5089029616500372
단기금리/NNG;상승할/VVX,-1,-0.26386649388257566,18,7,11,19,0.29680728736767065,0.5089029616500372
유동성/NNG;공급함/VVX,-1,-0.26386649388257566,18,7,11,8,0.29680728736767065,0.5089029616500372
변동성/NNG;완화되/VVX,-1,-0.26386649388257566,18,7,11,16,0.29680728736767065,0.5089029616500372
출구전략/NNG;실행하/VVX,-1,-0.26386649388257566,18,7,11,5,0.29680728736767065,0.5089029616500372
금리인상시기/NNG;늦춰질/VV,-1,-0.26386649388257566,18,7,11,41,0.29680728736767065,0.5089029616500372
정책금리인상/NNG;반영하/VVX,-1,-0.26386649388257566,18,7,11,9,0.29680728736767065,0.5089029616500372
물가/NNG;중요하/VVX,-1,-0.26386649388257566,18,7,11,8,0.29680728736767065,0.5089029616500372
인플레이션압력/NNG;완화하/VVX,-1,-0.26386649388257566,18,7,11,8,0.29680728736767065,0.5089029616500372
금리인상/NNG;가능성/NNG;상존해/VVX,-1,-0.26386649388257566,18,7,11,9,0.29680728736767065,0.5089029616500372
생산/NNG;늘어나/VV,-1,-0.26386649388257566,18,7,11,11,0.29680728736767065,0.5089029616500372
인플레이션/NNG;우려할/VVX,-1,-0.26386649388257566,18,7,11,12,0.29680728736767065,0.5089029616500372
물가안정/NNG;삼/VV,-1,-0.26386649388257566,18,7,11,7,0.29680728736767065,0.5089029616500372
경제/NNG;악영향/NNG;줄/VV,-1,-0.26386649388257566,18,7,11,24,0.29680728736767065,0.5089029616500372
경제/NNG;성장세/NNG;나타내/VV,-1,-0.26386649388257566,18,7,11,9,0.29680728736767065,0.5089029616500372
주택시장/NNG;냉각되/VVX,-1,-0.26386649388257566,18,7,11,16,0.29680728736767065,0.5089029616500372
주택시장/NNG;회복되/VVX,-1,-0.26386649388257566,18,7,11,13,0.29680728736767065,0.5089029616500372
투자심리/NNG;부정적/VAX;작용하/VVX,-1,-0.26386649388257566,18,7,11,7,0.29680728736767065,0.5089029616500372
수출/NNG;선행하/VVX,-1,-0.26386649388257566,18,7,11,4,0.29680728736767065,0.5089029616500372
경기회복/NNG;될/VV,-1,-0.26386649388257566,18,7,11,13,0.29680728736767065,0.5089029616500372
부양책/NNG;나오/VV,-1,-0.26386649388257566,18,7,11,12,0.29680728736767065,0.5089029616500372
소비위축/NNG;이어질/VV,-1,-0.26386649388257566,18,7,11,2,0.29680728736767065,0.5089029616500372
금리상승압력/NNG;지속될/VVX,-1,-0.2670411831337123,40,16,24,30,0.3447374240376927,0.5951306559957844
성장률/NNG;웃돌/VV,-1,-0.2672399961406222,23,9,14,15,0.30731675494482047,0.530757198149128
경제회복/NNG;따른/VV,-1,-0.2672399961406222,23,9,14,18,0.30731675494482047,0.530757198149128
부양책/NNG;힘입/VV,-1,-0.2672399961406222,23,9,14,15,0.30731675494482047,0.530757198149128
금리하락/NNG;제한할/VVX,-1,-0.2672399961406222,23,9,14,39,0.30731675494482047,0.530757198149128
금리/NNG;큰/VA;하락함/VVX,-1,-0.2672399961406222,23,9,14,20,0.30731675494482047,0.530757198149128
금리/NNG;내릴/VV;없/VA,-1,-0.2672399961406222,23,9,14,22,0.30731675494482047,0.530757198149128
금리인상/NNG;지지할/VVX,-1,-0.2672399961406222,23,9,14,22,0.30731675494482047,0.530757198149128
불확실성/NNG;제거하/VVX,-1,-0.2672399961406222,23,9,14,11,0.30731675494482047,0.530757198149128
침체/NNG;심화되/VVX,-1,-0.2672399961406222,23,9,14,8,0.30731675494482047,0.530757198149128
소비자물가/NNG;상승해/VVX,-1,-0.26786281291411596,52,21,31,27,0.36673332087274707,0.634223166960213
기준금리/NNG;인하해/VVX,-1,-0.26862423569547733,226,93,133,177,0.47020637007917765,0.8145019693239469
금리상승/NNG;이끌/VV,-1,-0.26990422867921426,64,26,38,69,0.38494282803226043,0.6686476309597261
성장세/NNG;지속하/VVX,-1,-0.26990422867921426,64,26,38,60,0.38494282803226043,0.6686476309597261
금리/NNG;인하되/VVX,-1,-0.26990422867921426,64,26,38,41,0.38494282803226043,0.6686476309597261
성장잠재력/NNG;확충하/VVX,-1,-0.27217755034906277,28,11,17,23,0.31633272127779444,0.5521716550629004
금리인상전망/NNG;따른/VV,-1,-0.27217755034906277,28,11,17,24,0.31633272127779444,0.5521716550629004
금리인상시기/NNG;지연될/VVX,-1,-0.27217755034906277,28,11,17,27,0.31633272127779444,0.5521716550629004
금리하락/NNG;여지/NNG;남/VV,-1,-0.27217755034906277,28,11,17,38,0.31633272127779444,0.5521716550629004
불안/NNG;해소되/VVX,-1,-0.27217755034906277,28,11,17,27,0.31633272127779444,0.5521716550629004
소비자물가상승률/NNG;기록하/VVX,-1,-0.27217755034906277,28,11,17,30,0.31633272127779444,0.5521716550629004
경기/NNG;반등할/VVX,-1,-0.27217755034906277,28,11,17,25,0.31633272127779444,0.5521716550629004
금리/NNG;크/VA;오르/VV,-1,-0.27385716517175207,45,18,27,29,0.35058969910850246,0.614191618053922
경기/NNG;부양할/VVX,-1,-0.27385716517175207,45,18,27,28,0.35058969910850246,0.614191618053922
금리인하/NNG;이뤄질/VV,-1,-0.27385716517175207,45,18,27,40,0.35058969910850246,0.614191618053922
완화적/VAX;통화정책/NNG;유지하/VVX,-1,-0.2742258111663778,57,23,34,49,0.37141050858416974,0.6511855543951955
인플레이션/NNG;상승하/VVX,-1,-0.2742258111663778,57,23,34,54,0.37141050858416974,0.6511855543951955
고용/NNG;개선되/VVX,-1,-0.27759805021399653,33,13,20,31,0.32440603774859333,0.5729366478181382
성장률/NNG;나타내/VV,-1,-0.27759805021399653,33,13,20,24,0.32440603774859333,0.5729366478181382
경기과열/NNG;억제하/VVX,-1,-0.27759805021399653,33,13,20,25,0.32440603774859333,0.5729366478181382
불안/NNG;진정시/VVX,-1,-0.27759805021399653,33,13,20,9,0.32440603774859333,0.5729366478181382
기준금리인하/NNG;단행하/VVX,-1,-0.27759805021399653,33,13,20,33,0.32440603774859333,0.5729366478181382
견실한/VAX;경제성장/NNG;지속되/VVX,-1,-0.27759805021399653,33,13,20,22,0.32440603774859333,0.5729366478181382
내수부진/NNG;따른/VV,-1,-0.27759805021399653,33,13,20,25,0.32440603774859333,0.5729366478181382
재정위기/NNG;부각되/VVX,-1,-0.27759805021399653,33,13,20,27,0.32440603774859333,0.5729366478181382
동결/NNG;유지할/VVX,-1,-0.2798763993003103,62,25,37,50,0.37589166612701846,0.6671503970425681
경제/NNG;살리/VV,-1,-0.27994777733206444,230,94,136,189,0.4619052843853295,0.819938312288289
마이너스/NNG;나타내/VV,-1,-0.2799991785788941,50,20,30,34,0.35615837339559825,0.6322950768627643
변동성/NNG;줄여/VV,-1,-0.2799991785788941,50,20,30,68,0.35615837339559825,0.6322950768627643
리스크/NNG;커졌/VV,-1,-0.2799991785788941,50,20,30,21,0.35615837339559825,0.6322950768627643
경기/NNG;미치/VV;영향/NNG,-1,-0.2803346082427961,74,30,44,46,0.39245032822086817,0.6972317714260914
금융위기/NNG;벗어나/VV,-1,-0.28302648871607006,38,15,23,13,0.3317969678738869,0.5929278076216906
경제/NNG;개선될/VVX,-1,-0.28823641267553934,43,17,26,26,0.33864625075122584,0.6120651740714431
금리/NNG;크/VA;하락했/VVX,-1,-0.28823641267553934,43,17,26,34,0.33864625075122584,0.6120651740714431
실물경제/NNG;전이되/VVX,-1,-0.28823641267553934,43,17,26,18,0.33864625075122584,0.6120651740714431
외환위기/NNG;겪/VV,-1,-0.28823641267553934,43,17,26,51,0.33864625075122584,0.6120651740714431
경기회복/NNG;이끌/VV,-1,-0.28823641267553934,43,17,26,24,0.33864625075122584,0.6120651740714431
금리인하/NNG;단행했/VVX,-1,-0.28949817194397554,209,85,124,105,0.45352361669800983,0.8219506391688756
기준금리/NNG;내릴/VV,-1,-0.2925785150796416,269,109,160,219,0.4533965581586477,0.8272638139881491
기준금리/NNG;인하하/VVX,-1,-0.29613775063483705,646,261,385,548,0.45112280482676254,0.8295483181767581
채권시장/NNG;우호적/VAX;작용하/VVX,-1,-0.2967639706054044,26,10,16,20,0.2987494950421605,0.5501102864641756
기준금리/NNG;유지키/VVX,-1,-0.2967639706054044,26,10,16,14,0.2987494950421605,0.5501102864641756
콜금리/NNG;유지할/VVX,-1,-0.2967639706054044,26,10,16,6,0.2987494950421605,0.5501102864641756
인플레이션/NNG;달성하/VVX,-1,-0.2967639706054044,26,10,16,27,0.2987494950421605,0.5501102864641756
성장률/NNG;하향조정했/VVX,-1,-0.2967639706054044,26,10,16,39,0.2987494950421605,0.5501102864641756
수익성/NNG;악화시/VVX,-1,-0.2967639706054044,26,10,16,13,0.2987494950421605,0.5501102864641756
유동성/NNG;확보하/VVX,-1,-0.297620284107707,53,21,32,54,0.3510285944851713,0.647589839208288
기준금리인상/NNG;예상된/VVX,-1,-0.29798635599455636,21,8,13,24,0.286560536385991,0.5290813313146007
불확실성/NNG;영향/NNG;받/VV,-1,-0.29798635599455636,21,8,13,16,0.286560536385991,0.5290813313146007
채권시장/NNG;유입될/VVX,-1,-0.29798635599455636,21,8,13,25,0.286560536385991,0.5290813313146007
금리인하/NNG;전망하/VVX,-1,-0.29798635599455636,21,8,13,20,0.286560536385991,0.5290813313146007
내수/NNG;회복세/NNG;약화되/VVX,-1,-0.29798635599455636,21,8,13,0,0.286560536385991,0.5290813313146007
변동성/NNG;축소된/VVX,-1,-0.29798635599455636,21,8,13,40,0.286560536385991,0.5290813313146007
금리/NNG;상승세/NNG;돌아섰/VV,-1,-0.29798635599455636,21,8,13,11,0.286560536385991,0.5290813313146007
시장금리/NNG;반등하/VVX,-1,-0.29798635599455636,21,8,13,22,0.286560536385991,0.5290813313146007
불안심리/NNG;커지/VV,-1,-0.29798635599455636,21,8,13,9,0.286560536385991,0.5290813313146007
투자심리/NNG;긍정적/VAX;영향/NNG;미쳤/VV,-1,-0.2982059906801384,31,12,19,19,0.30895982441869085,0.5707122743105194
통화완화/NNG;나서/VV,-1,-0.2982059906801384,31,12,19,27,0.30895982441869085,0.5707122743105194
금리상승/NNG;대비하/VVX,-1,-0.2982059906801384,31,12,19,20,0.30895982441869085,0.5707122743105194
금리/NNG;하락세/NNG;지속되/VVX,-1,-0.2996324694633934,104,42,62,83,0.41086029593026296,0.761322164017974
금리/NNG;인하하/VVX,-1,-0.300725690862259,551,222,329,323,0.4476652349102739,0.8315150402764553
금리인하/NNG;힘입/VV,-1,-0.30086424440472503,36,14,22,15,0.31790721422601387,0.5906759586583994
경제/NNG;위축될/VVX,-1,-0.30086424440472503,36,14,22,23,0.31790721422601387,0.5906759586583994
경기/NNG;침체되/VVX,-1,-0.30086424440472503,36,14,22,38,0.31790721422601387,0.5906759586583994
기준금리/NNG;내려가/VV,-1,-0.30086424440472503,36,14,22,17,0.31790721422601387,0.5906759586583994
경기침체/NNG;인해/VV,-1,-0.30086424440472503,36,14,22,27,0.31790721422601387,0.5906759586583994
불안/NNG;커지/VV,-1,-0.30172596831308196,58,23,35,52,0.3566560059689481,0.6639276484765343
금융시장안정/NNG;위한/VV,-1,-0.30226937339076676,75,30,45,46,0.3800072017151189,0.7082422426077668
경기침체/NNG;이어지/VV,-1,-0.30403959244247214,41,16,25,28,0.32595548111734596,0.6098732800890524
gdp/NNG;상승하/VVX,-1,-0.30531024327827516,16,6,10,7,0.27075671436952653,0.5080141424691148
금융시장/NNG;혼란/NNG;겪/VV,-1,-0.30531024327827516,16,6,10,13,0.27075671436952653,0.5080141424691148
금융시장/NNG;큰/VA;충격/NNG;주/VV,-1,-0.30531024327827516,16,6,10,8,0.27075671436952653,0.5080141424691148
인플레이션압력/NNG;강화될/VVX,-1,-0.30531024327827516,16,6,10,6,0.27075671436952653,0.5080141424691148
채권시장/NNG;강세/NNG;작용하/VVX,-1,-0.30531024327827516,16,6,10,10,0.27075671436952653,0.5080141424691148
물가/NNG;벗어나/VV,-1,-0.30531024327827516,16,6,10,10,0.27075671436952653,0.5080141424691148
리스크/NNG;증가하/VVX,-1,-0.30531024327827516,16,6,10,14,0.27075671436952653,0.5080141424691148
물가상승률/NNG;미치/VV,-1,-0.30531024327827516,16,6,10,11,0.27075671436952653,0.5080141424691148
리스크/NNG;관리하/VVX,-1,-0.30531024327827516,16,6,10,13,0.27075671436952653,0.5080141424691148
동결/NNG;주장했/VVX,-1,-0.30531024327827516,16,6,10,21,0.27075671436952653,0.5080141424691148
글로벌/NNG;금리/NNG;상승하/VVX,-1,-0.30531024327827516,16,6,10,21,0.27075671436952653,0.5080141424691148
가계부채/NNG;줄이/VV,-1,-0.30531024327827516,16,6,10,4,0.27075671436952653,0.5080141424691148
변동성/NNG;이어질/VV,-1,-0.30531024327827516,16,6,10,11,0.27075671436952653,0.5080141424691148
마이너스/NNG;돌아선/VV,-1,-0.30531024327827516,16,6,10,23,0.27075671436952653,0.5080141424691148
정책금리/NNG;조정하/VVX,-1,-0.30531024327827516,16,6,10,8,0.27075671436952653,0.5080141424691148
흑자/NNG;냈/VV,-1,-0.30531024327827516,16,6,10,5,0.27075671436952653,0.5080141424691148
유가급등/NNG;인해/VV,-1,-0.30531024327827516,16,6,10,4,0.27075671436952653,0.5080141424691148
기준금리인하/NNG;그칠/VV,-1,-0.30531024327827516,16,6,10,16,0.27075671436952653,0.5080141424691148
기준금리인하/NNG;가능성/NNG;열려/VV,-1,-0.30531024327827516,16,6,10,13,0.27075671436952653,0.5080141424691148
기준금리동결/NNG;발표하/VVX,-1,-0.30531024327827516,16,6,10,13,0.27075671436952653,0.5080141424691148
불확실성/NNG;남/VV;상황/NNG,-1,-0.30531024327827516,16,6,10,21,0.27075671436952653,0.5080141424691148
수입/NNG;증가할/VVX,-1,-0.30531024327827516,16,6,10,15,0.27075671436952653,0.5080141424691148
채권시장/NNG;강세/NNG;이어질/VV,-1,-0.30531024327827516,16,6,10,12,0.27075671436952653,0.5080141424691148
소매판매/NNG;상회하/VVX,-1,-0.30531024327827516,16,6,10,19,0.27075671436952653,0.5080141424691148
재정위기/NNG;우려/NNG;부각되/VVX,-1,-0.30531024327827516,16,6,10,5,0.27075671436952653,0.5080141424691148
성장률/NNG;상승하/VVX,-1,-0.30531024327827516,16,6,10,9,0.27075671436952653,0.5080141424691148
소비증가/NNG;이어지/VV,-1,-0.30531024327827516,16,6,10,22,0.27075671436952653,0.5080141424691148
통화완화정책/NNG;종료하/VVX,-1,-0.30531024327827516,16,6,10,15,0.27075671436952653,0.5080141424691148
세계경제/NNG;성장할/VVX,-1,-0.30531024327827516,16,6,10,9,0.27075671436952653,0.5080141424691148
금리인상/NNG;시사해/VVX,-1,-0.30531024327827516,16,6,10,15,0.27075671436952653,0.5080141424691148
금리인하/NNG;진행되/VVX,-1,-0.30531024327827516,16,6,10,16,0.27075671436952653,0.5080141424691148
세계경제/NNG;미국/NNG;경기회복세/NNG;지속되/VVX,-1,-0.30531024327827516,16,6,10,11,0.27075671436952653,0.5080141424691148
경제성장률/NNG;낮/VA;질/VX;있/VV,-1,-0.30531024327827516,16,6,10,13,0.27075671436952653,0.5080141424691148
소비/NNG;지표/NNG;개선되/VVX,-1,-0.30531024327827516,16,6,10,14,0.27075671436952653,0.5080141424691148
금리상승/NNG;인해/VV,-1,-0.30736553150755774,46,18,28,38,0.3333107078361785,0.6282228182350873
불안/NNG;이어지/VV,-1,-0.30736553150755774,46,18,28,50,0.3333107078361785,0.6282228182350873
경기둔화/NNG;지속되/VVX,-1,-0.31064085473611003,51,20,31,42,0.34009991630387587,0.6456730427691644
변동성/NNG;확대됐/VVX,-1,-0.31064085473611003,51,20,31,45,0.34009991630387587,0.6456730427691644
부양책/NNG;내놓/VV;않/VX,-1,-0.31375334706804126,56,22,34,20,0.3464070723695822,0.6621935141145873
환율하락/NNG;따른/VV,-1,-0.31497549689882964,167,67,100,114,0.42904510697272297,0.8223898537748439
금리인하/NNG;단행될/VVX,-1,-0.317413183570308,205,82,123,161,0.4324515737591452,0.8334165895177003
물가안정/NNG;유지하/VVX,-1,-0.31927427564909816,66,26,40,14,0.35779573017239247,0.692399223628195
신용스프레드/NNG;축소되/VVX,-1,-0.31977498007248106,170,68,102,101,0.42617114596828787,0.8256372176345362
양적완화/NNG;시행하/VVX,-1,-0.3209454464902386,34,13,21,39,0.30290832790378225,0.5883666609472392
실물경제/NNG;파급되/VVX,-1,-0.3209454464902386,34,13,21,17,0.30290832790378225,0.5883666609472392
금리인상/NNG;고려하/VVX,-1,-0.32152453182639773,39,15,24,37,0.31241146715012186,0.6076087587893017
금리/NNG;하락세/NNG;출발했/VVX,-1,-0.32152453182639773,39,15,24,34,0.31241146715012186,0.6076087587893017
경기침체/NNG;벗어나/VV,-1,-0.32152453182639773,39,15,24,31,0.31241146715012186,0.6076087587893017
소비/NNG;줄어들/VV,-1,-0.32152453182639773,39,15,24,32,0.31241146715012186,0.6076087587893017
기준금리/NNG;상향조정할/VVX,-1,-0.3219522711029804,29,11,18,26,0.29200150405844183,0.5684550104755784
금리/NNG;높일/VV,-1,-0.3219522711029804,29,11,18,19,0.29200150405844183,0.5684550104755784
금리인하/NNG;가능성/NNG;낮추/VV,-1,-0.3219522711029804,29,11,18,7,0.29200150405844183,0.5684550104755784
인플레이션리스크/NNG;남/VV,-1,-0.3219522711029804,29,11,18,5,0.29200150405844183,0.5684550104755784
유동성/NNG;관리하/VVX,-1,-0.32603605248445855,24,9,15,17,0.2789685791954526,0.5480559051508676
금리인하기대/NNG;지속되/VVX,-1,-0.32603605248445855,24,9,15,23,0.2789685791954526,0.5480559051508676
금리인하/NNG;이어지/VV,-1,-0.32603605248445855,24,9,15,17,0.2789685791954526,0.5480559051508676
인플레이션/NNG;발생하/VVX,-1,-0.32603605248445855,24,9,15,19,0.2789685791954526,0.5480559051508676
기준금리/NNG;인하/VV,-1,-0.32603605248445855,24,9,15,23,0.2789685791954526,0.5480559051508676
통화완화/NNG;유지할/VVX,-1,-0.32603605248445855,24,9,15,17,0.2789685791954526,0.5480559051508676
출구전략/NNG;나설/VV,-1,-0.32603605248445855,24,9,15,16,0.2789685791954526,0.5480559051508676
인플레이션/NNG;있/VV,-1,-0.32603605248445855,24,9,15,16,0.2789685791954526,0.5480559051508676
금리/NNG;상승세/NNG;지속될/VVX,-1,-0.32663725852239833,54,21,33,57,0.3356869263660519,0.6603706439715015
금리인하/NNG;나설/VV,-1,-0.3299069063537089,336,133,203,264,0.42567759174763453,0.843554969948057
금리/NNG;상승세/NNG;지속되/VVX,-1,-0.33173987776772296,111,44,67,84,0.3943683609795751,0.7847301198843584
경기/NNG;위축되/VVX,-1,-0.33606416237012615,84,33,51,44,0.3688615506267755,0.7411463728820581
금리인하/NNG;대응하/VVX,-1,-0.33642722008840653,19,7,12,19,0.26230667785427153,0.5274788743978435
금리인하/NNG;이끌/VV,-1,-0.33642722008840653,19,7,12,11,0.26230667785427153,0.5274788743978435
투자심리/NNG;부정적/VAX;영향/NNG;미칠/VV,-1,-0.33642722008840653,19,7,12,16,0.26230667785427153,0.5274788743978435
경기/NNG;약화되/VVX,-1,-0.33642722008840653,19,7,12,14,0.26230667785427153,0.5274788743978435
수출부진/NNG;심화되/VVX,-1,-0.33642722008840653,19,7,12,4,0.26230667785427153,0.5274788743978435
콜금리/NNG;동결된/VVX,-1,-0.33642722008840653,19,7,12,7,0.26230667785427153,0.5274788743978435
경기부진/NNG;지속될/VVX,-1,-0.33642722008840653,19,7,12,12,0.26230667785427153,0.5274788743978435
성장률/NNG;높일/VV,-1,-0.33642722008840653,19,7,12,13,0.26230667785427153,0.5274788743978435
경기회복세/NNG;지원하/VVX,-1,-0.33642722008840653,19,7,12,28,0.26230667785427153,0.5274788743978435
금리상승/NNG;확대시/VVX,-1,-0.33642722008840653,19,7,12,17,0.26230667785427153,0.5274788743978435
금리인상/NNG;이뤄진/VV,-1,-0.33642722008840653,19,7,12,5,0.26230667785427153,0.5274788743978435
물가상승압력/NNG;확대되/VVX,-1,-0.33642722008840653,19,7,12,13,0.26230667785427153,0.5274788743978435
지준율/NNG;인하할/VVX,-1,-0.33642722008840653,19,7,12,14,0.26230667785427153,0.5274788743978435
완화적/VAX;통화정책/NNG;지속하/VVX,-1,-0.33642722008840653,19,7,12,9,0.26230667785427153,0.5274788743978435
기준금리/NNG;하향조정할/VVX,-1,-0.33642722008840653,19,7,12,8,0.26230667785427153,0.5274788743978435
금리정상화/NNG;위한/VV,-1,-0.33642722008840653,19,7,12,17,0.26230667785427153,0.5274788743978435
고용/NNG;늘릴/VV,-1,-0.33642722008840653,19,7,12,8,0.26230667785427153,0.5274788743978435
경기회복/NNG;도모하/VVX,-1,-0.33642722008840653,19,7,12,22,0.26230667785427153,0.5274788743978435
성장률/NNG;하회할/VVX,-1,-0.33642722008840653,19,7,12,14,0.26230667785427153,0.5274788743978435
금리인상/NNG;나타날/VV,-1,-0.33642722008840653,19,7,12,18,0.26230667785427153,0.5274788743978435
수입/NNG;줄/VV,-1,-0.34000069532412036,42,16,26,31,0.30772606471582187,0.6238219030071066
성장/NNG;견인하/VVX,-1,-0.34000069532412036,42,16,26,44,0.30772606471582187,0.6238219030071066
정책금리/NNG;동결되/VVX,-1,-0.3410143263427784,37,14,23,45,0.29788744931055083,0.6052617739698509
불안/NNG;이어질/VV,-1,-0.3410143263427784,37,14,23,42,0.29788744931055083,0.6052617739698509
금융위기/NNG;극복/NNG;위해/VV,-1,-0.3410143263427784,37,14,23,21,0.29788744931055083,0.6052617739698509
금리/NNG;내린/VV,-1,-0.34298325192377577,280,110,170,218,0.415673224754015,0.8483547067905398
물가목표/NNG;달성하/VVX,-1,-0.3437760058769377,32,12,20,44,0.28660450562823686,0.5859871801304517
기준금리/NNG;오르/VV,-1,-0.3437760058769377,32,12,20,47,0.28660450562823686,0.5859871801304517
임금상승/NNG;따른/VV,-1,-0.3437760058769377,32,12,20,16,0.28660450562823686,0.5859871801304517
금리인하/NNG;될/VV,-1,-0.3437760058769377,32,12,20,19,0.28660450562823686,0.5859871801304517
금리인하/NNG;하/VV,-1,-0.3453681034863828,82,32,50,37,0.36087242672019476,0.7405017555451638
금리/NNG;내렸/VV,-1,-0.3482615130418,173,68,105,119,0.40601243768535233,0.8386197080880833
경기불확실성/NNG;따른/VV,-1,-0.34968750939495497,27,10,17,23,0.27320873915130467,0.5661466688114134
리스크/NNG;불거지/VV,-1,-0.34968750939495497,27,10,17,26,0.27320873915130467,0.5661466688114134
기준금리동결/NNG;따른/VV,-1,-0.34968750939495497,27,10,17,38,0.27320873915130467,0.5661466688114134
투자심리/NNG;크/VA;위축되/VVX,-1,-0.34968750939495497,27,10,17,12,0.27320873915130467,0.5661466688114134
디플레이션/NNG;빠질/VV,-1,-0.34968750939495497,27,10,17,25,0.27320873915130467,0.5661466688114134
수출/NNG;증가하/VVX,-1,-0.35388415152073405,148,58,90,130,0.3962478434751589,0.8290030960044383
변동성/NNG;키우/VV,-1,-0.35475342312992997,65,25,40,45,0.3349795226980067,0.7022146281443357
리스크/NNG;따른/VV,-1,-0.3554402111797468,50,19,31,75,0.3126487478731168,0.656432496057874
소비자물가/NNG;올랐/VV,-1,-0.35887368419435905,40,15,25,26,0.2936818236770955,0.6214762433498716
금리인상/NNG;가능성/NNG;높이/VV,-1,-0.35887368419435905,40,15,25,26,0.2936818236770955,0.6214762433498716
수출/NNG;개선될/VVX,-1,-0.35887368419435905,40,15,25,29,0.2936818236770955,0.6214762433498716
수출/NNG;감소하/VVX,-1,-0.36125332571144797,141,55,86,100,0.3887870744422587,0.8272392517198276
마이너스/NNG;확대되/VVX,-1,-0.3615720340339521,22,8,14,15,0.25641194043376775,0.5459785485575517
고용/NNG;감소하/VVX,-1,-0.3615720340339521,22,8,14,12,0.25641194043376775,0.5459785485575517
금리인상/NNG;중단되/VVX,-1,-0.3615720340339521,22,8,14,10,0.25641194043376775,0.5459785485575517
금리하락/NNG;기대하/VVX,-1,-0.3615720340339521,22,8,14,25,0.25641194043376775,0.5459785485575517
고용/NNG;창출하/VVX,-1,-0.3615720340339521,22,8,14,24,0.25641194043376775,0.5459785485575517
유동성/NNG;증가/NNG;따른/VV,-1,-0.3615720340339521,22,8,14,8,0.25641194043376775,0.5459785485575517
동결/NNG;스탠스/NNG;유지할/VVX,-1,-0.3615720340339521,22,8,14,24,0.25641194043376775,0.5459785485575517
금리인하/NNG;기대할/VVX,-1,-0.3615720340339521,22,8,14,16,0.25641194043376775,0.5459785485575517
금리/NNG;상승세/NNG;이어질/VV,-1,-0.36291707348087765,35,13,22,26,0.28223213648568435,0.6028188950949914
소비심리/NNG;위축시/VVX,-1,-0.36291707348087765,35,13,22,19,0.28223213648568435,0.6028188950949914
경기/NNG;둔화된/VVX,-1,-0.36291707348087765,35,13,22,20,0.28223213648568435,0.6028188950949914
기준금리인하/NNG;따른/VV,-1,-0.36365515423219885,93,36,57,99,0.3596062939321684,0.7693878272572346
성장/NNG;위한/VV,-1,-0.3642162834671875,88,34,54,85,0.35479256068012777,0.7600700591735903
기준금리/NNG;내렸/VV,-1,-0.364424204247231,167,65,102,85,0.3932674396714903,0.8428981202820678
소비/NNG;위축시/VVX,-1,-0.36709565013730816,63,24,39,37,0.32492844459843684,0.7007291700012985
불안/NNG;따른/VV,-1,-0.3680190304357168,235,91,144,211,0.3963681604020441,0.8566183371727899
고용지표/NNG;호조/NNG;보이/VV,-1,-0.3680930618049356,58,22,36,42,0.317441318589467,0.6861614966492752
고용/NNG;증가했/VVX,-1,-0.3695227864840298,53,20,33,33,0.30925503376931246,0.6706797441908703
금리하락/NNG;요인이/VVX,-1,-0.37001686183974136,30,11,19,26,0.26875706582417336,0.5835187148024561
주택가격/NNG;상승하/VVX,-1,-0.37001686183974136,30,11,19,26,0.26875706582417336,0.5835187148024561
성장률/NNG;개선될/VVX,-1,-0.37001686183974136,30,11,19,37,0.26875706582417336,0.5835187148024561
고용지표/NNG;호조/NNG;보인/VV,-1,-0.37001686183974136,30,11,19,23,0.26875706582417336,0.5835187148024561
금리/NNG;상승세/NNG;보일/VV,-1,-0.37001686183974136,30,11,19,28,0.26875706582417336,0.5835187148024561
침체/NNG;빠졌/VV,-1,-0.37164718724776935,48,18,30,21,0.30022230474029155,0.6543010580585423
마이너스/NNG;기록하/VVX,-1,-0.37391797118816017,168,65,103,148,0.38661657202828,0.8470380270696535
금리인하/NNG;단행하/VVX;않/VX,-1,-0.37487594408970704,43,16,27,43,0.2901293980902777,0.6370604864937893
재정적자/NNG;줄이/VV,-1,-0.37709555522822236,71,27,44,67,0.3289272683871832,0.7259910312727387
금리인하/NNG;통한/VV,-1,-0.3791196882409479,140,54,86,66,0.37592253311826257,0.8336399087940957
불확실성/NNG;계속되/VVX,-1,-0.37987080389011085,38,14,24,32,0.2786513616589747,0.6190168825505948
소비심리/NNG;위축되/VVX,-1,-0.37987080389011085,38,14,24,23,0.2786513616589747,0.6190168825505948
금리/NNG;내리/VV,-1,-0.3799857106843283,584,224,360,368,0.3883766228840076,0.863000201308589
경기회복/NNG;뒷받침하/VVX,-1,-0.3806966177263821,94,36,58,51,0.3494119726923756,0.7777080160061295
금융안정/NNG;유의하/VVX,-1,-0.38215838571434757,89,34,55,82,0.3442220537936444,0.7687787857518336
금리상승/NNG;견인할/VVX,-1,-0.38257288273912027,25,9,16,16,0.2521788624955505,0.5637577261472376
경기둔화/NNG;진행되/VVX,-1,-0.38257288273912027,25,9,16,9,0.2521788624955505,0.5637577261472376
실물경제/NNG;부정적/VAX;영향/NNG;미칠/VV,-1,-0.38257288273912027,25,9,16,7,0.2521788624955505,0.5637577261472376
경기/NNG;낙관하/VVX,-1,-0.38257288273912027,25,9,16,22,0.2521788624955505,0.5637577261472376
금리인하기대/NNG;형성되/VVX,-1,-0.38257288273912027,25,9,16,34,0.2521788624955505,0.5637577261472376
성장/NNG;유지되/VVX,-1,-0.3859456099674271,17,6,11,6,0.23338756263984572,0.5258889277010501
물가안정/NNG;촉진하/VVX,-1,-0.3859456099674271,17,6,11,5,0.23338756263984572,0.5258889277010501
양적완화정책/NNG;내놓/VV,-1,-0.3859456099674271,17,6,11,20,0.23338756263984572,0.5258889277010501
통화긴축정책/NNG;중단할/VVX,-1,-0.3859456099674271,17,6,11,12,0.23338756263984572,0.5258889277010501
금리인하/NNG;고려하/VVX,-1,-0.3859456099674271,17,6,11,17,0.23338756263984572,0.5258889277010501
물가/NNG;불안하/VVX,-1,-0.3859456099674271,17,6,11,12,0.23338756263984572,0.5258889277010501
변동성/NNG;축소될/VVX,-1,-0.3859456099674271,17,6,11,20,0.23338756263984572,0.5258889277010501
유동성/NNG;부족하/VVX,-1,-0.3859456099674271,17,6,11,20,0.23338756263984572,0.5258889277010501
수출부진/NNG;지속될/VVX,-1,-0.3859456099674271,17,6,11,9,0.23338756263984572,0.5258889277010501
불확실성/NNG;감소하/VVX,-1,-0.3859456099674271,17,6,11,7,0.23338756263984572,0.5258889277010501
인플레이션우려/NNG;부각돼/VVX,-1,-0.3859456099674271,17,6,11,8,0.23338756263984572,0.5258889277010501
유동성/NNG;투입하/VVX,-1,-0.3859456099674271,17,6,11,10,0.23338756263984572,0.5258889277010501
대외불확실성/NNG;해소되/VVX;않/VX,-1,-0.3859456099674271,17,6,11,11,0.23338756263984572,0.5258889277010501
불안/NNG;해소되/VVX;않/VX,-1,-0.3859456099674271,17,6,11,12,0.23338756263984572,0.5258889277010501
불확실성/NNG;자리/NNG;잡/VV,-1,-0.3859456099674271,17,6,11,11,0.23338756263984572,0.5258889277010501
산업생산/NNG;증가할/VVX,-1,-0.3859456099674271,17,6,11,18,0.23338756263984572,0.5258889277010501
취업자수/NNG;늘어나/VV,-1,-0.3859456099674271,17,6,11,17,0.23338756263984572,0.5258889277010501
통화완화정책/NNG;내놓/VV,-1,-0.3859456099674271,17,6,11,17,0.23338756263984572,0.5258889277010501
투자심리/NNG;북돋웠/VV,-1,-0.3859456099674271,17,6,11,12,0.23338756263984572,0.5258889277010501
경기침체/NNG;빠지/VV,-1,-0.3859456099674271,17,6,11,18,0.23338756263984572,0.5258889277010501
충분한/VAX;유동성/NNG;공급하/VVX,-1,-0.3859456099674271,17,6,11,6,0.23338756263984572,0.5258889277010501
금리하락/NNG;지속되/VVX,-1,-0.3859456099674271,17,6,11,8,0.23338756263984572,0.5258889277010501
수입/NNG;줄어든/VV,-1,-0.3859456099674271,17,6,11,9,0.23338756263984572,0.5258889277010501
성장률/NNG;달성/NNG;가능할/VVX,-1,-0.3859456099674271,17,6,11,15,0.23338756263984572,0.5258889277010501
임금/NNG;오르/VV;않/VX,-1,-0.3859456099674271,17,6,11,11,0.23338756263984572,0.5258889277010501
변동성/NNG;키웠/VV,-1,-0.3859456099674271,17,6,11,13,0.23338756263984572,0.5258889277010501
자본확충/NNG;필요하/VVX,-1,-0.3859456099674271,17,6,11,11,0.23338756263984572,0.5258889277010501
하방리스크/NNG;확대되/VVX,-1,-0.3859456099674271,17,6,11,13,0.23338756263984572,0.5258889277010501
하방리스크/NNG;우세하/VVX,-1,-0.3859456099674271,17,6,11,14,0.23338756263984572,0.5258889277010501
불안/NNG;막/VV,-1,-0.3859456099674271,17,6,11,12,0.23338756263984572,0.5258889277010501
금리인하/NNG;인해/VV,-1,-0.3870441921125376,74,28,46,44,0.3262649427112205,0.7370671148009624
신용스프레드/NNG;축소된/VVX,-1,-0.3877515726620854,33,12,21,38,0.26526634231933294,0.6002618359138902
긴축정책/NNG;펴/VV,-1,-0.3877515726620854,33,12,21,28,0.26526634231933294,0.6002618359138902
경기침체/NNG;지속되/VVX,-1,-0.3877515726620854,33,12,21,32,0.26526634231933294,0.6002618359138902
금융위기/NNG;겪/VV,-1,-0.3890282444019002,69,26,43,87,0.31932398813759055,0.7247601204870474
금리인하/NNG;가능성/NNG;열/VV,-1,-0.38924624011219944,225,86,139,132,0.38043222560073825,0.8638988250034361
지정학적리스크/NNG;따른/VV,-1,-0.3892962526181939,46,17,29,39,0.2871063783787659,0.6520479843778991
더블딥/NNG;빠질/VV,-1,-0.3892962526181939,46,17,29,29,0.2871063783787659,0.6520479843778991
금리/NNG;큰/VA;상승하/VVX,-1,-0.3919656590690308,87,33,54,101,0.3361959604841728,0.768354595143779
시장금리/NNG;하락하/VVX,-1,-0.393800531650354,157,60,97,125,0.3702552799166797,0.8498701970144492
경제지표/NNG;둔화되/VVX,-1,-0.3941677718738217,59,22,37,55,0.3035786028934077,0.6974283261771728
금융안정/NNG;위한/VV,-1,-0.3950073384885242,41,15,26,24,0.27569205045931866,0.6346221490367697
금리인하/NNG;단행되/VVX,-1,-0.3950532384382075,131,50,81,83,0.36157787274376435,0.8324152034010313
기준금리/NNG;인하했/VVX,-1,-0.39673727996283803,361,137,224,267,0.37598070392792493,0.8690324382301511
금리변동성/NNG;확대될/VVX,-1,-0.3977188195124949,54,20,34,55,0.29454664692740934,0.6823943587829417
동결/NNG;유지될/VVX,-1,-0.4005374916978892,28,10,18,32,0.24907901059239837,0.5809338927914054
금리인하/NNG;가능성/NNG;남/VV,-1,-0.4005374916978892,28,10,18,18,0.24907901059239837,0.5809338927914054
마이너스/NNG;되/VV,-1,-0.4005374916978892,28,10,18,27,0.24907901059239837,0.5809338927914054
지준율/NNG;인하하/VVX,-1,-0.4005374916978892,28,10,18,15,0.24907901059239837,0.5809338927914054
경기불확실성/NNG;지속되/VVX,-1,-0.4005374916978892,28,10,18,35,0.24907901059239837,0.5809338927914054
gdp/NNG;증가해/VVX,-1,-0.4005374916978892,28,10,18,24,0.24907901059239837,0.5809338927914054
성장/NNG;그쳤/VV,-1,-0.4005374916978892,28,10,18,24,0.24907901059239837,0.5809338927914054
불안/NNG;확산되/VVX,-1,-0.40235339664987957,49,18,31,45,0.28451685765782475,0.666461893062483
금리인하/NNG;나섰/VV,-1,-0.40235339664987957,49,18,31,40,0.28451685765782475,0.666461893062483
투자심리/NNG;악화되/VVX,-1,-0.4034034635361322,36,13,23,20,0.2624984035142,0.6164264927714179
신용스프레드/NNG;확대될/VVX,-1,-0.4034034635361322,36,13,23,28,0.2624984035142,0.6164264927714179
정책금리/NNG;동결하/VVX,-1,-0.4042591606930822,98,37,61,70,0.33724278104273214,0.7935680038503606
금리하락/NNG;베팅/NNG;하/VV,-1,-0.4056562776546606,20,7,13,11,0.2303388597458306,0.543823870717283
경기부양책/NNG;발표하/VVX,-1,-0.4056562776546606,20,7,13,11,0.2303388597458306,0.543823870717283
금융위기/NNG;직전인/VVX,-1,-0.4056562776546606,20,7,13,13,0.2303388597458306,0.543823870717283
물가상승압력/NNG;높이/VV,-1,-0.4056562776546606,20,7,13,13,0.2303388597458306,0.543823870717283
경제/NNG;활력/NNG;불어넣/VV,-1,-0.4056562776546606,20,7,13,11,0.2303388597458306,0.543823870717283
금리인상/NNG;시점/NNG;될/VV,-1,-0.4056562776546606,20,7,13,29,0.2303388597458306,0.543823870717283
경제/NNG;회복세/NNG;나타낼/VV,-1,-0.4056562776546606,20,7,13,24,0.2303388597458306,0.543823870717283
신용등급/NNG;받/VV,-1,-0.4056562776546606,20,7,13,13,0.2303388597458306,0.543823870717283
투자심리/NNG;악화됐/VVX,-1,-0.4056562776546606,20,7,13,11,0.2303388597458306,0.543823870717283
유동성/NNG;확대되/VVX,-1,-0.4056562776546606,20,7,13,26,0.2303388597458306,0.543823870717283
금리/NNG;스프레드/NNG;확대되/VVX,-1,-0.4056562776546606,20,7,13,11,0.2303388597458306,0.543823870717283
유동성/NNG;부족해/VVX,-1,-0.4056562776546606,20,7,13,21,0.2303388597458306,0.543823870717283
인플레이션압력/NNG;지속되/VVX,-1,-0.4056562776546606,20,7,13,14,0.2303388597458306,0.543823870717283
불확실성/NNG;반영해/VVX,-1,-0.4056562776546606,20,7,13,22,0.2303388597458306,0.543823870717283
금융시장/NNG;안정시/VVX,-1,-0.40779126266646226,75,28,47,48,0.3146385335037763,0.7466582927560854
불안요인/NNG;있/VV,-1,-0.4090797769354999,57,21,36,18,0.2922175348342413,0.6955969487355833
정책금리/NNG;인하하/VVX,-1,-0.41067264315683094,114,43,71,54,0.3431066440157475,0.81986269254602
금리인하/NNG;배경/NNG;설명했/VVX,-1,-0.41617972809083603,31,11,20,10,0.24678129184512432,0.5975657557368991
경제성장률/NNG;떨어지/VV,-1,-0.41617972809083603,31,11,20,20,0.24678129184512432,0.5975657557368991
변동성/NNG;지속될/VVX,-1,-0.41617972809083603,31,11,20,28,0.24678129184512432,0.5975657557368991
금리인하기대감/NNG;형성되/VVX,-1,-0.41617972809083603,31,11,20,18,0.24678129184512432,0.5975657557368991
금리하락/NNG;이어질/VV,-1,-0.41617972809083603,31,11,20,38,0.24678129184512432,0.5975657557368991
금리인상/NNG;재개될/VVX,-1,-0.41617972809083603,31,11,20,14,0.24678129184512432,0.5975657557368991
금리인상/NNG;대응하/VVX,-1,-0.41617972809083603,31,11,20,14,0.24678129184512432,0.5975657557368991
금리/NNG;낮춘/VV,-1,-0.4173449550240693,39,14,25,22,0.26028496906779724,0.6320416178765433
물가/NNG;낮추/VV,-1,-0.42220287574694715,23,8,15,23,0.22842230790256246,0.5612417156948097
성장률/NNG;하향조정되/VVX,-1,-0.42220287574694715,23,8,15,22,0.22842230790256246,0.5612417156948097
금리/NNG;계속/MAG;오를/VV,-1,-0.42220287574694715,23,8,15,3,0.22842230790256246,0.5612417156948097
경기둔화/NNG;가능성/NNG;시사하/VVX,-1,-0.42220287574694715,23,8,15,5,0.22842230790256246,0.5612417156948097
금융위기/NNG;발생하/VVX,-1,-0.42220287574694715,23,8,15,35,0.22842230790256246,0.5612417156948097
유동성/NNG;부족/NNG;따른/VV,-1,-0.42220287574694715,23,8,15,6,0.22842230790256246,0.5612417156948097
흑자/NNG;전환했/VVX,-1,-0.42220287574694715,23,8,15,10,0.22842230790256246,0.5612417156948097
재정정책/NNG;펴/VV,-1,-0.42220287574694715,23,8,15,16,0.22842230790256246,0.5612417156948097
수출/NNG;부진할/VVX,-1,-0.42220287574694715,23,8,15,28,0.22842230790256246,0.5612417156948097
정책금리/NNG;인하되/VVX,-1,-0.42220287574694715,23,8,15,27,0.22842230790256246,0.5612417156948097
기준금리/NNG;하회하/VVX,-1,-0.4280042537824187,76,28,48,76,0.3033304178848679,0.7559082137048355
금리/NNG;인하했/VVX,-1,-0.428180996629275,201,75,126,147,0.3510785483342921,0.8752761329431171
금리인하/NNG;가능성/NNG;시사했/VVX,-1,-0.4325899996788257,71,26,45,29,0.2953733880707405,0.7443986431965678
연방기금금리/NNG;인상하/VVX,-1,-0.43648309281928255,26,9,17,26,0.2272355688229015,0.5781932632105905
추경/NNG;편성해/VVX,-1,-0.43648309281928255,26,9,17,17,0.2272355688229015,0.5781932632105905
재정정책/NNG;따른/VV,-1,-0.43648309281928255,26,9,17,18,0.2272355688229015,0.5781932632105905
마이너스/NNG;떨어질/VV,-1,-0.43648309281928255,26,9,17,9,0.2272355688229015,0.5781932632105905
기준금리/NNG;인하되/VVX,-1,-0.43775753819598573,132,49,83,177,0.33271239741318526,0.849243278186314
성장/NNG;위해/VV,-1,-0.44082491262396306,103,38,65,73,0.3169066434822635,0.8150625731697063
과잉유동성/NNG;따른/VV,-1,-0.44114768714168173,45,16,29,18,0.25706529789922167,0.661683924096414
경기부양책/NNG;힘입/VV,-1,-0.44114768714168173,45,16,29,41,0.25706529789922167,0.661683924096414
유동성/NNG;공급되/VVX,-1,-0.44221770251564385,53,19,34,44,0.2679460315083116,0.6915242126426242
단기금리/NNG;하락하/VVX,-1,-0.44221770251564385,53,19,34,27,0.2679460315083116,0.6915242126426242
성장/NNG;기대하/VVX,-1,-0.44228965178075574,37,13,24,29,0.24379184078614793,0.6292986519266641
기준금리/NNG;인하됐/VVX,-1,-0.44228965178075574,37,13,24,18,0.24379184078614793,0.6292986519266641
금리/NNG;내리/VV;않/VX,-1,-0.4425284716374819,82,30,52,47,0.3000977988952268,0.7751004265664706
하방압력/NNG;작용할/VVX,-1,-0.44904446665594977,29,10,19,34,0.22654150066952036,0.5946969831291274
변동성/NNG;확대할/VVX,-1,-0.44904446665594977,29,10,19,7,0.22654150066952036,0.5946969831291274
채권시장/NNG;강세/NNG;보이/VV,-1,-0.44904446665594977,29,10,19,34,0.22654150066952036,0.5946969831291274
기준금리인상/NNG;가능할/VVX,-1,-0.44904446665594977,29,10,19,38,0.22654150066952036,0.5946969831291274
금리/NNG;내려가/VV,-1,-0.4499588197188784,93,34,59,67,0.30432918068298054,0.8007286026415421
금리/NNG;하락세/NNG;지속될/VVX,-1,-0.4504831380314457,101,37,64,105,0.3094213212712288,0.8151965041002879
리스크/NNG;될/VV,-1,-0.4513912572354726,48,17,31,67,0.2559004019393598,0.6757275787304882
신용스프레드/NNG;크/VA;축소되/VVX,-1,-0.45183069180064983,15,5,10,4,0.1982923862573248,0.524186051660859
경상수지흑자/NNG;기록하/VVX,-1,-0.45183069180064983,15,5,10,7,0.1982923862573248,0.524186051660859
금리/NNG;하락/NNG;제한되/VVX,-1,-0.45183069180064983,15,5,10,14,0.1982923862573248,0.524186051660859
소비자물가지수/NNG;오르/VV,-1,-0.45183069180064983,15,5,10,8,0.1982923862573248,0.524186051660859
실물경제/NNG;위축되/VVX,-1,-0.45183069180064983,15,5,10,4,0.1982923862573248,0.524186051660859
채권시장/NNG;호재/NNG;작용했/VVX,-1,-0.45183069180064983,15,5,10,5,0.1982923862573248,0.524186051660859
경기회복/NNG;기대/NNG;높이/VV,-1,-0.45183069180064983,15,5,10,16,0.1982923862573248,0.524186051660859
물가억제/NNG;위해/VV,-1,-0.45183069180064983,15,5,10,9,0.1982923862573248,0.524186051660859
시장금리/NNG;영향/NNG;미치/VV,-1,-0.45183069180064983,15,5,10,8,0.1982923862573248,0.524186051660859
인플레이션압력/NNG;완화시/VVX,-1,-0.45183069180064983,15,5,10,12,0.1982923862573248,0.524186051660859
연방기금금리/NNG;결정하/VVX,-1,-0.45183069180064983,15,5,10,17,0.1982923862573248,0.524186051660859
긴축정책/NNG;지속될/VVX,-1,-0.45183069180064983,15,5,10,6,0.1982923862573248,0.524186051660859
긴축정책/NNG;펼/VV,-1,-0.45183069180064983,15,5,10,9,0.1982923862573248,0.524186051660859
금리인하/NNG;그치/VV,-1,-0.45183069180064983,15,5,10,9,0.1982923862573248,0.524186051660859
불안요인/NNG;산재해/VVX,-1,-0.45183069180064983,15,5,10,8,0.1982923862573248,0.524186051660859
금리상승/NNG;진행되/VVX,-1,-0.45183069180064983,15,5,10,7,0.1982923862573248,0.524186051660859
대외여건/NNG;악화되/VVX,-1,-0.45183069180064983,15,5,10,15,0.1982923862573248,0.524186051660859
기준금리/NNG;떨어질/VV,-1,-0.45183069180064983,15,5,10,9,0.1982923862573248,0.524186051660859
유동성/NNG;확보할/VVX,-1,-0.45183069180064983,15,5,10,10,0.1982923862573248,0.524186051660859
경제/NNG;어려움/NNG;겪/VV,-1,-0.45183069180064983,15,5,10,17,0.1982923862573248,0.524186051660859
디플레이션/NNG;극복하/VVX,-1,-0.45183069180064983,15,5,10,15,0.1982923862573248,0.524186051660859
금리인하/NNG;기대하/VVX;어렵/VA,-1,-0.4533489700053166,40,14,26,29,0.24284740142418157,0.6444197120969284
금리인상/NNG;유지될/VVX,-1,-0.4602438134682667,32,11,21,27,0.22619154529812255,0.610756369373325
경기침체/NNG;심화되/VVX,-1,-0.4602438134682667,32,11,21,19,0.22619154529812255,0.610756369373325
잠재성장률/NNG;밑돌/VV,-1,-0.4602438134682667,32,11,21,25,0.22619154529812255,0.610756369373325
경제성장/NNG;촉진하/VVX,-1,-0.46064271221584874,83,30,53,26,0.2898212116643852,0.783358961946635
적자/NNG;줄어들/VV,-1,-0.46158924740945817,18,6,12,5,0.1998590999162789,0.5414983163680698
경제/NNG;미칠/VV;악영향/NNG,-1,-0.46158924740945817,18,6,12,8,0.1998590999162789,0.5414983163680698
경제/NNG;반등할/VVX,-1,-0.46158924740945817,18,6,12,15,0.1998590999162789,0.5414983163680698
추경/NNG;집행/NNG;따른/VV,-1,-0.46158924740945817,18,6,12,16,0.1998590999162789,0.5414983163680698
채권시장강세/NNG;지지할/VVX,-1,-0.46158924740945817,18,6,12,15,0.1998590999162789,0.5414983163680698
재정/NNG;확대하/VVX,-1,-0.46158924740945817,18,6,12,19,0.1998590999162789,0.5414983163680698
금리인상/NNG;시사함/VVX,-1,-0.46158924740945817,18,6,12,14,0.1998590999162789,0.5414983163680698
기준금리인하/NNG;단행된/VVX,-1,-0.46158924740945817,18,6,12,14,0.1998590999162789,0.5414983163680698
불안/NNG;요소/NNG;남/VV,-1,-0.46158924740945817,18,6,12,17,0.1998590999162789,0.5414983163680698
마이너스/NNG;지속되/VVX,-1,-0.46158924740945817,18,6,12,7,0.1998590999162789,0.5414983163680698
불확실성/NNG;확대/NNG;따른/VV,-1,-0.46158924740945817,18,6,12,21,0.1998590999162789,0.5414983163680698
기준금리인상/NNG;지지하/VVX,-1,-0.46158924740945817,18,6,12,18,0.1998590999162789,0.5414983163680698
실물경제/NNG;확산되/VVX,-1,-0.46158924740945817,18,6,12,9,0.1998590999162789,0.5414983163680698
시장금리상승/NNG;제한할/VVX,-1,-0.46158924740945817,18,6,12,16,0.1998590999162789,0.5414983163680698
금리인하/NNG;진행될/VVX,-1,-0.46158924740945817,18,6,12,13,0.1998590999162789,0.5414983163680698
수출/NNG;위축되/VVX,-1,-0.46158924740945817,18,6,12,14,0.1998590999162789,0.5414983163680698
듀레이션/NNG;줄여/VV,-1,-0.46158924740945817,18,6,12,19,0.1998590999162789,0.5414983163680698
성장률/NNG;끌어올릴/VV,-1,-0.46158924740945817,18,6,12,34,0.1998590999162789,0.5414983163680698
세계경제/NNG;회복/NNG;따른/VV,-1,-0.46158924740945817,18,6,12,9,0.1998590999162789,0.5414983163680698
양적완화/NNG;종료하/VVX,-1,-0.46334981044065837,43,15,28,37,0.24215949174642568,0.6590477443028454
성장률/NNG;떨어지/VV,-1,-0.4692441818424765,54,19,35,44,0.2541940202794259,0.7022838578941526
물가상승압력/NNG;작용하/VVX,-1,-0.47032659969211366,35,12,23,26,0.22608808233841407,0.6263679564304981
리스크/NNG;확대될/VVX,-1,-0.47032659969211366,35,12,23,36,0.22608808233841407,0.6263679564304981
경기회복세/NNG;이/VV,-1,-0.4707505367019065,21,7,14,7,0.20138175396877192,0.5585269868852872
금리인하/NNG;예상된/VVX,-1,-0.4707505367019065,21,7,14,18,0.20138175396877192,0.5585269868852872
불안요인/NNG;부각되/VVX,-1,-0.4707505367019065,21,7,14,23,0.20138175396877192,0.5585269868852872
금리인하/NNG;실시하/VVX,-1,-0.4707505367019065,21,7,14,23,0.20138175396877192,0.5585269868852872
금리/NNG;안정세/NNG;보이/VV,-1,-0.4707505367019065,21,7,14,7,0.20138175396877192,0.5585269868852872
금리/NNG;큰/VA;오르/VV,-1,-0.4707505367019065,21,7,14,17,0.20138175396877192,0.5585269868852872
성장/NNG;중시하/VVX,-1,-0.4707505367019065,21,7,14,18,0.20138175396877192,0.5585269868852872
자금이탈/NNG;나타나/VV,-1,-0.4707505367019065,21,7,14,33,0.20138175396877192,0.5585269868852872
취업자수/NNG;감소하/VVX,-1,-0.4707505367019065,21,7,14,8,0.20138175396877192,0.5585269868852872
물가/NNG;관리하/VVX,-1,-0.4707505367019065,21,7,14,9,0.20138175396877192,0.5585269868852872
경기부양/NNG;위해서/VV,-1,-0.4707505367019065,21,7,14,26,0.20138175396877192,0.5585269868852872
경제/NNG;회복된/VVX,-1,-0.4707505367019065,21,7,14,11,0.20138175396877192,0.5585269868852872
금리하락/NNG;작용하/VVX,-1,-0.47243828544917843,46,16,30,55,0.24167224256051184,0.673182826939066
수출/NNG;줄/VV,-1,-0.47502012733114407,65,23,42,62,0.26392667780727597,0.7400760379151827
성장률/NNG;떨어질/VV,-1,-0.47705363836901304,57,20,37,45,0.2535793853410938,0.7148042345367448
자산매입/NNG;유지했/VVX,-1,-0.4793460703033583,24,8,16,30,0.2028611746479651,0.5752404339247222
기준금리인하/NNG;인해/VV,-1,-0.4793460703033583,24,8,16,21,0.2028611746479651,0.5752404339247222
부양책/NNG;발표할/VVX,-1,-0.4793460703033583,24,8,16,23,0.2028611746479651,0.5752404339247222
소비자물가상승률/NNG;하락하/VVX,-1,-0.4793460703033583,24,8,16,9,0.2028611746479651,0.5752404339247222
양적완화/NNG;단행하/VVX,-1,-0.4793460703033583,24,8,16,18,0.2028611746479651,0.5752404339247222
금융위기/NNG;확산되/VVX,-1,-0.4793460703033583,24,8,16,11,0.2028611746479651,0.5752404339247222
경상수지흑자/NNG;지속되/VVX,-1,-0.47946951556158324,38,13,25,29,0.22616445747754532,0.6415253421820877
금리/NNG;상승세/NNG;보였/VV,-1,-0.48422447073101627,60,21,39,80,0.25308725263949333,0.7268250331582103
경기부양/NNG;위한/VV,-1,-0.48454239751712824,612,219,393,538,0.31242905629117357,0.8979894327777328
리스크/NNG;부각되/VVX,-1,-0.4854101409167866,79,28,51,75,0.2713706695097753,0.7817476508090132
금리상승/NNG;제한됨/VVX,-1,-0.48740617913898054,27,9,18,25,0.20429820832507758,0.5916100018389815
소비/NNG;회복될/VVX,-1,-0.48740617913898054,27,9,18,11,0.20429820832507758,0.5916100018389815
경제지표호조/NNG;따른/VV,-1,-0.48740617913898054,27,9,18,31,0.20429820832507758,0.5916100018389815
금리인하효과/NNG;지켜볼/VV,-1,-0.48740617913898054,27,9,18,35,0.20429820832507758,0.5916100018389815
금리/NNG;유지해/VVX,-1,-0.48740617913898054,27,9,18,26,0.20429820832507758,0.5916100018389815
변동성확대/NNG;따른/VV,-1,-0.48740617913898054,27,9,18,30,0.20429820832507758,0.5916100018389815
기준금리인하/NNG;가능성/NNG;열/VV,-1,-0.48740617913898054,27,9,18,31,0.20429820832507758,0.5916100018389815
금리/NNG;안정될/VVX,-1,-0.48740617913898054,27,9,18,24,0.20429820832507758,0.5916100018389815
물가안정/NNG;달성하/VVX,-1,-0.4878047251189901,41,14,27,37,0.22637371473970475,0.6562213256339876
금리인하기대감/NNG;약화되/VVX,-1,-0.48831931136077666,52,18,34,48,0.24114099090693944,0.6999727392114917
정책금리/NNG;낮추/VV,-1,-0.49495996341817083,30,10,20,12,0.20569371750383983,0.6076100375982868
금리/NNG;하락세/NNG;이어지/VV,-1,-0.49495996341817083,30,10,20,28,0.20569371750383983,0.6076100375982868
기준금리인하/NNG;단행되/VVX,-1,-0.49689836026741874,66,23,43,42,0.2523911706045703,0.7493886087062357
금리/NNG;큰/VA;상승했/VVX,-1,-0.5016848689405542,58,20,38,76,0.2410193072561177,0.7247919905333696
금리인상/NNG;가능성/NNG;낮추/VV,-1,-0.5020352629552685,33,11,22,18,0.2070485771163619,0.623217881943754
수출/NNG;증가세/NNG;둔화되/VVX,-1,-0.5020352629552685,33,11,22,22,0.2070485771163619,0.623217881943754
유동성/NNG;의한/VV,-1,-0.5024396950855059,47,16,31,37,0.22706397114527882,0.6842028131342591
마이너스/NNG;돌아서/VV,-1,-0.5086586454267639,36,12,24,23,0.20836367111091555,0.6384138271011909
인플레이션압력/NNG;완화될/VVX,-1,-0.5088867872475588,50,17,33,15,0.22750104293389395,0.6974780984476908
높/VA;변동성/NNG;보이/VV,-1,-0.5148554095214042,39,13,26,31,0.20963988932092723,0.653181045621481
금리상승/NNG;영향/NNG;받/VV,-1,-0.5148554095214042,39,13,26,18,0.20963988932092723,0.653181045621481
리스크/NNG;요인이/VVX,-1,-0.5260640342940135,45,15,30,43,0.2120792702354892,0.6813758021156157
수출/NNG;증가했/VVX,-1,-0.5300759718340011,62,21,41,45,0.2295556957089985,0.7457613172158939
물가상승률/NNG;접근하/VVX,-1,-0.5310021658269894,22,7,15,22,0.17561568392531698,0.5719955028978451
부양책/NNG;쓸/VV,-1,-0.5310021658269894,22,7,15,16,0.17561568392531698,0.5719955028978451
금리인하/NNG;하/VV;않/VX,-1,-0.5310021658269894,22,7,15,11,0.17561568392531698,0.5719955028978451
통화완화/NNG;따른/VV,-1,-0.5310021658269894,22,7,15,37,0.17561568392531698,0.5719955028978451
투자심리/NNG;부담/NNG;줬/VV,-1,-0.5310021658269894,22,7,15,13,0.17561568392531698,0.5719955028978451
정책금리인상/NNG;단행되/VVX,-1,-0.5310021658269894,22,7,15,13,0.17561568392531698,0.5719955028978451
성장률/NNG;유지할/VVX,-1,-0.5310021658269894,22,7,15,30,0.17561568392531698,0.5719955028978451
경기/NNG;악화되/VVX;않/VX,-1,-0.5310021658269894,22,7,15,16,0.17561568392531698,0.5719955028978451
신용등급/NNG;하향조정되/VVX,-1,-0.5310021658269894,22,7,15,20,0.17561568392531698,0.5719955028978451
인플레이션/NNG;웃돌/VV,-1,-0.5310021658269894,22,7,15,8,0.17561568392531698,0.5719955028978451
금리/NNG;안정된/VVX,-1,-0.5310628850018235,19,6,13,29,0.17052390487566307,0.5555049080296798
물가상승률/NNG;인해/VV,-1,-0.5310628850018235,19,6,13,18,0.17052390487566307,0.5555049080296798
소비/NNG;늘릴/VV,-1,-0.5310628850018235,19,6,13,9,0.17052390487566307,0.5555049080296798
부동산가격상승/NNG;따른/VV,-1,-0.5310628850018235,19,6,13,4,0.17052390487566307,0.5555049080296798
통화완화/NNG;이어질/VV,-1,-0.5310628850018235,19,6,13,22,0.17052390487566307,0.5555049080296798
경제지표/NNG;개선될/VVX,-1,-0.5310628850018235,19,6,13,33,0.17052390487566307,0.5555049080296798
금리인상/NNG;단행함/VVX,-1,-0.5310628850018235,19,6,13,11,0.17052390487566307,0.5555049080296798
채권시장/NNG;악재/NNG;작용할/VVX,-1,-0.5310628850018235,19,6,13,15,0.17052390487566307,0.5555049080296798
유동성/NNG;넘치/VV,-1,-0.5310628850018235,19,6,13,10,0.17052390487566307,0.5555049080296798
소비자물가/NNG;상승/NNG;영향/NNG;미칠/VV,-1,-0.5310628850018235,19,6,13,13,0.17052390487566307,0.5555049080296798
금리인상/NNG;예상됐/VVX,-1,-0.5310628850018235,19,6,13,6,0.17052390487566307,0.5555049080296798
금리/NNG;큰/VA;상승함/VVX,-1,-0.5310628850018235,19,6,13,12,0.17052390487566307,0.5555049080296798
생산자/NNG;물가/NNG;상승하/VVX,-1,-0.5310628850018235,19,6,13,17,0.17052390487566307,0.5555049080296798
금리상승/NNG;지지하/VVX,-1,-0.5310628850018235,19,6,13,20,0.17052390487566307,0.5555049080296798
물가/NNG;반영되/VVX,-1,-0.5310628850018235,19,6,13,16,0.17052390487566307,0.5555049080296798
투자심리/NNG;부정적/VAX;작용했/VVX,-1,-0.5310628850018235,19,6,13,6,0.17052390487566307,0.5555049080296798
금리인하/NNG;반대하/VVX,-1,-0.5325553229004882,25,8,17,16,0.17982514292941879,0.5882435597565538
금리인하/NNG;가능성/NNG;시사하/VVX,-1,-0.5325553229004882,25,8,17,30,0.17982514292941879,0.5882435597565538
기준금리인상/NNG;그칠/VV,-1,-0.5325553229004882,25,8,17,8,0.17982514292941879,0.5882435597565538
저성장/NNG;따른/VV,-1,-0.5325553229004882,25,8,17,20,0.17982514292941879,0.5882435597565538
흑자/NNG;돌아섰/VV,-1,-0.5325553229004882,25,8,17,21,0.17982514292941879,0.5882435597565538
금리인하/NNG;따른/VV,-1,-0.5331976644533796,292,101,191,179,0.27822091727897963,0.9117468432904048
금리/NNG;상승세/NNG;나타났/VV,-1,-0.5339406967776842,16,5,11,14,0.16408911296330161,0.5388461936532715
기준금리인하/NNG;기대감/NNG;커지/VV,-1,-0.5339406967776842,16,5,11,21,0.16408911296330161,0.5388461936532715
경제/NNG;감당할/VVX,-1,-0.5339406967776842,16,5,11,4,0.16408911296330161,0.5388461936532715
신용등급/NNG;하향될/VVX,-1,-0.5339406967776842,16,5,11,8,0.16408911296330161,0.5388461936532715
적자/NNG;국채발행/NNG;따른/VV,-1,-0.5339406967776842,16,5,11,8,0.16408911296330161,0.5388461936532715
투자심리/NNG;긍정적/VAX;작용하/VVX,-1,-0.5339406967776842,16,5,11,13,0.16408911296330161,0.5388461936532715
재정적자감축/NNG;위해/VV,-1,-0.5339406967776842,16,5,11,6,0.16408911296330161,0.5388461936532715
성장/NNG;그친/VV,-1,-0.5339406967776842,16,5,11,6,0.16408911296330161,0.5388461936532715
경제지표악화/NNG;따른/VV,-1,-0.5339406967776842,16,5,11,12,0.16408911296330161,0.5388461936532715
시장금리/NNG;하락/NNG;제한될/VVX,-1,-0.5339406967776842,16,5,11,17,0.16408911296330161,0.5388461936532715
금융시장/NNG;진정시/VVX,-1,-0.5339406967776842,16,5,11,7,0.16408911296330161,0.5388461936532715
실물경제/NNG;미치/VV;영향/NNG;제한적/VAX,-1,-0.5339406967776842,16,5,11,16,0.16408911296330161,0.5388461936532715
수출/NNG;크/VA;의존하/VVX,-1,-0.5339406967776842,16,5,11,7,0.16408911296330161,0.5388461936532715
성장/NNG;이끄/VV,-1,-0.5339406967776842,16,5,11,5,0.16408911296330161,0.5388461936532715
소비자물가/NNG;오를/VV,-1,-0.5339406967776842,16,5,11,14,0.16408911296330161,0.5388461936532715
금리/NNG;상승/NNG;이끌/VV,-1,-0.5339406967776842,16,5,11,5,0.16408911296330161,0.5388461936532715
금리/NNG;올릴/VV;필요/NNG;없/VA,-1,-0.5339406967776842,16,5,11,15,0.16408911296330161,0.5388461936532715
디플레이션/NNG;빠져/VV,-1,-0.5339406967776842,16,5,11,10,0.16408911296330161,0.5388461936532715
채권시장강세/NNG;견인하/VVX,-1,-0.5339406967776842,16,5,11,12,0.16408911296330161,0.5388461936532715
성장세/NNG;예상되/VVX,-1,-0.5339406967776842,16,5,11,11,0.16408911296330161,0.5388461936532715
경기회복/NNG;지연/NNG;따른/VV,-1,-0.5339406967776842,16,5,11,10,0.16408911296330161,0.5388461936532715
내수/NNG;위축될/VVX,-1,-0.5339406967776842,16,5,11,11,0.16408911296330161,0.5388461936532715
물가/NNG;하락하/VVX,-1,-0.534565926377371,79,27,52,71,0.24214249176914276,0.7965528856297036
금리인하기대/NNG;지속될/VVX,-1,-0.5350506128721393,28,9,19,31,0.18341931581049678,0.6041951113603163
금리/NNG;인상할/VVX;없/VA,-1,-0.5350506128721393,28,9,19,15,0.18341931581049678,0.6041951113603163
금리인하/NNG;가능성/NNG;제기되/VVX,-1,-0.5350506128721393,28,9,19,31,0.18341931581049678,0.6041951113603163
변동성/NNG;완화하/VVX,-1,-0.5350506128721393,28,9,19,24,0.18341931581049678,0.6041951113603163
금융시장/NNG;안정/NNG;찾/VV,-1,-0.5358389595710539,51,17,34,35,0.21437385382516339,0.7077210501929252
금리동결/NNG;주장했/VVX,-1,-0.5380886368866675,31,10,21,35,0.18656362354520645,0.6198088525822484
수출/NNG;늘어난/VV,-1,-0.5380886368866675,31,10,21,19,0.18656362354520645,0.6198088525822484
마이너스성장/NNG;할/VV,-1,-0.5414208726731841,34,11,23,13,0.1893660672826617,0.6350521442796547
금리인하/NNG;가능성/NNG;배제하/VVX,-1,-0.5448875833245774,37,12,25,26,0.19190023448048837,0.6498987930966353
투자심리/NNG;호전시/VVX,-1,-0.5518398048854,43,14,29,26,0.1963573919301582,0.6783221091100444
금융시장/NNG;안정/NNG;되찾/VV,-1,-0.5518398048854,43,14,29,34,0.1963573919301582,0.6783221091100444
소비/NNG;늘어날/VV,-1,-0.5584603657340864,49,16,33,28,0.20020667857504804,0.7049578438217587
소매판매/NNG;감소했/VVX,-1,-0.5783041234968627,32,10,22,28,0.16912493274290188,0.6314001884704856
변동성/NNG;보였/VV,-1,-0.5783041234968627,32,10,22,14,0.16912493274290188,0.6314001884704856
인플레이션압력/NNG;높이/VV,-1,-0.5792249410199107,29,9,20,15,0.16456901990818576,0.6160915512861865
시장금리/NNG;급등했/VVX,-1,-0.5792249410199107,29,9,20,19,0.16456901990818576,0.6160915512861865
물가상승률/NNG;둔화될/VVX,-1,-0.5792249410199107,29,9,20,8,0.16456901990818576,0.6160915512861865
금리상승/NNG;예상된/VVX,-1,-0.5792249410199107,29,9,20,33,0.16456901990818576,0.6160915512861865
성장세/NNG;유지하/VVX,-1,-0.5808745931176169,76,25,51,85,0.21309859792063285,0.8017381728154563
불안심리/NNG;확산되/VVX,-1,-0.5813516847433405,44,14,30,32,0.1827941490810443,0.6887135083256603
변동성/NNG;크/VA;확대된/VVX,-1,-0.5815351010361507,26,8,18,7,0.15927946360728154,0.6004491849340735
금리인하기대감/NNG;유지될/VVX,-1,-0.5815351010361507,26,8,18,36,0.15927946360728154,0.6004491849340735
연방기금금리/NNG;인상했/VVX,-1,-0.5859414183215219,23,7,16,16,0.152998398970508,0.5845159077993491
금리인하/NNG;주장하/VVX;소수의견/NNG,-1,-0.5859414183215219,23,7,16,18,0.152998398970508,0.5845159077993491
경제성장/NNG;지속하/VVX,-1,-0.5859414183215219,23,7,16,9,0.152998398970508,0.5845159077993491
경기회복/NNG;찬물/NNG;끼얹/VV,-1,-0.5859414183215219,23,7,16,23,0.152998398970508,0.5845159077993491
동결/NNG;지속될/VVX,-1,-0.5859414183215219,23,7,16,16,0.152998398970508,0.5845159077993491
불안/NNG;가중시/VVX,-1,-0.5859414183215219,23,7,16,24,0.152998398970508,0.5845159077993491
경기/NNG;과도한/VAX;위축/NNG;방지하/VVX,-1,-0.5859414183215219,23,7,16,0,0.152998398970508,0.5845159077993491
성장률/NNG;하회하/VVX,-1,-0.5859414183215219,23,7,16,16,0.152998398970508,0.5845159077993491
경제/NNG;부양할/VVX,-1,-0.5859414183215219,23,7,16,13,0.152998398970508,0.5845159077993491
금리인하/NNG;점치/VV,-1,-0.5859414183215219,23,7,16,11,0.152998398970508,0.5845159077993491
재정확대/NNG;따른/VV,-1,-0.5859414183215219,23,7,16,17,0.152998398970508,0.5845159077993491
금리/NNG;하향안정화되/VVX,-1,-0.5859414183215219,23,7,16,18,0.152998398970508,0.5845159077993491
신용경색/NNG;완화되/VVX,-1,-0.5893359175905484,59,19,40,17,0.19438240800879675,0.7503435679041208
기준금리동결/NNG;결정했/VVX,-1,-0.593587303032938,20,6,14,19,0.14532592935777772,0.5683466979241429
가계부채/NNG;늘/VV,-1,-0.593587303032938,20,6,14,27,0.14532592935777772,0.5683466979241429
수입/NNG;증가했/VVX,-1,-0.593587303032938,20,6,14,19,0.14532592935777772,0.5683466979241429
경기/NNG;회복/NNG;보이/VV,-1,-0.593587303032938,20,6,14,9,0.14532592935777772,0.5683466979241429
물가상승률/NNG;웃돌/VV,-1,-0.593587303032938,20,6,14,12,0.14532592935777772,0.5683466979241429
고용지표/NNG;개선될/VVX,-1,-0.593587303032938,20,6,14,14,0.14532592935777772,0.5683466979241429
기준금리인하/NNG;예상되/VVX,-1,-0.593587303032938,20,6,14,19,0.14532592935777772,0.5683466979241429
금리상승/NNG;될/VV,-1,-0.593587303032938,20,6,14,14,0.14532592935777772,0.5683466979241429
물가/NNG;안정세/NNG;유지할/VVX,-1,-0.593587303032938,20,6,14,5,0.14532592935777772,0.5683466979241429
경제/NNG;떠받치/VV,-1,-0.593587303032938,20,6,14,24,0.14532592935777772,0.5683466979241429
디레버리징/NNG;진행되/VVX,-1,-0.593587303032938,20,6,14,19,0.14532592935777772,0.5683466979241429
적자/NNG;내/VV,-1,-0.593587303032938,20,6,14,8,0.14532592935777772,0.5683466979241429
경기/NNG;악화하/VVX,-1,-0.593587303032938,20,6,14,20,0.14532592935777772,0.5683466979241429
신용경색/NNG;따른/VV,-1,-0.5975726714727375,77,25,52,36,0.20432621069575932,0.8089968640616975
마이너스/NNG;전환된/VVX,-1,-0.6064266921695727,17,5,12,9,0.13561036467764767,0.5520140810349689
성장/NNG;하방위험/NNG;작용할/VVX,-1,-0.6064266921695727,17,5,12,5,0.13561036467764767,0.5520140810349689
경기회복/NNG;예상되/VVX,-1,-0.6064266921695727,17,5,12,6,0.13561036467764767,0.5520140810349689
경기회복/NNG;맞춰/VV,-1,-0.6064266921695727,17,5,12,10,0.13561036467764767,0.5520140810349689
물가안정/NNG;작용할/VVX,-1,-0.6064266921695727,17,5,12,9,0.13561036467764767,0.5520140810349689
시장금리/NNG;하방경직성/NNG;강화되/VVX,-1,-0.6064266921695727,17,5,12,7,0.13561036467764767,0.5520140810349689
수입/NNG;증가해/VVX,-1,-0.6064266921695727,17,5,12,12,0.13561036467764767,0.5520140810349689
내수부진/NNG;이어지/VV,-1,-0.6064266921695727,17,5,12,24,0.13561036467764767,0.5520140810349689
재정지출/NNG;따른/VV,-1,-0.6064266921695727,17,5,12,10,0.13561036467764767,0.5520140810349689
금융위기/NNG;해결하/VVX,-1,-0.6064266921695727,17,5,12,13,0.13561036467764767,0.5520140810349689
기준금리/NNG;인하돼/VVX,-1,-0.6064266921695727,17,5,12,8,0.13561036467764767,0.5520140810349689
원자재가격/NNG;급등/NNG;따른/VV,-1,-0.6064266921695727,17,5,12,7,0.13561036467764767,0.5520140810349689
마이너스/NNG;진입하/VVX,-1,-0.6064266921695727,17,5,12,9,0.13561036467764767,0.5520140810349689
불확실성/NNG;증폭시/VVX,-1,-0.6064266921695727,17,5,12,17,0.13561036467764767,0.5520140810349689
성장세/NNG;약화되/VVX,-1,-0.6064266921695727,17,5,12,29,0.13561036467764767,0.5520140810349689
경제/NNG;성장세/NNG;둔화되/VVX,-1,-0.6064266921695727,17,5,12,7,0.13561036467764767,0.5520140810349689
인플레이션/NNG;높/VA;질/VX;있/VV,-1,-0.6064266921695727,17,5,12,7,0.13561036467764767,0.5520140810349689
불안심리/NNG;지속되/VVX,-1,-0.6064266921695727,17,5,12,14,0.13561036467764767,0.5520140810349689
하방리스크/NNG;완화되/VVX,-1,-0.6064266921695727,17,5,12,20,0.13561036467764767,0.5520140810349689
양적완화/NNG;발표하/VVX,-1,-0.6064266921695727,17,5,12,13,0.13561036467764767,0.5520140810349689
금리/NNG;하락세/NNG;나타나/VV,-1,-0.6064266921695727,17,5,12,8,0.13561036467764767,0.5520140810349689
금리/NNG;하락했/VVX;국고/NNG,-1,-0.6064266921695727,17,5,12,5,0.13561036467764767,0.5520140810349689
금리인하/NNG;예상했/VVX,-1,-0.6091814744587076,45,14,31,25,0.1701600132613249,0.6987157797838707
실물경제/NNG;영향/NNG;미치/VV,-1,-0.6091814744587076,45,14,31,28,0.1701600132613249,0.6987157797838707
경기둔화/NNG;막/VV,-1,-0.6103213779841996,60,19,41,31,0.18416323099838672,0.758959092823668
금리인하기대/NNG;반영하/VVX,-1,-0.6108480469152198,39,12,27,43,0.16265201096798065,0.671432793697604
신용경색/NNG;완화하/VVX,-1,-0.6126883379504761,36,11,25,25,0.15826096729440917,0.6571513658450733
금리/NNG;상승압력/NNG;작용할/VVX,-1,-0.6126883379504761,36,11,25,22,0.15826096729440917,0.6571513658450733
기준금리/NNG;내리/VV,-1,-0.6146160411604709,305,99,206,213,0.22324787986796146,0.9327351196383299
경제/NNG;회복세/NNG;나타내/VV,-1,-0.61555258313012,33,10,23,19,0.153311778991183,0.6424686092455711
물가/NNG;영향/NNG;미치/VV,-1,-0.6198456844878864,30,9,21,22,0.14765890398476147,0.6274095319592339
물가상승률/NNG;달성하/VVX,-1,-0.6198456844878864,30,9,21,27,0.14765890398476147,0.6274095319592339
단기금리/NNG;급등하/VVX,-1,-0.6261580047710723,27,8,19,14,0.1410991705758338,0.6120050089650854
금리/NNG;올리/VV;어렵/VA,-1,-0.6261580047710723,27,8,19,20,0.1410991705758338,0.6120050089650854
불확실성/NNG;줄/VV,-1,-0.6261580047710723,27,8,19,17,0.1410991705758338,0.6120050089650854
금리인하/NNG;그칠/VV,-1,-0.6261580047710723,27,8,19,22,0.1410991705758338,0.6120050089650854
채권시장/NNG;부담/NNG;작용하/VVX,-1,-0.6261580047710723,27,8,19,20,0.1410991705758338,0.6120050089650854
금융위기/NNG;직후인/VVX,-1,-0.633666252748286,49,15,34,62,0.16216777939645113,0.7210739905355932
통화정책/NNG;완화하/VVX,-1,-0.6353439291737171,46,14,32,41,0.15841838897150395,0.7083598119766019
gdp/NNG;감소하/VVX,-1,-0.6353758423811894,24,7,17,31,0.13334139038313247,0.5962929394945613
기준금리인하/NNG;통한/VV,-1,-0.6353758423811894,24,7,17,32,0.13334139038313247,0.5962929394945613
수출/NNG;급감하/VVX,-1,-0.6375860579977068,43,13,30,14,0.15430887555776304,0.6951915024695919
경제지표/NNG;혼조세/NNG;보이/VV,-1,-0.6405735695370558,40,12,28,41,0.14977098591346152,0.6815793301415951
물가/NNG;떨어지/VV,-1,-0.6405735695370558,40,12,28,20,0.14977098591346152,0.6815793301415951
수출/NNG;감소했/VVX,-1,-0.6426950117063999,86,27,59,56,0.1841039863583903,0.8438707669710468
금리상승/NNG;예상되/VVX,-1,-0.6445499296180544,37,11,26,37,0.14471685679525823,0.6675369094539392
신용경색/NNG;발생하/VVX,-1,-0.6488764212258405,21,6,15,16,0.1239562758049565,0.5803196555380301
금리상승압력/NNG;우세할/VVX,-1,-0.6488764212258405,21,6,15,15,0.1239562758049565,0.5803196555380301
경기부진/NNG;이어질/VV,-1,-0.6488764212258405,21,6,15,10,0.1239562758049565,0.5803196555380301
경제성장/NNG;힘입/VV,-1,-0.6488764212258405,21,6,15,9,0.1239562758049565,0.5803196555380301
고용지표/NNG;밑돌/VV,-1,-0.6488764212258405,21,6,15,15,0.1239562758049565,0.5803196555380301
통화완화/NNG;지속되/VVX,-1,-0.6488764212258405,21,6,15,19,0.1239562758049565,0.5803196555380301
변동성/NNG;제한된/VVX,-1,-0.6488764212258405,21,6,15,32,0.1239562758049565,0.5803196555380301
통화완화정책/NNG;지속될/VVX,-1,-0.6488764212258405,21,6,15,17,0.1239562758049565,0.5803196555380301
고용지표/NNG;개선되/VVX,-1,-0.6498477779965706,34,10,24,42,0.13903165033647183,0.6530815705379639
투자심리/NNG;약화시/VVX,-1,-0.6498477779965706,34,10,24,15,0.13903165033647183,0.6530815705379639
경제지표/NNG;악화되/VVX,-1,-0.6544292309384381,53,16,37,19,0.15549880932604712,0.7421409611660674
금리상승압력/NNG;작용할/VVX,-1,-0.654970183128256,90,28,62,83,0.1790560792503058,0.856186793976401
경기/NNG;부진할/VVX,-1,-0.6568742929043292,50,15,35,31,0.15168113778088924,0.7301395616890062
금리인하/NNG;지속될/VVX,-1,-0.6569296321563705,31,9,22,8,0.13256284642892532,0.6382347498220479
동결/NNG;예상되/VVX,-1,-0.6569296321563705,31,9,22,25,0.13256284642892532,0.6382347498220479
고용지표/NNG;호조/NNG;보일/VV,-1,-0.659870221096601,47,14,33,4,0.14752690779608774,0.7176721555904139
추가경정예산/NNG;편성하/VVX,-1,-0.6688855687634525,18,5,13,16,0.112293172609957,0.564141236382661
경기/NNG;회복됐/VVX,-1,-0.6688855687634525,18,5,13,10,0.112293172609957,0.564141236382661
물가/NNG;급등했/VVX,-1,-0.6688855687634525,18,5,13,9,0.112293172609957,0.564141236382661
금융안정/NNG;유의할/VVX,-1,-0.6688855687634525,18,5,13,9,0.112293172609957,0.564141236382661
실물경제/NNG;개선되/VVX,-1,-0.6688855687634525,18,5,13,5,0.112293172609957,0.564141236382661
소비자물가상승률/NNG;머물/VV,-1,-0.6688855687634525,18,5,13,9,0.112293172609957,0.564141236382661
성장률/NNG;미치/VV;못할/VX,-1,-0.6688855687634525,18,5,13,16,0.112293172609957,0.564141236382661
재정위기/NNG;지속되/VVX,-1,-0.6688855687634525,18,5,13,18,0.112293172609957,0.564141236382661
금리인하/NNG;실시할/VVX,-1,-0.6688855687634525,18,5,13,26,0.112293172609957,0.564141236382661
저성장/NNG;벗어나/VV,-1,-0.6688855687634525,18,5,13,12,0.112293172609957,0.564141236382661
금리인상/NNG;시작해/VVX,-1,-0.6688855687634525,18,5,13,17,0.112293172609957,0.564141236382661
변동성/NNG;나타내/VV,-1,-0.6751693664110445,54,16,38,29,0.14604524128440685,0.7506655817305895
경기회복/NNG;지속되/VVX,-1,-0.6751693664110445,54,16,38,44,0.14604524128440685,0.7506655817305895
기준금리인상/NNG;단행할/VVX,-1,-0.6786644530231203,51,15,36,48,0.14191991012233476,0.7389062843683004
기준금리/NNG;인하함/VVX,-1,-0.6786644530231203,51,15,36,37,0.14191991012233476,0.7389062843683004
수출/NNG;위축될/VVX,-1,-0.6793644562835695,25,7,18,8,0.11637442506823997,0.607475008908729
성장률/NNG;하향조정될/VVX,-1,-0.6793644562835695,25,7,18,27,0.11637442506823997,0.607475008908729
유동성함정/NNG;빠질/VV,-1,-0.6793644562835695,25,7,18,3,0.11637442506823997,0.607475008908729
경기/NNG;살아나/VV;않/VX,-1,-0.6812611053505798,35,10,25,34,0.12617607128490416,0.6632932371341632
성장세/NNG;둔화됐/VVX,-1,-0.6812611053505798,35,10,25,19,0.12617607128490416,0.6632932371341632
금리/NNG;내려/VV,-1,-0.6867947235245394,99,30,69,87,0.16443883890057606,0.8825490016949187
금리인하/NNG;압박하/VVX,-1,-0.6905772475985041,32,9,23,34,0.11913382007568173,0.6486343691980565
침체/NNG;인해/VV,-1,-0.6905772475985041,32,9,23,10,0.11913382007568173,0.6486343691980565
추경/NNG;따른/VV,-1,-0.691897870454367,148,45,103,140,0.17101450856511233,0.9358100818067034
만장일치/NNG;기준금리/NNG;동결했/VVX,-1,-0.6970784135942163,22,6,16,30,0.10598117263180205,0.5916277071411262
신용경색/NNG;해소되/VVX,-1,-0.6970784135942163,22,6,16,10,0.10598117263180205,0.5916277071411262
금리/NNG;하향안정될/VVX,-1,-0.6970784135942163,22,6,16,17,0.10598117263180205,0.5916277071411262
통화완화정책/NNG;펴/VV,-1,-0.6970784135942163,22,6,16,15,0.10598117263180205,0.5916277071411262
유동성함정/NNG;빠지/VV;않/VX,-1,-0.6970784135942163,22,6,16,5,0.10598117263180205,0.5916277071411262
금리인하/NNG;예상됨/VVX,-1,-0.6970784135942163,22,6,16,15,0.10598117263180205,0.5916277071411262
소비/NNG;촉진하/VVX,-1,-0.6970784135942163,22,6,16,15,0.10598117263180205,0.5916277071411262
경제성장/NNG;지탱하/VVX,-1,-0.6970784135942163,22,6,16,12,0.10598117263180205,0.5916277071411262
소비자물가상승률/NNG;그치/VV,-1,-0.6991489143839476,15,4,11,6,0.09734719108389382,0.5478229749731454
경기/NNG;확장국면/NNG;있/VV,-1,-0.6991489143839476,15,4,11,10,0.09734719108389382,0.5478229749731454
경기부양/NNG;있/VV,-1,-0.6991489143839476,15,4,11,14,0.09734719108389382,0.5478229749731454
금리/NNG;상승세/NNG;제한하/VVX,-1,-0.6991489143839476,15,4,11,13,0.09734719108389382,0.5478229749731454
경제회복/NNG;발목/NNG;잡/VV,-1,-0.6991489143839476,15,4,11,14,0.09734719108389382,0.5478229749731454
임금인상/NNG;따른/VV,-1,-0.6991489143839476,15,4,11,8,0.09734719108389382,0.5478229749731454
금리/NNG;하락세/NNG;전환되/VVX,-1,-0.6991489143839476,15,4,11,11,0.09734719108389382,0.5478229749731454
금리/NNG;큰/VA;영향/NNG;미치/VV,-1,-0.6991489143839476,15,4,11,8,0.09734719108389382,0.5478229749731454
경기둔화우려/NNG;부각돼/VVX,-1,-0.6991489143839476,15,4,11,13,0.09734719108389382,0.5478229749731454
콜금리/NNG;내리/VV,-1,-0.6991489143839476,15,4,11,7,0.09734719108389382,0.5478229749731454
금리/NNG;상승했/VVX;국고/NNG,-1,-0.6991489143839476,15,4,11,4,0.09734719108389382,0.5478229749731454
유동성/NNG;공급한/VVX,-1,-0.6991489143839476,15,4,11,15,0.09734719108389382,0.5478229749731454
유동성/NNG;확대하/VVX,-1,-0.6991489143839476,15,4,11,21,0.09734719108389382,0.5478229749731454
불안/NNG;완화시/VVX,-1,-0.6991489143839476,15,4,11,12,0.09734719108389382,0.5478229749731454
금리/NNG;고점인/VVX,-1,-0.6991489143839476,15,4,11,11,0.09734719108389382,0.5478229749731454
경기회복/NNG;기대감/NNG;높였/VV,-1,-0.6991489143839476,15,4,11,18,0.09734719108389382,0.5478229749731454
잠재성장률/NNG;끌어올리/VV,-1,-0.6991489143839476,15,4,11,9,0.09734719108389382,0.5478229749731454
재정적자/NNG;확대되/VVX,-1,-0.6991489143839476,15,4,11,10,0.09734719108389382,0.5478229749731454
불확실성/NNG;반영된/VVX,-1,-0.6991489143839476,15,4,11,9,0.09734719108389382,0.5478229749731454
경기/NNG;미칠/VV;영향/NNG,-1,-0.6991489143839476,15,4,11,8,0.09734719108389382,0.5478229749731454
정치적/VAX;불확실성/NNG;완화되/VVX,-1,-0.6991489143839476,15,4,11,11,0.09734719108389382,0.5478229749731454
마이너스성장/NNG;기록할/VVX,-1,-0.6991489143839476,15,4,11,6,0.09734719108389382,0.5478229749731454
기준금리/NNG;역전되/VVX,-1,-0.7009920715103409,39,11,28,44,0.12123806948052288,0.6872037339784927
주택가격하락/NNG;따른/VV,-1,-0.7009920715103409,39,11,28,21,0.12123806948052288,0.6872037339784927
금리인하/NNG;더불/VV,-1,-0.7025683537913415,29,8,21,11,0.11108871684680591,0.6335859780070574
금리인하/NNG;위한/VV,-1,-0.7099093359741678,36,10,26,25,0.11462894446195761,0.6731473723285463
금리인하/NNG;가능성/NNG;있/VV,-1,-0.7129973445490043,56,16,40,23,0.1289774261743866,0.7669072445440354
하방위험/NNG;커졌/VV,-1,-0.7181601774069111,26,7,19,11,0.10179355519650825,0.6181710654915844
금리/NNG;낮/VA;유지할/VVX,-1,-0.7209524749946978,33,9,24,40,0.10721654474549731,0.6586614149542489
마이너스/NNG;돌아설/VV,-1,-0.7217229202948153,19,5,14,13,0.09338309306958847,0.5755180302705145
채권시장/NNG;강세/NNG;나타냈/VV,-1,-0.7217229202948153,19,5,14,12,0.09338309306958847,0.5755180302705145
경제성장률/NNG;낮춰/VV,-1,-0.7217229202948153,19,5,14,11,0.09338309306958847,0.5755180302705145
경기회복/NNG;무게/NNG;두/VV,-1,-0.7217229202948153,19,5,14,5,0.09338309306958847,0.5755180302705145
양적완화/NNG;실시할/VVX,-1,-0.7217229202948153,19,5,14,18,0.09338309306958847,0.5755180302705145
경기/NNG;진작시/VVX,-1,-0.7217229202948153,19,5,14,11,0.09338309306958847,0.5755180302705145
기준금리/NNG;내린/VV;이/VV,-1,-0.7217229202948153,19,5,14,11,0.09338309306958847,0.5755180302705145
신용등급/NNG;낮추/VV,-1,-0.7217229202948153,19,5,14,18,0.09338309306958847,0.5755180302705145
채권시장/NNG;강세/NNG;이끌/VV,-1,-0.7217229202948153,19,5,14,28,0.09338309306958847,0.5755180302705145
금리인상/NNG;가능성/NNG;높여/VV,-1,-0.7217229202948153,19,5,14,13,0.09338309306958847,0.5755180302705145
인플레이션/NNG;억제할/VVX,-1,-0.7217229202948153,19,5,14,12,0.09338309306958847,0.5755180302705145
시장금리/NNG;오르/VV,-1,-0.7241364092842696,50,14,36,57,0.11948379623943958,0.7438334673396878
금리인하/NNG;단행된/VVX,-1,-0.724990294276352,60,17,43,58,0.1256837481434368,0.7852387307186307
금리상승/NNG;제한될/VVX,-1,-0.7355350542036503,104,30,74,109,0.13826216704261918,0.9036112706396106
불안/NNG;반영하/VVX,-1,-0.7386518405437232,23,6,17,10,0.09093074771647898,0.602413766333531
내수부진/NNG;심화되/VVX,-1,-0.7386518405437232,23,6,17,4,0.09093074771647898,0.602413766333531
인플레이션/NNG;위험/NNG;남/VV,-1,-0.7386518405437232,23,6,17,5,0.09093074771647898,0.602413766333531
물가안정/NNG;유지되/VVX,-1,-0.7390250726063698,44,12,32,42,0.10832576296692967,0.7188314748906721
금리/NNG;인하할/VVX;가능성/NNG;낮/VA,-1,-0.7521446010553183,27,7,20,5,0.08929319263473699,0.6284619905381748
수출/NNG;증가세/NNG;보이/VV,-1,-0.7521446010553183,27,7,20,2,0.08929319263473699,0.6284619905381748
금융시장안정/NNG;위해/VV,-1,-0.7549322541547057,79,22,57,63,0.11987272296790434,0.85459676762527
금리/NNG;하락세/NNG;나타냈/VV,-1,-0.7565193399103649,16,4,12,13,0.07785909280418206,0.5591798106456768
시장금리/NNG;떨어지/VV,-1,-0.7565193399103649,16,4,12,12,0.07785909280418206,0.5591798106456768
큰/VA;금리하락/NNG;기대하/VVX,-1,-0.7565193399103649,16,4,12,5,0.07785909280418206,0.5591798106456768
유동성/NNG;지원할/VVX,-1,-0.7565193399103649,16,4,12,5,0.07785909280418206,0.5591798106456768
인플레이션압력/NNG;줄/VV,-1,-0.7565193399103649,16,4,12,5,0.07785909280418206,0.5591798106456768
자본확충/NNG;지원하/VVX,-1,-0.7565193399103649,16,4,12,10,0.07785909280418206,0.5591798106456768
기대인플레이션/NNG;억제하/VVX,-1,-0.7565193399103649,16,4,12,10,0.07785909280418206,0.5591798106456768
금리인하/NNG;기대하/VVX;쉽/VA;않/VX,-1,-0.7565193399103649,16,4,12,10,0.07785909280418206,0.5591798106456768
성장률/NNG;하향조정할/VVX,-1,-0.7565193399103649,16,4,12,12,0.07785909280418206,0.5591798106456768
경기/NNG;악화시/VVX,-1,-0.7565193399103649,16,4,12,12,0.07785909280418206,0.5591798106456768
성장경로/NNG;불확실성/NNG;높/VA;진/VX;판단된/VVX,-1,-0.7565193399103649,16,4,12,12,0.07785909280418206,0.5591798106456768
성장/NNG;저해하/VVX;않/VX,-1,-0.7565193399103649,16,4,12,8,0.07785909280418206,0.5591798106456768
수출/NNG;감소세/NNG;지속되/VVX,-1,-0.7565193399103649,16,4,12,8,0.07785909280418206,0.5591798106456768
성장/NNG;주도했/VVX,-1,-0.7565193399103649,16,4,12,15,0.07785909280418206,0.5591798106456768
물가상승/NNG;지속되/VVX,-1,-0.7565193399103649,16,4,12,9,0.07785909280418206,0.5591798106456768
금리인하/NNG;이/VV,-1,-0.7574920500902628,69,19,50,46,0.11432978426166805,0.8248451056073565
유동성/NNG;지원하/VVX,-1,-0.7598761312686981,52,14,38,34,0.10416463731509416,0.7599634428971523
시장금리/NNG;하락/NNG;제한되/VVX,-1,-0.7658519752873829,20,5,15,13,0.07811039755061215,0.58633572456791
마이너스/NNG;하락했/VVX,-1,-0.7658519752873829,20,5,15,11,0.07811039755061215,0.58633572456791
경제지표/NNG;개선된/VVX,-1,-0.7658519752873829,20,5,15,24,0.07811039755061215,0.58633572456791
인플레이션압력/NNG;커질/VV,-1,-0.7690876879440418,42,11,31,23,0.09369094898741623,0.7144048500532743
추경편성/NNG;따른/VV,-1,-0.7721345535660147,98,27,71,56,0.11658197029815202,0.9023308884366182
실업률/NNG;상승했/VVX,-1,-0.7727404442802562,35,9,26,26,0.08730540032148217,0.6777579324334876
경제/NNG;약화되/VVX,-1,-0.7742356510633146,24,6,18,12,0.07835234469958811,0.6127794769854928
설비투자/NNG;감소하/VVX,-1,-0.7742356510633146,24,6,18,21,0.07835234469958811,0.6127794769854928
성장세/NNG;꺾이/VV,-1,-0.7742356510633146,24,6,18,8,0.07835234469958811,0.6127794769854928
경기침체/NNG;대응하/VVX,-1,-0.7742356510633146,24,6,18,13,0.07835234469958811,0.6127794769854928
신용등급/NNG;하향조정할/VVX,-1,-0.7742356510633146,24,6,18,8,0.07835234469958811,0.6127794769854928
침체/NNG;이어질/VV,-1,-0.7772968609240443,46,12,34,30,0.09265130362747345,0.7357863490523757
수출부진/NNG;따른/VV,-1,-0.7808556858148006,39,10,29,22,0.0866801811668082,0.7008890910123438
경기활성화/NNG;위한/VV,-1,-0.7817693390697182,28,7,21,28,0.07858528811749665,0.6384084267474246
금리인하/NNG;여력/NNG;있/VV,-1,-0.7817693390697182,28,7,21,12,0.07858528811749665,0.6384084267474246
물가/NNG;영향/NNG;주/VV,-1,-0.7817693390697182,28,7,21,31,0.07858528811749665,0.6384084267474246
기준금리/NNG;밑돌/VV,-1,-0.7817693390697182,28,7,21,27,0.07858528811749665,0.6384084267474246
유동성/NNG;조이/VV,-1,-0.7885411859765601,32,8,24,9,0.07880956929821176,0.6631353272362698
내수/NNG;위축되/VVX,-1,-0.7940826735153503,47,12,35,18,0.0858381190445396,0.743905458635479
금융위기/NNG;대처하/VVX,-1,-0.7946296289905115,36,9,27,14,0.0790255175811417,0.6868882389601442
수출증가/NNG;힘입/VV,-1,-0.7946296289905115,36,9,27,19,0.0790255175811417,0.6868882389601442
정책금리/NNG;인하할/VVX,-1,-0.8019555527060662,91,24,67,34,0.09898916798349817,0.8957007865824832
재정적자확대/NNG;따른/VV,-1,-0.8021507315627551,17,4,13,5,0.06291970908336494,0.5699474558225571
정책금리/NNG;인하해/VVX,-1,-0.8021507315627551,17,4,13,10,0.06291970908336494,0.5699474558225571
성장세회복/NNG;지속되/VVX,-1,-0.8021507315627551,17,4,13,8,0.06291970908336494,0.5699474558225571
물가/NNG;높이/VV,-1,-0.8021507315627551,17,4,13,14,0.06291970908336494,0.5699474558225571
소매판매/NNG;감소해/VVX,-1,-0.8021507315627551,17,4,13,13,0.06291970908336494,0.5699474558225571
금융위기/NNG;해소되/VVX,-1,-0.8021507315627551,17,4,13,5,0.06291970908336494,0.5699474558225571
강한/VA;성장세/NNG;나타내/VV,-1,-0.8021507315627551,17,4,13,9,0.06291970908336494,0.5699474558225571
금리인하/NNG;필요할/VVX,-1,-0.8021507315627551,17,4,13,19,0.06291970908336494,0.5699474558225571
시장금리/NNG;올랐/VV,-1,-0.8021507315627551,17,4,13,9,0.06291970908336494,0.5699474558225571
콜금리/NNG;인상하/VVX;않/VX,-1,-0.8021507315627551,17,4,13,8,0.06291970908336494,0.5699474558225571
금리/NNG;급락한/VAX;따른/VV,-1,-0.8021507315627551,17,4,13,10,0.06291970908336494,0.5699474558225571
금리인하/NNG;지속되/VVX,-1,-0.8021507315627551,17,4,13,11,0.06291970908336494,0.5699474558225571
고용/NNG;유지하/VVX,-1,-0.8021507315627551,17,4,13,7,0.06291970908336494,0.5699474558225571
경기회복/NNG;걸림돌/NNG;작용할/VVX,-1,-0.8024142717180293,21,5,16,9,0.06577873124935547,0.5967228960747406
경제성장/NNG;저해할/VVX,-1,-0.8024142717180293,21,5,16,16,0.06577873124935547,0.5967228960747406
경기회복/NNG;기대감/NNG;확산되/VVX,-1,-0.8024142717180293,21,5,16,6,0.06577873124935547,0.5967228960747406
소비지출/NNG;증가했/VVX,-1,-0.8045426660807115,25,6,19,7,0.06783764501195479,0.6227980614742215
금리인하/NNG;단행함/VVX,-1,-0.80751011388369,29,7,22,18,0.06940919498024814,0.6480562443345064
금리인하/NNG;시사했/VVX,-1,-0.8141735886095607,37,9,28,18,0.07169068687754956,0.6957709031291707
성장/NNG;지지하/VVX,-1,-0.8298345787131876,30,7,23,14,0.06153537727373079,0.657440412556346
가계부채/NNG;늘어날/VV,-1,-0.8302851514775184,26,6,20,10,0.0590328684653791,0.632522854508609
유동성함정/NNG;빠지/VV,-1,-0.8302851514775184,26,6,20,3,0.0590328684653791,0.632522854508609
경기둔화/NNG;우려되/VVX,-1,-0.8325822543444259,22,5,17,16,0.05579769175494105,0.6067674910906847
금리스프레드/NNG;확대되/VVX,-1,-0.8325822543444259,22,5,17,35,0.05579769175494105,0.6067674910906847
경기부양/NNG;나선/VV,-1,-0.8325822543444259,22,5,17,19,0.05579769175494105,0.6067674910906847
물가/NNG;억제하/VVX,-1,-0.8382054019528176,18,4,14,18,0.051424513286392255,0.5802876316632244
성장세/NNG;기록하/VVX,-1,-0.8382054019528176,18,4,14,19,0.051424513286392255,0.5802876316632244
기준금리/NNG;내려/VV,-1,-0.8481721016417318,51,12,39,44,0.06406891877019541,0.77425508911627
금리인하/NNG;나선/VV,-1,-0.8491821140357142,31,7,24,35,0.05476537989652195,0.6665877781035945
불안요인/NNG;작용했/VVX,-1,-0.8491821140357142,31,7,24,12,0.05476537989652195,0.6665877781035945
소매판매/NNG;감소하/VVX,-1,-0.8521297001283098,27,6,21,25,0.051639225791377676,0.6419930764257777
기준금리/NNG;만장일치/NNG;동결되/VVX,-1,-0.8521297001283098,27,6,21,25,0.051639225791377676,0.6419930764257777
경기침체/NNG;진행되/VVX,-1,-0.8574451415107329,23,5,18,2,0.04768512747493699,0.6165305489793352
금리인하/NNG;선반영하/VVX,-1,-0.8574451415107329,23,5,18,19,0.04768512747493699,0.6165305489793352
수출경쟁력/NNG;높이/VV,-1,-0.8574451415107329,23,5,18,18,0.04768512747493699,0.6165305489793352
인플레이션/NNG;잘/MAG;제어되/VVX,-1,-0.8574451415107329,23,5,18,7,0.04768512747493699,0.6165305489793352
재정지출확대/NNG;따른/VV,-1,-0.8629208457821189,36,8,28,15,0.051837434099592794,0.6988244466956648
금리상승/NNG;과도했/VVX,-1,-0.8666613098449585,19,4,15,15,0.04251710801072442,0.5903034520797504
금리상승압력/NNG;확대될/VVX,-1,-0.8666613098449585,19,4,15,10,0.04251710801072442,0.5903034520797504
기준금리/NNG;근접하/VVX,-1,-0.8666613098449585,19,4,15,6,0.04251710801072442,0.5903034520797504
성장세회복/NNG;지원하/VVX,-1,-0.8671907073118783,65,15,50,41,0.06005497936617502,0.8373306548020961
기준금리/NNG;내린/VV,-1,-0.87771890895289,197,46,151,128,0.06454736058377573,0.9822522146674105
유동성/NNG;힘입/VV,-1,-0.8825061484083886,15,3,12,27,0.035498747223500875,0.5634378313041742
기준금리/NNG;인하한/VAX;있/VV,-1,-0.8825061484083886,15,3,12,19,0.035498747223500875,0.5634378313041742
물가상승압력/NNG;낮추/VV,-1,-0.8825061484083886,15,3,12,8,0.035498747223500875,0.5634378313041742
인플레이션압력/NNG;나타나/VV,-1,-0.8825061484083886,15,3,12,7,0.035498747223500875,0.5634378313041742
안전자산선호심리/NNG;강해/VV,-1,-0.8825061484083886,15,3,12,19,0.035498747223500875,0.5634378313041742
지준율/NNG;올린/VV,-1,-0.8825061484083886,15,3,12,5,0.035498747223500875,0.5634378313041742
성장/NNG;머물/VV,-1,-0.8891795048353015,20,4,16,13,0.03555327537758045,0.6000620154003328
경제지표/NNG;약화된/VVX,-1,-0.8891795048353015,20,4,16,6,0.03555327537758045,0.6000620154003328
물가/NNG;고려하/VVX,-1,-0.8949232070716943,25,5,20,14,0.03560558483848731,0.6353711147977479
지정학적리스크/NNG;고조되/VVX,-1,-0.9065168270708882,16,3,13,11,0.02844926024637406,0.5733658165102816
마이너스/NNG;전환했/VVX,-1,-0.9065168270708882,16,3,13,18,0.02844926024637406,0.5733658165102816
성장률/NNG;내려갈/VV,-1,-0.9065168270708882,16,3,13,19,0.02844926024637406,0.5733658165102816
투자심리/NNG;개선돼/VVX,-1,-0.9065168270708882,16,3,13,5,0.02844926024637406,0.5733658165102816
경기후퇴/NNG;제한하/VVX,-1,-0.9065168270708882,16,3,13,14,0.02844926024637406,0.5733658165102816
금리상승압력/NNG;높/VA;질/VX;예상된/VVX,-1,-0.9065168270708882,16,3,13,18,0.02844926024637406,0.5733658165102816
고용지표/NNG;호조/NNG;보임/VV,-1,-0.9065168270708882,16,3,13,6,0.02844926024637406,0.5733658165102816
경기진작/NNG;위한/VV,-1,-0.9065168270708882,16,3,13,12,0.02844926024637406,0.5733658165102816
마이너스성장/NNG;했/VV,-1,-0.9070901785890941,21,4,17,10,0.030055165382304332,0.6096076942399908
성장/NNG;도모하/VVX,-1,-0.9070901785890941,21,4,17,15,0.030055165382304332,0.6096076942399908
캐리트레이드/NNG;청산/NNG;매물/NNG;나와/VV,-1,-0.9070901785890941,21,4,17,4,0.030055165382304332,0.6096076942399908
기준금리/NNG;내린/VV;뒤/NNG,-1,-0.9070901785890941,21,4,17,22,0.030055165382304332,0.6096076942399908
물가안정/NNG;하회할/VVX,-1,-0.9070901785890941,21,4,17,5,0.030055165382304332,0.6096076942399908
마이너스성장/NNG;하/VV,-1,-0.9090088057874115,26,5,21,11,0.031095879687948396,0.6445007845868083
금리/NNG;내려도/VV,-1,-0.9113557470822171,31,6,25,17,0.031830675451844016,0.6778104493066998
경제성장률/NNG;낮춘/VV,-1,-0.9211972266704466,32,6,26,23,0.028550024747569104,0.6863228255084145
주택가격/NNG;떨어지/VV,-1,-0.9214306801702934,22,4,18,7,0.02566992977232447,0.6189701852802413
경기침체/NNG;이어질/VV,-1,-0.9233233956759145,42,8,34,20,0.03019574356941912,0.7465467760154015
경기/NNG;확장세/NNG;이/VV,-1,-0.9245110061440162,17,3,14,13,0.023209598393862163,0.583078933583744
물가상승/NNG;부추기/VV,-1,-0.9245110061440162,17,3,14,4,0.023209598393862163,0.583078933583744
환율변동성/NNG;커지/VV,-1,-0.9245110061440162,17,3,14,25,0.023209598393862163,0.583078933583744
경기회복/NNG;기대/NNG;확산되/VVX,-1,-0.9245110061440162,17,3,14,4,0.023209598393862163,0.583078933583744
흑자/NNG;낼/VV,-1,-0.9245110061440162,17,3,14,9,0.023209598393862163,0.583078933583744
경기부양책/NNG;고려하/VVX,-1,-0.9245110061440162,17,3,14,3,0.023209598393862163,0.583078933583744
신용등급/NNG;강등/NNG;따른/VV,-1,-0.9295207464464981,38,7,31,21,0.02691163194520316,0.7252665090181106
기대인플레이션/NNG;낮추/VV,-1,-0.9329987785751517,23,4,19,6,0.022136704867224587,0.6281695139312593
재고조정/NNG;진행되/VVX,-1,-0.9329987785751517,23,4,19,6,0.022136704867224587,0.6281695139312593
수출/NNG;이/VV,-1,-0.9329987785751517,23,4,19,15,0.022136704867224587,0.6281695139312593
동결/NNG;따른/VV,-1,-0.9381746557431697,18,3,15,23,0.01924570905673345,0.5926178631915495
불안/NNG;진정될/VVX,-1,-0.9381746557431697,18,3,15,12,0.01924570905673345,0.5926178631915495
양적완화/NNG;시사하/VVX,-1,-0.9381746557431697,18,3,15,13,0.01924570905673345,0.5926178631915495
경제지표/NNG;악화된/VVX,-1,-0.9381746557431697,18,3,15,10,0.01924570905673345,0.5926178631915495
근원소비자물가/NNG;상승했/VVX,-1,-0.9381746557431697,18,3,15,5,0.01924570905673345,0.5926178631915495
근원인플레이션율/NNG;하락하/VVX,-1,-0.9381746557431697,18,3,15,18,0.01924570905673345,0.5926178631915495
금리인하/NNG;했/VV,-1,-0.9424042723172081,24,4,20,17,0.019261725174396553,0.6372192198677277
가계부채/NNG;자본유출입/NNG;점검해/VVX,-1,-0.948693618392293,19,3,16,11,0.016195903688778292,0.6020076624417261
고용지표/NNG;양호하/VVX,-1,-0.9569029560920058,20,3,17,25,0.013811955043480408,0.6112638204462824
소비/NNG;회복세/NNG;이어지/VV,-1,-0.9569029560920058,20,3,17,7,0.013811955043480408,0.6112638204462824
가계대출/NNG;상회하/VVX,-1,-0.9569029560920058,20,3,17,23,0.013811955043480408,0.6112638204462824
경기둔화우려/NNG;반영하/VVX,-1,-0.9633946848864381,21,3,18,14,0.011920932341674559,0.6203958192455127
경기하강/NNG;위험/NNG;남/VV,-1,-0.9662272328365028,28,4,24,4,0.011927075225953071,0.672063984762227
고용지표/NNG;악화된/VVX,-1,-0.9677697600687049,15,2,13,7,0.009746420921438837,0.5750365483522291
지준율/NNG;인하했/VVX,-1,-0.9677697600687049,15,2,13,8,0.009746420921438837,0.5750365483522291
성장/NNG;하방위험/NNG;큰/VA;판단된/VVX,-1,-0.9677697600687049,15,2,13,16,0.009746420921438837,0.5750365483522291
부양책/NNG;쏟/VV,-1,-0.9677697600687049,15,2,13,7,0.009746420921438837,0.5750365483522291
체감경기/NNG;나타내/VV,-1,-0.9677697600687049,15,2,13,5,0.009746420921438837,0.5750365483522291
침체/NNG;막/VV,-1,-0.9684900580037051,35,5,30,13,0.011932956406559302,0.7198437613864456
유동성함정/NNG;빠진/VV,-1,-0.9685926230021461,22,3,19,6,0.010400478506227604,0.6294092920023241
투자심리/NNG;개선된/VVX,-1,-0.9685926230021461,22,3,19,19,0.010400478506227604,0.6294092920023241
물가안정/NNG;아래/NNG;머물/VV,-1,-0.9736331497582132,16,2,14,6,0.008140428592136258,0.5844499255230048
기준금리인하/NNG;내린/VV,-1,-0.9736331497582132,16,2,14,5,0.008140428592136258,0.5844499255230048
성장경로/NNG;밟/VV,-1,-0.9736331497582132,16,2,14,11,0.008140428592136258,0.5844499255230048
인플레이션/NNG;완화됐/VVX,-1,-0.9736331497582132,16,2,14,4,0.008140428592136258,0.5844499255230048
경기/NNG;부추기/VV,-1,-0.9780639864935597,17,2,15,3,0.006921754368950609,0.5937628575198879
불안/NNG;계속될/VVX,-1,-0.9780639864935597,17,2,15,5,0.006921754368950609,0.5937628575198879
경기침체/NNG;지속될/VVX,-1,-0.9791059093637604,25,3,22,15,0.0072952903497878075,0.6557621652776952
기준금리/NNG;하향조정하/VVX,-1,-0.9813569391922073,41,5,36,12,0.00762141269678746,0.7639523919017549
경기후퇴/NNG;겪/VV,-1,-0.981481736423492,18,2,16,4,0.005977142111883155,0.6029788152873052
신용경색/NNG;풀리/VV,-1,-0.981481736423492,18,2,16,6,0.005977142111883155,0.6029788152873052
금리인하/NNG;취할/VV,-1,-0.9863110557190506,20,2,18,5,0.0046320675107045335,0.6211225064315099
경기위축/NNG;의미한/VVX,-1,-0.9916562649815029,24,2,22,8,0.0031197232282525553,0.6562211314301173
투자심리/NNG;위축/NNG;따른/VV,-1,-0.9940716684043294,15,1,14,7,0.002069170616421462,0.5849801912418721
금리인하기대/NNG;약화된/VVX,-1,-0.9940716684043294,15,1,14,16,0.002069170616421462,0.5849801912418721
하방위험/NNG;커진/VA;판단된/VVX,-1,-0.9940716684043294,15,1,14,7,0.002069170616421462,0.5849801912418721
금리인상/NNG;부추길/VV,-1,-0.9948708779624822,16,1,15,10,0.0018629672563820745,0.5942174376463023
수출/NNG;감소세/NNG;확대되/VVX,-1,-0.9952737986999107,30,2,28,4,0.002069373026674398,0.7056411962432426
하방리스크/NNG;커졌/VV,-1,-0.9959688150727828,32,2,30,32,0.0018631313327797394,0.7211871068095411
수출/NNG;가/VV,-1,-0.9960388450890365,18,1,17,2,0.0015606712633662622,0.6124477956675896
소비자물가/NNG;큰/VA;영향/NNG;미치/VV,-1,-0.9960388450890365,18,1,17,2,0.0015606712633662622,0.6124477956675896
경상수지/NNG;줄어들/VV,-1,-0.9964751760964637,19,1,18,3,0.0014474247243364787,0.6214337778076935
성장경로/NNG;하회할/VVX,-1,-0.9964751760964637,19,1,18,6,0.0014474247243364787,0.6214337778076935
불확실성/NNG;증대/NNG;따른/VV,-1,-0.9968422596331133,20,1,19,12,0.0013520119945158416,0.6303289405955258
금리인상/NNG;강조하/VVX,-1,-0.9999655255770986,15,0,15,7,0.0003447850735133489,0.5943521223791688
기준금리/NNG;인하하/VVX;했/VV,-1,-1.0,17,0,17,4,0.0003447850735133489,0.6125623030679619
