word,label,polarity,count,pos_count,neg_count,neu_count,pos_score,neg_score
금리인상/NNG;있/VV;유동성/NNG;문제/NNG;금리정책/NNG;적합한/VAX;대책/NNG,1,1.0,34,34,0,0,0.8456291152340734,0.0002581773758247794
유동성/NNG;문제/NNG;금리정책/NNG;적합한/VAX;대책/NNG;되/VV;노력하/VVX,1,1.0,34,34,0,0,0.8456291152340734,0.0002581773758247794
성장/NNG;능력/NNG;괜찮/VA;경로이/VVX;갈/VX,1,1.0,34,34,0,0,0.8456291152340734,0.0002581773758247794
금리/NNG;너무/MAG;낮/VA;아니/VCN;올리/VV;가/VV;판단/NNG,1,0.9999866199174141,32,32,0,0,0.8275114223991532,0.0002581773758247794
부동산가격/NNG;잡/VV;결정적/VAX;역할/NNG;할/VV;기대/NNG;했/VV,1,0.9999866199174141,32,32,0,0,0.8275114223991532,0.0002581773758247794
금리인상/NNG;부동산가격/NNG;영향/NNG;주/VV;아니/VCN,1,0.9999792998168842,31,31,0,0,0.817924069907663,0.0002581773758247794
성장/NNG;될/VV;보/VX,1,0.9999715245200973,30,30,0,0,0.8079808064619719,0.0002581773758247794
성장/NNG;될/VV;경제전망/NNG;하/VV;보/VX,1,0.9999715245200973,30,30,0,0,0.8079808064619719,0.0002581773758247794
흑자/NNG;정부/NNG;가/VV;적립했/VVX,1,0.9999544910203235,28,28,0,0,0.7870206565982311,0.0002581773758247794
금리/NNG;내려갈/VV;올라갈/VV;수지/NNG;상황/NNG;달라졌/VV,1,0.9999544910203235,28,28,0,0,0.7870206565982311,0.0002581773758247794
자산/NNG;원화/NNG;달러화/NNG;크/VA;영향/NNG;받/VV,1,0.9999544910203235,28,28,0,0,0.7870206565982311,0.0002581773758247794
흑자/NNG;환율하락/NNG;예상하/VVX,1,0.999924733128901,25,25,0,0,0.7528983711415181,0.0002581773758247794
경제/NNG;큰/VA;흐름/NNG;환율/NNG;되돌려/VV;놓/VX;어렵/VA,1,0.999924733128901,25,25,0,0,0.7528983711415181,0.0002581773758247794
경상수지/NNG;적자지/VVX;기본적/VAX;흑자/NNG;기조다/VVX,1,0.999924733128901,25,25,0,0,0.7528983711415181,0.0002581773758247794
경제상황/NNG;고려하/VVX;경제/NNG;견조한/VAX;성장/NNG;지속하/VVX;물가안정기조/NNG,1,0.9999016374725496,23,23,0,18,0.7283877546414445,0.0002581773758247794
경제/NNG;견조한/VAX;성장/NNG;지속하/VVX;물가안정기조/NNG;유지될/VVX;있/VV,1,0.9998459051159749,19,19,0,17,0.6753323503406671,0.0002581773758247794
수요압력/NNG;증대될/VVX,1,0.9998296449925304,18,18,0,14,0.6612788764912493,0.0002581773758247794
콜금리/NNG;목표/NNG;인상하/VVX,1,0.9995498224030022,43,42,1,15,0.9046363787192876,0.0004796911851228044
인플레이션기대심리/NNG;확산될/VVX,1,0.9978032462310893,20,19,1,14,0.6752534565794039,0.0009480347154748689
물가안정기조/NNG;유지되/VVX;하/VV;중점/NNG;두/VV,1,0.9978032462310893,20,19,1,17,0.6752534565794039,0.0009480347154748689
금융완화/NNG;기조/NNG;유지하/VVX;경제/NNG,1,0.9964390854032013,16,15,1,12,0.6173212206834937,0.0012886215183774772
금리인상/NNG;이뤄지지/VV;않/VX,1,0.9964390854032013,16,15,1,27,0.6173212206834937,0.0012886215183774772
성장경로/NNG;불확실성/NNG;상존하/VVX,1,0.9960944226175323,27,25,2,35,0.7526929129689632,0.0017012903425577552
경기회복세/NNG;둔화될/VVX,1,0.9958824447864658,15,14,1,22,0.6021796865486867,0.0014251167039382117
경제/NNG;물가안정/NNG;기조/NNG;위/NNG;견조한/VAX;성장/NNG;지속할/VVX,1,0.9923941173864639,21,19,2,8,0.6750426404516212,0.0027808700244978364
콜금리/NNG;올렸/VV,1,0.9898783653691552,19,17,2,10,0.6465921533853267,0.003483560506561216
금리/NNG;낮/VA;있/VV,1,0.9887022966627956,26,23,3,3,0.7278388735173338,0.0043535296457349985
경제성장/NNG;가능할/VVX,1,0.9887022966627956,26,23,3,6,0.7278388735173338,0.0043535296457349985
잠재성장률/NNG;웃돌/VV,1,0.9854483737817858,24,21,3,13,0.7018751703917483,0.0053540691900671135
성장/NNG;이룰/VV,1,0.9829582199078932,16,14,2,35,0.6018178599389286,0.005351444012520556
경기/NNG;부진해/VVX,1,0.9790599870862811,15,13,2,15,0.5863893554018523,0.006378209544360451
기준금리/NNG;상향조정하/VVX,1,0.9775856988894049,39,33,6,23,0.8350575244590763,0.009711573336468023
경제/NNG;위기/NNG;겪/VV,1,0.977328819580704,21,18,3,20,0.6604428135545172,0.007767531745804417
경제/NNG;견조한/VAX;성장/NNG;지속하/VVX;물가안정기조/NNG;유지되/VVX,1,0.9754115167091384,38,32,6,30,0.8257162988367687,0.010521242729304376
인플레이션/NNG;억제/NNG;위한/VV,1,0.9746316836848632,32,27,5,39,0.7744769226693619,0.01017775201043246
경제성장률/NNG;낮추/VV,1,0.9737880408121742,26,22,4,32,0.7143822645250527,0.009697018525428702
기준금리/NNG;인상될/VVX;가능성/NNG;높/VA,1,0.9737880408121742,26,22,4,44,0.7143822645250527,0.009697018525428702
물가안정/NNG;기조/NNG;위/NNG;견조한/VAX;성장/NNG;지속할/VVX;있/VV,1,0.9698228455357072,25,21,4,13,0.7011605752547407,0.010946459886276131
불확실성/NNG;상존한/VVX,1,0.9682849388618238,46,38,8,20,0.8749607690462089,0.014353324719738826
금리/NNG;상승세/NNG;지속하/VVX,1,0.9678574425067454,19,16,3,19,0.6312590978721221,0.010494734055012627
기준금리/NNG;인상하/VVX;결정했/VVX,1,0.9678574425067454,19,16,3,6,0.6312590978721221,0.010494734055012627
성장/NNG;지속할/VVX;있/VV;하/VV;방향/NNG,1,0.964976449932518,24,20,4,10,0.6875917326261298,0.012454962987198013
성장경로/NNG;크/VA;벗어나/VV;않/VX,1,0.9589974823735088,23,19,4,28,0.6736800808524966,0.014293876539535094
변동성/NNG;과도하/VVX,1,0.9589974823735088,23,19,4,22,0.6736800808524966,0.014293876539535094
인플레이션/NNG;대응하/VVX,1,0.9519055925371813,17,14,3,14,0.6009035134105588,0.01497671491466824
확장국면/NNG;지속되/VVX,1,0.9519055925371813,17,14,3,11,0.6009035134105588,0.01497671491466824
경기/NNG;위험요인/NNG;상존하/VVX;상승기조/NNG;이/VV;갈/VX;전망된/VVX,1,0.9515490633124626,22,18,4,18,0.6594295968640445,0.01655872839368529
물가안정기조/NNG;유지되/VVX;하/VV;중점/NNG;두/VV;운용할/VVX,1,0.9492669680413981,36,29,7,28,0.7942591205369425,0.020896496125245818
기준금리/NNG;동결한/VAX;배경/NNG;설명했/VVX,1,0.9448207909961301,26,21,5,21,0.6999619306318916,0.02005598774272703
콜금리/NNG;올린/VV,1,0.9421763833957955,21,17,4,16,0.6448431791092142,0.019378763793208707
기준금리/NNG;인상할/VVX;가능성/NNG;있/VV,1,0.9397631528201886,16,13,3,26,0.5852992345532125,0.018338515105550266
출구전략/NNG;지연될/VVX,1,0.9397631528201886,16,13,3,16,0.5852992345532125,0.018338515105550266
경기회복세/NNG;진행되/VVX,1,0.9397631528201886,16,13,3,15,0.5852992345532125,0.018338515105550266
기준금리/NNG;인상할/VVX;내다봤/VV,1,0.9397631528201886,16,13,3,19,0.5852992345532125,0.018338515105550266
기준금리/NNG;유지한/VVX,1,0.9357675048148797,60,47,13,56,0.9247441977599308,0.030940215842023316
물가/NNG;올리/VV,1,0.9302619053531771,20,16,4,25,0.6299215579846061,0.0229306105404043
물가상승압력/NNG;크/VA;않/VX;전망되/VVX;통화정책/NNG;완화/NNG;기조/NNG,1,0.9302619053531771,20,16,4,17,0.6299215579846061,0.0229306105404043
금융완화/NNG;기조/NNG;유지하/VVX,1,0.9269397822916297,75,58,17,80,0.9612031440276696,0.036705469749184004
물가상승압력/NNG;이어질/VV,1,0.924598364341727,24,19,5,14,0.6721621341056911,0.026515812295284175
국제원자재가격/NNG;상승하/VVX,1,0.924598364341727,24,19,5,18,0.6721621341056911,0.026515812295284175
금리인상/NNG;대비해/VVX,1,0.924598364341727,24,19,5,33,0.6721621341056911,0.026515812295284175
경제/NNG;우려/NNG;커지/VV,1,0.9232208012791234,15,12,3,18,0.5694074353614638,0.022885729477270626
경제/NNG;미치/VV;파급효과/NNG,1,0.9232208012791234,15,12,3,21,0.5694074353614638,0.022885729477270626
경기/NNG;상승세/NNG;지속/NNG;따른/VV;수요압력/NNG,1,0.9232208012791234,15,12,3,17,0.5694074353614638,0.022885729477270626
성장세/NNG;이/VV,1,0.9149646931449715,19,15,4,26,0.6146616095954496,0.027457840131335783
금리인상/NNG;가능성/NNG;열/VV;뒀/VX,1,0.9149646931449715,19,15,4,30,0.6146616095954496,0.027457840131335783
경기/NNG;상승/NNG;이어지/VV;국제원자재가격/NNG;오르/VV,1,0.9089764464069279,27,21,6,1,0.6981183505729902,0.03347098044421553
하방위험/NNG;요인/NNG;작용할/VVX;가능성/NNG,1,0.8954135274275219,30,23,7,19,0.7226657124124285,0.04006042422252728
금리/NNG;인상되/VVX;않/VX,1,0.895141521776931,18,14,4,30,0.5990537057537594,0.03329872427627646
경제/NNG;과열/NNG;막/VV;위해/VV,1,0.895141521776931,18,14,4,7,0.5990537057537594,0.03329872427627646
경제지표/NNG;양호하/VVX,1,0.8942375244554353,26,20,6,37,0.6841770643147695,0.03837459890935352
국제유가/NNG;급등/NNG;따른/VV,1,0.8938183581740076,22,17,5,24,0.6428619096876147,0.036207372114972804
금리상승/NNG;축소되/VVX,1,0.8938183581740076,22,17,5,45,0.6428619096876147,0.036207372114972804
금리인상/NNG;나타나/VV,1,0.8918113617938783,45,34,11,4,0.8363460150167807,0.04804092233311778
경기과열/NNG;막/VV,1,0.8802450182451627,29,22,7,19,0.7092893429182171,0.04535081765567229
콜금리/NNG;올릴/VV,1,0.8780470702193268,51,38,13,22,0.8658886215463586,0.05644038524106949
경기/NNG;찬물/NNG;끼얹/VV,1,0.8764389681376905,25,19,6,15,0.669822927391072,0.044271131057102044
금리/NNG;인상해/VVX;한다는/VX,1,0.8764389681376905,25,19,6,35,0.669822927391072,0.044271131057102044
경기둔화/NNG;우려/NNG;부각되/VVX,1,0.8725668834841662,21,16,5,36,0.6276279172371819,0.04286419564255013
양적완화/NNG;지속되/VVX,1,0.8725668834841662,21,16,5,22,0.6276279172371819,0.04286419564255013
물가상승압력/NNG;작용할/VVX;가능성/NNG,1,0.8725668834841662,21,16,5,22,0.6276279172371819,0.04286419564255013
물가/NNG;낮/VA;유지하/VVX,1,0.8725668834841662,21,16,5,19,0.6276279172371819,0.04286419564255013
유가/NNG;급락했/VVX,1,0.8725668834841662,21,16,5,28,0.6276279172371819,0.04286419564255013
금리상승/NNG;기다리/VV,1,0.869252451871203,17,13,4,34,0.583077466066487,0.04092472848438617
출구전략/NNG;시행되/VVX,1,0.869252451871203,17,13,4,31,0.583077466066487,0.04092472848438617
흑자/NNG;줄어들/VV,1,0.869252451871203,17,13,4,24,0.583077466066487,0.04092472848438617
소비지출/NNG;증가하/VVX,1,0.869252451871203,17,13,4,22,0.583077466066487,0.04092472848438617
양적완화/NNG;축소할/VVX,1,0.869252451871203,17,13,4,68,0.583077466066487,0.04092472848438617
경제/NNG;큰/VA;영향/NNG;주/VV,1,0.869252451871203,17,13,4,11,0.583077466066487,0.04092472848438617
콜금리/NNG;인하하/VVX,1,0.869252451871203,17,13,4,9,0.583077466066487,0.04092472848438617
금리/NNG;올릴/VV;필요/NNG;있/VA,1,0.869252451871203,17,13,4,9,0.583077466066487,0.04092472848438617
생산/NNG;증가했/VVX,1,0.869252451871203,17,13,4,32,0.583077466066487,0.04092472848438617
동결/NNG;기조/NNG;이어질/VV,1,0.8623188303524008,28,21,7,46,0.6954776074891316,0.05158148536995295
재정위기/NNG;인해/VV,1,0.854891928880996,24,18,6,37,0.6550423876928237,0.051396333327059444
기준금리인상/NNG;단행되/VVX,1,0.854891928880996,24,18,6,37,0.6550423876928237,0.051396333327059444
경기/NNG;회복세/NNG;지속하/VVX,1,0.854891928880996,24,18,6,23,0.6550423876928237,0.051396333327059444
기준금리/NNG;유지해/VVX,1,0.845980097352643,20,15,5,46,0.611979743691206,0.05119984359191892
경제/NNG;미치/VV;파장/NNG,1,0.845980097352643,20,15,5,10,0.611979743691206,0.05119984359191892
금리/NNG;동결함/VVX,1,0.845980097352643,20,15,5,32,0.611979743691206,0.05119984359191892
금리인상/NNG;했/VV,1,0.845980097352643,20,15,5,16,0.611979743691206,0.05119984359191892
금융시장/NNG;불안/NNG;따른/VV;안전자산선호/NNG,1,0.845980097352643,20,15,5,11,0.611979743691206,0.05119984359191892
채권시장/NNG;강세/NNG;요인/NNG;작용할/VVX,1,0.845980097352643,20,15,5,20,0.611979743691206,0.05119984359191892
경기/NNG;불확실성/NNG;남/VV,1,0.8352675427009253,16,12,4,31,0.5666947837417475,0.05099128499733019
수출/NNG;타격/NNG;입/VV,1,0.8352675427009253,16,12,4,42,0.5666947837417475,0.05099128499733019
기준금리인상/NNG;시작될/VVX,1,0.8352675427009253,16,12,4,24,0.5666947837417475,0.05099128499733019
금리상승/NNG;예상하/VVX,1,0.8352675427009253,16,12,4,61,0.5666947837417475,0.05099128499733019
자산/NNG;늘리/VV,1,0.8352675427009253,16,12,4,16,0.5666947837417475,0.05099128499733019
금리인상/NNG;단행될/VVX;가능성/NNG,1,0.8302938522914627,30,22,8,70,0.7060828505607035,0.06562220715499896
듀레이션/NNG;늘리/VV,1,0.8287774304663917,23,17,6,41,0.6398153879694163,0.06004253196001957
확장/NNG;기조/NNG;유지하/VVX,1,0.8160127376549025,26,19,7,11,0.6664864225649892,0.06766332093422604
경기/NNG;상승세/NNG;지속하/VVX,1,0.8160127376549025,26,19,7,11,0.6664864225649892,0.06766332093422604
리스크/NNG;완화될/VVX,1,0.8126850085528179,19,14,5,34,0.5958833795827576,0.06169898879500753
경기/NNG;상승세/NNG;지속되/VVX,1,0.8091445389874128,39,28,11,19,0.7724265095117158,0.0816446620163229
금리/NNG;동결해/VVX,1,0.8091445389874128,39,28,11,57,0.7724265095117158,0.0816446620163229
대외불확실성/NNG;완화되/VVX,1,0.7991451762297328,32,23,9,54,0.7160207445340788,0.08007719888903717
인플레이션/NNG;완화될/VVX,1,0.7971505952444786,22,16,6,24,0.624112275623156,0.07056764613461226
인플레이션/NNG;억제될/VVX,1,0.7971505952444786,22,16,6,22,0.624112275623156,0.07056764613461226
경제/NNG;견조한/VAX;성장/NNG;지속하/VVX;물가안정/NNG;유지될/VVX;있/VV,1,0.7971505952444786,22,16,6,7,0.624112275623156,0.07056764613461226
금리인상/NNG;검토하/VVX,1,0.7906230489055708,15,11,4,18,0.549838049720563,0.06439771136953208
금리인상/NNG;전망/NNG;유지하/VVX,1,0.7906230489055708,15,11,4,22,0.549838049720563,0.06439771136953208
물가안정/NNG;있/VV,1,0.7906230489055708,15,11,4,20,0.549838049720563,0.06439771136953208
금리인상/NNG;할/VV;가능성/NNG,1,0.7906230489055708,15,11,4,15,0.549838049720563,0.06439771136953208
안전자산선호/NNG;심리/NNG;약화될/VVX,1,0.7906230489055708,15,11,4,27,0.549838049720563,0.06439771136953208
경기회복세/NNG;찬물/NNG;끼얹/VV,1,0.7906230489055708,15,11,4,19,0.549838049720563,0.06439771136953208
경제/NNG;반등하/VVX,1,0.7906230489055708,15,11,4,23,0.549838049720563,0.06439771136953208
금리/NNG;올리/VV;쉽/VA;않/VX,1,0.7906230489055708,15,11,4,33,0.549838049720563,0.06439771136953208
금리/NNG;인상시/VVX,1,0.7906230489055708,15,11,4,14,0.549838049720563,0.06439771136953208
금리/NNG;인상해/VVX;할/VX,1,0.7863602778683443,25,18,7,42,0.6512618735225212,0.07801048818798774
정책금리/NNG;인하될/VVX,1,0.7710872386610026,18,13,5,26,0.5792843775952808,0.07497539738115391
성장/NNG;기대된/VVX,1,0.7710872386610026,18,13,5,18,0.5792843775952808,0.07497539738115391
금리인상/NNG;배제하/VVX,1,0.7710872386610026,18,13,5,18,0.5792843775952808,0.07497539738115391
고용지표/NNG;예상치/NNG;상회하/VVX,1,0.7710872386610026,18,13,5,14,0.5792843775952808,0.07497539738115391
고용지표/NNG;부진/NNG;따른/VV,1,0.7710872386610026,18,13,5,37,0.5792843775952808,0.07497539738115391
불확실성/NNG;따른/VV;안전자산선호/NNG,1,0.7710872386610026,18,13,5,37,0.5792843775952808,0.07497539738115391
침체/NNG;벗어나/VV,1,0.76945392323739,34,24,10,69,0.7253234081003634,0.09463207619679914
내수/NNG;개선되/VVX,1,0.76945392323739,34,24,10,56,0.7253234081003634,0.09463207619679914
금리/NNG;올려야/VV;하/VV,1,0.7644078576107909,40,28,12,65,0.7679974577292171,0.10267946356912783
금리인상/NNG;통한/VV,1,0.7644078576107909,40,28,12,83,0.7679974577292171,0.10267946356912783
물가/NNG;있/VV,1,0.758971103901591,21,15,6,25,0.6078892543548347,0.08340071408006469
금리인상/NNG;미룰/VV,1,0.758971103901591,21,15,6,26,0.6078892543548347,0.08340071408006469
경제/NNG;둔화시/VVX,1,0.758971103901591,21,15,6,12,0.6078892543548347,0.08340071408006469
경기둔화/NNG;심화될/VVX,1,0.758971103901591,21,15,6,20,0.6078892543548347,0.08340071408006469
금리하락/NNG;압력/NNG;지속될/VVX,1,0.7514381739077893,24,17,7,52,0.6355067707877144,0.0902940159969443
세계경제/NNG;회복세/NNG;이/VV;갈/VX;전망되/VVX,1,0.7514381739077893,24,17,7,4,0.6355067707877144,0.0902940159969443
금리/NNG;올린/VV,1,0.7504382514572492,126,86,40,159,0.9592973306371562,0.1369238289974361
금리인상/NNG;단행될/VVX;가능성/NNG;높/VA,1,0.7467920468157281,27,19,8,42,0.662014601051997,0.09606867765454122
금리인상/NNG;인해/VV,1,0.7414464060313983,60,41,19,73,0.8671713518209292,0.12888433148227343
콜금리/NNG;인상하/VVX,1,0.7325239033716484,108,73,35,88,0.9503812848789024,0.14686599126365413
금리/NNG;올릴/VV;예상/NNG,1,0.7194797848065331,17,12,5,20,0.5620962772351616,0.09177935892260118
물가상승/NNG;유발하/VVX,1,0.7194797848065331,17,12,5,13,0.5620962772351616,0.09177935892260118
기준금리/NNG;인상해/VVX;한다고/VX,1,0.7194797848065331,17,12,5,28,0.5620962772351616,0.09177935892260118
경기/NNG;부양할/VVX;있/VV,1,0.7194797848065331,17,12,5,23,0.5620962772351616,0.09177935892260118
단기금리/NNG;상승/NNG;따른/VV,1,0.7194797848065331,17,12,5,18,0.5620962772351616,0.09177935892260118
주택시장/NNG;지원하/VVX,1,0.7194797848065331,17,12,5,9,0.5620962772351616,0.09177935892260118
금리인상/NNG;자제해/VVX,1,0.7194797848065331,17,12,5,11,0.5620962772351616,0.09177935892260118
국제유가/NNG;떨어지/VV,1,0.7194797848065331,17,12,5,17,0.5620962772351616,0.09177935892260118
가계대출/NNG;증가세/NNG;둔화되/VVX,1,0.7194797848065331,17,12,5,8,0.5620962772351616,0.09177935892260118
내수/NNG;증가하/VVX,1,0.7188875628651314,44,30,14,40,0.7820878671054612,0.12801273396789803
기준금리/NNG;인상한/VVX,1,0.7144678771106281,76,51,25,69,0.9076661899883803,0.15128669539208306
불확실성/NNG;줄어들/VV,1,0.7136152481288878,35,24,11,59,0.7201406961503144,0.12044806643936165
경제/NNG;성장세/NNG;지속될/VVX,1,0.7131766974243874,20,14,6,20,0.5910815792364492,0.09903849707757144
경제/NNG;회복세/NNG;지속되/VVX,1,0.7131766974243874,20,14,6,27,0.5910815792364492,0.09903849707757144
경기둔화/NNG;나타나/VV,1,0.7131766974243874,20,14,6,25,0.5910815792364492,0.09903849707757144
인플레이션/NNG;유발하/VVX;않/VX,1,0.7131766974243874,20,14,6,18,0.5910815792364492,0.09903849707757144
물가목표/NNG;달성/NNG;위해/VV,1,0.7131766974243874,20,14,6,21,0.5910815792364492,0.09903849707757144
기준금리/NNG;올라갈/VV,1,0.7131766974243874,20,14,6,10,0.5910815792364492,0.09903849707757144
수출/NNG;호조/NNG;이어지/VV,1,0.7131766974243874,20,14,6,16,0.5910815792364492,0.09903849707757144
금리인상/NNG;할/VV;있/VV,1,0.7119631808322042,32,22,10,40,0.6967821665155279,0.11732502438852088
침체/NNG;빠지/VV;않/VX,1,0.7106459705012051,29,20,9,21,0.6721217697194136,0.11377655097407728
인플레이션기대심리/NNG;확산되/VVX,1,0.7106459705012051,29,20,9,29,0.6721217697194136,0.11377655097407728
유가/NNG;안정되/VVX,1,0.7106459705012051,29,20,9,26,0.6721217697194136,0.11377655097407728
경제/NNG;미치/VV;영향력/NNG,1,0.7105363130303575,23,16,7,43,0.6191711680706944,0.10485944107210245
금리인상/NNG;신중하/VVX,1,0.7105363130303575,23,16,7,32,0.6191711680706944,0.10485944107210245
금융시장/NNG;미치/VV;영향/NNG;제한적/VAX,1,0.7099919082574246,26,18,8,52,0.646222422666337,0.10968094979464708
채권시장/NNG;우호적/VAX;작용할/VVX,1,0.7099919082574246,26,18,8,84,0.646222422666337,0.10968094979464708
수출/NNG;늘어날/VV,1,0.7099919082574246,26,18,8,23,0.646222422666337,0.10968094979464708
원자재/NNG;가격/NNG;하락하/VVX,1,0.7077255688523814,58,39,19,64,0.8497705692054449,0.14554580520576013
경기/NNG;회복된/VVX,1,0.6826884031015996,34,23,11,23,0.7056698336032182,0.13314623000276
콜금리/NNG;인상했/VVX,1,0.6737380965908857,45,30,15,34,0.77620219027474,0.15138147768721105
경제성장률/NNG;떨어질/VV,1,0.6679215415210706,25,17,8,23,0.6298006837540643,0.12545007638335384
리스크/NNG;지속되/VVX,1,0.6679215415210706,25,17,8,21,0.6298006837540643,0.12545007638335384
잠재성장률/NNG;웃도/VV,1,0.6679215415210706,25,17,8,25,0.6298006837540643,0.12545007638335384
불확실성/NNG;고려하/VVX,1,0.6679215415210706,25,17,8,23,0.6298006837540643,0.12545007638335384
금리하락/NNG;동조화되/VVX,1,0.6679215415210706,25,17,8,27,0.6298006837540643,0.12545007638335384
금리인상/NNG;필요하/VVX,1,0.6662447307838295,84,55,29,101,0.9099751561585789,0.18235470968182274
경기둔화/NNG;우려/NNG;지속될/VVX,1,0.6630228895652943,22,15,7,29,0.6021850552333405,0.12207353147889943
기준금리/NNG;통화정책방향/NNG;유지하/VVX,1,0.6630228895652943,22,15,7,31,0.6021850552333405,0.12207353147889943
물가/NNG;하/VV,1,0.6630228895652943,22,15,7,29,0.6021850552333405,0.12207353147889943
인플레이션기대심리/NNG;낮추/VV,1,0.6630228895652943,22,15,7,24,0.6021850552333405,0.12207353147889943
잠재성장률/NNG;밑도/VV,1,0.6630228895652943,22,15,7,29,0.6021850552333405,0.12207353147889943
성장률/NNG;낮추/VV,1,0.6630228895652943,22,15,7,87,0.6021850552333405,0.12207353147889943
금리/NNG;끌어올렸/VV,1,0.6588173258528949,19,13,6,12,0.5735931761914254,0.1180240555436417
금리인상/NNG;기조/NNG;지속될/VVX,1,0.6588173258528949,19,13,6,39,0.5735931761914254,0.1180240555436417
경기/NNG;호전되/VVX,1,0.6588173258528949,19,13,6,39,0.5735931761914254,0.1180240555436417
경기둔화/NNG;우려/NNG;확대되/VVX,1,0.6588173258528949,19,13,6,13,0.5735931761914254,0.1180240555436417
인플레이션/NNG;잘/MAG;제어될/VVX,1,0.6562913643329178,16,11,5,26,0.5441816397858394,0.11297155877997514
흑자/NNG;축소될/VVX,1,0.6562913643329178,16,11,5,15,0.5441816397858394,0.11297155877997514
gdp/NNG;감소했/VVX,1,0.6562913643329178,16,11,5,15,0.5441816397858394,0.11297155877997514
금리인상/NNG;따른/VV;영향/NNG,1,0.6562913643329178,16,11,5,14,0.5441816397858394,0.11297155877997514
기준금리/NNG;만장일치/NNG;동결했/VVX,1,0.6562913643329178,16,11,5,33,0.5441816397858394,0.11297155877997514
금리/NNG;메리트/NNG;인해/VV,1,0.6562913643329178,16,11,5,21,0.5441816397858394,0.11297155877997514
경제성장률/NNG;전망치/NNG;낮추/VV,1,0.6562913643329178,16,11,5,25,0.5441816397858394,0.11297155877997514
채권시장/NNG;소폭/MAG;약세/NNG;보임/VV,1,0.6562913643329178,16,11,5,24,0.5441816397858394,0.11297155877997514
기준금리/NNG;올려/VV,1,0.654069756003903,47,31,16,46,0.7821963917418288,0.1636501067520198
금융시장/NNG;변동성/NNG;확대되/VVX,1,0.653459138916457,58,38,20,60,0.8343389701258552,0.17493137625697952
물가안정/NNG;위한/VV,1,0.6413035525960034,85,55,30,170,0.9046457095484287,0.197765497960971
기준금리/NNG;인상한/VAX;이/VV,1,0.6401690049258715,30,20,10,19,0.6658319953527113,0.14611867146591756
변동성/NNG;축소되/VVX,1,0.6401165759311447,41,27,14,95,0.743332871958929,0.1631553890515849
유가/NNG;급락/NNG;따른/VV,1,0.6316735238134124,38,25,13,44,0.7218477185119493,0.1629882143740767
성장/NNG;이/VV;갈/VX,1,0.6307724205463934,27,18,9,41,0.6398393748436254,0.1449040710460644
금융시장/NNG;불안한/VAX;모습/NNG;보이/VV,1,0.6307724205463934,27,18,9,20,0.6398393748436254,0.1449040710460644
금리/NNG;인상된/VVX,1,0.6220497651189032,35,23,12,65,0.6990007239674877,0.16290599874267442
경제/NNG;받/VV,1,0.6202412575290477,24,16,8,34,0.6126777636614648,0.14363001137880613
성장/NNG;기록하/VVX,1,0.6110471663265562,32,21,11,58,0.6748168162847072,0.1629444472602435
금리인상/NNG;지연될/VVX,1,0.610126173705217,64,41,23,64,0.8438702975663969,0.20436329350975768
금리인상/NNG;결정했/VVX,1,0.6084494439126187,21,14,7,17,0.5844494929162324,0.1422940968057684
경기/NNG;나아지/VV,1,0.6084494439126187,21,14,7,39,0.5844494929162324,0.1422940968057684
경기/NNG;나아질/VV,1,0.6084494439126187,21,14,7,39,0.5844494929162324,0.1422940968057684
gdp/NNG;증가하/VVX,1,0.6084494439126187,21,14,7,52,0.5844494929162324,0.1422940968057684
경제/NNG;성장세/NNG;둔화하/VVX,1,0.6084494439126187,21,14,7,12,0.5844494929162324,0.1422940968057684
불확실성/NNG;큰/VA;상황이/VVX,1,0.6084494439126187,21,14,7,22,0.5844494929162324,0.1422940968057684
경제/NNG;미치/VV;영향/NNG;제한적/VAX,1,0.6001397516917899,45,29,16,51,0.7564033604003495,0.18903662593199286
콜금리/NNG;인상되/VVX,1,0.5984129698684844,29,19,10,25,0.6493382772994547,0.1631549885225089
금리인상/NNG;위한/VV,1,0.5969631672473499,66,42,24,119,0.8464345671382564,0.2136382241215691
인플레이션기대심리/NNG;억제하/VVX,1,0.5952578132491873,18,12,6,28,0.5552804415565845,0.14089392388310537
경기/NNG;악영향/NNG;미칠/VV,1,0.5952578132491873,18,12,6,19,0.5552804415565845,0.14089392388310537
채권시장/NNG;호재/NNG;작용할/VVX,1,0.5952578132491873,18,12,6,20,0.5552804415565845,0.14089392388310537
국제유가/NNG;돌파하/VVX,1,0.5952578132491873,18,12,6,17,0.5552804415565845,0.14089392388310537
금리인상/NNG;단행된/VVX;하/VV,1,0.5952578132491873,18,12,6,17,0.5552804415565845,0.14089392388310537
리스크/NNG;반영하/VVX,1,0.5952578132491873,18,12,6,35,0.5552804415565845,0.14089392388310537
재고조정/NNG;마무리되/VVX,1,0.5952578132491873,18,12,6,32,0.5552804415565845,0.14089392388310537
금리/NNG;유지될/VVX,1,0.5952578132491873,18,12,6,28,0.5552804415565845,0.14089392388310537
경제성장률/NNG;하락할/VVX,1,0.5952578132491873,18,12,6,15,0.5552804415565845,0.14089392388310537
금리/NNG;동결됐/VVX,1,0.5952578132491873,18,12,6,35,0.5552804415565845,0.14089392388310537
물가상승/NNG;인해/VV,1,0.5952578132491873,18,12,6,32,0.5552804415565845,0.14089392388310537
불확실성/NNG;완화될/VVX,1,0.5867743212764778,55,35,20,121,0.8020552077220406,0.2088776243668264
금리인상/NNG;가능하/VVX,1,0.5867743212764778,55,35,20,90,0.8020552077220406,0.2088776243668264
성장/NNG;유지하/VVX,1,0.5851365113230027,34,22,12,69,0.6833049892722669,0.17884033570596525
금리인상/NNG;남/VV,1,0.5851365113230027,34,22,12,41,0.6833049892722669,0.17884033570596525
정책금리/NNG;인상해/VVX,1,0.5838137964201171,26,17,9,37,0.6226254468790721,0.16361390449685234
기준금리/NNG;인상됐/VVX,1,0.5838137964201171,26,17,9,38,0.6226254468790721,0.16361390449685234
성장동력/NNG;약화되/VVX,1,0.5838137964201171,26,17,9,6,0.6226254468790721,0.16361390449685234
국제유가/NNG;급락하/VVX,1,0.5838137964201171,26,17,9,37,0.6226254468790721,0.16361390449685234
성장/NNG;있/VV,1,0.5838137964201171,26,17,9,40,0.6226254468790721,0.16361390449685234
기준금리/NNG;낮/VA;수준이/VVX,1,0.5805134818547206,15,10,5,29,0.5253199834701653,0.13942709805451384
경기회복/NNG;의심/NNG;걷히/VV;시작하/VVX,1,0.5805134818547206,15,10,5,23,0.5253199834701653,0.13942709805451384
금리인하/NNG;기대감/NNG;강화되/VVX,1,0.5805134818547206,15,10,5,29,0.5253199834701653,0.13942709805451384
변동성/NNG;확대될/VVX;가능성/NNG;있/VA,1,0.5805134818547206,15,10,5,15,0.5253199834701653,0.13942709805451384
생산/NNG;줄/VV,1,0.5805134818547206,15,10,5,17,0.5253199834701653,0.13942709805451384
성장/NNG;달성할/VVX;있/VV,1,0.5805134818547206,15,10,5,25,0.5253199834701653,0.13942709805451384
기준금리인상/NNG;예상했/VVX,1,0.5805134818547206,15,10,5,26,0.5253199834701653,0.13942709805451384
경기회복/NNG;인해/VV,1,0.5805134818547206,15,10,5,21,0.5253199834701653,0.13942709805451384
콜금리/NNG;인상된/VVX,1,0.5805134818547206,15,10,5,18,0.5253199834701653,0.13942709805451384
인플레이션/NNG;우려/NNG;상존해/VVX,1,0.5805134818547206,15,10,5,40,0.5253199834701653,0.13942709805451384
금리인상/NNG;가져올/VV,1,0.5805134818547206,15,10,5,18,0.5253199834701653,0.13942709805451384
기준금리인상/NNG;필요하/VVX,1,0.5805134818547206,15,10,5,14,0.5253199834701653,0.13942709805451384
부동산가격/NNG;안정/NNG;위해/VV,1,0.5805134818547206,15,10,5,19,0.5253199834701653,0.13942709805451384
기준금리/NNG;유지되/VVX,1,0.5805134818547206,15,10,5,21,0.5253199834701653,0.13942709805451384
성장률/NNG;전망치/VAX;하향조정될/VVX,1,0.5805134818547206,15,10,5,13,0.5253199834701653,0.13942709805451384
실업률/NNG;하락했/VVX,1,0.5769231864324573,52,33,19,72,0.7855942716234563,0.2107675092951935
불확실성/NNG;해소하/VVX,1,0.5764754739638043,39,25,14,45,0.7144059721483779,0.19192531016053585
기준금리/NNG;인상하/VVX;않/VX,1,0.5723136488824798,70,44,26,133,0.8507494374475433,0.23140670895759682
장단기/NNG;금리/NNG;스프레드/NNG;축소되/VVX,1,0.5701194051585539,31,20,11,27,0.6583391644212365,0.1802390435264052
유동성/NNG;줄이/VV,1,0.5701194051585539,31,20,11,59,0.6583391644212365,0.1802390435264052
선진국/NNG;경제/NNG;회복세/NNG;이/VV;가/VX,1,0.5701194051585539,31,20,11,22,0.6583391644212365,0.1802390435264052
경제성장률/NNG;하향조정하/VVX,1,0.5701194051585539,31,20,11,50,0.6583391644212365,0.1802390435264052
경제/NNG;악영향/NNG;미치/VV,1,0.5701194051585539,31,20,11,32,0.6583391644212365,0.1802390435264052
기준금리/NNG;유지했/VVX,1,0.5667906784762513,23,15,8,33,0.5947562348001679,0.16443859461987984
기준금리/NNG;인하할/VVX;예상했/VVX,1,0.5667906784762513,23,15,8,23,0.5947562348001679,0.16443859461987984
성장률/NNG;나타낼/VV,1,0.5667906784762513,23,15,8,34,0.5947562348001679,0.16443859461987984
내수/NNG;회복세/NNG;보이/VV,1,0.5667906784762513,23,15,8,33,0.5947562348001679,0.16443859461987984
성장률/NNG;달성할/VVX;있/VV,1,0.5667906784762513,23,15,8,31,0.5947562348001679,0.16443859461987984
불안/NNG;야기하/VVX,1,0.5667906784762513,23,15,8,37,0.5947562348001679,0.16443859461987984
금리/NNG;큰/VA;하락했/VVX,1,0.5586643449631079,59,37,22,95,0.8098144297447316,0.22927953391423886
성장/NNG;예상된/VVX,1,0.556768876351017,41,26,15,48,0.7214406541253011,0.20538406264955342
경기/NNG;위축될/VVX,1,0.5531384619565274,46,29,17,31,0.7486283053475026,0.21536876303741337
금리하락/NNG;이끌/VV,1,0.5479451713365571,56,35,21,117,0.794403865232821,0.2319645368893426
금융완화/NNG;기조/NNG;유지할/VVX,1,0.5466759568190556,20,13,7,29,0.5658233054042527,0.16581842617028886
동결/NNG;기조/NNG;이/VV,1,0.5466759568190556,20,13,7,33,0.5658233054042527,0.16581842617028886
인플레이션/NNG;인해/VV,1,0.5466759568190556,20,13,7,23,0.5658233054042527,0.16581842617028886
금리인하/NNG;기대감/NNG;확산되/VVX,1,0.5466759568190556,20,13,7,19,0.5658233054042527,0.16581842617028886
경기/NNG;불확실성/NNG;상존하/VVX,1,0.5466759568190556,20,13,7,30,0.5658233054042527,0.16581842617028886
경제/NNG;안정시/VVX,1,0.5466759568190556,20,13,7,23,0.5658233054042527,0.16581842617028886
금리인상/NNG;되/VV,1,0.5466759568190556,20,13,7,21,0.5658233054042527,0.16581842617028886
경제/NNG;위축되/VVX,1,0.5466759568190556,20,13,7,36,0.5658233054042527,0.16581842617028886
물가/NNG;잡/VV;위해/VV;금리/NNG,1,0.5466759568190556,20,13,7,18,0.5658233054042527,0.16581842617028886
기준금리/NNG;인상된/VVX,1,0.5457215582936263,61,38,23,122,0.8132184452595643,0.23896758624625308
금리상승/NNG;되돌리/VV,1,0.5452308161033428,33,21,12,62,0.6668762704955464,0.1962379556999879
금리/NNG;오르/VV;않/VX,1,0.5452308161033428,33,21,12,49,0.6668762704955464,0.1962379556999879
금리동결/NNG;예상되/VVX,1,0.5452308161033428,33,21,12,60,0.6668762704955464,0.1962379556999879
금리인상/NNG;시사할/VVX,1,0.5411574694651697,38,24,14,43,0.698910558645442,0.20805178998857204
불확실성/NNG;증폭되/VVX,1,0.5321103691980218,25,16,9,34,0.6045794485544517,0.18459714249827597
기준금리인상/NNG;지연될/VVX,1,0.5321103691980218,25,16,9,34,0.6045794485544517,0.18459714249827597
경제/NNG;둔화/NNG;따른/VV,1,0.5321103691980218,25,16,9,22,0.6045794485544517,0.18459714249827597
기준금리/NNG;유지하/VVX;결정했/VVX,1,0.5269021066292743,83,51,32,91,0.8660305694120065,0.26827661448567136
금리인상/NNG;단행할/VVX;가능성/NNG;높/VA,1,0.5257618349464224,30,19,11,42,0.6410780232915896,0.19921800407255627
금리/NNG;올려서/VV,1,0.5257618349464224,30,19,11,47,0.6410780232915896,0.19921800407255627
기준금리인상/NNG;이뤄질/VV,1,0.5231825846417923,35,22,13,46,0.6749779244799697,0.21124844823731181
금리인하/NNG;기정사실화하/VVX,1,0.5224270076329531,17,11,6,35,0.535926275230732,0.1680780264792168
금리/NNG;스프레드/NNG;축소될/VVX,1,0.5224270076329531,17,11,6,37,0.535926275230732,0.1680780264792168
신용등급/NNG;강등될/VVX,1,0.5224270076329531,17,11,6,35,0.535926275230732,0.1680780264792168
금리인상/NNG;나/VV,1,0.5224270076329531,17,11,6,31,0.535926275230732,0.1680780264792168
내수/NNG;부진해/VVX,1,0.5224270076329531,17,11,6,9,0.535926275230732,0.1680780264792168
국제금융시장/NNG;변동성/NNG;확대될/VVX,1,0.5224270076329531,17,11,6,22,0.535926275230732,0.1680780264792168
금리/NNG;높여/VV,1,0.5224270076329531,17,11,6,23,0.535926275230732,0.1680780264792168
경기/NNG;개선된/VVX,1,0.5224270076329531,17,11,6,47,0.535926275230732,0.1680780264792168
경기침체/NNG;우려하/VVX,1,0.5224270076329531,17,11,6,14,0.535926275230732,0.1680780264792168
금리/NNG;하향/NNG;안정되/VVX,1,0.5224270076329531,17,11,6,31,0.535926275230732,0.1680780264792168
경기회복/NNG;확인되/VVX,1,0.5224270076329531,17,11,6,25,0.535926275230732,0.1680780264792168
금리인상/NNG;따른/VV;신흥국/NNG,1,0.5224270076329531,17,11,6,32,0.535926275230732,0.1680780264792168
자본확충/NNG;위한/VV,1,0.5224270076329531,17,11,6,49,0.535926275230732,0.1680780264792168
투자심리/NNG;개선시/VVX,1,0.5224270076329531,17,11,6,49,0.535926275230732,0.1680780264792168
세계경제/NNG;미국/NNG;선진국/NNG;회복세/NNG;이/VV;갈/VX,1,0.5224270076329531,17,11,6,9,0.535926275230732,0.1680780264792168
기준금리/NNG;올릴/VV;있/VV,1,0.5222207159671233,45,28,17,85,0.7342889877346337,0.23041937023280837
수출/NNG;줄어들/VV,1,0.5222207159671233,45,28,17,42,0.7342889877346337,0.23041937023280837
경기회복/NNG;따른/VV,1,0.5190057581380383,163,100,63,311,0.9072526045226075,0.2872141771095016
수출/NNG;호조/NNG;힘입/VV,1,0.5095928213539249,57,35,22,86,0.7862156512309094,0.25534138855295574
성장세/NNG;이/VV;가/VX,1,0.5094217139029502,82,50,32,94,0.8582731946002831,0.27887240875063657
콜금리/NNG;올리/VV,1,0.5084635963019868,52,32,20,64,0.7645689738975561,0.24906822361380224
신흥시장/NNG;경제/NNG;호조/NNG;지속하/VVX;선진국/NNG,1,0.5076552302732122,22,14,8,12,0.5759021550366381,0.18801632254246659
금리인상/NNG;가능성/NNG;반영해/VVX,1,0.5076552302732122,22,14,8,20,0.5759021550366381,0.18801632254246659
신용등급/NNG;강등하/VVX,1,0.5076552302732122,22,14,8,63,0.5759021550366381,0.18801632254246659
금리인상/NNG;시사하/VVX;않/VX,1,0.5076552302732122,22,14,8,19,0.5759021550366381,0.18801632254246659
신용등급/NNG;유지하/VVX,1,0.5076552302732122,22,14,8,25,0.5759021550366381,0.18801632254246659
성장/NNG;둔화되/VVX,1,0.5072607134643625,92,56,36,111,0.8738227508254552,0.2855821871072044
변동성/NNG;줄어들/VV,1,0.50696787838191,47,29,18,73,0.7401424170121923,0.2420834069159
소비/NNG;개선되/VVX,1,0.5035070016437739,37,23,14,42,0.6826679229834122,0.22536704640783847
경기회복/NNG;따른/VV;수요/NNG,1,0.5029250770617264,27,17,10,46,0.6139665356239594,0.20300259289163372
금리인상/NNG;나설/VV;가능성/NNG;높/VA,1,0.5029250770617264,27,17,10,33,0.6139665356239594,0.20300259289163372
내수/NNG;부진하/VVX,1,0.5029250770617264,27,17,10,37,0.6139665356239594,0.20300259289163372
금리/NNG;인상할/VVX;가능성/NNG;크/VA,1,0.5029250770617264,27,17,10,20,0.6139665356239594,0.20300259289163372
물가상승압력/NNG;커질/VV,1,0.5023610478521077,32,20,12,42,0.6496530363196327,0.21512606504788154
불확실성/NNG;있/VV,1,0.497901662844086,140,85,55,165,0.8989831717461811,0.30124638945691096
콜금리/NNG;목표/NNG;유지하/VVX,1,0.4908389008497773,76,46,30,53,0.8390939306163421,0.28647677532251914
기준금리/NNG;동결한/VVX,1,0.48958184471986055,44,27,17,71,0.7192455912756951,0.2463720558867211
금리인상/NNG;나설/VV;있/VV,1,0.4861965186050947,61,37,24,70,0.7935231113532972,0.27423819198252714
콜금리/NNG;동결하/VVX,1,0.4861965186050947,61,37,24,52,0.7935231113532972,0.27423819198252714
생산/NNG;증가하/VVX,1,0.48582195093219327,39,24,15,54,0.6899666214697174,0.238683200584868
원자재/NNG;가격/NNG;상승하/VVX,1,0.48582195093219327,39,24,15,58,0.6899666214697174,0.238683200584868
기준금리/NNG;유지하/VVX,1,0.48313720744999644,301,182,119,396,0.897838475303361,0.3127773331870144
금리인상/NNG;예상된/VVX,1,0.4796988587592881,51,31,20,60,0.7507958856954934,0.2639012805260462
금리상승/NNG;제한하/VVX,1,0.4781396833271334,68,41,27,125,0.8135229143186578,0.287107495046472
경기/NNG;부양해/VVX,1,0.47806183690032,29,18,11,26,0.6229516445690957,0.21989563954700253
하방위험/NNG;있/VV,1,0.47806183690032,29,18,11,48,0.6229516445690957,0.21989563954700253
수출/NNG;증가해/VVX,1,0.47806183690032,29,18,11,28,0.6229516445690957,0.21989563954700253
금리/NNG;높이/VV,1,0.4779868584363738,19,12,7,38,0.5461026505629463,0.1928061457727547
가계대출/NNG;늘/VV,1,0.4779868584363738,19,12,7,11,0.5461026505629463,0.1928061457727547
기준금리인상/NNG;가능성/NNG;시사했/VVX,1,0.4779868584363738,19,12,7,26,0.5461026505629463,0.1928061457727547
유동성/NNG;넘쳐나/VV,1,0.4779868584363738,19,12,7,25,0.5461026505629463,0.1928061457727547
고용지표/NNG;개선된/VVX,1,0.4779868584363738,19,12,7,20,0.5461026505629463,0.1928061457727547
불안/NNG;보이/VV,1,0.4779868584363738,19,12,7,15,0.5461026505629463,0.1928061457727547
기준금리인상/NNG;하/VV,1,0.4779868584363738,19,12,7,23,0.5461026505629463,0.1928061457727547
금융완화/NNG;크/VA;축소될/VVX,1,0.4779868584363738,19,12,7,16,0.5461026505629463,0.1928061457727547
성장률/NNG;달성할/VVX,1,0.47583220827185024,24,15,9,19,0.5855770064057138,0.20789785958986134
경제지표/NNG;부진하/VVX;나오/VV,1,0.47583220827185024,24,15,9,50,0.5855770064057138,0.20789785958986134
성장세/NNG;둔화할/VVX,1,0.47583220827185024,24,15,9,34,0.5855770064057138,0.20789785958986134
기준금리/NNG;인상함/VVX,1,0.47583220827185024,24,15,9,53,0.5855770064057138,0.20789785958986134
콜금리/NNG;인상할/VVX,1,0.47471227234059676,90,54,36,91,0.8597997720951855,0.30613878302844716
변동성/NNG;커질/VV,1,0.4739157940254539,85,51,34,122,0.8514480445647619,0.3037880462986846
기준금리/NNG;인상해/VVX,1,0.46566688643742804,87,52,35,118,0.8519000425877441,0.31044438977761996
금리인상/NNG;미루/VV,1,0.46356729921691353,36,22,14,30,0.6656241290670245,0.243863640115286
콜금리/NNG;인상될/VVX,1,0.46192312734986896,48,29,19,41,0.730972901197468,0.2689268968646748
금리인상/NNG;이/VV,1,0.4610789153545891,60,36,24,47,0.7812316441804059,0.28803372283550605
금리인상/NNG;될/VV,1,0.45593938864478023,55,33,22,51,0.760149021233614,0.2839276526085349
경기/NNG;둔화하/VVX,1,0.45593938864478023,55,33,22,72,0.760149021233614,0.2839276526085349
양적완화/NNG;유지하/VVX,1,0.4494409861019788,26,16,10,62,0.5948867069974976,0.22585710326388247
지준율/NNG;인상했/VVX,1,0.4494409861019788,26,16,10,41,0.5948867069974976,0.22585710326388247
금리인상/NNG;단행하/VVX;않/VX,1,0.4472626158561528,38,23,15,67,0.6730564672084919,0.2569308279024008
경제/NNG;살아나/VV,1,0.4472626158561528,38,23,15,49,0.6730564672084919,0.2569308279024008
기준금리/NNG;유지하/VVX;했/VV,1,0.4472626158561528,38,23,15,85,0.6730564672084919,0.2569308279024008
경기회복세/NNG;강화되/VVX,1,0.4432091573869079,21,13,8,27,0.5559292135425828,0.21437300898289977
경제/NNG;회복/NNG;위한/VV,1,0.4432091573869079,21,13,8,24,0.5559292135425828,0.21437300898289977
기준금리동결/NNG;예상하/VVX,1,0.4432091573869079,21,13,8,39,0.5559292135425828,0.21437300898289977
국제유가/NNG;안정되/VVX,1,0.4432091573869079,21,13,8,5,0.5559292135425828,0.21437300898289977
정책금리/NNG;인상될/VVX,1,0.4432091573869079,21,13,8,42,0.5559292135425828,0.21437300898289977
실업률/NNG;나타내/VV,1,0.4432091573869079,21,13,8,10,0.5559292135425828,0.21437300898289977
인플레이션/NNG;나타나/VV,1,0.4432091573869079,21,13,8,16,0.5559292135425828,0.21437300898289977
기준금리/NNG;묶/VV,1,0.4432091573869079,21,13,8,35,0.5559292135425828,0.21437300898289977
금리동결/NNG;예상하/VVX,1,0.4432091573869079,21,13,8,53,0.5559292135425828,0.21437300898289977
유동성/NNG;늘/VV,1,0.441035477404375,16,10,6,9,0.5151971563171863,0.19974133002734035
금리인상/NNG;우려하/VVX,1,0.441035477404375,16,10,6,11,0.5151971563171863,0.19974133002734035
동결/NNG;결정되/VVX,1,0.441035477404375,16,10,6,22,0.5151971563171863,0.19974133002734035
금리인상/NNG;필요할/VVX;있/VA,1,0.441035477404375,16,10,6,16,0.5151971563171863,0.19974133002734035
투자심리/NNG;고무시/VVX,1,0.441035477404375,16,10,6,29,0.5151971563171863,0.19974133002734035
기준금리인상/NNG;가능성/NNG;부각되/VVX,1,0.441035477404375,16,10,6,12,0.5151971563171863,0.19974133002734035
금리인상/NNG;이루어지/VV,1,0.441035477404375,16,10,6,14,0.5151971563171863,0.19974133002734035
투자심리/NNG;위축될/VVX;가능성/NNG,1,0.441035477404375,16,10,6,14,0.5151971563171863,0.19974133002734035
불확실성/NNG;대비해/VVX,1,0.441035477404375,16,10,6,15,0.5151971563171863,0.19974133002734035
경제성장률/NNG;하/VV,1,0.441035477404375,16,10,6,18,0.5151971563171863,0.19974133002734035
금리인상/NNG;힘/NNG;실/VV,1,0.441035477404375,16,10,6,15,0.5151971563171863,0.19974133002734035
경상수지/NNG;개선되/VVX,1,0.441035477404375,16,10,6,11,0.5151971563171863,0.19974133002734035
경기둔화/NNG;따른/VV;수요/NNG;감소/NNG,1,0.441035477404375,16,10,6,45,0.5151971563171863,0.19974133002734035
금리동결/NNG;점쳤/VV,1,0.441035477404375,16,10,6,17,0.5151971563171863,0.19974133002734035
경기회복/NNG;이어지/VV,1,0.441035477404375,16,10,6,24,0.5151971563171863,0.19974133002734035
기준금리/NNG;인상되/VVX;않/VX,1,0.441035477404375,16,10,6,29,0.5151971563171863,0.19974133002734035
유가/NNG;하락/NNG;이끌/VV,1,0.441035477404375,16,10,6,18,0.5151971563171863,0.19974133002734035
금리인상/NNG;그치/VV,1,0.441035477404375,16,10,6,17,0.5151971563171863,0.19974133002734035
금리정상화/NNG;나설/VV,1,0.441035477404375,16,10,6,18,0.5151971563171863,0.19974133002734035
불안/NNG;초래하/VVX,1,0.441035477404375,16,10,6,19,0.5151971563171863,0.19974133002734035
불안요인/NNG;남/VV,1,0.4381241095542896,52,31,21,78,0.7413805211803821,0.2895117915690732
생산/NNG;늘/VV,1,0.4379127265225269,33,20,13,20,0.6398094783361683,0.24997850742357614
국제유가/NNG;하락하/VVX,1,0.43344284897010255,78,46,32,42,0.8228112929726491,0.32504125544317247
금리/NNG;올라/VV,1,0.43344284897010255,78,46,32,104,0.8228112929726491,0.32504125544317247
콜금리/NNG;인상해/VVX,1,0.43256629297088867,40,24,16,28,0.6801396248089827,0.2692602423876696
금리/NNG;동결한/VVX,1,0.43256629297088867,40,24,16,44,0.6801396248089827,0.2692602423876696
불확실성/NNG;확대된/VVX,1,0.43256629297088867,40,24,16,46,0.6801396248089827,0.2692602423876696
양적완화/NNG;나서/VV,1,0.4271957105782336,28,17,11,56,0.6038564217955871,0.24222735153120797
정책금리/NNG;유지하/VVX,1,0.4271957105782336,28,17,11,37,0.6038564217955871,0.24222735153120797
불안/NNG;심화될/VVX,1,0.4271957105782336,28,17,11,29,0.6038564217955871,0.24222735153120797
금리동결/NNG;예상된/VVX,1,0.4271957105782336,28,17,11,24,0.6038564217955871,0.24222735153120797
경기회복/NNG;기대/NNG;커지/VV,1,0.4271957105782336,28,17,11,45,0.6038564217955871,0.24222735153120797
흑자/NNG;기록하/VVX,1,0.4214160821784594,35,21,14,46,0.6477153142744064,0.2635048453886832
경제성장/NNG;뒷받침하/VVX,1,0.4214160821784594,35,21,14,20,0.6477153142744064,0.2635048453886832
금리/NNG;하/VV;있/VV,1,0.4214160821784594,35,21,14,63,0.6477153142744064,0.2635048453886832
유동성/NNG;줄어들/VV,1,0.4214160821784594,35,21,14,44,0.6477153142744064,0.2635048453886832
물가/NNG;안정세/NNG;유지하/VVX,1,0.4214160821784594,35,21,14,21,0.6477153142744064,0.2635048453886832
성장/NNG;할/VV,1,0.4206868418800489,75,44,31,63,0.8110902749771071,0.3305541395861687
정책금리/NNG;인상/NNG;따른/VV,1,0.4192240712274846,42,25,17,40,0.6868860655178235,0.28093046842649955
금리상승/NNG;제한할/VVX,1,0.41731628894885353,56,33,23,73,0.7505748867520277,0.3083998719712131
불확실성/NNG;줄이/VV,1,0.4153380496945527,23,14,9,33,0.5654504691648261,0.23344832296517612
대외불확실성/NNG;지속되/VVX,1,0.4153380496945527,23,14,9,42,0.5654504691648261,0.23344832296517612
금리인상/NNG;검토할/VVX,1,0.4153380496945527,23,14,9,14,0.5654504691648261,0.23344832296517612
내수/NNG;부진/NNG;지속되/VVX,1,0.4153380496945527,23,14,9,34,0.5654504691648261,0.23344832296517612
금리/NNG;올리/VV;않/VX,1,0.41047553683149873,188,110,78,256,0.8738020232907876,0.3650015422920701
침체/NNG;빠지/VV,1,0.40816150251861516,30,18,12,37,0.6125026113507132,0.2572771126395664
금리상승/NNG;요인이/VVX,1,0.40816150251861516,30,18,12,46,0.6125026113507132,0.2572771126395664
기준금리/NNG;인하될/VVX;있/VV,1,0.40816150251861516,30,18,12,57,0.6125026113507132,0.2572771126395664
변동성/NNG;확대시/VVX,1,0.40759185441184687,51,30,21,74,0.7264222304566819,0.30554497839914757
변동성/NNG;크/VA;확대되/VVX,1,0.40759185441184687,51,30,21,77,0.7264222304566819,0.30554497839914757
기준금리/NNG;올린/VV,1,0.407130428747708,127,74,53,122,0.8654353431715466,0.36441865551222646
고용지표/NNG;부진하/VVX,1,0.40703182353499145,44,26,18,53,0.6933070749259931,0.2920075914337379
불확실성/NNG;완화된/VVX,1,0.40703182353499145,44,26,18,75,0.6933070749259931,0.2920075914337379
금리인상/NNG;시작하/VVX,1,0.40703182353499145,44,26,18,47,0.6933070749259931,0.2920075914337379
시장금리/NNG;상승압력/NNG;작용할/VVX,1,0.4031447235127259,18,11,7,25,0.5249888555683635,0.22317874452336675
동결/NNG;전망하/VVX,1,0.4031447235127259,18,11,7,16,0.5249888555683635,0.22317874452336675
금리/NNG;상단/NNG;제한하/VVX,1,0.4031447235127259,18,11,7,44,0.5249888555683635,0.22317874452336675
경기회복/NNG;저해하/VVX,1,0.4031447235127259,18,11,7,16,0.5249888555683635,0.22317874452336675
시장금리/NNG;하락했/VVX,1,0.4031447235127259,18,11,7,29,0.5249888555683635,0.22317874452336675
금리/NNG;변동성/NNG;확대될/VVX;가능성/NNG,1,0.4031447235127259,18,11,7,31,0.5249888555683635,0.22317874452336675
물가/NNG;오름세/NNG;확대될/VVX,1,0.4031447235127259,18,11,7,22,0.5249888555683635,0.22317874452336675
금리인상/NNG;시기/NNG;앞당길/VV,1,0.4031447235127259,18,11,7,6,0.5249888555683635,0.22317874452336675
금융시장/NNG;변동성/NNG;확대될/VVX;가능성/NNG,1,0.4031447235127259,18,11,7,30,0.5249888555683635,0.22317874452336675
금리/NNG;인상할/VVX;내다봤/VV,1,0.4031447235127259,18,11,7,16,0.5249888555683635,0.22317874452336675
경기회복/NNG;저해할/VVX,1,0.4031447235127259,18,11,7,31,0.5249888555683635,0.22317874452336675
금리인하/NNG;기대/NNG;약화될/VVX,1,0.4031447235127259,18,11,7,41,0.5249888555683635,0.22317874452336675
경제지표/NNG;개선되/VVX;모습/NNG,1,0.4031447235127259,18,11,7,43,0.5249888555683635,0.22317874452336675
불확실성/NNG;우려하/VVX,1,0.4031447235127259,18,11,7,20,0.5249888555683635,0.22317874452336675
금리인상/NNG;지연/NNG;따른/VV,1,0.4031447235127259,18,11,7,17,0.5249888555683635,0.22317874452336675
성장/NNG;따른/VV,1,0.3988790209503912,60,35,25,81,0.7586526453434707,0.32580336716088326
성장세/NNG;지속되/VVX,1,0.3935311069354457,39,23,16,72,0.6625398172258962,0.28815628368725393
경기부양/NNG;따른/VV,1,0.3925015883953189,25,15,10,27,0.5746900691113987,0.2505567576695735
금리인하/NNG;기대/NNG;강화되/VVX,1,0.3925015883953189,25,15,10,33,0.5746900691113987,0.2505567576695735
금리인상/NNG;이루어질/VV,1,0.3925015883953189,25,15,10,20,0.5746900691113987,0.2505567576695735
불안/NNG;대응하/VVX,1,0.3925015883953189,25,15,10,23,0.5746900691113987,0.2505567576695735
안전자산선호/NNG;따른/VV,1,0.3916528044272083,32,19,13,72,0.620836286121297,0.27121870616437427
금리인하/NNG;기대감/NNG;유지되/VVX,1,0.3916528044272083,32,19,13,69,0.620836286121297,0.27121870616437427
금리인상/NNG;가능성/NNG;있/VV,1,0.3916528044272083,32,19,13,61,0.620836286121297,0.27121870616437427
출구전략/NNG;시행할/VVX,1,0.3916528044272083,32,19,13,34,0.620836286121297,0.27121870616437427
기준금리/NNG;인상할/VVX;있/VV,1,0.391306922649582,83,48,35,148,0.8166703298105763,0.3570620593158315
금리인상/NNG;이뤄질/VV,1,0.39036556227817254,90,52,38,121,0.8281652378327673,0.36289237399458374
성장세/NNG;나타낼/VV,1,0.38546712873312794,48,28,20,66,0.7052140428646047,0.31259656783478507
금리인상/NNG;할/VV,1,0.3846435986272163,85,49,36,92,0.8176614136235215,0.3631412479012651
성장/NNG;예상되/VVX,1,0.38405328668609995,92,53,39,76,0.8285768688704391,0.36849854292786216
경제/NNG;미치/VV;부정적/VAX;영향/NNG,1,0.3815839436527777,41,24,17,46,0.669476787674521,0.29946677106656766
금리인상/NNG;선반영하/VVX,1,0.3771604550346661,34,20,14,55,0.6288651219110496,0.28421920841578724
통화완화/NNG;기조/NNG;유지하/VVX,1,0.3771604550346661,34,20,14,19,0.6288651219110496,0.28421920841578724
금리/NNG;올리/VV;어려울/VA,1,0.3771604550346661,34,20,14,13,0.6288651219110496,0.28421920841578724
기준금리/NNG;인상해/VVX;한다는/VX,1,0.37410496419874373,20,12,8,27,0.5345747836714543,0.2433272044360965
소비자물가/NNG;하락하/VVX,1,0.37410496419874373,20,12,8,26,0.5345747836714543,0.2433272044360965
금리하락/NNG;견인했/VVX,1,0.37410496419874373,20,12,8,30,0.5345747836714543,0.2433272044360965
성장세/NNG;회복할/VVX,1,0.37410496419874373,20,12,8,40,0.5345747836714543,0.2433272044360965
수입/NNG;늘어나/VV,1,0.37410496419874373,20,12,8,26,0.5345747836714543,0.2433272044360965
인플레이션/NNG;위험/NNG;상존해/VVX,1,0.37410496419874373,20,12,8,23,0.5345747836714543,0.2433272044360965
침체/NNG;보이/VV,1,0.37410496419874373,20,12,8,6,0.5345747836714543,0.2433272044360965
금리/NNG;인하할/VVX;전망했/VVX,1,0.37410496419874373,20,12,8,16,0.5345747836714543,0.2433272044360965
성장세/NNG;이/VV;갔/VV,1,0.37410496419874373,20,12,8,18,0.5345747836714543,0.2433272044360965
소비/NNG;미치/VV;영향/NNG,1,0.37410496419874373,20,12,8,22,0.5345747836714543,0.2433272044360965
양적완화/NNG;확대하/VVX,1,0.37410496419874373,20,12,8,36,0.5345747836714543,0.2433272044360965
불확실성/NNG;언급하/VVX,1,0.37410496419874373,20,12,8,24,0.5345747836714543,0.2433272044360965
유동성/NNG;축소되/VVX,1,0.37410496419874373,20,12,8,24,0.5345747836714543,0.2433272044360965
대외여건/NNG;개선되/VVX,1,0.37410496419874373,20,12,8,37,0.5345747836714543,0.2433272044360965
금리/NNG;상승세/NNG;이어지/VV,1,0.3734169844313675,27,16,11,29,0.5836596648774818,0.26609435296277467
성장/NNG;기록할/VVX,1,0.3734169844313675,27,16,11,35,0.5836596648774818,0.26609435296277467
금융시장/NNG;안정/NNG;도모하/VVX,1,0.3734169844313675,27,16,11,9,0.5836596648774818,0.26609435296277467
물가/NNG;올라가/VV,1,0.3734169844313675,27,16,11,34,0.5836596648774818,0.26609435296277467
기준금리/NNG;인상했/VVX,1,0.37268470424226985,351,202,149,383,0.8606628787909697,0.39304931750277516
인플레이션/NNG;억제/NNG;위해/VV,1,0.3714828888877961,59,34,25,79,0.7446546505611505,0.341019385739346
금리/NNG;치솟/VV,1,0.3714828888877961,59,34,25,142,0.7446546505611505,0.341019385739346
경기부양/NNG;나설/VV,1,0.3706903958714649,43,25,18,112,0.6761075772897515,0.31019678520803
금리인상/NNG;반영하/VVX,1,0.3668792883265344,52,30,22,51,0.7159381744454866,0.33137811284777346
경제/NNG;성장하/VVX,1,0.36618467500702834,105,60,45,162,0.8363402463960159,0.3877282423679586
금리인상/NNG;늦춰질/VV,1,0.3643009180318788,36,21,15,54,0.6365948319304756,0.2964103685013212
유가/NNG;하락하/VVX,1,0.360836374129214,100,57,43,140,0.8291444847980808,0.38915365510158934
불안/NNG;지속될/VVX,1,0.3584805526591506,54,31,23,58,0.7208795124767523,0.34017394699396897
금리인상/NNG;가능성/NNG;배제할/VVX;없/VA,1,0.3584805526591506,54,31,23,86,0.7208795124767523,0.34017394699396897
성장세/NNG;확대되/VVX,1,0.35718911272054643,29,17,12,43,0.5923641715718397,0.28035743548806047
유동성/NNG;증가하/VVX,1,0.35718911272054643,29,17,12,37,0.5923641715718397,0.28035743548806047
gdp성장률/NNG;기록하/VVX,1,0.35718911272054643,29,17,12,51,0.5923641715718397,0.28035743548806047
성장률/NNG;하/VV,1,0.35718911272054643,29,17,12,43,0.5923641715718397,0.28035743548806047
금융시장/NNG;불안해/VVX,1,0.35718911272054643,29,17,12,29,0.5923641715718397,0.28035743548806047
안전자산선호/NNG;강화되/VVX,1,0.35718911272054643,29,17,12,89,0.5923641715718397,0.28035743548806047
수출/NNG;회복되/VVX,1,0.35278113600107863,38,22,16,53,0.6440300540255459,0.3078966808565338
유가/NNG;하락했/VVX,1,0.35278113600107863,38,22,16,64,0.6440300540255459,0.3078966808565338
유가/NNG;급락하/VVX,1,0.35278113600107863,38,22,16,35,0.6440300540255459,0.3078966808565338
유동성/NNG;흡수/NNG;위한/VV,0,0.352613346591625,15,9,6,22,0.49256967775063293,0.23557694960279338
금리/NNG;인상한/VAX;이/VV,0,0.352613346591625,15,9,6,20,0.49256967775063293,0.23557694960279338
인플레이션/NNG;잘/MAG;통제되/VVX,0,0.352613346591625,15,9,6,13,0.49256967775063293,0.23557694960279338
수출/NNG;급감했/VVX,0,0.352613346591625,15,9,6,8,0.49256967775063293,0.23557694960279338
금리/NNG;올리/VV;못할/VX,0,0.352613346591625,15,9,6,25,0.49256967775063293,0.23557694960279338
금리/NNG;메리트/NNG;부각되/VVX,0,0.352613346591625,15,9,6,38,0.49256967775063293,0.23557694960279338
대외불확실성/NNG;남/VV,0,0.352613346591625,15,9,6,18,0.49256967775063293,0.23557694960279338
부양책/NNG;내놓/VV;가능성/NNG,0,0.352613346591625,15,9,6,15,0.49256967775063293,0.23557694960279338
경기/NNG;호전될/VVX;예상하/VVX,0,0.352613346591625,15,9,6,21,0.49256967775063293,0.23557694960279338
리스크/NNG;고려하/VVX,0,0.352613346591625,15,9,6,21,0.49256967775063293,0.23557694960279338
금리상승/NNG;보였/VV,0,0.352613346591625,15,9,6,12,0.49256967775063293,0.23557694960279338
경제/NNG;회복세/NNG;이/VV;가/VX,0,0.352613346591625,15,9,6,14,0.49256967775063293,0.23557694960279338
경기부양/NNG;나섰/VV,0,0.352613346591625,15,9,6,30,0.49256967775063293,0.23557694960279338
성장/NNG;지속할/VVX;있/VV,0,0.352613346591625,15,9,6,7,0.49256967775063293,0.23557694960279338
경기/NNG;후퇴/NNG;막/VV,0,0.352613346591625,15,9,6,10,0.49256967775063293,0.23557694960279338
유가/NNG;상승했/VVX;말했/VVX,0,0.352613346591625,15,9,6,33,0.49256967775063293,0.23557694960279338
기준금리/NNG;낮/VA;유지할/VVX,0,0.352613346591625,15,9,6,16,0.49256967775063293,0.23557694960279338
성장/NNG;했/VV,0,0.352613346591625,15,9,6,28,0.49256967775063293,0.23557694960279338
경제성장/NNG;이루/VV,0,0.352613346591625,15,9,6,14,0.49256967775063293,0.23557694960279338
산업생산/NNG;감소해/VVX,0,0.352613346591625,15,9,6,17,0.49256967775063293,0.23557694960279338
리스크관리/NNG;강화하/VVX,1,0.3514703170610345,47,27,20,38,0.6884799568349353,0.3301325545423939
금리인상/NNG;주장하/VVX,1,0.3514703170610345,47,27,20,73,0.6884799568349353,0.3301325545423939
성장률/NNG;기록할/VVX;전망했/VVX,1,0.3511446618131886,22,13,9,30,0.543971097554193,0.2610328584738571
물가상승압력/NNG;완화하/VVX,1,0.3511446618131886,22,13,9,8,0.543971097554193,0.2610328584738571
유가/NNG;떨어졌/VV;말했/VVX,1,0.3511446618131886,22,13,9,20,0.543971097554193,0.2610328584738571
부양책/NNG;내놓/VV;않/VX,1,0.3511446618131886,22,13,9,51,0.543971097554193,0.2610328584738571
금리인상/NNG;단행되/VVX;않/VX,1,0.3511446618131886,22,13,9,31,0.543971097554193,0.2610328584738571
경제/NNG;충격/NNG;주/VV,1,0.3511446618131886,22,13,9,20,0.543971097554193,0.2610328584738571
경기회복/NNG;기대감/NNG;커지/VV,1,0.3511446618131886,22,13,9,43,0.543971097554193,0.2610328584738571
경제/NNG;호조/NNG;보이/VV,1,0.3511446618131886,22,13,9,21,0.543971097554193,0.2610328584738571
투자심리/NNG;위축되/VVX,1,0.3508583665655536,111,63,48,166,0.8350082821171227,0.4009529524810977
금리/NNG;인상할/VVX;전망했/VVX,1,0.3431802607371508,31,18,13,36,0.6008048992765227,0.29356844152418715
물가/NNG;끌어올리/VV,1,0.3431802607371508,31,18,13,40,0.6008048992765227,0.29356844152418715
수출/NNG;의존하/VVX,1,0.34237407844609913,40,23,17,52,0.6511749204477346,0.3187616742880086
물가안정/NNG;위해/VV,1,0.3419951028671466,122,69,53,184,0.8380030516386661,0.4105692517448788
리스크/NNG;커지/VV,1,0.3413282125576984,76,43,33,105,0.7815050917443328,0.38346670761551466
기준금리/NNG;동결될/VVX,1,0.33982366371279404,217,123,94,342,0.847916599995031,0.41747026533620707
불안/NNG;지속되/VVX,1,0.33689075878194985,94,53,41,102,0.8117731787924408,0.4023282747746155
기준금리/NNG;오를/VV,1,0.3329015595870737,42,24,18,65,0.6580334186458895,0.3290727206948896
금리/NNG;상승세/NNG;지속될/VVX,1,0.3325036093113134,24,14,10,60,0.5531783020455099,0.2768836348173036
금리/NNG;변동성/NNG;확대되/VVX,1,0.3325036093113134,24,14,10,64,0.5531783020455099,0.2768836348173036
금리인하/NNG;단행될/VVX;있/VV,1,0.3325036093113134,24,14,10,35,0.5531783020455099,0.2768836348173036
수출/NNG;호조/NNG;지속되/VVX,1,0.3325036093113134,24,14,10,42,0.5531783020455099,0.2768836348173036
동결/NNG;전망했/VVX,1,0.3325036093113134,24,14,10,21,0.5531783020455099,0.2768836348173036
경제/NNG;내수/NNG;회복세/NNG;이/VV;갈/VX;전망되/VVX;경제여건/NNG,1,0.3325036093113134,24,14,10,4,0.5531783020455099,0.2768836348173036
금리인상/NNG;지속되/VVX,1,0.3325036093113134,24,14,10,41,0.5531783020455099,0.2768836348173036
국제유가/NNG;하락했/VVX,1,0.33092660013190645,33,19,14,23,0.6089814185567296,0.30589579278505985
성장률/NNG;전망치/NNG;낮췄/VV,1,0.33092660013190645,33,19,14,38,0.6089814185567296,0.30589579278505985
경기둔화/NNG;우려/NNG;따른/VV,1,0.33092660013190645,33,19,14,62,0.6089814185567296,0.30589579278505985
금리/NNG;올릴/VV;가능성/NNG,1,0.32982087840050633,80,45,35,118,0.7852375540857837,0.39540971649709206
인플레이션/NNG;우려하/VVX,1,0.32982087840050633,80,45,35,92,0.7852375540857837,0.39540971649709206
금리하락/NNG;제한하/VVX,1,0.32422201685804275,44,25,19,80,0.6646096138274807,0.33888468727337906
금리인상/NNG;진행될/VVX,1,0.32422201685804275,44,25,19,65,0.6646096138274807,0.33888468727337906
물가상승압력/NNG;나타날/VV,1,0.3233088243457043,17,10,7,11,0.5020364072377576,0.2565107452360695
금리인상/NNG;따른/VV;달러화/NNG;강세/NNG,1,0.3233088243457043,17,10,7,16,0.5020364072377576,0.2565107452360695
경제성장률/NNG;전망치/NNG;상향조정했/VVX,1,0.3233088243457043,17,10,7,29,0.5020364072377576,0.2565107452360695
유동성/NNG;흡수할/VVX,1,0.3233088243457043,17,10,7,39,0.5020364072377576,0.2565107452360695
금리인상/NNG;미뤄질/VV,1,0.3233088243457043,17,10,7,28,0.5020364072377576,0.2565107452360695
부동산가격/NNG;오르/VV,1,0.3233088243457043,17,10,7,20,0.5020364072377576,0.2565107452360695
경제/NNG;확산될/VVX,1,0.3233088243457043,17,10,7,12,0.5020364072377576,0.2565107452360695
부동산가격/NNG;상승하/VVX,1,0.3233088243457043,17,10,7,22,0.5020364072377576,0.2565107452360695
양적완화/NNG;가능성/NNG;열/VV,1,0.3233088243457043,17,10,7,21,0.5020364072377576,0.2565107452360695
수출/NNG;영향/NNG;받/VV,1,0.3233088243457043,17,10,7,18,0.5020364072377576,0.2565107452360695
소비/NNG;증가했/VVX,1,0.3233088243457043,17,10,7,23,0.5020364072377576,0.2565107452360695
경제/NNG;타격/NNG;입/VV,1,0.3233088243457043,17,10,7,23,0.5020364072377576,0.2565107452360695
수출/NNG;부정적/VAX;영향/NNG;줄/VV,1,0.3233088243457043,17,10,7,19,0.5020364072377576,0.2565107452360695
인플레이션압력/NNG;선제적/VAX;대응하/VVX,1,0.3233088243457043,17,10,7,8,0.5020364072377576,0.2565107452360695
금리/NNG;최저치/NNG;경신했/VVX,1,0.3233088243457043,17,10,7,14,0.5020364072377576,0.2565107452360695
경기/NNG;살리/VV;위해/VV,1,0.3233088243457043,17,10,7,13,0.5020364072377576,0.2565107452360695
변동성/NNG;따른/VV,1,0.3233088243457043,17,10,7,18,0.5020364072377576,0.2565107452360695
경기둔화/NNG;반영해/VVX,1,0.3233088243457043,17,10,7,12,0.5020364072377576,0.2565107452360695
금리인상/NNG;시기/NNG;늦추/VV,1,0.3233088243457043,17,10,7,23,0.5020364072377576,0.2565107452360695
금리인상/NNG;단행해/VVX,1,0.323117609547086,64,36,28,66,0.7417281830806233,0.3791406697636342
경기둔화/NNG;우려/NNG;지속되/VVX,1,0.32008410409184473,35,20,15,53,0.6168926685049801,0.3174684376426629
금리인하/NNG;기대/NNG;유지될/VVX,1,0.32008410409184473,35,20,15,67,0.6168926685049801,0.3174684376426629
생산/NNG;감소하/VVX,1,0.31702639751992767,26,15,11,31,0.562189694716636,0.29129040424460334
경제/NNG;미치/VV;충격/NNG,1,0.31702639751992767,26,15,11,28,0.562189694716636,0.29129040424460334
물가/NNG;오름세/NNG;확대되/VVX,1,0.31702639751992767,26,15,11,18,0.562189694716636,0.29129040424460334
주택가격/NNG;하락하/VVX,1,0.3162217045864695,46,26,20,32,0.6709077798175096,0.34824270890467435
경기회복세/NNG;지속되/VVX,1,0.3162103203468716,127,71,56,158,0.8293952054168402,0.4305183813698505
금리인상/NNG;있/VV,1,0.31236495802365516,177,99,78,232,0.8360320952663618,0.4376781572364016
기준금리/NNG;동결해/VVX,1,0.3103929495849016,37,21,16,61,0.6245376067162104,0.32838631198824075
금리인상/NNG;빨라질/VA;있/VV,1,0.3103929495849016,37,21,16,34,0.6245376067162104,0.32838631198824075
성장률/NNG;하락하/VVX,1,0.3103929495849016,37,21,16,47,0.6245376067162104,0.32838631198824075
금리인상/NNG;나서/VV;않/VX,1,0.3103929495849016,37,21,16,57,0.6245376067162104,0.32838631198824075
유가/NNG;급등/NNG;따른/VV,1,0.30880826545938733,48,27,21,62,0.6769324690921708,0.3571842985740391
금리/NNG;동결될/VVX,1,0.3077463603429147,115,64,51,129,0.8194287262448321,0.43338733394979606
경기회복세/NNG;지속될/VVX,1,0.30764880757494883,59,33,26,98,0.7189956552407056,0.38035119045518895
출구전략/NNG;따른/VV,1,0.30392961983420874,28,16,12,61,0.570995747800998,0.3045445662717139
채권시장/NNG;미치/VV;영향력/NNG,1,0.30392961983420874,28,16,12,80,0.570995747800998,0.3045445662717139
금리인상/NNG;가능성/NNG;열/VV;놓/VX,1,0.3019059779225357,50,28,22,81,0.6826885426561781,0.365740961238175
금리/NNG;올릴/VV;있/VV,1,0.3017302822287389,135,75,60,183,0.8259438857831662,0.44265893412473384
채권시장/NNG;미치/VV;영향/NNG;제한적/VAX,1,0.3016536417703566,39,22,17,62,0.6319155794591029,0.3387278474290708
양적완화/NNG;할/VV,1,0.3011752306598008,19,11,8,28,0.5114630310908935,0.27444960783161365
경기/NNG;불확실성/NNG;인해/VV,1,0.3011752306598008,19,11,8,41,0.5114630310908935,0.27444960783161365
경기선행지수/NNG;비/VV,1,0.3011752306598008,19,11,8,17,0.5114630310908935,0.27444960783161365
금리차/NNG;따른/VV,1,0.3011752306598008,19,11,8,40,0.5114630310908935,0.27444960783161365
채권시장/NNG;부담/NNG;되/VV,1,0.3011752306598008,19,11,8,22,0.5114630310908935,0.27444960783161365
금리인하/NNG;통한/VV;경기부양/NNG,1,0.3011752306598008,19,11,8,28,0.5114630310908935,0.27444960783161365
성장/NNG;유지할/VVX,1,0.3011752306598008,19,11,8,39,0.5114630310908935,0.27444960783161365
자산가격/NNG;상승/NNG;따른/VV,1,0.3011752306598008,19,11,8,24,0.5114630310908935,0.27444960783161365
금리/NNG;내려야/VV;하/VV,1,0.3011752306598008,19,11,8,9,0.5114630310908935,0.27444960783161365
금리인상/NNG;뒷받침할/VVX,1,0.3011752306598008,19,11,8,21,0.5114630310908935,0.27444960783161365
기준금리/NNG;동결될/VVX;전망이/VVX,1,0.3011752306598008,19,11,8,33,0.5114630310908935,0.27444960783161365
금리/NNG;인하해/VVX;할/VX,1,0.3011752306598008,19,11,8,23,0.5114630310908935,0.27444960783161365
불안/NNG;나타나/VV,1,0.3011752306598008,19,11,8,27,0.5114630310908935,0.27444960783161365
국제유가/NNG;급락/NNG;따른/VV,1,0.3011752306598008,19,11,8,24,0.5114630310908935,0.27444960783161365
불안/NNG;나타날/VV,1,0.3011752306598008,19,11,8,22,0.5114630310908935,0.27444960783161365
기준금리/NNG;유지하/VVX;바람직하/VAX;견해/NNG,1,0.3011752306598008,19,11,8,8,0.5114630310908935,0.27444960783161365
콜금리/NNG;유지하/VVX,1,0.3011752306598008,19,11,8,35,0.5114630310908935,0.27444960783161365
신용스프레드/NNG;확대되/VVX,1,0.3005716691724851,72,40,32,95,0.7542830853001273,0.4052830879694735
금리동결/NNG;예상했/VVX,1,0.2954521996966324,52,29,23,61,0.6881811737052481,0.3739394347288719
성장/NNG;하/VV,1,0.2950966685716683,139,77,62,101,0.824142985649788,0.448166047893539
성장/NNG;지속되/VVX,1,0.2937106908029461,41,23,18,49,0.639026519638526,0.3485553844791091
불확실성/NNG;증가하/VVX,1,0.29266607794846755,30,17,13,42,0.579586378855712,0.3168564690472019
금리인하/NNG;시사하/VVX,1,0.29266607794846755,30,17,13,68,0.579586378855712,0.3168564690472019
물가상승압력/NNG;지속될/VVX,1,0.29266607794846755,30,17,13,43,0.579586378855712,0.3168564690472019
리스크/NNG;존재하/VVX,1,0.29266607794846755,30,17,13,23,0.579586378855712,0.3168564690472019
금리/NNG;올려도/VV,1,0.29068115010841433,76,42,34,89,0.7593648202225577,0.41694334865431226
경기/NNG;회복세/NNG;보이/VV,1,0.2893946755685137,54,30,24,87,0.6934158345341305,0.3818026494693655
금리/NNG;올린다고/VV,1,0.2893946755685137,54,30,24,65,0.6934158345341305,0.3818026494693655
금리인상/NNG;따른/VV,1,0.2893892754502325,354,196,158,494,0.827088370899306,0.4554096308757843
기준금리/NNG;인상되/VVX,1,0.2884385963613634,161,89,72,247,0.8247762582360991,0.4550785160960227
물가상승압력/NNG;커지/VV,1,0.2864412427100682,43,24,19,62,0.6458710384102755,0.3579191054512729
경제/NNG;연착륙할/VVX,1,0.2838410946411065,21,12,9,21,0.5208227599790489,0.29025816834355045
금리인상/NNG;단행할/VVX;전망/NNG,1,0.2838410946411065,21,12,9,53,0.5208227599790489,0.29025816834355045
불안/NNG;확대될/VVX,1,0.2838410946411065,21,12,9,12,0.5208227599790489,0.29025816834355045
소비자물가/NNG;급등하/VVX,1,0.2838410946411065,21,12,9,19,0.5208227599790489,0.29025816834355045
콜금리/NNG;인상할/VVX;가능성/NNG,1,0.2838410946411065,21,12,9,16,0.5208227599790489,0.29025816834355045
유가/NNG;떨어질/VV,1,0.2838410946411065,21,12,9,24,0.5208227599790489,0.29025816834355045
리스크/NNG;완화된/VVX,1,0.2838410946411065,21,12,9,28,0.5208227599790489,0.29025816834355045
추경/NNG;통한/VV,1,0.2838410946411065,21,12,9,33,0.5208227599790489,0.29025816834355045
장단기/NNG;금리/NNG;스프레드/NNG;확대되/VVX,1,0.2838410946411065,21,12,9,27,0.5208227599790489,0.29025816834355045
설비투자/NNG;늘어나/VV,1,0.2838410946411065,21,12,9,19,0.5208227599790489,0.29025816834355045
동결/NNG;상태/NNG;유지하/VVX,1,0.2838410946411065,21,12,9,17,0.5208227599790489,0.29025816834355045
금리/NNG;내릴/VV;있/VA,1,0.2838410946411065,21,12,9,25,0.5208227599790489,0.29025816834355045
기준금리/NNG;동결키/VVX,1,0.2838410946411065,21,12,9,20,0.5208227599790489,0.29025816834355045
유가/NNG;하락/NNG;압력/NNG;받/VV,1,0.2838410946411065,21,12,9,39,0.5208227599790489,0.29025816834355045
수출/NNG;미치/VV,1,0.2838410946411065,21,12,9,21,0.5208227599790489,0.29025816834355045
경기/NNG;판단하/VVX,1,0.28284327958039523,32,18,14,25,0.5879521060233119,0.32838073788122457
유가/NNG;하락/NNG;인해/VV,1,0.28284327958039523,32,18,14,37,0.5879521060233119,0.32838073788122457
물가/NNG;오르/VV;않/VX,1,0.28284327958039523,32,18,14,40,0.5879521060233119,0.32838073788122457
불안심리/NNG;완화되/VVX,1,0.28284327958039523,32,18,14,48,0.5879521060233119,0.32838073788122457
금리인상/NNG;예상하/VVX,1,0.28095259029646114,91,50,41,132,0.7825741531156214,0.43887729102690376
금리하락/NNG;따른/VV,1,0.28095259029646114,91,50,41,140,0.7825741531156214,0.43887729102690376
물가/NNG;상승할/VVX,1,0.2808184621691774,69,38,31,89,0.7377242754366694,0.4138452886000786
성장률/NNG;달성하/VVX,1,0.27974702019262976,45,25,20,66,0.6524504513069218,0.3668599179440148
금리/NNG;올려야/VV;할/VX,1,0.27974702019262976,45,25,20,54,0.6524504513069218,0.3668599179440148
소비자물가/NNG;상승했/VVX,1,0.27974702019262976,45,25,20,66,0.6524504513069218,0.3668599179440148
금리/NNG;인상함/VVX,1,0.27974702019262976,45,25,20,20,0.6524504513069218,0.3668599179440148
물가/NNG;미치/VV,1,0.27974702019262976,45,25,20,41,0.6524504513069218,0.3668599179440148
금리/NNG;올리/VV,1,0.27804502649770235,937,516,421,1168,0.8221080306241222,0.4639623493676832
금리인상/NNG;하/VV,1,0.2773257694979496,151,83,68,149,0.8186451246007088,0.46272787415642397
불확실성/NNG;존재한/VVX,1,0.27417300717022997,34,19,15,38,0.5960846053463935,0.33923307538346126
변동성/NNG;확대될/VVX;가능성/NNG;있/VV,1,0.27417300717022997,34,19,15,43,0.5960846053463935,0.33923307538346126
국제유가/NNG;상승하/VVX,1,0.2735485149240813,47,26,21,63,0.6587667645276494,0.3754115891629776
금리상승/NNG;확대되/VVX,1,0.2731927717065754,60,33,27,98,0.7076306752497367,0.4035675150504798
유가/NNG;상승하/VVX,1,0.2731927717065754,60,33,27,99,0.7076306752497367,0.4035675150504798
물가/NNG;잡/VV,1,0.27119620810292244,146,80,66,217,0.8150207583111226,0.4668194648181373
경제/NNG;경착륙할/VVX,1,0.26986335370032966,23,13,10,27,0.5300854044258104,0.3044905156727713
수출/NNG;부진/NNG;이어지/VV,1,0.26986335370032966,23,13,10,45,0.5300854044258104,0.3044905156727713
경제/NNG;흔들리/VV,1,0.26986335370032966,23,13,10,31,0.5300854044258104,0.3044905156727713
경기/NNG;바닥/NNG;쳤/VV,1,0.26986335370032966,23,13,10,10,0.5300854044258104,0.3044905156727713
금리/NNG;상승세/NNG;출발했/VVX,1,0.2677807378753547,49,27,22,60,0.6648226376581494,0.383602340698362
재정위기/NNG;따른/VV,1,0.2677807378753547,49,27,22,96,0.6648226376581494,0.383602340698362
금리인상/NNG;이어지/VV,1,0.2664391774696071,36,20,16,54,0.6039769445461353,0.34950155249548404
경제성장/NNG;이끌/VV,1,0.2664391774696071,36,20,16,47,0.6039769445461353,0.34950155249548404
금리인상/NNG;늦출/VV,1,0.2623900653753539,51,28,23,42,0.6706213332081956,0.3914560510064611
금리/NNG;인하될/VVX,1,0.2621440190949256,101,55,46,90,0.7864780579507382,0.4593264792066122
금리인상/NNG;지연되/VVX,1,0.2594767871324253,38,21,17,41,0.6116236416262519,0.359254317021224
금리/NNG;내려간/VV,1,0.2594767871324253,38,21,17,55,0.6116236416262519,0.359254317021224
기준금리/NNG;동결할/VVX;예상했/VVX,1,0.2594767871324253,38,21,17,48,0.6116236416262519,0.359254317021224
금리인상/NNG;가능성/NNG;시사하/VVX,1,0.259297878327712,79,43,36,81,0.7513450157572267,0.4414927238538319
금리/NNG;인상할/VVX;필요/NNG;있/VA,1,0.2583192813859707,25,14,11,20,0.5392222112021418,0.31751324636959194
재정지출/NNG;확대하/VVX,1,0.2583192813859707,25,14,11,28,0.5392222112021418,0.31751324636959194
경제/NNG;체질/NNG;개선하/VVX,1,0.2583192813859707,25,14,11,31,0.5392222112021418,0.31751324636959194
성장/NNG;보였/VV,1,0.2583192813859707,25,14,11,23,0.5392222112021418,0.31751324636959194
경제성장/NNG;발목/NNG;잡/VV,1,0.2583192813859707,25,14,11,25,0.5392222112021418,0.31751324636959194
침체/NNG;벗어나/VV;못하/VX,1,0.2583192813859707,25,14,11,25,0.5392222112021418,0.31751324636959194
변동성/NNG;키울/VV;있/VV,1,0.2583192813859707,25,14,11,40,0.5392222112021418,0.31751324636959194
금융시장/NNG;변동성/NNG;커질/VV,1,0.2583192813859707,25,14,11,37,0.5392222112021418,0.31751324636959194
금리인하/NNG;가능할/VVX,1,0.25733186755719717,53,29,24,75,0.6761666596231218,0.39899316988567685
기준금리인상/NNG;따른/VV,1,0.25534950552071556,127,69,58,115,0.8019915165548787,0.47525013111598097
성장률/NNG;둔화되/VVX,1,0.25256870340928606,55,30,25,84,0.6814629120270839,0.4062314194992114
정책금리/NNG;인상하/VVX,1,0.2519085994512993,151,82,69,161,0.8069936895861175,0.48174033518083487
금리하락/NNG;견인하/VVX,1,0.2485935135834192,27,15,12,59,0.5482076023053232,0.32957638109046383
경기회복/NNG;힘입/VV,1,0.2485935135834192,27,15,12,45,0.5482076023053232,0.32957638109046383
기준금리동결/NNG;전망했/VVX,1,0.2485935135834192,27,15,12,21,0.5482076023053232,0.32957638109046383
금융완화/NNG;기조/NNG;유지되/VVX,1,0.2485935135834192,27,15,12,16,0.5482076023053232,0.32957638109046383
세계경제/NNG;회복되/VVX,1,0.2485935135834192,27,15,12,35,0.5482076023053232,0.32957638109046383
금리인상/NNG;우려/NNG;따른/VV,1,0.2485935135834192,27,15,12,30,0.5482076023053232,0.32957638109046383
리스크/NNG;상존하/VVX,1,0.2485935135834192,27,15,12,50,0.5482076023053232,0.32957638109046383
성장세/NNG;둔화될/VVX,1,0.24806893160414822,57,31,26,67,0.6865148133970765,0.4131863357553649
기준금리/NNG;올리/VV,1,0.24793250399188138,339,184,155,492,0.8083906937959775,0.48667995331939684
성장/NNG;가능할/VVX,1,0.2476302451758039,98,53,45,123,0.7760862831287891,0.4675322110296396
경제/NNG;부정적/VAX;영향/NNG;미칠/VV,1,0.24738126994097098,42,23,19,40,0.6261651746141811,0.37741619632540363
인플레이션/NNG;우려/NNG;커지/VV,1,0.24738126994097098,42,23,19,61,0.6261651746141811,0.37741619632540363
불확실성/NNG;해소된/VVX,1,0.24349949447780506,74,40,34,141,0.732935058759347,0.4454311981088796
경기회복/NNG;되/VV,1,0.24026080398931948,29,16,13,21,0.5570196159794247,0.3408552203452383
불안/NNG;해소하/VVX,1,0.24026080398931948,29,16,13,30,0.5570196159794247,0.3408552203452383
수출/NNG;호조/NNG;지속하/VVX,1,0.24026080398931948,29,16,13,25,0.5570196159794247,0.3408552203452383
금리인상/NNG;시기/NNG;될/VV,1,0.24026080398931948,29,16,13,34,0.5570196159794247,0.3408552203452383
금리/NNG;올린다는/VV,1,0.24026080398931948,29,16,13,30,0.5570196159794247,0.3408552203452383
유럽재정위기/NNG;따른/VV,1,0.24026080398931948,29,16,13,53,0.5570196159794247,0.3408552203452383
금리인상/NNG;시사했/VVX,1,0.23992979641948842,76,41,35,94,0.7357498489918468,0.4505410565589336
불확실성/NNG;지속될/VVX,1,0.23975574835248392,61,33,28,146,0.6959062569971952,0.4262998147144609
금리인하/NNG;단행할/VVX;전망/NNG,0,0.23974219845723987,16,9,7,12,0.4765666605832522,0.2919446570601194
경기선행지수/NNG;상승했/VVX,0,0.23974219845723987,16,9,7,21,0.4765666605832522,0.2919446570601194
내수/NNG;성장기여/VVX,0,0.23974219845723987,16,9,7,11,0.4765666605832522,0.2919446570601194
경기선행지수/NNG;전년동월비/NNG;하락하/VVX,0,0.23974219845723987,16,9,7,14,0.4765666605832522,0.2919446570601194
디레버리징/NNG;따른/VV,0,0.23974219845723987,16,9,7,16,0.4765666605832522,0.2919446570601194
경제/NNG;침체/NNG;벗어나/VV,0,0.23974219845723987,16,9,7,29,0.4765666605832522,0.2919446570601194
물가/NNG;크/VA;오르/VV,0,0.23974219845723987,16,9,7,14,0.4765666605832522,0.2919446570601194
성장세/NNG;힘입/VV,0,0.23974219845723987,16,9,7,20,0.4765666605832522,0.2919446570601194
금리인하/NNG;기대감/NNG;커지/VV,0,0.23974219845723987,16,9,7,55,0.4765666605832522,0.2919446570601194
장단기/NNG;금리차/NNG;축소될/VVX,0,0.23974219845723987,16,9,7,20,0.4765666605832522,0.2919446570601194
금리상승/NNG;대비해/VVX,0,0.23974219845723987,16,9,7,39,0.4765666605832522,0.2919446570601194
금리인상/NNG;막/VV,0,0.23974219845723987,16,9,7,25,0.4765666605832522,0.2919446570601194
통화완화/NNG;기조/NNG;강화되/VVX,0,0.23974219845723987,16,9,7,17,0.4765666605832522,0.2919446570601194
변동성/NNG;확대시/VVX;요인/NNG,0,0.23974219845723987,16,9,7,31,0.4765666605832522,0.2919446570601194
재정/NNG;확대/NNG;통한/VV,0,0.23974219845723987,16,9,7,23,0.4765666605832522,0.2919446570601194
채권시장/NNG;미치/VV;영향/NNG;크/VA;않/VX,0,0.23974219845723987,16,9,7,41,0.4765666605832522,0.2919446570601194
불안/NNG;재연될/VVX,0,0.23974219845723987,16,9,7,20,0.4765666605832522,0.2919446570601194
물가/NNG;상승한/VVX,0,0.23974219845723987,16,9,7,23,0.4765666605832522,0.2919446570601194
불안/NNG;가중될/VVX,0,0.23974219845723987,16,9,7,13,0.4765666605832522,0.2919446570601194
물가/NNG;상승세/NNG;지속되/VVX,0,0.23974219845723987,16,9,7,18,0.4765666605832522,0.2919446570601194
경기둔화/NNG;우려/NNG;확산되/VVX,0,0.23974219845723987,16,9,7,25,0.4765666605832522,0.2919446570601194
기준금리인상/NNG;인해/VV,0,0.23974219845723987,16,9,7,18,0.4765666605832522,0.2919446570601194
정책금리/NNG;인상/NNG;단행될/VVX,0,0.23974219845723987,16,9,7,12,0.4765666605832522,0.2919446570601194
기준금리/NNG;인상하/VVX;통화정책/NNG,0,0.23974219845723987,16,9,7,11,0.4765666605832522,0.2919446570601194
경기회복/NNG;맞물려/VV,0,0.23974219845723987,16,9,7,23,0.4765666605832522,0.2919446570601194
기준금리인상/NNG;가능성/NNG;열려/VV,0,0.23974219845723987,16,9,7,13,0.4765666605832522,0.2919446570601194
국제유가/NNG;상승/NNG;따른/VV,1,0.23714950546450342,46,25,21,63,0.6396920119541328,0.3940330792266534
경기/NNG;회복될/VVX,1,0.23649328047848406,78,42,36,133,0.7383850716793883,0.4554574335280276
금리인상/NNG;가능할/VVX,1,0.2331814331108184,80,43,37,118,0.7408474906952285,0.46018725152236395
기준금리/NNG;인상할/VVX;전망했/VVX,1,0.23301828059418517,31,17,14,41,0.5656398162173393,0.3514757905010063
불안/NNG;잠재우/VV,1,0.23301828059418517,31,17,14,37,0.5656398162173393,0.3514757905010063
유가/NNG;하락/NNG;따른/VV,1,0.23246363806106496,182,98,84,205,0.8003842420926726,0.49792359673622405
경제성장률/NNG;둔화될/VVX,1,0.23221949894950056,65,35,30,76,0.7043852577063576,0.43842804192936274
내수/NNG;회복되/VVX,1,0.22830363265441567,50,27,23,56,0.6522047479403585,0.40931665649120913
금리인상/NNG;단행하/VVX,0,0.22781851633749062,227,122,105,282,0.7987687239069794,0.501811330648895
금리인상/NNG;기조/NNG;이어질/VV,1,0.22664459537194626,33,18,15,29,0.5740530025444286,0.3615307811568089
경기회복세/NNG;이어질/VV,1,0.22664459537194626,33,18,15,30,0.5740530025444286,0.3615307811568089
양적완화/NNG;축소하/VVX,1,0.22664459537194626,33,18,15,111,0.5740530025444286,0.3615307811568089
안전자산선호/NNG;현상/NNG;강화돼/VVX;상승했/VVX,0,0.2252155597848684,18,10,8,8,0.4860471304636365,0.30702808570160717
기준금리/NNG;동결할/VVX;내다봤/VV,0,0.2252155597848684,18,10,8,26,0.4860471304636365,0.30702808570160717
기준금리/NNG;인상해/VVX;할/VX,0,0.2252155597848684,18,10,8,20,0.4860471304636365,0.30702808570160717
경기/NNG;불확실성/NNG;따른/VV,0,0.2252155597848684,18,10,8,36,0.4860471304636365,0.30702808570160717
금리인하/NNG;반영하/VVX,0,0.2252155597848684,18,10,8,42,0.4860471304636365,0.30702808570160717
유동성/NNG;사정/NNG;원활하/VVX,0,0.2252155597848684,18,10,8,8,0.4860471304636365,0.30702808570160717
기준금리/NNG;인상될/VVX;가능성/NNG;크/VA,0,0.2252155597848684,18,10,8,17,0.4860471304636365,0.30702808570160717
수출/NNG;증가율/NNG;둔화될/VVX,0,0.2252155597848684,18,10,8,28,0.4860471304636365,0.30702808570160717
금융시장/NNG;출렁이/VV,0,0.2252155597848684,18,10,8,22,0.4860471304636365,0.30702808570160717
수출/NNG;둔화될/VVX,0,0.2252155597848684,18,10,8,29,0.4860471304636365,0.30702808570160717
변동성/NNG;확대/NNG;요인/NNG;작용할/VVX,0,0.2252155597848684,18,10,8,24,0.4860471304636365,0.30702808570160717
변동성/NNG;크/VA;확대됐/VVX,0,0.2252155597848684,18,10,8,14,0.4860471304636365,0.30702808570160717
주택가격/NNG;상승세/NNG;둔화되/VVX,0,0.2252155597848684,18,10,8,11,0.4860471304636365,0.30702808570160717
경기/NNG;회복되/VVX;않/VX,0,0.2252155597848684,18,10,8,15,0.4860471304636365,0.30702808570160717
금리/NNG;상승한/VAX;스프레드/NNG;확대된/VVX,0,0.2252155597848684,18,10,8,17,0.4860471304636365,0.30702808570160717
금리/NNG;올릴/VV;전망했/VVX,0,0.2252155597848684,18,10,8,22,0.4860471304636365,0.30702808570160717
경제/NNG;회복/NNG;보이/VV,0,0.2252155597848684,18,10,8,15,0.4860471304636365,0.30702808570160717
자금이탈/NNG;지속되/VVX,0,0.2252155597848684,18,10,8,37,0.4860471304636365,0.30702808570160717
불확실성/NNG;존재하/VVX,1,0.22429520360813648,52,28,24,74,0.658084999484304,0.4165073208988328
불확실성/NNG;해소되/VVX;않/VX,1,0.22392137069805385,86,46,40,96,0.7472645905468195,0.4733218100815371
수출/NNG;늘/VV,1,0.22103915139460817,88,47,41,72,0.74910204988639,0.4773684946553426
불확실성/NNG;확대될/VVX,1,0.22097435101688134,35,19,16,60,0.5822468635724226,0.371089810140662
금리/NNG;인상할/VVX;가능성/NNG,0,0.21861398088417006,146,78,68,134,0.7900348647394932,0.5060224545149425
경기/NNG;살아나/VV,1,0.21825027278054976,90,48,42,157,0.7507993871474281,0.4812589074470002
실물경제/NNG;미칠/VV,0,0.21393386813862936,20,11,9,22,0.49556273100822845,0.32053952058186974
유동성/NNG;흡수해/VVX,0,0.21393386813862936,20,11,9,30,0.49556273100822845,0.32053952058186974
금리/NNG;낮춰야/VV,0,0.21393386813862936,20,11,9,26,0.49556273100822845,0.32053952058186974
금리/NNG;최저치/NNG;경신하/VVX,0,0.21393386813862936,20,11,9,42,0.49556273100822845,0.32053952058186974
불확실성/NNG;확대됐/VVX,0,0.21393386813862936,20,11,9,19,0.49556273100822845,0.32053952058186974
금리인상/NNG;가능성/NNG;커졌/VV,0,0.21393386813862936,20,11,9,20,0.49556273100822845,0.32053952058186974
지준율/NNG;올리/VV,0,0.21393386813862936,20,11,9,14,0.49556273100822845,0.32053952058186974
경제/NNG;불확실성/NNG;커지/VV,0,0.21393386813862936,20,11,9,36,0.49556273100822845,0.32053952058186974
경제/NNG;부정적/VAX;영향/NNG;미치/VV,0,0.21393386813862936,20,11,9,22,0.49556273100822845,0.32053952058186974
소비/NNG;줄/VV,0,0.21393386813862936,20,11,9,27,0.49556273100822845,0.32053952058186974
금리/NNG;인상해/VVX,0,0.21295266202002705,124,66,58,176,0.7798495139112605,0.5054586283573421
기준금리/NNG;동결하/VVX,0,0.21162906633051648,467,249,218,768,0.7908712695039093,0.5140236081389744
추경/NNG;편성하/VVX,1,0.2112686152148433,39,21,18,73,0.5979397819966326,0.38892159231680107
금리/NNG;인상할/VVX;가능성/NNG;있/VV,1,0.2070587932907717,41,22,19,63,0.6054257221942756,0.39726905336183027
금리/NNG;하락/NNG;압력/NNG;받/VV,1,0.2070587932907717,41,22,19,92,0.6054257221942756,0.39726905336183027
불확실성/NNG;지속되/VVX,0,0.20667901867478955,130,69,61,191,0.7793483135962952,0.511799271923346
수출/NNG;증가율/NNG;기록하/VVX,1,0.20490666990039674,22,12,10,20,0.5050507637827052,0.3328960660347572
기업실적/NNG;개선되/VVX,1,0.20490666990039674,22,12,10,18,0.5050507637827052,0.3328960660347572
변동성/NNG;커질/VA;있/VV,1,0.20490666990039674,22,12,10,38,0.5050507637827052,0.3328960660347572
물가/NNG;상승세/NNG;둔화되/VVX,1,0.20490666990039674,22,12,10,26,0.5050507637827052,0.3328960660347572
금리인상/NNG;가능성/NNG;시사할/VVX,1,0.20490666990039674,22,12,10,33,0.5050507637827052,0.3328960660347572
자산가격/NNG;상승하/VVX,1,0.20490666990039674,22,12,10,20,0.5050507637827052,0.3328960660347572
금리/NNG;인하된/VVX,1,0.20490666990039674,22,12,10,24,0.5050507637827052,0.3328960660347572
경기/NNG;후퇴/NNG;따른/VV,1,0.20490666990039674,22,12,10,21,0.5050507637827052,0.3328960660347572
경제/NNG;성장세/NNG;지속하/VVX,1,0.20490666990039674,22,12,10,29,0.5050507637827052,0.3328960660347572
금리인상/NNG;시작된/VVX,1,0.20490666990039674,22,12,10,19,0.5050507637827052,0.3328960660347572
금리하락/NNG;제한될/VVX,1,0.20319097055830926,43,23,20,60,0.6126655731947404,0.4052753555381239
금리인상/NNG;가능성/NNG;커지/VV,1,0.20319097055830926,43,23,20,48,0.6126655731947404,0.4052753555381239
경기침체/NNG;막/VV,1,0.20319097055830926,43,23,20,47,0.6126655731947404,0.4052753555381239
경기둔화/NNG;우려/NNG;커지/VV,1,0.20158622299860363,66,35,31,113,0.6925614101689529,0.45965991775744736
금리인상/NNG;나서/VV,0,0.2010809320639837,198,105,93,311,0.7853038559019807,0.5217626059466579
유가/NNG;상승/NNG;따른/VV,0,0.2010007671904559,104,55,49,122,0.7592654730628319,0.504546672673206
금리/NNG;인상해/VVX;한다고/VX,1,0.19750667810721168,24,13,11,33,0.5144615824992395,0.34436356265688844
금리인하/NNG;단행할/VVX;가능성/NNG;높/VA,1,0.19750667810721168,24,13,11,25,0.5144615824992395,0.34436356265688844
수출/NNG;호조/NNG;따른/VV,1,0.19750667810721168,24,13,11,30,0.5144615824992395,0.34436356265688844
성장률/NNG;전망치/NNG;하향조정하/VVX,1,0.19750667810721168,24,13,11,49,0.5144615824992395,0.34436356265688844
연착륙/NNG;유도하/VVX,1,0.19750667810721168,24,13,11,21,0.5144615824992395,0.34436356265688844
재정/NNG;풀/VV,1,0.19750667810721168,24,13,11,20,0.5144615824992395,0.34436356265688844
성장/NNG;지속하/VVX;물가안정/NNG;유지될/VVX;있/VV;경제상황/NNG;고려하/VVX,1,0.19750667810721168,24,13,11,16,0.5144615824992395,0.34436356265688844
경제/NNG;안정되/VVX,1,0.19750667810721168,24,13,11,40,0.5144615824992395,0.34436356265688844
금리상승/NNG;막/VV,1,0.19750667810721168,24,13,11,31,0.5144615824992395,0.34436356265688844
금리인상/NNG;카드/NNG;꺼내/VV,1,0.19750667810721168,24,13,11,17,0.5144615824992395,0.34436356265688844
불확실성/NNG;해소되/VVX,0,0.1944921324139688,227,120,107,390,0.7821767720706312,0.5268522486692078
기준금리/NNG;낮춰/VV,1,0.19319063438235307,49,26,23,41,0.6328909202353017,0.4274506211035719
기준금리/NNG;인상될/VVX;가능성/NNG,0,0.19265665586478153,112,59,53,197,0.7619138416443663,0.5151623298691258
재정지출/NNG;줄이/VV,1,0.19131759105217094,26,14,12,18,0.5237557960340234,0.35511842495214047
불안/NNG;가중되/VVX,1,0.19131759105217094,26,14,12,43,0.5237557960340234,0.35511842495214047
유가/NNG;상승/NNG;부추겼/VV,1,0.19131759105217094,26,14,12,30,0.5237557960340234,0.35511842495214047
성장세/NNG;이어지/VV,1,0.19028014262630677,51,27,24,76,0.6391345670568542,0.43428085458851745
금리/NNG;인상할/VVX;있/VA,1,0.19028014262630677,51,27,24,59,0.6391345670568542,0.43428085458851745
유동성/NNG;공급했/VVX,1,0.18917779833334514,76,40,36,104,0.710683540317312,0.4840014396591564
성장세/NNG;유지될/VVX,1,0.18605241974879783,28,15,13,30,0.5329020421625126,0.3652818026613306
경제성장률/NNG;전망치/NNG;하향조정했/VVX,1,0.18605241974879783,28,15,13,49,0.5329020421625126,0.3652818026613306
금리인상/NNG;더불/VV,1,0.18605241974879783,28,15,13,40,0.5329020421625126,0.3652818026613306
경기/NNG;바닥/NNG;치/VV,1,0.18605241974879783,28,15,13,16,0.5329020421625126,0.3652818026613306
과잉유동성/NNG;흡수하/VVX,1,0.18605241974879783,28,15,13,26,0.5329020421625126,0.3652818026613306
금융시장/NNG;안정될/VVX,1,0.18605241974879783,28,15,13,18,0.5329020421625126,0.3652818026613306
물가/NNG;상승해/VVX,1,0.18605241974879783,28,15,13,51,0.5329020421625126,0.3652818026613306
금리인상/NNG;단행된/VVX,1,0.18494833213426354,55,29,26,54,0.6508843359707294,0.44717387730201313
금리인상/NNG;지속할/VVX,1,0.18494833213426354,55,29,26,82,0.6508843359707294,0.44717387730201313
경제성장률/NNG;높이/VV,1,0.18150700828091382,30,16,14,28,0.5418752959275179,0.3749394040844273
실업률/NNG;치솟/VV,1,0.18150700828091382,30,16,14,34,0.5418752959275179,0.3749394040844273
변동성/NNG;키울/VV,1,0.18150700828091382,30,16,14,42,0.5418752959275179,0.3749394040844273
물가상승압력/NNG;지속되/VVX,1,0.18150700828091382,30,16,14,29,0.5418752959275179,0.3749394040844273
산업생산/NNG;증가했/VVX,1,0.18150700828091382,30,16,14,63,0.5418752959275179,0.3749394040844273
경기/NNG;하강할/VVX,1,0.18150700828091382,30,16,14,14,0.5418752959275179,0.3749394040844273
금리/NNG;낮/VA;유지하/VVX,1,0.17792626168914727,61,32,29,71,0.6667130781435603,0.4647407427763887
성장세/NNG;유지할/VVX,1,0.17792626168914727,61,32,29,55,0.6667130781435603,0.4647407427763887
불확실성/NNG;높/VA;상황이/VVX,1,0.1775322562709667,32,17,15,53,0.550655598099942,0.3841534936381019
물가/NNG;잡/VV;위해/VV,1,0.1775322562709667,32,17,15,62,0.550655598099942,0.3841534936381019
수입/NNG;감소하/VVX,1,0.1775322562709667,32,17,15,40,0.550655598099942,0.3841534936381019
자본확충/NNG;위해/VV,1,0.1775322562709667,32,17,15,70,0.550655598099942,0.3841534936381019
금리인상/NNG;늦추/VV,1,0.1775322562709667,32,17,15,47,0.550655598099942,0.3841534936381019
불확실성/NNG;남/VV,0,0.17690045285511768,271,142,129,463,0.7730852644497398,0.5400301342837432
경제/NNG;부담/NNG;줄/VV,1,0.17401681837265937,34,18,16,22,0.559227095354212,0.3929704195209052
인플레이션/NNG;완화되/VVX,1,0.17401681837265937,34,18,16,40,0.559227095354212,0.3929704195209052
금리하락/NNG;요인/NNG;작용할/VVX,1,0.17401681837265937,34,18,16,47,0.559227095354212,0.3929704195209052
금리/NNG;올릴/VV;있/VA,1,0.17401681837265937,34,18,16,31,0.559227095354212,0.3929704195209052
자산/NNG;줄이/VV,1,0.17401681837265937,34,18,16,44,0.559227095354212,0.3929704195209052
채권시장/NNG;약세/NNG;보임/VV,1,0.17179439276350594,67,35,32,66,0.680489747494111,0.4803752688461078
변동성/NNG;확대될/VVX;가능성/NNG;높/VA,1,0.1708759424240085,36,19,17,63,0.567577307411799,0.40142548519254934
금리인상/NNG;예상했/VVX,1,0.1708759424240085,36,19,17,78,0.567577307411799,0.40142548519254934
성장률/NNG;그칠/VV,1,0.16546964532520958,40,21,19,58,0.5835775324766691,0.41735441489801933
금리인상/NNG;서두르/VV;않/VX,1,0.16546964532520958,40,21,19,80,0.5835775324766691,0.41735441489801933
불확실성/NNG;이어질/VV,1,0.16311181398425156,42,22,20,51,0.5912149087654424,0.4248679802240056
변동성/NNG;지속될/VVX,1,0.16311181398425156,42,22,20,51,0.5912149087654424,0.4248679802240056
경제/NNG;위협하/VVX,1,0.16311181398425156,42,22,20,55,0.5912149087654424,0.4248679802240056
채권시장/NNG;강세/NNG;지지하/VVX,0,0.1630089997394366,77,40,37,112,0.699279167157926,0.5026328202203231
금리/NNG;인상할/VVX,0,0.16163287504552093,552,287,265,769,0.7649489428195776,0.5513898952971191
금리상승/NNG;압력/NNG;작용하/VVX,1,0.1609376522033843,44,23,21,39,0.598605075571142,0.4321016909200303
금리/NNG;동결하/VVX,0,0.1599530617983782,308,160,148,428,0.7640415417099878,0.5526360962188113
금리인상/NNG;주장했/VVX,1,0.1589204510267992,46,24,22,61,0.6057458855082234,0.4390681222417309
유가/NNG;급등하/VVX,1,0.15703833536676992,48,25,23,57,0.6126364534491158,0.44577817420381666
기준금리인상/NNG;가능성/NNG;반영했/VVX,0,0.15575623961195206,166,86,80,122,0.7601222868755181,0.5545485054668217
물가상승/NNG;주도했/VVX,0,0.15324196256197609,15,8,7,12,0.4475219812858274,0.32817456410020757
성장세/NNG;약화될/VVX,0,0.15324196256197609,15,8,7,25,0.4475219812858274,0.32817456410020757
경기/NNG;상승/NNG;따른/VV;수요압력/NNG,0,0.15324196256197609,15,8,7,28,0.4475219812858274,0.32817456410020757
성장/NNG;될/VV,0,0.15324196256197609,15,8,7,14,0.4475219812858274,0.32817456410020757
채권시장/NNG;호재/NNG;작용하/VVX,0,0.15324196256197609,15,8,7,13,0.4475219812858274,0.32817456410020757
기준금리/NNG;동결됨/VVX,0,0.15324196256197609,15,8,7,38,0.4475219812858274,0.32817456410020757
경제/NNG;나아지/VV,0,0.15324196256197609,15,8,7,32,0.4475219812858274,0.32817456410020757
금리인상/NNG;우려/NNG;확대되/VVX,0,0.15324196256197609,15,8,7,15,0.4475219812858274,0.32817456410020757
경제성장률/NNG;전망치/NNG;낮췄/VV,0,0.15324196256197609,15,8,7,11,0.4475219812858274,0.32817456410020757
수출/NNG;미치/VV;부정적/VAX,0,0.15324196256197609,15,8,7,11,0.4475219812858274,0.32817456410020757
가계대출/NNG;증가하/VVX,0,0.15324196256197609,15,8,7,11,0.4475219812858274,0.32817456410020757
경기/NNG;꺾일/VV,0,0.15324196256197609,15,8,7,13,0.4475219812858274,0.32817456410020757
유가/NNG;하락해/VVX,0,0.15324196256197609,15,8,7,14,0.4475219812858274,0.32817456410020757
성장률/NNG;기록할/VVX;예상했/VVX,0,0.15324196256197609,15,8,7,10,0.4475219812858274,0.32817456410020757
물가상승압력/NNG;확대되/VVX,0,0.15324196256197609,15,8,7,17,0.4475219812858274,0.32817456410020757
연방기금금리/NNG;선물시장/NNG;반영된/VVX,0,0.15324196256197609,15,8,7,12,0.4475219812858274,0.32817456410020757
금리하락/NNG;두드러졌/VV,0,0.15324196256197609,15,8,7,26,0.4475219812858274,0.32817456410020757
유가/NNG;급등했/VVX,0,0.15324196256197609,15,8,7,20,0.4475219812858274,0.32817456410020757
디플레이션/NNG;우려/NNG;제기되/VVX,0,0.15324196256197609,15,8,7,24,0.4475219812858274,0.32817456410020757
경기부양책/NNG;쓰/VV,0,0.15324196256197609,15,8,7,28,0.4475219812858274,0.32817456410020757
금리인하/NNG;기대감/NNG;확대되/VVX,0,0.15324196256197609,15,8,7,12,0.4475219812858274,0.32817456410020757
금리인상/NNG;가능성/NNG;반영했/VVX,0,0.15324196256197609,15,8,7,18,0.4475219812858274,0.32817456410020757
경제지표/NNG;결정될/VVX,0,0.15324196256197609,15,8,7,21,0.4475219812858274,0.32817456410020757
하방리스크/NNG;요인/NNG;작용할/VVX,0,0.15324196256197609,15,8,7,10,0.4475219812858274,0.32817456410020757
유가/NNG;상승/NNG;힘입/VV,0,0.15324196256197609,15,8,7,18,0.4475219812858274,0.32817456410020757
기준금리인하/NNG;단행될/VVX;가능성/NNG,0,0.15324196256197609,15,8,7,24,0.4475219812858274,0.32817456410020757
기준금리인상/NNG;시작하/VVX,0,0.15324196256197609,15,8,7,15,0.4475219812858274,0.32817456410020757
투자심리/NNG;회복됐/VVX,0,0.15324196256197609,15,8,7,13,0.4475219812858274,0.32817456410020757
금리인상/NNG;가능성/NNG;불거지/VV,0,0.15324196256197609,15,8,7,14,0.4475219812858274,0.32817456410020757
금리/NNG;인상하/VVX;않/VX,0,0.1526689704675197,147,76,71,182,0.7557849266610716,0.5548783102270851
물가/NNG;안정될/VVX,1,0.15203655339089406,54,28,26,62,0.6318133408842839,0.46446176913433634
수출/NNG;부진하/VVX,1,0.15203655339089406,54,28,26,55,0.6318133408842839,0.46446176913433634
산업생산/NNG;증가하/VVX,1,0.15054181547711298,56,29,27,56,0.63771379465892,0.4702340213526717
금리/NNG;인상되/VVX,0,0.14963753336503172,126,65,61,132,0.7473015703413293,0.5520604951135023
성장세/NNG;보이/VV,0,0.1471304763149841,188,97,91,250,0.7565581590469969,0.561767899701621
소비자물가상승률/NNG;둔화되/VVX,0,0.14662194151817443,17,9,8,13,0.45751810773578344,0.3400742624014476
금리인상/NNG;예상한/VVX,0,0.14662194151817443,17,9,8,26,0.45751810773578344,0.3400742624014476
설비투자/NNG;개선되/VVX,0,0.14662194151817443,17,9,8,20,0.45751810773578344,0.3400742624014476
완전고용/NNG;근접했/VVX,0,0.14662194151817443,17,9,8,8,0.45751810773578344,0.3400742624014476
성장/NNG;주도하/VVX,0,0.14662194151817443,17,9,8,37,0.45751810773578344,0.3400742624014476
주택시장/NNG;둔화되/VVX,0,0.14662194151817443,17,9,8,20,0.45751810773578344,0.3400742624014476
유동성/NNG;과도하/VVX,0,0.14662194151817443,17,9,8,22,0.45751810773578344,0.3400742624014476
기준금리/NNG;인상할/VVX;예상했/VVX,0,0.14662194151817443,17,9,8,19,0.45751810773578344,0.3400742624014476
채권시장/NNG;미치/VV;충격/NNG,0,0.14662194151817443,17,9,8,10,0.45751810773578344,0.3400742624014476
gdp/NNG;감소할/VVX,0,0.14662194151817443,17,9,8,18,0.45751810773578344,0.3400742624014476
경제/NNG;성장세/NNG;지속되/VVX,0,0.14662194151817443,17,9,8,24,0.45751810773578344,0.3400742624014476
물가/NNG;시차/NNG;두/VV,0,0.14662194151817443,17,9,8,27,0.45751810773578344,0.3400742624014476
수출/NNG;부정적/VAX;영향/NNG;미칠/VV,0,0.14662194151817443,17,9,8,28,0.45751810773578344,0.3400742624014476
금리/NNG;인상하/VVX;될/VV,0,0.14662194151817443,17,9,8,15,0.45751810773578344,0.3400742624014476
리스크/NNG;해소되/VVX;않/VX,0,0.14662194151817443,17,9,8,33,0.45751810773578344,0.3400742624014476
변동성/NNG;확대할/VVX;있/VV,0,0.14662194151817443,17,9,8,14,0.45751810773578344,0.3400742624014476
기준금리/NNG;낮춰야/VV,0,0.14662194151817443,17,9,8,21,0.45751810773578344,0.3400742624014476
수출/NNG;증가율/NNG;둔화되/VVX,0,0.14662194151817443,17,9,8,34,0.45751810773578344,0.3400742624014476
물가상승압력/NNG;작용할/VVX;있/VV,0,0.14662194151817443,17,9,8,26,0.45751810773578344,0.3400742624014476
성장세/NNG;기록할/VVX,0,0.14662194151817443,17,9,8,17,0.45751810773578344,0.3400742624014476
안전자산선호/NNG;현상/NNG;강화될/VVX,0,0.14662194151817443,17,9,8,13,0.45751810773578344,0.3400742624014476
인플레이션/NNG;우려/NNG;부각되/VVX,0,0.14662194151817443,17,9,8,10,0.45751810773578344,0.3400742624014476
금리인상/NNG;따른/VV;유동성/NNG,0,0.14662194151817443,17,9,8,13,0.45751810773578344,0.3400742624014476
불안요인/NNG;작용하/VVX,1,0.1464479585972427,62,32,30,79,0.6539848321105036,0.48628110430768623
장단기/NNG;금리차/NNG;확대되/VVX,1,0.1464479585972427,62,32,30,85,0.6539848321105036,0.48628110430768623
금리/NNG;인상할/VVX;전망/NNG,1,0.14519165369480524,64,33,31,105,0.6589457891988723,0.4912277792136121
금리/NNG;인상될/VVX;가능성/NNG,1,0.14519165369480524,64,33,31,108,0.6589457891988723,0.4912277792136121
투자심리/NNG;위축됐/VVX,1,0.1439808696741478,66,34,32,86,0.6636833279912745,0.4959831374755815
금리/NNG;동결했/VVX,0,0.14335093177835745,200,103,97,282,0.7547159220704539,0.5647386327191037
성장세/NNG;보일/VV,0,0.1423081887343196,109,56,53,168,0.7323138435106317,0.5491419700302301
산업생산/NNG;감소했/VVX,0,0.14161034633943737,19,10,9,38,0.46756337561625894,0.35111202262101043
경제전망/NNG;있/VV,0,0.14161034633943737,19,10,9,23,0.46756337561625894,0.35111202262101043
금리/NNG;인상하/VVX;어려울/VA,0,0.14161034633943737,19,10,9,45,0.46756337561625894,0.35111202262101043
시장금리/NNG;하락/NNG;견인하/VVX,0,0.14161034633943737,19,10,9,28,0.46756337561625894,0.35111202262101043
경제지표/NNG;혼조세/NNG;나타내/VV,0,0.14161034633943737,19,10,9,18,0.46756337561625894,0.35111202262101043
경제/NNG;위기/NNG;극복하/VVX,0,0.14161034633943737,19,10,9,21,0.46756337561625894,0.35111202262101043
금리동결/NNG;전망했/VVX,0,0.14161034633943737,19,10,9,16,0.46756337561625894,0.35111202262101043
경제/NNG;미칠/VV;부정적/VAX;영향/NNG,0,0.14161034633943737,19,10,9,32,0.46756337561625894,0.35111202262101043
수출/NNG;높/VA;신장세/NNG;유지하/VVX,0,0.14161034633943737,19,10,9,7,0.46756337561625894,0.35111202262101043
금리하락/NNG;예상된/VVX,0,0.14161034633943737,19,10,9,26,0.46756337561625894,0.35111202262101043
소비자물가/NNG;안정세/NNG;보이/VV,0,0.14161034633943737,19,10,9,19,0.46756337561625894,0.35111202262101043
자산매입/NNG;연장하/VVX,0,0.14161034633943737,19,10,9,9,0.46756337561625894,0.35111202262101043
성장률/NNG;될/VV,0,0.14161034633943737,19,10,9,35,0.46756337561625894,0.35111202262101043
동결/NNG;예상된/VVX,0,0.14161034633943737,19,10,9,17,0.46756337561625894,0.35111202262101043
경제/NNG;금융시장/NNG;미치/VV;영향/NNG,0,0.14161034633943737,19,10,9,19,0.46756337561625894,0.35111202262101043
경제/NNG;미칠/VV;영향/NNG,0,0.1383577926072339,117,60,57,161,0.7360156049208995,0.5563783055965832
금리/NNG;인하할/VVX;예상/NNG,0,0.1377103255538794,21,11,10,7,0.47758108603648713,0.36149547277029564
금리동결/NNG;기조/NNG;이/VV,0,0.1377103255538794,21,11,10,22,0.47758108603648713,0.36149547277029564
경기회복세/NNG;둔화되/VVX,0,0.1377103255538794,21,11,10,39,0.47758108603648713,0.36149547277029564
성장/NNG;제약하/VVX,0,0.1377103255538794,21,11,10,21,0.47758108603648713,0.36149547277029564
금리/NNG;인상될/VVX;확률/NNG,0,0.1377103255538794,21,11,10,18,0.47758108603648713,0.36149547277029564
금리/NNG;낮/VA;유지되/VVX,0,0.1377103255538794,21,11,10,31,0.47758108603648713,0.36149547277029564
듀레이션/NNG;줄이/VV,0,0.1377103255538794,21,11,10,53,0.47758108603648713,0.36149547277029564
금리상승/NNG;동조화되/VVX,0,0.1377103255538794,21,11,10,18,0.47758108603648713,0.36149547277029564
유가/NNG;돌파하/VVX,0,0.1377103255538794,21,11,10,16,0.47758108603648713,0.36149547277029564
재정긴축/NNG;따른/VV,0,0.1377103255538794,21,11,10,39,0.47758108603648713,0.36149547277029564
대외불확실성/NNG;인해/VV,0,0.1377103255538794,21,11,10,32,0.47758108603648713,0.36149547277029564
gdp/NNG;성장하/VVX,0,0.1377103255538794,21,11,10,32,0.47758108603648713,0.36149547277029564
경기둔화/NNG;대응하/VVX,0,0.1377103255538794,21,11,10,23,0.47758108603648713,0.36149547277029564
기준금리인상/NNG;가능성/NNG;시사하/VVX,0,0.1377103255538794,21,11,10,11,0.47758108603648713,0.36149547277029564
침체/NNG;빠질/VV;가능성/NNG,0,0.1377103255538794,21,11,10,33,0.47758108603648713,0.36149547277029564
금리인하/NNG;나서/VV;않/VX,0,0.1377103255538794,21,11,10,40,0.47758108603648713,0.36149547277029564
금리하락/NNG;견인할/VVX,0,0.1377103255538794,21,11,10,57,0.47758108603648713,0.36149547277029564
불확실성/NNG;커지/VV,0,0.13684234427775266,189,97,92,279,0.7508682877477798,0.5693599704429757
경기/NNG;회복되/VVX,0,0.13590376298332707,306,157,149,388,0.750792907325374,0.5703913931180056
시장금리/NNG;상승했/VVX,0,0.13460628397425345,23,12,11,35,0.4875155570205278,0.3713537369996019
금리동결/NNG;기조/NNG;유지할/VVX,0,0.13460628397425345,23,12,11,24,0.4875155570205278,0.3713537369996019
경기/NNG;낙관하/VVX,0,0.13460628397425345,23,12,11,28,0.4875155570205278,0.3713537369996019
성장세/NNG;둔화된/VVX,0,0.13460628397425345,23,12,11,19,0.4875155570205278,0.3713537369996019
성장세/NNG;회복/NNG;이어지/VV;물가안정기조/NNG;유지되/VVX;하/VV;금융안정/NNG,0,0.13460628397425345,23,12,11,14,0.4875155570205278,0.3713537369996019
경제/NNG;타격/NNG;줄/VV,0,0.13460628397425345,23,12,11,28,0.4875155570205278,0.3713537369996019
성장/NNG;기대되/VVX,0,0.13460628397425345,23,12,11,36,0.4875155570205278,0.3713537369996019
물가안정/NNG;유지될/VVX;있/VV;경제상황/NNG;고려하/VVX;나갈/VX,0,0.13460628397425345,23,12,11,16,0.4875155570205278,0.3713537369996019
금리/NNG;인상할/VVX;있/VV,0,0.1331533050439031,129,66,63,193,0.7394240552785845,0.5649061907030306
물가/NNG;안정시/VVX,0,0.13280173192083988,88,45,43,134,0.7026456272031738,0.5371920545036618
투자심리/NNG;부정적/VAX;영향/NNG;미쳤/VV,0,0.132088266378102,25,13,12,33,0.4973251464295934,0.3807707865738695
가계부채/NNG;증가/NNG;따른/VV,0,0.132088266378102,25,13,12,28,0.4973251464295934,0.3807707865738695
금리/NNG;인상할/VVX;예상/NNG,0,0.132088266378102,25,13,12,43,0.4973251464295934,0.3807707865738695
수출/NNG;호조/NNG;지속하/VVX;소비/NNG,0,0.132088266378102,25,13,12,4,0.4973251464295934,0.3807707865738695
금리인상/NNG;가능성/NNG;배제하/VVX,0,0.132088266378102,25,13,12,39,0.4973251464295934,0.3807707865738695
금리/NNG;올려야/VV;한다고/VX,0,0.132088266378102,25,13,12,35,0.4973251464295934,0.3807707865738695
금리하락/NNG;요인/NNG;작용했/VVX,0,0.132088266378102,25,13,12,30,0.4973251464295934,0.3807707865738695
소비/NNG;이어지/VV,0,0.132088266378102,25,13,12,30,0.4973251464295934,0.3807707865738695
금융시장/NNG;불안하/VVX,0,0.132088266378102,25,13,12,33,0.4973251464295934,0.3807707865738695
금리인상/NNG;점치/VV,1,0.13001132633084822,27,14,13,30,0.5069780092058984,0.38980330178923733
기준금리인하/NNG;예상하/VVX,1,0.13001132633084822,27,14,13,40,0.5069780092058984,0.38980330178923733
금리/NNG;인상할/VVX;예상했/VVX,1,0.13001132633084822,27,14,13,29,0.5069780092058984,0.38980330178923733
신용경색/NNG;우려/NNG;완화되/VVX,1,0.13001132633084822,27,14,13,18,0.5069780092058984,0.38980330178923733
금리인상/NNG;진행되/VVX,1,0.13001132633084822,27,14,13,53,0.5069780092058984,0.38980330178923733
금리인상/NNG;나선/VV,1,0.13001132633084822,27,14,13,32,0.5069780092058984,0.38980330178923733
채권시장/NNG;부담/NNG;작용할/VVX,1,0.13001132633084822,27,14,13,50,0.5069780092058984,0.38980330178923733
금리/NNG;인상했/VVX,0,0.12918658136896655,266,136,130,256,0.7470044662861659,0.5753170721405996
금융안정/NNG;위해/VV,1,0.12827232863343285,29,15,14,31,0.5164494130585202,0.39849081027334354
산업생산/NNG;증가해/VVX,1,0.12827232863343285,29,15,14,38,0.5164494130585202,0.39849081027334354
하방위험/NNG;상존하/VVX,1,0.12827232863343285,29,15,14,28,0.5164494130585202,0.39849081027334354
기준금리/NNG;유지될/VVX,1,0.12827232863343285,29,15,14,42,0.5164494130585202,0.39849081027334354
기준금리/NNG;동결되/VVX,0,0.1274093814890347,145,74,71,389,0.7412287380561757,0.5729329459971769
통화완화/NNG;정책/NNG;따른/VV,1,0.12679603104164516,31,16,15,23,0.5257199761045621,0.40686172092639067
수출/NNG;개선되/VVX,1,0.12679603104164516,31,16,15,68,0.5257199761045621,0.40686172092639067
금리동결/NNG;기조/NNG;이어질/VV,1,0.1255263803100155,33,17,16,52,0.5347744686697806,0.41493705834555855
금리동결/NNG;따른/VV,1,0.1255263803100155,33,17,16,53,0.5347744686697806,0.41493705834555855
경기침체/NNG;막/VV;위해/VV,1,0.1255263803100155,33,17,16,44,0.5347744686697806,0.41493705834555855
기준금리/NNG;인상될/VVX,0,0.12498926270151678,153,78,75,309,0.7413853479232869,0.5758759226217595
변동성/NNG;커졌/VV,1,0.12442087464507234,35,18,17,57,0.5436009710493351,0.42273285015713746
기준금리인상/NNG;있/VV,1,0.12442087464507234,35,18,17,47,0.5436009710493351,0.42273285015713746
금리인상/NNG;나설/VV,0,0.12367005375149986,255,130,125,319,0.743864160562337,0.5793498590789423
금융시장/NNG;안정된/VVX,1,0.12344680059029378,37,19,18,33,0.5521902622685455,0.43026169461238517
채권시장/NNG;강세/NNG;보임/VV,1,0.12344680059029378,37,19,18,53,0.5521902622685455,0.43026169461238517
경제성장/NNG;따른/VV,1,0.12344680059029378,37,19,18,37,0.5521902622685455,0.43026169461238517
불확실성/NNG;이어지/VV,1,0.12344680059029378,37,19,18,74,0.5521902622685455,0.43026169461238517
금리/NNG;올렸/VV,0,0.1230763400297199,208,106,102,214,0.7433934266124558,0.579680884262918
불확실성/NNG;고조되/VVX,1,0.12257865458323103,39,20,19,87,0.5605353627451585,0.4375338127875454
신용등급/NNG;강등되/VVX,1,0.12257865458323103,39,20,19,61,0.5605353627451585,0.4375338127875454
기준금리/NNG;동결함/VVX,1,0.121796335335149,41,21,20,97,0.5686311821000214,0.44455776747241643
정책금리/NNG;인상되/VVX,1,0.121796335335149,41,21,20,44,0.5686311821000214,0.44455776747241643
국제유가/NNG;급등하/VVX,1,0.121796335335149,41,21,20,45,0.5686311821000214,0.44455776747241643
기준금리인상/NNG;단행하/VVX,1,0.121796335335149,41,21,20,54,0.5686311821000214,0.44455776747241643
물가/NNG;급등하/VVX,1,0.12108385075127326,43,22,21,45,0.5764742405995783,0.45134096119309214
불확실성/NNG;커질/VV,1,0.12108385075127326,43,22,21,57,0.5764742405995783,0.45134096119309214
금리인상/NNG;결정하/VVX,1,0.12042837619890046,45,23,22,63,0.584062443444071,0.4578899847831098
성장률/NNG;높이/VV,1,0.12042837619890046,45,23,22,74,0.584062443444071,0.4578899847831098
자산/NNG;매각하/VVX,1,0.11981955759950025,47,24,23,49,0.5913948939359657,0.4642108630027055
기준금리/NNG;인상될/VVX;있/VV,1,0.11981955759950025,47,24,23,49,0.5913948939359657,0.4642108630027055
경기부양/NNG;위해/VV;기준금리/NNG,1,0.11981955759950025,47,24,23,71,0.5913948939359657,0.4642108630027055
경기회복/NNG;지연되/VVX,1,0.11819641202519948,53,27,26,69,0.6118635824376014,0.4818596857838966
성장률/NNG;기록하/VVX,0,0.11800935852897432,130,66,64,125,0.7311913051858738,0.5760518356521602
수출/NNG;호조/NNG;보이/VV,1,0.1167687474197654,59,30,29,78,0.63008410780113,0.4976457521489461
변동성/NNG;보일/VV,0,0.11631985545003665,61,31,30,77,0.6356736189424899,0.5025169613998057
경기/NNG;개선/NNG;따른/VV,0,0.11588055012722598,63,32,31,70,0.6410282459214309,0.5072008742042007
정책금리/NNG;올리/VV,0,0.11588055012722598,63,32,31,87,0.6410282459214309,0.5072008742042007
성장/NNG;이끌/VV,0,0.11255957574205011,79,40,39,95,0.6760314892993448,0.5385036715157624
금리/NNG;인상한/VVX,0,0.11215820705664492,81,41,40,98,0.6795122490418747,0.5417159931656397
부양책/NNG;내놓/VV,0,0.11096600765237552,87,44,43,178,0.6889032607923957,0.5505285316291543
금리인상/NNG;단행되/VVX,0,0.10826216237335107,101,51,50,139,0.7054390303361819,0.5668329446512905
금리인상/NNG;우려/NNG;완화되/VVX,0,0.1075159848734275,105,53,52,113,0.7089860712695605,0.5705427678621365
기준금리/NNG;인상할/VVX,0,0.10617849868276119,390,197,193,541,0.73375438503642,0.5920724106254293
기준금리/NNG;인상하/VVX,0,0.0904058286455367,553,277,276,769,0.7244204180452503,0.6034351273900863
유동성/NNG;흡수하/VVX,0,0.08883124292505906,120,60,60,158,0.7091790282035653,0.5926150959869007
소비/NNG;증가하/VVX,0,0.08806356209739485,78,39,39,64,0.6604074289620656,0.552713337080575
금리/NNG;인상될/VVX,0,0.08789285928873114,152,76,76,223,0.7195024425444378,0.6023785468236261
정책금리/NNG;인상할/VVX,0,0.08786757144922697,76,38,38,115,0.6563874747402931,0.5495656951402625
금리인상/NNG;가능성/NNG;시사했/VVX,0,0.08786757144922697,76,38,38,90,0.6563874747402931,0.5495656951402625
기준금리/NNG;동결했/VVX,0,0.08703237063585534,376,188,188,706,0.7223981025900593,0.6058512335900531
불확실성/NNG;커졌/VV,0,0.08652727685819772,66,33,33,106,0.6331837391533942,0.5315701870504422
투자심리/NNG;위축된/VVX,0,0.08538733622760364,60,30,30,96,0.6165734264179327,0.5188142001144652
금리인하/NNG;예상하/VVX,0,0.08538733622760364,60,30,30,70,0.6165734264179327,0.5188142001144652
불안/NNG;커지/VV,0,0.08538733622760364,60,30,30,78,0.6165734264179327,0.5188142001144652
기준금리/NNG;동결할/VVX;전망했/VVX,1,0.08339431672692821,52,26,26,47,0.5910030033542657,0.4992958521108158
기준금리인상/NNG;나설/VV,1,0.08339431672692821,52,26,26,82,0.5910030033542657,0.4992958521108158
시장금리/NNG;상승할/VVX,1,0.08339431672692821,52,26,26,96,0.5910030033542657,0.4992958521108158
성장/NNG;지속할/VVX,1,0.08216617829105877,48,24,24,51,0.5766762518302144,0.48839703436096704
인플레이션/NNG;억제하/VVX;위해/VV,1,0.08216617829105877,48,24,24,68,0.5766762518302144,0.48839703436096704
채권시장/NNG;국채/NNG;가격/NNG;올랐/VV,1,0.08216617829105877,48,24,24,88,0.5766762518302144,0.48839703436096704
정책금리/NNG;동결될/VVX,1,0.08148820962095815,46,23,23,71,0.569116716891206,0.48265226747181406
경기둔화/NNG;인해/VV,1,0.07999545183913592,42,21,21,58,0.5531961631164564,0.47056056824846676
자산/NNG;투자하/VVX,1,0.07917694290448285,40,20,20,55,0.5448335051859381,0.4642102286991127
경기/NNG;부진/NNG;따른/VV,1,0.07917694290448285,40,20,20,86,0.5448335051859381,0.4642102286991127
변동성/NNG;커질/VV;가능성/NNG,1,0.07830781266128795,38,19,19,49,0.536202779292895,0.4576553810506961
금리/NNG;하락세/NNG;보임/VV,1,0.07738612496535002,36,18,18,81,0.5273051852221087,0.45089552818829015
물가/NNG;안정세/NNG;보이/VV,1,0.07738612496535002,36,18,18,58,0.5273051852221087,0.45089552818829015
금리/NNG;동결된/VVX,1,0.07738612496535002,36,18,18,57,0.5273051852221087,0.45089552818829015
기준금리/NNG;인하하/VVX;않/VX,1,0.07738612496535002,36,18,18,53,0.5273051852221087,0.45089552818829015
금리인하/NNG;단행될/VVX;가능성/NNG,1,0.07738612496535002,36,18,18,37,0.5273051852221087,0.45089552818829015
불확실성/NNG;제거되/VVX,1,0.07738612496535002,36,18,18,49,0.5273051852221087,0.45089552818829015
유동성/NNG;회수하/VVX,1,0.07640992122686052,34,17,17,38,0.5181428527879305,0.44393074350977896
기준금리인상/NNG;단행될/VVX,1,0.07640992122686052,34,17,17,63,0.5181428527879305,0.44393074350977896
인플레이션/NNG;잡/VV,1,0.07640992122686052,34,17,17,45,0.5181428527879305,0.44393074350977896
금리인하/NNG;주장하/VVX,1,0.07640992122686052,34,17,17,54,0.5181428527879305,0.44393074350977896
금리/NNG;올려야/VV;한다는/VX,1,0.07640992122686052,34,17,17,59,0.5181428527879305,0.44393074350977896
경기회복/NNG;발목/NNG;잡/VV,1,0.07537722605462416,32,16,16,27,0.5087189097247599,0.43676172160011284
물가/NNG;치솟/VV,1,0.07537722605462416,32,16,16,22,0.5087189097247599,0.43676172160011284
금리인상/NNG;따른/VV;자본유출/NNG,1,0.07537722605462416,32,16,16,25,0.5087189097247599,0.43676172160011284
유동성/NNG;확보/NNG;위한/VV,1,0.07537722605462416,32,16,16,21,0.5087189097247599,0.43676172160011284
물가/NNG;상승했/VVX,1,0.07537722605462416,32,16,16,57,0.5087189097247599,0.43676172160011284
경제지표/NNG;부진했/VVX,0,0.07428605369740082,30,15,15,66,0.4990375482142181,0.4293898294040312
성장/NNG;이/VV;가/VX,0,0.07428605369740082,30,15,15,40,0.4990375482142181,0.4293898294040312
금리인상/NNG;나섰/VV,0,0.07428605369740082,30,15,15,44,0.4990375482142181,0.4293898294040312
경기선행지수/NNG;상승하/VVX,0,0.07428605369740082,30,15,15,49,0.4990375482142181,0.4293898294040312
실업률/NNG;떨어지/VV,0,0.07428605369740082,30,15,15,49,0.4990375482142181,0.4293898294040312
금리인상/NNG;단행될/VVX,0,0.0742658651503898,135,67,68,182,0.7071065737589733,0.6084445617007906
금리/NNG;하/VV,0,0.07374269775477105,129,64,65,231,0.7045343436935381,0.6068685270303774
금리/NNG;크/VA;상승했/VVX,0,0.07313441529894593,28,14,14,21,0.4891040889440378,0.4218171573040836
유가/NNG;하/VV,0,0.07313441529894593,28,14,14,35,0.4891040889440378,0.4218171573040836
기준금리/NNG;인상될/VVX;전망/NNG,0,0.07313441529894593,28,14,14,57,0.4891040889440378,0.4218171573040836
유동성/NNG;늘어나/VV,0,0.07313441529894593,28,14,14,29,0.4891040889440378,0.4218171573040836
금리/NNG;유지했/VVX,0,0.07313441529894593,28,14,14,25,0.4891040889440378,0.4218171573040836
경기둔화/NNG;우려하/VVX,0,0.07313441529894593,28,14,14,28,0.4891040889440378,0.4218171573040836
수입/NNG;늘/VV,0,0.0719203269707267,26,13,13,46,0.4789250414690421,0.4140465694202653
잠재성장률/NNG;높이/VV,0,0.0719203269707267,26,13,13,29,0.4789250414690421,0.4140465694202653
금리상승/NNG;이어질/VV,0,0.0719203269707267,26,13,13,45,0.4789250414690421,0.4140465694202653
인플레이션/NNG;우려/NNG;따른/VV,0,0.0719203269707267,26,13,13,40,0.4789250414690421,0.4140465694202653
유가/NNG;하락했/VVX;말했/VVX,0,0.0719203269707267,26,13,13,35,0.4789250414690421,0.4140465694202653
리스크/NNG;인해/VV,0,0.0719203269707267,26,13,13,52,0.4789250414690421,0.4140465694202653
금리상승/NNG;이어지/VV,0,0.0719203269707267,26,13,13,40,0.4789250414690421,0.4140465694202653
불안/NNG;고조되/VVX,0,0.07064181867152786,24,12,12,31,0.4685081595289523,0.4060817523570215
인플레이션/NNG;우려/NNG;완화되/VVX,0,0.07064181867152786,24,12,12,47,0.4685081595289523,0.4060817523570215
경기회복/NNG;지속될/VVX,0,0.07064181867152786,24,12,12,42,0.4685081595289523,0.4060817523570215
경기/NNG;호조/NNG;보이/VV,0,0.07064181867152786,24,12,12,27,0.4685081595289523,0.4060817523570215
인플레이션압력/NNG;높일/VV,0,0.07064181867152786,24,12,12,20,0.4685081595289523,0.4060817523570215
변동성/NNG;확대시/VVX;있/VV,0,0.07064181867152786,24,12,12,37,0.4685081595289523,0.4060817523570215
수입/NNG;줄어들/VV,0,0.07064181867152786,24,12,12,23,0.4685081595289523,0.4060817523570215
성장/NNG;뒷받침하/VVX,0,0.07064181867152786,24,12,12,23,0.4685081595289523,0.4060817523570215
지준율/NNG;인상이/VVX,0,0.07064181867152786,24,12,12,21,0.4685081595289523,0.4060817523570215
유동성/NNG;억제하/VVX,0,0.07064181867152786,24,12,12,24,0.4685081595289523,0.4060817523570215
성장/NNG;달성할/VVX,0,0.07064181867152786,24,12,12,28,0.4685081595289523,0.4060817523570215
성장/NNG;견인할/VVX,0,0.07064181867152786,24,12,12,40,0.4685081595289523,0.4060817523570215
소비심리/NNG;살아나/VV,0,0.07064181867152786,24,12,12,17,0.4685081595289523,0.4060817523570215
불확실성/NNG;커질/VV;있/VV,0,0.07064181867152786,24,12,12,42,0.4685081595289523,0.4060817523570215
불확실성/NNG;인해/VV,0,0.0694691760792363,99,49,50,245,0.6804852559800819,0.5912038137528545
자산/NNG;팔/VV,0,0.0692969438662554,22,11,11,29,0.45786248987643346,0.39792726153538294
금리/NNG;하락세/NNG;출발했/VVX,0,0.0692969438662554,22,11,11,53,0.45786248987643346,0.39792726153538294
실물경제/NNG;영향/NNG;주/VV,0,0.0692969438662554,22,11,11,21,0.45786248987643346,0.39792726153538294
유가/NNG;상승했/VVX,0,0.0692969438662554,22,11,11,42,0.45786248987643346,0.39792726153538294
기준금리인상/NNG;나서/VV,0,0.0692969438662554,22,11,11,58,0.45786248987643346,0.39792726153538294
불확실성/NNG;걷히/VV,0,0.0692969438662554,22,11,11,25,0.45786248987643346,0.39792726153538294
인플레이션압력/NNG;대응하/VVX;위해/VV,0,0.0692969438662554,22,11,11,21,0.45786248987643346,0.39792726153538294
금리인하/NNG;기대/NNG;소멸되/VVX,0,0.0692969438662554,22,11,11,37,0.45786248987643346,0.39792726153538294
투자심리/NNG;줬/VV,0,0.0692969438662554,22,11,11,36,0.45786248987643346,0.39792726153538294
불확실성/NNG;상존하/VVX,0,0.06903511522156003,97,48,49,146,0.6779822857904798,0.5895425851455556
불확실성/NNG;키울/VV,0,0.06788378991732791,20,10,10,28,0.44699841308762445,0.38958856416564275
경제지표/NNG;호조/NNG;보였/VV,0,0.06788378991732791,20,10,10,53,0.44699841308762445,0.38958856416564275
인플레이션/NNG;억제되/VVX,0,0.06788378991732791,20,10,10,28,0.44699841308762445,0.38958856416564275
기준금리/NNG;역전된/VVX,0,0.06788378991732791,20,10,10,32,0.44699841308762445,0.38958856416564275
경기둔화/NNG;지속될/VVX,0,0.06788378991732791,20,10,10,31,0.44699841308762445,0.38958856416564275
경기회복/NNG;둔화되/VVX,0,0.06788378991732791,20,10,10,51,0.44699841308762445,0.38958856416564275
경기/NNG;상승기조/NNG;이/VV;가/VX,0,0.06788378991732791,20,10,10,12,0.44699841308762445,0.38958856416564275
기준금리/NNG;낮/VA;유지하/VVX,0,0.06788378991732791,20,10,10,17,0.44699841308762445,0.38958856416564275
수출/NNG;감소할/VVX,0,0.06788378991732791,20,10,10,26,0.44699841308762445,0.38958856416564275
수출/NNG;품목인/VVX,0,0.06788378991732791,20,10,10,31,0.44699841308762445,0.38958856416564275
gdp성장률/NNG;기록할/VVX,0,0.06788378991732791,20,10,10,16,0.44699841308762445,0.38958856416564275
금리인상/NNG;기대하/VVX,0,0.06788378991732791,20,10,10,31,0.44699841308762445,0.38958856416564275
내수/NNG;회복/NNG;따른/VV,0,0.06788378991732791,20,10,10,29,0.44699841308762445,0.38958856416564275
흑자/NNG;전환되/VVX,0,0.06788378991732791,20,10,10,20,0.44699841308762445,0.38958856416564275
수출/NNG;잘/MAG;되/VV,0,0.06788378991732791,20,10,10,24,0.44699841308762445,0.38958856416564275
인플레이션/NNG;걱정하/VVX,0,0.06788378991732791,20,10,10,19,0.44699841308762445,0.38958856416564275
경기둔화/NNG;우려/NNG;완화되/VVX,0,0.06788378991732791,20,10,10,45,0.44699841308762445,0.38958856416564275
채권시장/NNG;미칠/VV;영향/NNG,0,0.06788378991732791,20,10,10,35,0.44699841308762445,0.38958856416564275
수입/NNG;늘리/VV,0,0.06788378991732791,20,10,10,12,0.44699841308762445,0.38958856416564275
투자심리/NNG;개선됐/VVX,0,0.06788378991732791,20,10,10,41,0.44699841308762445,0.38958856416564275
금리인상/NNG;단행할/VVX,0,0.06655066160816459,273,135,138,346,0.7099257073273726,0.6204042290305481
성장률/NNG;기록할/VVX,0,0.06644529230980512,87,43,44,106,0.6632191692133135,0.5797099066265262
소비자물가/NNG;상승하/VVX,0,0.06644529230980512,87,43,44,118,0.6632191692133135,0.5797099066265262
경기/NNG;진작/NNG;위해/VV,0,0.06640048914129237,18,9,9,24,0.4359276747726958,0.3810720778427847
변동성/NNG;완화되/VVX,0,0.06640048914129237,18,9,9,35,0.4359276747726958,0.3810720778427847
물가상승압력/NNG;완화시/VVX,0,0.06640048914129237,18,9,9,17,0.4359276747726958,0.3810720778427847
경제/NNG;회복/NNG;따른/VV,0,0.06640048914129237,18,9,9,33,0.4359276747726958,0.3810720778427847
경제성장률/NNG;하락하/VVX,0,0.06640048914129237,18,9,9,38,0.4359276747726958,0.3810720778427847
수출/NNG;크/VA;증가하/VVX,0,0.06640048914129237,18,9,9,9,0.4359276747726958,0.3810720778427847
경기회복/NNG;위해서/VV,0,0.06640048914129237,18,9,9,26,0.4359276747726958,0.3810720778427847
통화긴축/NNG;단행할/VVX,0,0.06640048914129237,18,9,9,18,0.4359276747726958,0.3810720778427847
경제전망/NNG;하/VV,0,0.06640048914129237,18,9,9,14,0.4359276747726958,0.3810720778427847
통화긴축/NNG;중단할/VVX,0,0.06640048914129237,18,9,9,18,0.4359276747726958,0.3810720778427847
인플레이션/NNG;유발할/VVX,0,0.06640048914129237,18,9,9,24,0.4359276747726958,0.3810720778427847
경기/NNG;회복세/NNG;보일/VV,0,0.06640048914129237,18,9,9,17,0.4359276747726958,0.3810720778427847
내수/NNG;회복/NNG;힘입/VV,0,0.06640048914129237,18,9,9,18,0.4359276747726958,0.3810720778427847
금리/NNG;묶/VV,0,0.06640048914129237,18,9,9,22,0.4359276747726958,0.3810720778427847
자산매입/NNG;유지하/VVX,0,0.06640048914129237,18,9,9,56,0.4359276747726958,0.3810720778427847
금리하락/NNG;지지하/VVX,0,0.06640048914129237,18,9,9,50,0.4359276747726958,0.3810720778427847
경기둔화/NNG;이어지/VV,0,0.06640048914129237,18,9,9,18,0.4359276747726958,0.3810720778427847
성장/NNG;모멘텀/NNG;불확실성/NNG;해소되/VVX,0,0.06640048914129237,18,9,9,9,0.4359276747726958,0.3810720778427847
금리인하/NNG;대응할/VVX,0,0.06640048914129237,18,9,9,27,0.4359276747726958,0.3810720778427847
금리인상/NNG;시기/NNG;늦춰질/VV,0,0.06640048914129237,18,9,9,45,0.4359276747726958,0.3810720778427847
인플레이션/NNG;우려/NNG;부각돼/VVX,0,0.06640048914129237,18,9,9,14,0.4359276747726958,0.3810720778427847
자산/NNG;매각할/VVX,0,0.06640048914129237,18,9,9,11,0.4359276747726958,0.3810720778427847
성장/NNG;지속하/VVX,0,0.0658314387950778,85,42,43,81,0.6597759873297481,0.577410880346067
인플레이션압력/NNG;가중시/VVX,0,0.06484523044105006,16,8,8,27,0.42466340558218363,0.37238520368672273
경제상황/NNG;악화될/VVX,0,0.06484523044105006,16,8,8,16,0.42466340558218363,0.37238520368672273
인플레이션/NNG;우려/NNG;완화돼/VVX,0,0.06484523044105006,16,8,8,10,0.42466340558218363,0.37238520368672273
기준금리/NNG;동결될/VVX;예상되/VVX,0,0.06484523044105006,16,8,8,20,0.42466340558218363,0.37238520368672273
금리인상/NNG;계속할/VVX,0,0.06484523044105006,16,8,8,17,0.42466340558218363,0.37238520368672273
인플레이션/NNG;유발하/VVX,0,0.06484523044105006,16,8,8,22,0.42466340558218363,0.37238520368672273
변동성/NNG;높/VA;질/VX;있/VV,0,0.06484523044105006,16,8,8,49,0.42466340558218363,0.37238520368672273
금리/NNG;고점/NNG;확인하/VVX,0,0.06484523044105006,16,8,8,10,0.42466340558218363,0.37238520368672273
경기회복/NNG;이어질/VV,0,0.06484523044105006,16,8,8,11,0.42466340558218363,0.37238520368672273
성장세/NNG;회복하/VVX,0,0.06484523044105006,16,8,8,34,0.42466340558218363,0.37238520368672273
인플레이션압력/NNG;억제하/VVX,0,0.06484523044105006,16,8,8,26,0.42466340558218363,0.37238520368672273
경제상황/NNG;악화되/VVX,0,0.06484523044105006,16,8,8,11,0.42466340558218363,0.37238520368672273
수출/NNG;통한/VV,0,0.06484523044105006,16,8,8,21,0.42466340558218363,0.37238520368672273
금리하락/NNG;되돌리/VV,0,0.06484523044105006,16,8,8,20,0.42466340558218363,0.37238520368672273
가계부채/NNG;문제/NNG;해결하/VVX,0,0.06484523044105006,16,8,8,12,0.42466340558218363,0.37238520368672273
인플레이션압력/NNG;줄어들/VV,0,0.06484523044105006,16,8,8,16,0.42466340558218363,0.37238520368672273
인플레이션/NNG;우려/NNG;고조되/VVX,0,0.06484523044105006,16,8,8,11,0.42466340558218363,0.37238520368672273
경기회복/NNG;걸림돌/NNG;될/VV,0,0.06484523044105006,16,8,8,23,0.42466340558218363,0.37238520368672273
안전자산선호/NNG;심리/NNG;완화되/VVX,0,0.06484523044105006,16,8,8,23,0.42466340558218363,0.37238520368672273
경기회복세/NNG;뒷받침하/VVX,0,0.06484523044105006,16,8,8,13,0.42466340558218363,0.37238520368672273
세계경제/NNG;회복세/NNG;이/VV;갈/VX,0,0.06484523044105006,16,8,8,9,0.42466340558218363,0.37238520368672273
추경/NNG;편성되/VVX,0,0.06484523044105006,16,8,8,18,0.42466340558218363,0.37238520368672273
유동성/NNG;확보/NNG;위해/VV,0,0.06484523044105006,16,8,8,16,0.42466340558218363,0.37238520368672273
금융시장/NNG;변동성/NNG;커지/VV,0,0.06484523044105006,16,8,8,44,0.42466340558218363,0.37238520368672273
금리상승/NNG;견인하/VVX,0,0.06484523044105006,16,8,8,26,0.42466340558218363,0.37238520368672273
국제금융시장/NNG;변동성/NNG;커지/VV,0,0.06484523044105006,16,8,8,11,0.42466340558218363,0.37238520368672273
동결/NNG;예상한/VVX,0,0.06484523044105006,16,8,8,25,0.42466340558218363,0.37238520368672273
양적완화/NNG;확대할/VVX,0,0.06484523044105006,16,8,8,25,0.42466340558218363,0.37238520368672273
금리/NNG;변동성/NNG;확대시/VVX,0,0.06484523044105006,16,8,8,28,0.42466340558218363,0.37238520368672273
신흥시장/NNG;성장세/NNG;약화/NNG;영향/NNG;받/VV;가능성/NNG;상존하/VVX,0,0.06484523044105006,16,8,8,21,0.42466340558218363,0.37238520368672273
지준율/NNG;인상할/VVX,0,0.06484523044105006,16,8,8,24,0.42466340558218363,0.37238520368672273
변동성/NNG;확대되/VVX,0,0.05628540259757653,303,149,154,422,0.7035529850283354,0.6276198226003008
금리/NNG;동결할/VVX,0,0.055189904718367266,234,115,119,295,0.7028483695027764,0.6283689034030641
금리인상/NNG;예상되/VVX,0,0.05512451637585136,114,56,58,156,0.6849387570706946,0.6124373596127028
시장금리/NNG;상승하/VVX,0,0.054523735631346604,112,55,57,168,0.6831467694043424,0.6115706618303635
성장세/NNG;지속하/VVX,0,0.05255504382124254,106,52,54,114,0.6771071762032352,0.6085588709822731
금리/NNG;올릴/VV,0,0.05092835146303165,516,253,263,643,0.7001950238032391,0.6313627879491751
금리인상/NNG;이어질/VV,0,0.049231385824387575,53,26,27,66,0.5764639801301618,0.5215642105050785
실업률/NNG;하락하/VVX,0,0.047716933677019346,94,46,48,144,0.6615692279458654,0.6003819494238894
경기/NNG;개선될/VVX,0,0.04758329232310876,51,25,26,98,0.5691992498223888,0.5166933034098199
경제/NNG;둔화될/VVX,0,0.04758329232310876,51,25,26,75,0.5691992498223888,0.5166933034098199
금리인상/NNG;가능성/NNG;제기되/VVX,0,0.04758329232310876,51,25,26,77,0.5691992498223888,0.5166933034098199
경제/NNG;둔화되/VVX,0,0.04721516657604341,139,68,71,137,0.6915988564182082,0.6282649179960242
기준금리/NNG;낮췄/VV,0,0.04197437305232188,45,22,23,61,0.5457495725824499,0.5009989702207
금리상승/NNG;이끌/VV,0,0.04197437305232188,45,22,23,88,0.5457495725824499,0.5009989702207
금리/NNG;유지하/VVX,0,0.04116305896473538,121,59,62,163,0.6805453347906755,0.6257565897068709
금리/NNG;인상하/VVX,0,0.03991446196680637,751,366,385,859,0.6932234123055596,0.6390081403557974
소비/NNG;줄이/VV,1,0.03984987218252134,43,21,22,49,0.5373675933606574,0.4954054210433002
경기/NNG;둔화되/VVX,0,0.0388718848600329,232,113,119,301,0.6925361076728215,0.6397073070340776
금리/NNG;상승세/NNG;보이/VV,1,0.037577314485112145,41,20,21,61,0.5286964805009278,0.48963205322437153
시장금리/NNG;급등하/VVX,0,0.03585765700151855,74,36,38,59,0.6225265920196756,0.5785154227322283
기준금리/NNG;내릴/VV;있/VV,1,0.03514111292280897,39,19,20,32,0.5197324413549772,0.4836811470144996
국제유가/NNG;반등하/VVX,1,0.03252274512713149,37,18,19,29,0.5104715301807378,0.4775562973960776
금리인상/NNG;가능성/NNG;열/VV;두/VX,1,0.03252274512713149,37,18,19,69,0.5104715301807378,0.4775562973960776
물가/NNG;안정되/VVX,0,0.0309929662705255,68,33,35,143,0.6068570872706097,0.5694658827837458
인플레이션/NNG;따른/VV,1,0.02969992420494738,35,17,18,47,0.5009094126567172,0.47126269030064183
성장/NNG;이/VV,1,0.02969992420494738,35,17,18,32,0.5009094126567172,0.47126269030064183
금리/NNG;유지할/VVX,0,0.0290812444543751,97,47,50,185,0.6536670541586577,0.615740260590101
금리/NNG;올려/VV,0,0.028805707540357606,128,62,66,166,0.6760828386590801,0.6372062986367184
기준금리/NNG;동결할/VVX,0,0.0283908959932333,254,123,131,306,0.6858296234446538,0.6469287883066464
기준금리/NNG;인상할/VVX;가능성/NNG,0,0.027778271648541297,95,46,49,146,0.6505654527327979,0.6144167208584769
기준금리/NNG;동결된/VVX,0,0.027778271648541297,95,46,49,152,0.6505654527327979,0.6144167208584769
성장/NNG;둔화될/VVX,0,0.027304670237928708,64,31,33,77,0.5952397243585762,0.5626975641672893
기준금리인하/NNG;단행될/VVX,0,0.026645465178741556,33,16,17,41,0.49104101483196344,0.4648074570550416
금리인상/NNG;반대하/VVX,0,0.026645465178741556,33,16,17,43,0.49104101483196344,0.4648074570550416
경제지표/NNG;부진한/VAX;모습/NNG;보이/VV,0,0.026645465178741556,33,16,17,58,0.49104101483196344,0.4648074570550416
경기/NNG;개선되/VVX,0,0.025822554135901843,122,59,63,208,0.6713638117885447,0.6365426446796131
성장률/NNG;하향조정하/VVX,0,0.023325708216816787,31,15,16,62,0.4808600008357654,0.4582001386683701
정책금리/NNG;올릴/VV,0,0.023325708216816787,31,15,16,52,0.4808600008357654,0.4582001386683701
경제/NNG;둔화하/VVX,0,0.023325708216816787,31,15,16,45,0.4808600008357654,0.4582001386683701
금리인상/NNG;단행될/VVX;있/VV,0,0.023325708216816787,31,15,16,47,0.4808600008357654,0.4582001386683701
수출/NNG;타격/NNG;받/VV,0,0.023325708216816787,31,15,16,47,0.4808600008357654,0.4582001386683701
기준금리/NNG;인하된/VVX,0,0.02034302486999695,85,41,44,130,0.6325576817741694,0.6063522570919342
설비투자/NNG;증가하/VVX,0,0.019698282291513713,29,14,15,44,0.4703579916685473,0.4514533077116642
금리인상/NNG;단행할/VVX;있/VV,0,0.019698282291513713,29,14,15,42,0.4703579916685473,0.4514533077116642
기준금리/NNG;변경할/VVX,0,0.019698282291513713,29,14,15,15,0.4703579916685473,0.4514533077116642
소비/NNG;제약하/VVX,0,0.019698282291513713,29,14,15,46,0.4703579916685473,0.4514533077116642
금리인하/NNG;결정하/VVX,0,0.019698282291513713,29,14,15,33,0.4703579916685473,0.4514533077116642
경제지표/NNG;호조/NNG;나타내/VV,0,0.015708862845024596,27,13,14,45,0.4595233829055159,0.4445834215020706
디플레이션/NNG;우려/NNG;커지/VV,0,0.015708862845024596,27,13,14,28,0.4595233829055159,0.4445834215020706
금리/NNG;인하할/VVX;가능성/NNG;있/VV,0,0.015708862845024596,27,13,14,17,0.4595233829055159,0.4445834215020706
침체/NNG;심화되/VVX,0,0.015708862845024596,27,13,14,10,0.4595233829055159,0.4445834215020706
금리/NNG;하락세/NNG;보이/VV,0,0.015708862845024596,27,13,14,54,0.4595233829055159,0.4445834215020706
변동성/NNG;확대하/VVX,0,0.015708862845024596,27,13,14,40,0.4595233829055159,0.4445834215020706
금리/NNG;안정될/VVX,0,0.015708862845024596,27,13,14,43,0.4595233829055159,0.4445834215020706
경제성장률/NNG;하향조정했/VVX,0,0.015708862845024596,27,13,14,46,0.4595233829055159,0.4445834215020706
기준금리/NNG;동결할/VVX;전망/NNG,0,0.013499394953351507,52,25,27,84,0.5542207709797234,0.5385738243066093
침체/NNG;겪/VV,0,0.013499394953351507,52,25,27,64,0.5542207709797234,0.5385738243066093
장단기/NNG;금리차/NNG;확대될/VVX,0,0.01128635145049306,25,12,13,41,0.44833952308177183,0.4376120231202725
불확실성/NNG;상존해/VVX,0,0.01128635145049306,25,12,13,47,0.44833952308177183,0.4376120231202725
성장/NNG;둔화하/VVX,0,0.01128635145049306,25,12,13,43,0.44833952308177183,0.4376120231202725
금리인상/NNG;점쳤/VV,0,0.01128635145049306,25,12,13,22,0.44833952308177183,0.4376120231202725
불확실성/NNG;완화됐/VVX,0,0.01128635145049306,25,12,13,26,0.44833952308177183,0.4376120231202725
리스크/NNG;있/VV,0,0.007725627923541367,48,23,25,37,0.5383276380636707,0.529197220188999
금리/NNG;크/VA;하락하/VVX,0,0.007725627923541367,48,23,25,100,0.5383276380636707,0.529197220188999
기준금리/NNG;올릴/VV,0,0.006867184935678727,209,100,109,297,0.6716587634726118,0.6613999617203804
수입/NNG;의존하/VVX,0,0.006335498974824549,23,11,12,19,0.43678183837702367,0.43056747941861423
더블딥/NNG;빠질/VV;가능성/NNG,0,0.006335498974824549,23,11,12,15,0.43678183837702367,0.43056747941861423
금리인상/NNG;결정할/VVX,0,0.006335498974824549,23,11,12,40,0.43678183837702367,0.43056747941861423
금리인상/NNG;가능성/NNG;열려/VV,0,0.006335498974824549,23,11,12,45,0.43678183837702367,0.43056747941861423
금리인상/NNG;가능성/NNG;언급하/VVX,0,0.006335498974824549,23,11,12,25,0.43678183837702367,0.43056747941861423
경제여건/NNG;성장경로/NNG;불확실성/NNG;높/VA;판단된/VVX,0,0.006335498974824549,23,11,12,26,0.43678183837702367,0.43056747941861423
추경/NNG;편성할/VVX,0,0.006335498974824549,23,11,12,41,0.43678183837702367,0.43056747941861423
내수/NNG;부진/NNG;이어지/VV,0,0.006335498974824549,23,11,12,31,0.43678183837702367,0.43056747941861423
추경/NNG;하/VV,0,0.006335498974824549,23,11,12,37,0.43678183837702367,0.43056747941861423
성장/NNG;위해서/VV,0,0.006335498974824549,23,11,12,68,0.43678183837702367,0.43056747941861423
금리상승/NNG;따른/VV,0,0.004488579179146912,203,97,106,349,0.6700272993782281,0.6629352364198521
채권시장/NNG;국채/NNG;가격/NNG;오른/VV,0,0.0042062394455657515,180,86,94,209,0.6692818194644878,0.6625711501653978
수출/NNG;부진/NNG;지속되/VVX,0,0.0018414904342052285,67,32,35,58,0.5876758539824288,0.5845375182799221
인플레이션압력/NNG;커지/VV,0,0.0011790625108614172,44,21,23,66,0.5212389735022177,0.5191417685150919
금리인하/NNG;기대감/NNG;약화되/VVX,0,0.0011790625108614172,44,21,23,71,0.5212389735022177,0.5191417685150919
수출/NNG;둔화되/VVX,0,0.0011790625108614172,44,21,23,62,0.5212389735022177,0.5191417685150919
경기/NNG;나타내/VV,0,0.0007252283681136173,21,10,11,57,0.4248131513297276,0.4234875722870091
금리/NNG;인상될/VVX;가능성/NNG;높/VA,0,0.0007252283681136173,21,10,11,20,0.4248131513297276,0.4234875722870091
내수/NNG;부양/NNG;위해/VV,0,0.0007252283681136173,21,10,11,35,0.4248131513297276,0.4234875722870091
경제/NNG;미치/VV;효과/NNG,0,0.0007252283681136173,21,10,11,18,0.4248131513297276,0.4234875722870091
수출/NNG;감소해/VVX,0,0.0007252283681136173,21,10,11,11,0.4248131513297276,0.4234875722870091
경제/NNG;회복시/VVX,0,0.0007252283681136173,21,10,11,31,0.4248131513297276,0.4234875722870091
변동성/NNG;높일/VV;있/VV,0,0.0007252283681136173,21,10,11,9,0.4248131513297276,0.4234875722870091
신용등급/NNG;강등했/VVX,0,0.0007252283681136173,21,10,11,57,0.4248131513297276,0.4234875722870091
신용경색/NNG;나타나/VV,0,0.0007252283681136173,21,10,11,8,0.4248131513297276,0.4234875722870091
수출/NNG;부진/NNG;지속될/VVX,0,0.0007252283681136173,21,10,11,15,0.4248131513297276,0.4234875722870091
출구전략/NNG;나서/VV,0,0.0007252283681136173,21,10,11,26,0.4248131513297276,0.4234875722870091
불확실성/NNG;해소/NNG;따른/VV,0,0.0007252283681136173,21,10,11,43,0.4248131513297276,0.4234875722870091
성장률/NNG;둔화하/VVX,0,0.0007252283681136173,21,10,11,25,0.4248131513297276,0.4234875722870091
성장률/NNG;둔화할/VVX,0,0.0007252283681136173,21,10,11,18,0.4248131513297276,0.4234875722870091
정책금리/NNG;동결되/VVX,0,0.0007252283681136173,21,10,11,62,0.4248131513297276,0.4234875722870091
인플레이션/NNG;우려/NNG;완화된/VVX,0,0.0007252283681136173,21,10,11,21,0.4248131513297276,0.4234875722870091
경기침체/NNG;우려/NNG;커지/VV,0,0.0007252283681136173,21,10,11,20,0.4248131513297276,0.4234875722870091
금리인하/NNG;단행되/VVX;않/VX,0,0.0007252283681136173,21,10,11,26,0.4248131513297276,0.4234875722870091
실물경제/NNG;부정적/VAX;영향/NNG;미칠/VV,0,0.0007252283681136173,21,10,11,20,0.4248131513297276,0.4234875722870091
기준금리/NNG;올릴/VV;전망/NNG,0,0.0007252283681136173,21,10,11,36,0.4248131513297276,0.4234875722870091
소비자물가/NNG;올랐/VV,0,0.0007252283681136173,21,10,11,36,0.4248131513297276,0.4234875722870091
불확실성/NNG;확대되/VVX,0,0.0003512510261776125,130,62,68,195,0.6584602234754119,0.6568960107993485
투자심리/NNG;위축시/VVX,0,0.0001823257290511915,193,92,101,302,0.6670112153433675,0.6656512164796774
금리인상/NNG;중단할/VVX,0,-0.0013183196318113932,86,41,45,119,0.6207170989391922,0.6213107366497936
듀레이션/NNG;확대하/VVX,0,-0.0024349116501017898,42,20,22,49,0.5122282250833289,0.5138627188690624
경기선행지수/NNG;하락하/VVX,0,-0.0024349116501017898,42,20,22,47,0.5122282250833289,0.5138627188690624
성장률/NNG;끌어올리/VV,0,-0.0024349116501017898,42,20,22,56,0.5122282250833289,0.5138627188690624
성장세/NNG;보였/VV,0,-0.0034837770574386306,63,30,33,79,0.5751428343834863,0.5781879487325793
금리인상/NNG;지연시/VVX,0,-0.005730604235857806,19,9,10,30,0.41237575842739616,0.4164234897922503
경기/NNG;판단/NNG;개선되/VVX,0,-0.005730604235857806,19,9,10,22,0.41237575842739616,0.4164234897922503
성장률/NNG;전망/NNG;낮추/VV,0,-0.005730604235857806,19,9,10,20,0.41237575842739616,0.4164234897922503
경기/NNG;수출/NNG;호조/NNG;보이/VV,0,-0.005730604235857806,19,9,10,12,0.41237575842739616,0.4164234897922503
경제/NNG;나아질/VV,0,-0.005730604235857806,19,9,10,15,0.41237575842739616,0.4164234897922503
불안/NNG;가시/VV;않/VX,0,-0.005730604235857806,19,9,10,19,0.41237575842739616,0.4164234897922503
금리인상/NNG;가능성/NNG;시사함/VVX,0,-0.005730604235857806,19,9,10,17,0.41237575842739616,0.4164234897922503
불확실성/NNG;작용하/VVX,0,-0.005730604235857806,19,9,10,36,0.41237575842739616,0.4164234897922503
불확실성/NNG;지속될/VVX;전망/NNG,0,-0.005730604235857806,19,9,10,23,0.41237575842739616,0.4164234897922503
단기금리/NNG;오르/VV,0,-0.005730604235857806,19,9,10,20,0.41237575842739616,0.4164234897922503
금리/NNG;동결할/VVX;전망했/VVX,0,-0.005730604235857806,19,9,10,27,0.41237575842739616,0.4164234897922503
금리/NNG;상승세/NNG;이어졌/VV,0,-0.005730604235857806,19,9,10,34,0.41237575842739616,0.4164234897922503
금리/NNG;상승세/NNG;제한될/VVX,0,-0.005730604235857806,19,9,10,48,0.41237575842739616,0.4164234897922503
금리인상/NNG;멈출/VV,0,-0.005730604235857806,19,9,10,36,0.41237575842739616,0.4164234897922503
부양책/NNG;힘입/VV,0,-0.005730604235857806,19,9,10,18,0.41237575842739616,0.4164234897922503
금리인상/NNG;멈추/VV,0,-0.005730604235857806,19,9,10,34,0.41237575842739616,0.4164234897922503
노동시장/NNG;개선되/VVX,0,-0.005730604235857806,19,9,10,79,0.41237575842739616,0.4164234897922503
금융안정/NNG;유의하/VVX,0,-0.005730604235857806,19,9,10,27,0.41237575842739616,0.4164234897922503
듀레이션/NNG;중립/NNG;유지하/VVX,0,-0.005730604235857806,19,9,10,41,0.41237575842739616,0.4164234897922503
더블딥/NNG;빠지/VV,0,-0.005730604235857806,19,9,10,22,0.41237575842739616,0.4164234897922503
물가안정/NNG;강조하/VVX,0,-0.005730604235857806,19,9,10,36,0.41237575842739616,0.4164234897922503
유가/NNG;반등하/VVX,0,-0.006310532411735403,40,19,21,37,0.5028953991821965,0.5084201534638917
금리인하/NNG;필요하/VVX,0,-0.006310532411735403,40,19,21,63,0.5028953991821965,0.5084201534638917
경제성장률/NNG;둔화되/VVX,0,-0.006310532411735403,40,19,21,56,0.5028953991821965,0.5084201534638917
금리/NNG;오른/VV,0,-0.007609401900789736,158,75,83,241,0.6597270486233476,0.6687071652058945
출구전략/NNG;시행하/VVX,0,-0.009387661045590967,59,28,31,66,0.5615614251152246,0.571230493282951
경기회복세/NNG;이어지/VV,0,-0.009387661045590967,59,28,31,77,0.5615614251152246,0.571230493282951
유동성/NNG;공급하/VVX,0,-0.010327723717889259,344,163,181,372,0.660320826030096,0.6729526711136301
수출/NNG;미치/VV;영향/NNG,-1,-0.010480016147149773,38,18,20,66,0.4932305883970147,0.5028189404254902
유가/NNG;따른/VV,-1,-0.010480016147149773,38,18,20,37,0.4932305883970147,0.5028189404254902
변동성/NNG;줄이/VV,-1,-0.010480016147149773,38,18,20,67,0.4932305883970147,0.5028189404254902
금리인하/NNG;기대하/VVX,0,-0.010854410523737146,97,46,51,116,0.6285271499262587,0.6412249665522054
기준금리/NNG;올릴/VV;예상했/VVX,0,-0.013306470170681872,17,8,9,13,0.3993773638033288,0.409446197700217
근원인플레이션율/NNG;상승하/VVX,0,-0.013306470170681872,17,8,9,14,0.3993773638033288,0.409446197700217
금리인상/NNG;시기/NNG;앞당겨질/VV,0,-0.013306470170681872,17,8,9,30,0.3993773638033288,0.409446197700217
불확실성/NNG;사라지/VV,0,-0.013306470170681872,17,8,9,26,0.3993773638033288,0.409446197700217
경기/NNG;둔화할/VVX,0,-0.013306470170681872,17,8,9,18,0.3993773638033288,0.409446197700217
정책금리/NNG;인상할/VVX;가능성/NNG,0,-0.013306470170681872,17,8,9,20,0.3993773638033288,0.409446197700217
금리인상/NNG;가능성/NNG;남/VV,0,-0.013306470170681872,17,8,9,29,0.3993773638033288,0.409446197700217
gdp/NNG;증가할/VVX,0,-0.013306470170681872,17,8,9,34,0.3993773638033288,0.409446197700217
기준금리/NNG;인상하/VVX;어려울/VA,0,-0.013306470170681872,17,8,9,31,0.3993773638033288,0.409446197700217
금리인상/NNG;점진적/VAX;이뤄질/VV,0,-0.013306470170681872,17,8,9,14,0.3993773638033288,0.409446197700217
경제/NNG;큰/VA;영향/NNG;미치/VV,0,-0.013306470170681872,17,8,9,31,0.3993773638033288,0.409446197700217
경제/NNG;지탱해/VVX,0,-0.013306470170681872,17,8,9,13,0.3993773638033288,0.409446197700217
경기둔화/NNG;우려/NNG;제기되/VVX,0,-0.013306470170681872,17,8,9,20,0.3993773638033288,0.409446197700217
성장세/NNG;나타냈/VV,0,-0.013306470170681872,17,8,9,31,0.3993773638033288,0.409446197700217
불안심리/NNG;자극하/VVX,0,-0.013306470170681872,17,8,9,32,0.3993773638033288,0.409446197700217
경기/NNG;안정/NNG;위한/VV,0,-0.013306470170681872,17,8,9,30,0.3993773638033288,0.409446197700217
물가/NNG;올라갈/VV,0,-0.013306470170681872,17,8,9,13,0.3993773638033288,0.409446197700217
변동성/NNG;제한될/VVX,0,-0.013306470170681872,17,8,9,34,0.3993773638033288,0.409446197700217
금리동결/NNG;결정했/VVX,0,-0.013306470170681872,17,8,9,38,0.3993773638033288,0.409446197700217
물가상승/NNG;요인/NNG;작용할/VVX,0,-0.013306470170681872,17,8,9,18,0.3993773638033288,0.409446197700217
물가상승/NNG;이어지/VV,0,-0.013306470170681872,17,8,9,34,0.3993773638033288,0.409446197700217
물가상승/NNG;이어질/VV,0,-0.013306470170681872,17,8,9,26,0.3993773638033288,0.409446197700217
금리인상/NNG;기조/NNG;유지하/VVX,0,-0.013306470170681872,17,8,9,18,0.3993773638033288,0.409446197700217
금리인상/NNG;대비하/VVX,0,-0.013306470170681872,17,8,9,24,0.3993773638033288,0.409446197700217
인플레이션/NNG;하락하/VVX,0,-0.013306470170681872,17,8,9,18,0.3993773638033288,0.409446197700217
변동성/NNG;지속되/VVX,0,-0.013306470170681872,17,8,9,17,0.3993773638033288,0.409446197700217
유가/NNG;내리/VV,0,-0.013306470170681872,17,8,9,14,0.3993773638033288,0.409446197700217
변동성/NNG;확대/NNG;예상되/VVX,0,-0.013306470170681872,17,8,9,14,0.3993773638033288,0.409446197700217
정책금리/NNG;동결했/VVX,0,-0.014982360558210894,36,17,19,39,0.48322196492704916,0.49706578639173665
성장/NNG;그칠/VV,0,-0.014982360558210894,36,17,19,68,0.48322196492704916,0.49706578639173665
기준금리/NNG;인하될/VVX;가능성/NNG;가격/NNG;반영했/VVX,0,-0.014982360558210894,36,17,19,17,0.48322196492704916,0.49706578639173665
금리인하/NNG;가능하/VVX,0,-0.014982360558210894,36,17,19,41,0.48322196492704916,0.49706578639173665
경기/NNG;부양하/VVX;위해/VV,0,-0.014982360558210894,36,17,19,69,0.48322196492704916,0.49706578639173665
변동성/NNG;확대됐/VVX,0,-0.01596090525567051,55,26,29,63,0.5468742869805476,0.5636423426218153
금리인상/NNG;하/VV;않/VX,0,-0.01596090525567051,55,26,29,64,0.5468742869805476,0.5636423426218153
기준금리/NNG;동결될/VVX;가능성/NNG;높/VA,0,-0.01596090525567051,55,26,29,59,0.5468742869805476,0.5636423426218153
경제/NNG;성장할/VVX,0,-0.01831700744038023,108,51,57,123,0.6338214758160053,0.656337349825571
금리인상/NNG;시사하/VVX,0,-0.018732433834812268,142,67,75,181,0.6494597034851365,0.6730894803754459
금리/NNG;하회하/VVX,0,-0.019533212042230352,53,25,28,84,0.5390972305469165,0.559606132554177
금리인상/NNG;전망하/VVX,0,-0.019865391977136326,34,16,18,41,0.4728549385068444,0.49116962986892837
유가/NNG;상승할/VVX,0,-0.019865391977136326,34,16,18,53,0.4728549385068444,0.49116962986892837
동결/NNG;예상했/VVX,0,-0.019865391977136326,34,16,18,48,0.4728549385068444,0.49116962986892837
인플레이션/NNG;잡/VV;위해/VV,0,-0.019865391977136326,34,16,18,39,0.4728549385068444,0.49116962986892837
유가/NNG;하락/NNG;힘입/VV,0,-0.019865391977136326,34,16,18,33,0.4728549385068444,0.49116962986892837
금리/NNG;올릴/VV;없/VA,0,-0.019865391977136326,34,16,18,34,0.4728549385068444,0.49116962986892837
재정위기/NNG;겪/VV,0,-0.019865391977136326,34,16,18,87,0.4728549385068444,0.49116962986892837
금리/NNG;인하할/VVX;가능성/NNG,0,-0.019976066601052334,89,42,47,108,0.6131692447411791,0.6370594556225854
기준금리/NNG;유지할/VVX,0,-0.020403925223439257,106,50,56,124,0.6308590653611289,0.6559990105663467
금리인하/NNG;검토할/VVX,0,-0.02242617365276467,15,7,8,24,0.3856645714046532,0.4026570244938894
경제/NNG;큰/VA;영향/NNG;미칠/VV,0,-0.02242617365276467,15,7,8,15,0.3856645714046532,0.4026570244938894
기준금리/NNG;동결할/VVX;예상/NNG,0,-0.02242617365276467,15,7,8,13,0.3856645714046532,0.4026570244938894
시장금리/NNG;상승압력/NNG;작용하/VVX,0,-0.02242617365276467,15,7,8,12,0.3856645714046532,0.4026570244938894
단기금리/NNG;오를/VV,0,-0.02242617365276467,15,7,8,13,0.3856645714046532,0.4026570244938894
인플레이션압력/NNG;가중되/VVX,0,-0.02242617365276467,15,7,8,24,0.3856645714046532,0.4026570244938894
금리/NNG;되/VV,0,-0.02242617365276467,15,7,8,13,0.3856645714046532,0.4026570244938894
시장금리/NNG;상승/NNG;제한하/VVX,0,-0.02242617365276467,15,7,8,33,0.3856645714046532,0.4026570244938894
금리인상/NNG;우려/NNG;커졌/VV,0,-0.02242617365276467,15,7,8,11,0.3856645714046532,0.4026570244938894
경기선행지수/NNG;반등하/VVX,0,-0.02242617365276467,15,7,8,23,0.3856645714046532,0.4026570244938894
금리인상/NNG;신중해/VVX,0,-0.02242617365276467,15,7,8,21,0.3856645714046532,0.4026570244938894
주택가격/NNG;하/VV,0,-0.02242617365276467,15,7,8,10,0.3856645714046532,0.4026570244938894
금리/NNG;크/VA;올랐/VV,0,-0.02242617365276467,15,7,8,23,0.3856645714046532,0.4026570244938894
금리인상/NNG;가능성/NNG;반영되/VVX,0,-0.02242617365276467,15,7,8,20,0.3856645714046532,0.4026570244938894
출구전략/NNG;있/VV,0,-0.02242617365276467,15,7,8,12,0.3856645714046532,0.4026570244938894
성장/NNG;예상했/VVX,0,-0.02242617365276467,15,7,8,22,0.3856645714046532,0.4026570244938894
금리/NNG;올릴/VV;가능성/NNG;높/VA,0,-0.02242617365276467,15,7,8,35,0.3856645714046532,0.4026570244938894
안전자산선호/NNG;현상/NNG;약화됐/VVX,0,-0.02242617365276467,15,7,8,19,0.3856645714046532,0.4026570244938894
투자심리/NNG;부담/NNG;주/VV,0,-0.02242617365276467,15,7,8,12,0.3856645714046532,0.4026570244938894
부양책/NNG;나오/VV;않/VX,0,-0.02242617365276467,15,7,8,17,0.3856645714046532,0.4026570244938894
금리인하/NNG;효과/NNG;나타나/VV,0,-0.02242617365276467,15,7,8,11,0.3856645714046532,0.4026570244938894
채권시장/NNG;약세/NNG;보일/VV,0,-0.02242617365276467,15,7,8,12,0.3856645714046532,0.4026570244938894
성장/NNG;나타내/VV,0,-0.02242617365276467,15,7,8,15,0.3856645714046532,0.4026570244938894
정책금리/NNG;인상/NNG;반영하/VVX,0,-0.02242617365276467,15,7,8,10,0.3856645714046532,0.4026570244938894
금리/NNG;횡보하/VVX,0,-0.02242617365276467,15,7,8,17,0.3856645714046532,0.4026570244938894
경기부양/NNG;하/VV,0,-0.02242617365276467,15,7,8,26,0.3856645714046532,0.4026570244938894
투자심리/NNG;부정적/VAX;영향/NNG;미칠/VV,0,-0.02242617365276467,15,7,8,20,0.3856645714046532,0.4026570244938894
불확실성/NNG;감안해/VVX,0,-0.02242617365276467,15,7,8,31,0.3856645714046532,0.4026570244938894
출구전략/NNG;시행해/VVX,0,-0.02242617365276467,15,7,8,13,0.3856645714046532,0.4026570244938894
금리인상/NNG;단행할/VVX;전망했/VVX,0,-0.02242617365276467,15,7,8,16,0.3856645714046532,0.4026570244938894
외환위기/NNG;직후인/VVX,0,-0.02242617365276467,15,7,8,11,0.3856645714046532,0.4026570244938894
가계부채/NNG;급증하/VVX,0,-0.02242617365276467,15,7,8,25,0.3856645714046532,0.4026570244938894
경기회복세/NNG;나타나/VV,0,-0.02242617365276467,15,7,8,32,0.3856645714046532,0.4026570244938894
소비/NNG;회복되/VVX,0,-0.02331825194650894,51,24,27,47,0.5310204591074057,0.5554064135236458
콜금리/NNG;동결될/VVX,0,-0.024803408299663765,68,32,36,49,0.5741359962197391,0.6022866369763735
불안심리/NNG;해소되/VVX,0,-0.025188615826545968,32,15,17,22,0.4621109432366245,0.4851421416175576
경제전망/NNG;발표하/VVX,0,-0.025188615826545968,32,15,17,48,0.4621109432366245,0.4851421416175576
물가상승/NNG;억제하/VVX,0,-0.025188615826545968,32,15,17,50,0.4621109432366245,0.4851421416175576
기준금리인상/NNG;단행했/VVX,0,-0.025188615826545968,32,15,17,33,0.4621109432366245,0.4851421416175576
불안/NNG;인해/VV,0,-0.027335774847118022,49,23,26,81,0.5226352869317041,0.5510423464226117
경기/NNG;부양하/VVX,0,-0.02989319958799863,160,75,85,202,0.6449149561671521,0.6834528137993325
경기회복/NNG;뒷받침하/VVX,0,-0.03048008944957492,113,53,60,68,0.6293864616223499,0.6677792944060581
경기/NNG;하강/NNG;막/VV,0,-0.031027266530370246,30,14,16,22,0.4509656641675454,0.4789983704213766
재정/NNG;통한/VV,0,-0.031027266530370246,30,14,16,25,0.4509656641675454,0.4789983704213766
불안요인/NNG;작용할/VVX;있/VV,0,-0.031027266530370246,30,14,16,43,0.4509656641675454,0.4789983704213766
물가상승압력/NNG;완화되/VVX,0,-0.031027266530370246,30,14,16,26,0.4509656641675454,0.4789983704213766
경제/NNG;확산되/VVX,0,-0.031027266530370246,30,14,16,39,0.4509656641675454,0.4789983704213766
수출/NNG;감소세/NNG;지속하/VVX,0,-0.0316085953583487,47,22,25,43,0.51393228779243,0.5465138016158538
기준금리/NNG;낮추/VV,0,-0.0347091955879395,94,44,50,116,0.6098729011845081,0.6525692698396659
투자심리/NNG;악화시/VVX,0,-0.036163291245763785,45,21,24,62,0.5049010269790387,0.5418214881327368
금리/NNG;올라가/VV,0,-0.03741253359832819,107,50,57,169,0.6204798816538459,0.6675173822941032
금리/NNG;올리/VV;시작하/VVX,0,-0.037478195621039934,28,13,15,25,0.43938639706008364,0.47275758895759384
물가/NNG;올라/VV,0,-0.037478195621039934,28,13,15,65,0.43938639706008364,0.47275758895759384
금리인하/NNG;지지하/VVX,0,-0.037478195621039934,28,13,15,20,0.43938639706008364,0.47275758895759384
기준금리인상/NNG;반영하/VVX,0,-0.037478195621039934,28,13,15,22,0.43938639706008364,0.47275758895759384
부양책/NNG;나올/VV,0,-0.037478195621039934,28,13,15,44,0.43938639706008364,0.47275758895759384
성장/NNG;지속될/VVX,0,-0.037478195621039934,28,13,15,44,0.43938639706008364,0.47275758895759384
금리인상/NNG;단행한/VVX,0,-0.037478195621039934,28,13,15,29,0.43938639706008364,0.47275758895759384
금리인하/NNG;카드/NNG;꺼내/VV,0,-0.037478195621039934,28,13,15,34,0.43938639706008364,0.47275758895759384
성장/NNG;보일/VV,0,-0.03890408932641132,60,28,32,58,0.5471245130167629,0.5903594490210329
불확실성/NNG;해소될/VVX,0,-0.03890408932641132,60,28,32,85,0.5471245130167629,0.5903594490210329
경기둔화/NNG;따른/VV,0,-0.039274170609633674,120,56,64,208,0.6276049241496292,0.6777010207446578
리스크/NNG;남/VV,0,-0.04007250013280439,75,35,40,90,0.5787523971885294,0.625947715267237
성장/NNG;보이/VV,-1,-0.04103110877198135,43,20,23,76,0.4955296961040651,0.5369671055203852
금리인상/NNG;그칠/VV,0,-0.04290403134937426,58,27,31,77,0.5396769856401036,0.587001325040744
불확실성/NNG;높이/VV,0,-0.04290403134937426,58,27,31,73,0.5396769856401036,0.587001325040744
기준금리/NNG;낮춘/VV,0,-0.04347610564822546,73,34,39,64,0.5729432553074689,0.623898384634734
기준금리/NNG;유지하/VVX;통화정책/NNG,0,-0.0438771618441437,116,54,62,189,0.622299915458172,0.678188588352906
경기/NNG;침체될/VVX,0,-0.04466866146805126,26,12,14,19,0.4273280286120838,0.4664444184357199
기준금리인상/NNG;시사하/VVX,0,-0.04466866146805126,26,12,14,22,0.4273280286120838,0.4664444184357199
지정학적리스크/NNG;부각되/VVX,0,-0.04466866146805126,26,12,14,39,0.4273280286120838,0.4664444184357199
경기/NNG;하강하/VVX,0,-0.04466866146805126,26,12,14,25,0.4273280286120838,0.4664444184357199
경제지표/NNG;개선/NNG;따른/VV,0,-0.04466866146805126,26,12,14,28,0.4273280286120838,0.4664444184357199
인플레이션압력/NNG;증가하/VVX,0,-0.04466866146805126,26,12,14,32,0.4273280286120838,0.4664444184357199
경제성장/NNG;둔화하/VVX,0,-0.04466866146805126,26,12,14,31,0.4273280286120838,0.4664444184357199
가계대출/NNG;크/VA;상회하/VVX;증가세/NNG;이/VV;갔/VV,0,-0.04466866146805126,26,12,14,15,0.4273280286120838,0.4664444184357199
물가/NNG;오르/VV,0,-0.04545449905168719,142,66,76,252,0.631304092852622,0.6901762949674689
불확실성/NNG;키우/VV,-1,-0.04624915086310688,41,19,22,60,0.48580461340938286,0.5319535231232692
금리인하/NNG;기대/NNG;약화되/VVX,-1,-0.04624915086310688,41,19,22,108,0.48580461340938286,0.5319535231232692
금리인상/NNG;나설/VV;가능성/NNG,0,-0.047124353632665095,56,26,30,65,0.5319345610023672,0.5834866816875098
금리/NNG;인하해/VVX,0,-0.04947005598447718,84,39,45,97,0.5875066215907455,0.6474773554424612
성장세/NNG;나타내/VV,0,-0.04947005598447718,84,39,45,114,0.5875066215907455,0.6474773554424612
가계부채/NNG;늘어나/VV,-1,-0.05186195772897295,39,18,21,44,0.47570953573446356,0.5267849927296163
금리인상/NNG;시작될/VVX,-1,-0.05186195772897295,39,18,21,61,0.47570953573446356,0.5267849927296163
침체/NNG;이어지/VV,-1,-0.05186195772897295,39,18,21,28,0.47570953573446356,0.5267849927296163
물가상승/NNG;막/VV,0,-0.05276985815157187,24,11,13,28,0.41472674897160877,0.46009034551851224
양적완화/NNG;정책/NNG;시행하/VVX,0,-0.05276985815157187,24,11,13,16,0.41472674897160877,0.46009034551851224
금리인상/NNG;가능성/NNG;열/VV,0,-0.05276985815157187,24,11,13,44,0.41472674897160877,0.46009034551851224
금리상승/NNG;나타날/VV,0,-0.05276985815157187,24,11,13,47,0.41472674897160877,0.46009034551851224
채권시장/NNG;강세/NNG;보였/VV,0,-0.05276985815157187,24,11,13,46,0.41472674897160877,0.46009034551851224
물가/NNG;상승시/VVX,0,-0.05276985815157187,24,11,13,20,0.41472674897160877,0.46009034551851224
실업률/NNG;낮추/VV,0,-0.05276985815157187,24,11,13,41,0.41472674897160877,0.46009034551851224
콜금리/NNG;동결되/VVX,0,-0.05276985815157187,24,11,13,20,0.41472674897160877,0.46009034551851224
경제/NNG;회복할/VVX,0,-0.05276985815157187,24,11,13,22,0.41472674897160877,0.46009034551851224
기준금리인하/NNG;나설/VV,0,-0.05276985815157187,24,11,13,52,0.41472674897160877,0.46009034551851224
유동성/NNG;인해/VV,0,-0.05276985815157187,24,11,13,50,0.41472674897160877,0.46009034551851224
부동산가격/NNG;잡/VV,0,-0.05276985815157187,24,11,13,22,0.41472674897160877,0.46009034551851224
금리인상/NNG;뒷받침하/VVX,0,-0.05276985815157187,24,11,13,15,0.41472674897160877,0.46009034551851224
잠재성장률/NNG;부합하/VVX,0,-0.05276985815157187,24,11,13,26,0.41472674897160877,0.46009034551851224
리스크/NNG;부각될/VVX,0,-0.05276985815157187,24,11,13,41,0.41472674897160877,0.46009034551851224
침체/NNG;빠져/VV,0,-0.05276985815157187,24,11,13,39,0.41472674897160877,0.46009034551851224
소비심리/NNG;회복되/VVX,0,-0.05276985815157187,24,11,13,27,0.41472674897160877,0.46009034551851224
물가/NNG;미치/VV;영향/NNG,0,-0.05279972741326577,82,38,44,99,0.5824230512332652,0.6461682346727616
금리/NNG;오르/VV,0,-0.05538689986197831,418,193,225,622,0.6294229206494855,0.7019398542254889
경제/NNG;개선되/VVX,0,-0.0562716507730171,80,37,43,113,0.5771197972398443,0.6447524660401178
양적완화/NNG;하/VV,-1,-0.05792364128677874,37,17,20,35,0.46522470306787195,0.521467401959609
수출/NNG;늘어나/VV,0,-0.05877830151277508,65,30,35,80,0.5471791674859621,0.6143808600973568
기준금리/NNG;인하할/VVX;있/VV,0,-0.05877830151277508,65,30,35,80,0.5471791674859621,0.6143808600973568
양적완화/NNG;나설/VV,0,-0.06130885618559945,50,23,27,83,0.5068403602153557,0.5719813129284599
물가/NNG;안정돼/VVX,0,-0.06130885618559945,50,23,27,50,0.5068403602153557,0.5719813129284599
금리인상/NNG;전망/NNG;따른/VV,0,-0.06201849834623896,22,10,12,32,0.40148989484347025,0.45373579457394625
성장잠재력/NNG;확충하/VVX,0,-0.06201849834623896,22,10,12,32,0.40148989484347025,0.45373579457394625
유동성/NNG;조절하/VVX,0,-0.06201849834623896,22,10,12,37,0.40148989484347025,0.45373579457394625
금리인상/NNG;따른/VV;부담/NNG,0,-0.06201849834623896,22,10,12,13,0.40148989484347025,0.45373579457394625
물가/NNG;자극할/VVX,0,-0.06201849834623896,22,10,12,21,0.40148989484347025,0.45373579457394625
인플레이션/NNG;자극할/VVX,0,-0.06201849834623896,22,10,12,22,0.40148989484347025,0.45373579457394625
물가/NNG;상승세/NNG;지속될/VVX,0,-0.06201849834623896,22,10,12,20,0.40148989484347025,0.45373579457394625
기대인플레이션/NNG;상승하/VVX,0,-0.06201849834623896,22,10,12,27,0.40148989484347025,0.45373579457394625
금리/NNG;인상돼/VVX,0,-0.06201849834623896,22,10,12,20,0.40148989484347025,0.45373579457394625
금리/NNG;유지한/VVX,0,-0.06201849834623896,22,10,12,35,0.40148989484347025,0.45373579457394625
수출/NNG;호조/NNG;보이/VV;내수/NNG,0,-0.06201849834623896,22,10,12,20,0.40148989484347025,0.45373579457394625
고용지표/NNG;호조/NNG;보인/VV,0,-0.06201849834623896,22,10,12,33,0.40148989484347025,0.45373579457394625
변동성/NNG;크/VA;확대될/VVX,0,-0.06201849834623896,22,10,12,35,0.40148989484347025,0.45373579457394625
변동성/NNG;장세/NNG;이어질/VV,0,-0.06201849834623896,22,10,12,26,0.40148989484347025,0.45373579457394625
기준금리/NNG;동결될/VVX;예상했/VVX,0,-0.06201849834623896,22,10,12,32,0.40148989484347025,0.45373579457394625
시장금리/NNG;상승압력/NNG;받/VV,0,-0.06201849834623896,22,10,12,21,0.40148989484347025,0.45373579457394625
정책금리/NNG;내리/VV,0,-0.06201849834623896,22,10,12,15,0.40148989484347025,0.45373579457394625
경제/NNG;회복되/VVX,0,-0.06215610758776591,139,64,75,215,0.6190455831957095,0.6997950282355598
성장세/NNG;둔화되/VVX,0,-0.06277016756312237,102,47,55,126,0.5994672643570103,0.6784975952942195
금리인상/NNG;지속될/VVX,0,-0.06367567538175734,76,35,41,78,0.5658249104738838,0.6415837239894755
경기부양책/NNG;따른/VV,-1,-0.06450081578602074,35,16,19,60,0.45432549729363675,0.5160085774466961
기준금리/NNG;동결될/VVX;전망/NNG,-1,-0.06450081578602074,35,16,19,72,0.45432549729363675,0.5160085774466961
금리인하/NNG;요구하/VVX,-1,-0.06450081578602074,35,16,19,43,0.45432549729363675,0.5160085774466961
불안/NNG;확산되/VVX,-1,-0.06662751157758773,48,22,26,65,0.4978162698147963,0.5678206499909682
성장세/NNG;이/VV;갈/VX,0,-0.06695780166695275,87,40,47,138,0.5804055778729152,0.6624626419670578
변동성/NNG;확대될/VVX,0,-0.07046348795004431,109,50,59,179,0.5998213888757878,0.6894557293400796
금리/NNG;상승세/NNG;보임/VV,-1,-0.07167669721646153,33,15,18,56,0.44298053412953436,0.5104186486508961
소비/NNG;위축되/VVX,0,-0.072380306465885,59,27,32,77,0.5249699070723713,0.6057447532367419
불확실성/NNG;반영하/VVX,0,-0.07275273947636807,20,9,11,28,0.3874788984645538,0.4474329842799805
경기부양/NNG;위한/VV;재정/NNG,0,-0.07275273947636807,20,9,11,19,0.3874788984645538,0.4474329842799805
수출/NNG;증가할/VVX,0,-0.07275273947636807,20,9,11,32,0.3874788984645538,0.4474329842799805
금융시장/NNG;흔들/VV,0,-0.07275273947636807,20,9,11,24,0.3874788984645538,0.4474329842799805
인플레이션/NNG;기대/NNG;억제하/VVX,0,-0.07275273947636807,20,9,11,17,0.3874788984645538,0.4474329842799805
출구전략/NNG;나설/VV,0,-0.07275273947636807,20,9,11,21,0.3874788984645538,0.4474329842799805
소비/NNG;둔화되/VVX,0,-0.07275273947636807,20,9,11,34,0.3874788984645538,0.4474329842799805
인플레이션/NNG;억제하/VVX;위한/VV,0,-0.07275273947636807,20,9,11,12,0.3874788984645538,0.4474329842799805
동결/NNG;기조/NNG;이/VV;갈/VX,0,-0.07275273947636807,20,9,11,21,0.3874788984645538,0.4474329842799805
금리/NNG;올린다/VV,0,-0.07275273947636807,20,9,11,16,0.3874788984645538,0.4474329842799805
물가상승압력/NNG;작용할/VVX,0,-0.07275273947636807,20,9,11,26,0.3874788984645538,0.4474329842799805
디플레이션/NNG;막/VV,0,-0.07275273947636807,20,9,11,27,0.3874788984645538,0.4474329842799805
소비/NNG;하/VV,0,-0.07275273947636807,20,9,11,24,0.3874788984645538,0.4474329842799805
인플레이션/NNG;통제하/VVX,0,-0.07275273947636807,20,9,11,26,0.3874788984645538,0.4474329842799805
성장/NNG;가능하/VVX,0,-0.07607793156382081,70,32,38,86,0.5470461805828374,0.635921671162431
gdp/NNG;증가했/VVX,-1,-0.07834457067567868,44,20,24,63,0.4786976200493831,0.5590083944837564
경기/NNG;악화되/VVX,-1,-0.07834457067567868,44,20,24,59,0.4786976200493831,0.5590083944837564
소비심리/NNG;개선되/VVX,-1,-0.07834457067567868,44,20,24,53,0.4786976200493831,0.5590083944837564
성장/NNG;힘입/VV,-1,-0.07955695899227744,31,14,17,24,0.43114890503178066,0.5047104846420132
금리인상/NNG;기정사실화하/VVX,-1,-0.07955695899227744,31,14,17,23,0.43114890503178066,0.5047104846420132
기준금리/NNG;동결할/VVX;가능성/NNG,-1,-0.07955695899227744,31,14,17,32,0.43114890503178066,0.5047104846420132
금리인상/NNG;계속될/VVX,-1,-0.07955695899227744,31,14,17,28,0.43114890503178066,0.5047104846420132
내수/NNG;살아나/VV,-1,-0.07955695899227744,31,14,17,47,0.43114890503178066,0.5047104846420132
안전자산선호/NNG;심리/NNG;강화되/VVX,-1,-0.07955695899227744,31,14,17,83,0.43114890503178066,0.5047104846420132
경기침체/NNG;겪/VV,-1,-0.07955695899227744,31,14,17,59,0.43114890503178066,0.5047104846420132
대외불확실성/NNG;따른/VV,0,-0.08270973036258888,55,25,30,124,0.5086489391527291,0.5992187185293616
금리인상/NNG;중단하/VVX,-1,-0.08482891532857517,42,19,23,47,0.46856830257668314,0.5543586907590357
금리인하/NNG;주장했/VVX,-1,-0.08482891532857517,42,19,23,62,0.46856830257668314,0.5543586907590357
기준금리/NNG;상향조정할/VVX,0,-0.0854751202987698,18,8,10,30,0.3724793164812377,0.44124986955281686
고용지표/NNG;개선/NNG;따른/VV,0,-0.0854751202987698,18,8,10,26,0.3724793164812377,0.44124986955281686
연방기금금리/NNG;동결하/VVX,0,-0.0854751202987698,18,8,10,26,0.3724793164812377,0.44124986955281686
지정학적리스크/NNG;인해/VV,0,-0.0854751202987698,18,8,10,22,0.3724793164812377,0.44124986955281686
투자심리/NNG;위축돼/VVX,0,-0.0854751202987698,18,8,10,23,0.3724793164812377,0.44124986955281686
불확실성/NNG;가중시/VVX,0,-0.0854751202987698,18,8,10,17,0.3724793164812377,0.44124986955281686
주택시장/NNG;안정되/VVX,0,-0.0854751202987698,18,8,10,15,0.3724793164812377,0.44124986955281686
성장/NNG;이어질/VV,0,-0.0854751202987698,18,8,10,16,0.3724793164812377,0.44124986955281686
금리/NNG;인하할/VVX;있/VA,0,-0.0854751202987698,18,8,10,41,0.3724793164812377,0.44124986955281686
금융시장/NNG;확산되/VVX,0,-0.0854751202987698,18,8,10,14,0.3724793164812377,0.44124986955281686
자산/NNG;보유하/VVX,0,-0.0854751202987698,18,8,10,36,0.3724793164812377,0.44124986955281686
연방기금금리/NNG;인상하/VVX,0,-0.0854751202987698,18,8,10,22,0.3724793164812377,0.44124986955281686
수출/NNG;하/VV,0,-0.0854751202987698,18,8,10,19,0.3724793164812377,0.44124986955281686
기준금리인상/NNG;예상된/VVX,0,-0.0854751202987698,18,8,10,28,0.3724793164812377,0.44124986955281686
유동성/NNG;증가/NNG;따른/VV,0,-0.0854751202987698,18,8,10,15,0.3724793164812377,0.44124986955281686
금리인상/NNG;기조/NNG;이/VV,0,-0.0854751202987698,18,8,10,20,0.3724793164812377,0.44124986955281686
신용경색/NNG;인해/VV,0,-0.0854751202987698,18,8,10,23,0.3724793164812377,0.44124986955281686
스태그플레이션/NNG;빠질/VV,0,-0.0854751202987698,18,8,10,17,0.3724793164812377,0.44124986955281686
양적완화/NNG;정책/NNG;펴/VV,0,-0.0854751202987698,18,8,10,22,0.3724793164812377,0.44124986955281686
유동성/NNG;부족/NNG;따른/VV,0,-0.0854751202987698,18,8,10,11,0.3724793164812377,0.44124986955281686
경기회복세/NNG;이/VV,0,-0.0854751202987698,18,8,10,14,0.3724793164812377,0.44124986955281686
경상수지/NNG;흑자/NNG;줄어들/VV,0,-0.0854751202987698,18,8,10,20,0.3724793164812377,0.44124986955281686
인플레이션/NNG;발생하/VVX,0,-0.0854751202987698,18,8,10,24,0.3724793164812377,0.44124986955281686
기준금리/NNG;동결하/VVX;결정했/VVX,0,-0.0854751202987698,18,8,10,30,0.3724793164812377,0.44124986955281686
변동성/NNG;확대된/VVX,0,-0.08671702219080202,77,35,42,90,0.5529371623926288,0.6566640047649579
경기부양/NNG;위해/VV,0,-0.08713469457940248,406,184,222,531,0.6069789239402935,0.7214496045369919
경기/NNG;둔화될/VVX,0,-0.08718641312067943,88,40,48,114,0.5684818018902045,0.6757625933566973
물가/NNG;상승하/VVX,0,-0.08785132677733754,130,59,71,160,0.5984514119877314,0.7123403248759611
경제/NNG;성장세/NNG;둔화될/VVX,0,-0.08827829719946012,29,13,16,38,0.4187761143838991,0.4989002163852516
기준금리/NNG;내려야/VV,0,-0.08827829719946012,29,13,16,22,0.4187761143838991,0.4989002163852516
인플레이션/NNG;상승할/VVX,0,-0.08827829719946012,29,13,16,38,0.4187761143838991,0.4989002163852516
투자심리/NNG;냉각시/VVX,0,-0.08827829719946012,29,13,16,57,0.4187761143838991,0.4989002163852516
경제성장/NNG;위한/VV,0,-0.08827829719946012,29,13,16,28,0.4187761143838991,0.4989002163852516
리스크/NNG;줄이/VV,0,-0.08827829719946012,29,13,16,67,0.4187761143838991,0.4989002163852516
금리인하/NNG;기대감/NNG;형성되/VVX,0,-0.08827829719946012,29,13,16,32,0.4187761143838991,0.4989002163852516
경기회복/NNG;진행되/VVX,0,-0.08831994761692552,53,24,29,39,0.5000008437117571,0.5957155392349252
금리/NNG;인상할/VVX;가능성/NNG;높/VA,0,-0.08831994761692552,53,24,29,83,0.5000008437117571,0.5957155392349252
유가/NNG;오르/VV,0,-0.0903239361483742,64,29,35,87,0.5258641218436658,0.6290621125399991
성장/NNG;위한/VV,0,-0.0903239361483742,64,29,35,114,0.5258641218436658,0.6290621125399991
재할인율/NNG;인하했/VVX,-1,-0.09180231124641414,40,18,22,22,0.45803019597772715,0.5495495173313059
유동성/NNG;풀/VV,-1,-0.09180231124641414,40,18,22,52,0.45803019597772715,0.5495495173313059
안전자산선호/NNG;현상/NNG;강화됐/VVX,-1,-0.09180231124641414,40,18,22,23,0.45803019597772715,0.5495495173313059
지준율/NNG;인상하/VVX,-1,-0.09426478795994897,51,23,28,59,0.49101036775852047,0.5920486851749327
소비/NNG;늘어나/VV,-1,-0.09426478795994897,51,23,28,85,0.49101036775852047,0.5920486851749327
침체/NNG;따른/VV,0,-0.09555258557277768,62,28,34,48,0.5182265205068495,0.6264887580347194
금리인하/NNG;기대/NNG;커지/VV,0,-0.09802130302352274,27,12,15,47,0.4057879610170825,0.49300785353949084
신용경색/NNG;심화되/VVX,0,-0.09802130302352274,27,12,15,17,0.4057879610170825,0.49300785353949084
불안/NNG;확산될/VVX,0,-0.09802130302352274,27,12,15,43,0.4057879610170825,0.49300785353949084
소비자물가/NNG;오르/VV,0,-0.09802130302352274,27,12,15,22,0.4057879610170825,0.49300785353949084
금리/NNG;크/VA;오르/VV,-1,-0.09933335818847433,38,17,21,36,0.44705572886602196,0.544584524453386
인플레이션/NNG;상승하/VVX,-1,-0.09933335818847433,38,17,21,56,0.44705572886602196,0.544584524453386
금리인상/NNG;신중할/VVX,-1,-0.10057812650581688,49,22,27,54,0.48166253095979755,0.5882159550879693
변동성/NNG;확대/NNG;대비해/VVX,0,-0.10096991804517308,16,7,9,19,0.3561451573779096,0.4352754879817561
소비/NNG;투자심리/NNG;위축되/VVX,0,-0.10096991804517308,16,7,9,10,0.3561451573779096,0.4352754879817561
경기/NNG;둔화시/VVX,0,-0.10096991804517308,16,7,9,19,0.3561451573779096,0.4352754879817561
경기부양책/NNG;발표하/VVX,0,-0.10096991804517308,16,7,9,17,0.3561451573779096,0.4352754879817561
경기회복/NNG;따른/VV;금리상승/NNG,0,-0.10096991804517308,16,7,9,13,0.3561451573779096,0.4352754879817561
저성장/NNG;지속되/VVX,0,-0.10096991804517308,16,7,9,25,0.3561451573779096,0.4352754879817561
부양책/NNG;쓸/VV,0,-0.10096991804517308,16,7,9,22,0.3561451573779096,0.4352754879817561
수출/NNG;호조/NNG;이/VV,0,-0.10096991804517308,16,7,9,14,0.3561451573779096,0.4352754879817561
지정학적리스크/NNG;확대되/VVX,0,-0.10096991804517308,16,7,9,23,0.3561451573779096,0.4352754879817561
재정/NNG;투입하/VVX,0,-0.10096991804517308,16,7,9,29,0.3561451573779096,0.4352754879817561
경제성장/NNG;하/VV,0,-0.10096991804517308,16,7,9,15,0.3561451573779096,0.4352754879817561
경제성장/NNG;저해하/VVX,0,-0.10096991804517308,16,7,9,20,0.3561451573779096,0.4352754879817561
경제성장/NNG;지속되/VVX;소비자물가상승률/NNG;물가안정/NNG;목표/NNG;안정되/VVX;통화정책/NNG,0,-0.10096991804517308,16,7,9,22,0.3561451573779096,0.4352754879817561
경기/NNG;위축/NNG;따른/VV,0,-0.10096991804517308,16,7,9,14,0.3561451573779096,0.4352754879817561
금리하락/NNG;여지/NNG;남/VV,0,-0.10096991804517308,16,7,9,50,0.3561451573779096,0.4352754879817561
인플레이션/NNG;우려/NNG;완화됐/VVX,0,-0.10096991804517308,16,7,9,24,0.3561451573779096,0.4352754879817561
금리/NNG;하락세/NNG;지속될/VVX;예상되/VVX,0,-0.10096991804517308,16,7,9,33,0.3561451573779096,0.4352754879817561
물가상승압력/NNG;확대될/VVX,0,-0.10096991804517308,16,7,9,25,0.3561451573779096,0.4352754879817561
경제지표/NNG;예상치/NNG;상회하/VVX,0,-0.10096991804517308,16,7,9,16,0.3561451573779096,0.4352754879817561
경제/NNG;악영향/NNG;줄/VV,0,-0.10096991804517308,16,7,9,24,0.3561451573779096,0.4352754879817561
금리상승/NNG;이어졌/VV,0,-0.10096991804517308,16,7,9,17,0.3561451573779096,0.4352754879817561
금리/NNG;인하할/VVX;없/VA,0,-0.10096991804517308,16,7,9,14,0.3561451573779096,0.4352754879817561
금리/NNG;오를/VV,0,-0.10321762615344843,196,88,108,284,0.5951558596158734,0.7306973344955234
금리상승/NNG;제한되/VVX,0,-0.10444025891395103,80,36,44,162,0.5462552130109288,0.6723171127541917
불확실성/NNG;증대되/VVX,-1,-0.10750682063631745,36,16,20,72,0.4356105013404734,0.5394687303741328
투자심리/NNG;얼어붙/VV,-1,-0.10750682063631745,36,16,20,60,0.4356105013404734,0.5394687303741328
금리/NNG;동결할/VVX;가능성/NNG;높/VA,0,-0.1090304196970211,25,11,14,27,0.3920810840645355,0.4870579919514833
불안/NNG;가중시/VVX,0,-0.1090304196970211,25,11,14,33,0.3920810840645355,0.4870579919514833
금리인상/NNG;지속하/VVX,0,-0.1090304196970211,25,11,14,22,0.3920810840645355,0.4870579919514833
성장/NNG;촉진하/VVX,0,-0.1090304196970211,25,11,14,30,0.3920810840645355,0.4870579919514833
테이퍼링/NNG;따른/VV,0,-0.1090304196970211,25,11,14,43,0.3920810840645355,0.4870579919514833
기준금리/NNG;인하할/VVX;전망/NNG,-1,-0.11295782517367703,56,25,31,82,0.4934333922120896,0.6178476524221038
경기침체/NNG;따른/VV,0,-0.1140762026790042,123,55,68,90,0.5773390251505485,0.7245464273211342
자금이탈/NNG;따른/VV,-1,-0.11447622120177459,45,20,25,37,0.46182341872825255,0.5800463714071892
금리/NNG;인하할/VVX,0,-0.11470017702326996,323,144,179,366,0.5871110165342459,0.7377407525898342
기준금리/NNG;동결하/VVX;했/VV,-1,-0.11642900886506469,34,15,19,40,0.42365076707544036,0.5342086933904733
경제/NNG;견조하/VVX,-1,-0.11642900886506469,34,15,19,20,0.42365076707544036,0.5342086933904733
금리상승/NNG;인해/VV,-1,-0.11642900886506469,34,15,19,48,0.42365076707544036,0.5342086933904733
기준금리/NNG;올려야/VV,-1,-0.11642900886506469,34,15,19,29,0.42365076707544036,0.5342086933904733
금리인하/NNG;가능성/NNG;반영하/VVX,-1,-0.11642900886506469,34,15,19,40,0.42365076707544036,0.5342086933904733
콜금리/NNG;동결할/VVX,0,-0.11716299692221854,94,42,52,47,0.5553055941269349,0.7012619320261656
유동성/NNG;공급할/VVX,0,-0.11939598581193311,74,33,41,112,0.5270622582698457,0.6686115579886018
성장세/NNG;이어질/VV,0,-0.11939598581193311,74,33,41,71,0.5270622582698457,0.6686115579886018
금리하락/NNG;제한되/VVX,0,-0.11939598581193311,74,33,41,142,0.5270622582698457,0.6686115579886018
유가/NNG;치솟/VV,0,-0.12164601814469989,23,10,13,21,0.3775079135352253,0.4810805729761774
수입/NNG;늘어난/VV,0,-0.12164601814469989,23,10,13,24,0.3775079135352253,0.4810805729761774
생산/NNG;늘리/VV,0,-0.12164601814469989,23,10,13,21,0.3775079135352253,0.4810805729761774
물가상승압력/NNG;높일/VV,0,-0.12164601814469989,23,10,13,10,0.3775079135352253,0.4810805729761774
금리인상/NNG;준비하/VVX,0,-0.12164601814469989,23,10,13,28,0.3775079135352253,0.4810805729761774
침체/NNG;빠질/VV,0,-0.12164601814469989,23,10,13,27,0.3775079135352253,0.4810805729761774
경기/NNG;회복시/VVX,0,-0.12164601814469989,23,10,13,45,0.3775079135352253,0.4810805729761774
경제성장/NNG;위해/VV,-1,-0.12216390245819364,43,19,24,56,0.4512886096219068,0.5757076102684504
원자재/NNG;가격/NNG;하락/NNG;따른/VV,-1,-0.12623549140444856,32,14,18,58,0.4111198364732431,0.5288126780697338
수입/NNG;줄/VV,-1,-0.12623549140444856,32,14,18,39,0.4111198364732431,0.5288126780697338
소비/NNG;살아나/VV,-1,-0.12623549140444856,32,14,18,41,0.4111198364732431,0.5288126780697338
금리인하/NNG;가능성/NNG;열려/VV,-1,-0.12625963495592762,52,23,29,77,0.4752086395284194,0.6112783698244244
기준금리/NNG;인하될/VVX;가능성/NNG,0,-0.12785745558949413,124,55,69,204,0.5679696289528093,0.7329730763880499
신용스프레드/NNG;축소되/VVX,0,-0.1289255082449121,115,51,64,112,0.5630804644863764,0.7282407876926551
금리하락/NNG;확대되/VVX,-1,-0.1289532231718663,61,27,34,68,0.4956591857786431,0.6410798642092875
변동성/NNG;보이/VV,0,-0.12991396786137743,106,47,59,118,0.5568462996984133,0.7216249964679554
금리/NNG;낮췄/VV,-1,-0.13043034598462,41,18,23,49,0.44030736731777964,0.5711992776088265
금리인하/NNG;단행할/VVX;가능성/NNG,-1,-0.13043034598462,41,18,23,45,0.44030736731777964,0.5711992776088265
금리인상/NNG;시작되/VVX,-1,-0.13043034598462,41,18,23,60,0.44030736731777964,0.5711992776088265
인플레이션압력/NNG;완화되/VVX,-1,-0.13043034598462,41,18,23,38,0.44030736731777964,0.5711992776088265
소비/NNG;위축될/VVX,-1,-0.13043034598462,41,18,23,46,0.44030736731777964,0.5711992776088265
물가/NNG;오를/VV,0,-0.13071338672592825,97,43,54,122,0.5490087729675616,0.7126243560816072
기준금리/NNG;낮출/VV,0,-0.13118544196479343,79,35,44,90,0.527368787846553,0.6851919584554192
경기회복/NNG;위한/VV,0,-0.13118544196479343,79,35,44,128,0.527368787846553,0.6851919584554192
경기회복/NNG;위해/VV,0,-0.13160373544007764,122,54,68,166,0.5644942338732352,0.7340513064732257
금리/NNG;동결할/VVX;예상했/VVX,0,-0.13635816420179947,21,9,12,20,0.3618518781942765,0.4751115682111642
유동성/NNG;떨어지/VV,0,-0.13635816420179947,21,9,12,56,0.3618518781942765,0.4751115682111642
경기/NNG;둔화된/VVX,0,-0.13635816420179947,21,9,12,31,0.3618518781942765,0.4751115682111642
리스크/NNG;줄/VV,0,-0.13635816420179947,21,9,12,22,0.3618518781942765,0.4751115682111642
안전자산선호/NNG;현상/NNG;강화돼/VVX,0,-0.13635816420179947,21,9,12,21,0.3618518781942765,0.4751115682111642
금리인상/NNG;우려/NNG;커지/VV,0,-0.13635816420179947,21,9,12,44,0.3618518781942765,0.4751115682111642
성장률/NNG;상향조정했/VVX,0,-0.13635816420179947,21,9,12,30,0.3618518781942765,0.4751115682111642
유가/NNG;인해/VV,0,-0.13635816420179947,21,9,12,29,0.3618518781942765,0.4751115682111642
금리상승/NNG;압력/NNG;가중될/VVX,0,-0.13635816420179947,21,9,12,11,0.3618518781942765,0.4751115682111642
유동성/NNG;공급할/VVX;있/VV,0,-0.13635816420179947,21,9,12,15,0.3618518781942765,0.4751115682111642
리스크/NNG;꼽/VV,0,-0.13635816420179947,21,9,12,32,0.3618518781942765,0.4751115682111642
대외불확실성/NNG;커지/VV,0,-0.13635816420179947,21,9,12,34,0.3618518781942765,0.4751115682111642
불안요인/NNG;작용할/VVX;가능성/NNG,0,-0.13635816420179947,21,9,12,32,0.3618518781942765,0.4751115682111642
정책금리/NNG;결정하/VVX,0,-0.13635816420179947,21,9,12,19,0.3618518781942765,0.4751115682111642
금리/NNG;동결되/VVX,0,-0.13646125068809922,68,30,38,99,0.5054476172777983,0.6637919885460928
잠재성장률/NNG;상회하/VVX,-1,-0.13710240956766884,30,13,17,31,0.39794284739614627,0.5232907911722814
금리/NNG;기준금리/NNG;하회하/VVX,-1,-0.13710240956766884,30,13,17,84,0.39794284739614627,0.5232907911722814
금융완화/NNG;기조/NNG;유지될/VVX,-1,-0.13710240956766884,30,13,17,21,0.39794284739614627,0.5232907911722814
불안/NNG;계속되/VVX,-1,-0.13710240956766884,30,13,17,37,0.39794284739614627,0.5232907911722814
변동성/NNG;높이/VV,-1,-0.13710240956766884,30,13,17,45,0.39794284739614627,0.5232907911722814
신용등급/NNG;하향조정하/VVX,-1,-0.13710240956766884,30,13,17,38,0.39794284739614627,0.5232907911722814
금융안정/NNG;유의해/VVX,-1,-0.13710240956766884,30,13,17,12,0.39794284739614627,0.5232907911722814
성장률/NNG;전망치/NNG;하향조정했/VVX,-1,-0.13710240956766884,30,13,17,42,0.39794284739614627,0.5232907911722814
경기회복/NNG;지연될/VVX,-1,-0.1393582879650338,39,17,22,44,0.4288449267783443,0.5665220151359305
투자심리/NNG;개선될/VVX,-1,-0.1393582879650338,39,17,22,33,0.4288449267783443,0.5665220151359305
시장금리/NNG;큰/VA;상승하/VVX,-1,-0.1393582879650338,39,17,22,40,0.4288449267783443,0.5665220151359305
경기/NNG;부진하/VVX,-1,-0.1393582879650338,39,17,22,44,0.4288449267783443,0.5665220151359305
금리인하/NNG;할/VV,-1,-0.14125068103938299,48,21,27,60,0.45547643313415065,0.6040268135881123
기준금리/NNG;동결됐/VVX,-1,-0.14125068103938299,48,21,27,113,0.45547643313415065,0.6040268135881123
성장률/NNG;둔화될/VVX,-1,-0.14125068103938299,48,21,27,110,0.45547643313415065,0.6040268135881123
기준금리/NNG;인하될/VVX,0,-0.1423354386461818,148,65,83,226,0.5636683756712836,0.7491587134684321
기준금리/NNG;인상할/VVX;전망/NNG,0,-0.14235464630992345,75,33,42,122,0.513940271420284,0.6830929668717522
기준금리/NNG;인하할/VVX;가능성/NNG,0,-0.14527922905734003,91,40,51,106,0.5331512300487404,0.7128644237665333
금리/NNG;낮춰/VV,-1,-0.14923723358002627,64,28,36,89,0.48955902648186217,0.6598868545824323
금리/NNG;상승세/NNG;재개될/VVX,-1,-0.14926351777719038,28,12,16,65,0.38401900962539565,0.5176550399942743
경기부양/NNG;위해/VV;금리/NNG,-1,-0.14926351777719038,28,12,16,42,0.38401900962539565,0.5176550399942743
내수/NNG;살리/VV,-1,-0.14926351777719038,28,12,16,33,0.38401900962539565,0.5176550399942743
경제/NNG;회복세/NNG;지속하/VVX,-1,-0.14926351777719038,28,12,16,37,0.38401900962539565,0.5176550399942743
기준금리동결/NNG;예상했/VVX,-1,-0.14926351777719038,28,12,16,43,0.38401900962539565,0.5176550399942743
금리/NNG;하락세/NNG;재개될/VVX,-1,-0.14926351777719038,28,12,16,70,0.38401900962539565,0.5176550399942743
기준금리/NNG;인하될/VVX;전망/NNG,-1,-0.14926351777719038,28,12,16,61,0.38401900962539565,0.5176550399942743
금리인하/NNG;단행해/VVX,-1,-0.14963829778953053,55,24,31,42,0.4690791654956245,0.6327996712842817
변동성/NNG;확대될/VVX;있/VV,0,-0.15052268317353534,105,46,59,133,0.5417745888880713,0.7321890145907516
경기회복/NNG;확인하/VVX,0,-0.15390131540707896,19,8,11,21,0.34478492431504626,0.46919325061692246
소비/NNG;증가할/VVX,0,-0.15390131540707896,19,8,11,23,0.34478492431504626,0.46919325061692246
경기/NNG;반등하/VVX,0,-0.15390131540707896,19,8,11,43,0.34478492431504626,0.46919325061692246
인플레이션/NNG;발생할/VVX,0,-0.15390131540707896,19,8,11,24,0.34478492431504626,0.46919325061692246
불안/NNG;있/VV,0,-0.15390131540707896,19,8,11,35,0.34478492431504626,0.46919325061692246
금리/NNG;오를/VV;가능성/NNG,0,-0.15390131540707896,19,8,11,38,0.34478492431504626,0.46919325061692246
물가상승/NNG;억제하/VVX;위해/VV,0,-0.15390131540707896,19,8,11,27,0.34478492431504626,0.46919325061692246
콜금리/NNG;인하할/VVX,0,-0.15390131540707896,19,8,11,39,0.34478492431504626,0.46919325061692246
금리/NNG;내려왔/VV,0,-0.15390131540707896,19,8,11,12,0.34478492431504626,0.46919325061692246
경기/NNG;부정적/VAX;영향/NNG;미칠/VV,0,-0.15390131540707896,19,8,11,25,0.34478492431504626,0.46919325061692246
동결/NNG;주장하/VVX,0,-0.15390131540707896,19,8,11,13,0.34478492431504626,0.46919325061692246
경기부양책/NNG;필요하/VVX,0,-0.15390131540707896,19,8,11,8,0.34478492431504626,0.46919325061692246
불안요인/NNG;되/VV,0,-0.15390131540707896,19,8,11,25,0.34478492431504626,0.46919325061692246
주택가격/NNG;상승하/VVX,0,-0.15390131540707896,19,8,11,33,0.34478492431504626,0.46919325061692246
리스크/NNG;완화되/VVX,-1,-0.15453679157343447,71,31,40,100,0.4994177540385998,0.6805058649142985
경제지표/NNG;호조/NNG;보이/VV,0,-0.15594838250183685,87,38,49,150,0.521490136941671,0.7126365985424304
불확실성/NNG;따른/VV,0,-0.15753005940929476,154,67,87,209,0.5533235210094984,0.7585899128255744
변동성/NNG;커지/VV,0,-0.15912575698511477,175,76,99,225,0.5536716038248211,0.761551494420876
금리인하/NNG;나서/VV,0,-0.15957073711255398,131,57,74,176,0.5475228172452282,0.753780865548062
시장금리/NNG;오르/VV,-1,-0.1596352304054477,35,15,20,71,0.4042918910120283,0.5566667687930731
소비자물가/NNG;상승할/VVX,-1,-0.16303662022330523,26,11,15,52,0.36920984259740525,0.5119192229382548
불확실성/NNG;완화하/VVX,-1,-0.16303662022330523,26,11,15,19,0.36920984259740525,0.5119192229382548
금리/NNG;상승세/NNG;예상된/VVX,-1,-0.16303662022330523,26,11,15,26,0.36920984259740525,0.5119192229382548
불안심리/NNG;진정되/VVX,-1,-0.16303662022330523,26,11,15,34,0.36920984259740525,0.5119192229382548
안전자산선호/NNG;심리/NNG;약화되/VVX,-1,-0.16303662022330523,26,11,15,58,0.36920984259740525,0.5119192229382548
유가/NNG;떨어지/VV,-1,-0.16303662022330523,26,11,15,44,0.36920984259740525,0.5119192229382548
지준율/NNG;인하하/VVX,-1,-0.16303662022330523,26,11,15,20,0.36920984259740525,0.5119192229382548
투자심리/NNG;악화되/VVX,-1,-0.16303662022330523,26,11,15,31,0.36920984259740525,0.5119192229382548
기준금리/NNG;인하할/VVX;전망했/VVX,-1,-0.16303662022330523,26,11,15,33,0.36920984259740525,0.5119192229382548
정책금리/NNG;동결하/VVX,0,-0.16476129268879192,76,33,43,95,0.500933160300631,0.6970188900069746
국제유가/NNG;하락/NNG;따른/VV,-1,-0.16550529353465382,51,22,29,63,0.449515218249433,0.626429654218171
단기금리/NNG;상승하/VVX,-1,-0.16550529353465382,51,22,29,83,0.449515218249433,0.626429654218171
안전자산선호/NNG;현상/NNG;강화되/VVX,-1,-0.16783526049018505,42,18,24,57,0.4226474459822528,0.5918122967822157
금리/NNG;인하할/VVX;기대/NNG,-1,-0.16783526049018505,42,18,24,38,0.4226474459822528,0.5918122967822157
금리/NNG;내려갈/VV,-1,-0.16783526049018505,42,18,24,51,0.4226474459822528,0.5918122967822157
소비/NNG;늘리/VV,-1,-0.16783526049018505,42,18,24,55,0.4226474459822528,0.5918122967822157
경제지표/NNG;개선되/VVX,0,-0.17221505331274067,125,54,71,210,0.5364738363896775,0.7579919990315603
금리/NNG;상승압력/NNG;받/VV,0,-0.17360440471854022,81,35,46,172,0.5022086766956749,0.7116098834583735
경제지표/NNG;호조/NNG;보인/VV,-1,-0.1741956108808944,49,21,28,76,0.4391203065564238,0.6229738771287119
성장률/NNG;전망치/NNG;낮추/VV,0,-0.1754311615581361,17,7,10,26,0.3257913988178628,0.46337319538502714
생산/NNG;증가해/VVX,0,-0.1754311615581361,17,7,10,11,0.3257913988178628,0.46337319538502714
금융안정/NNG;리스크/NNG;균형/NNG;있/VV,0,-0.1754311615581361,17,7,10,8,0.3257913988178628,0.46337319538502714
침체/NNG;가/VV,0,-0.1754311615581361,17,7,10,15,0.3257913988178628,0.46337319538502714
설비투자/NNG;부진하/VVX,0,-0.1754311615581361,17,7,10,17,0.3257913988178628,0.46337319538502714
경제지표/NNG;부진할/VVX,0,-0.1754311615581361,17,7,10,28,0.3257913988178628,0.46337319538502714
경기둔화/NNG;따른/VV;수출/NNG,0,-0.1754311615581361,17,7,10,33,0.3257913988178628,0.46337319538502714
경기둔화/NNG;진행되/VVX,0,-0.1754311615581361,17,7,10,16,0.3257913988178628,0.46337319538502714
디플레이션/NNG;벗어나/VV,0,-0.1754311615581361,17,7,10,36,0.3257913988178628,0.46337319538502714
금리/NNG;상승세/NNG;돌아섰/VV,0,-0.1754311615581361,17,7,10,15,0.3257913988178628,0.46337319538502714
금리/NNG;메리트/NNG;남/VV,0,-0.1754311615581361,17,7,10,53,0.3257913988178628,0.46337319538502714
리스크/NNG;존재한/VVX,0,-0.1754311615581361,17,7,10,24,0.3257913988178628,0.46337319538502714
금리인상/NNG;반영해/VVX,0,-0.1754311615581361,17,7,10,17,0.3257913988178628,0.46337319538502714
경기/NNG;부양하/VVX;위한/VV,0,-0.1754311615581361,17,7,10,31,0.3257913988178628,0.46337319538502714
변동성/NNG;줄여/VV,0,-0.1754311615581361,17,7,10,37,0.3257913988178628,0.46337319538502714
금리하락/NNG;주도했/VVX,0,-0.1754311615581361,17,7,10,16,0.3257913988178628,0.46337319538502714
소비자물가/NNG;이/VV,0,-0.1754311615581361,17,7,10,17,0.3257913988178628,0.46337319538502714
경기/NNG;부양할/VVX,-1,-0.1780958300315063,40,17,23,37,0.41071222156526205,0.5873725703077808
경기둔화/NNG;지속되/VVX,-1,-0.1780958300315063,40,17,23,57,0.41071222156526205,0.5873725703077808
하방리스크/NNG;작용할/VVX,-1,-0.1780958300315063,40,17,23,34,0.41071222156526205,0.5873725703077808
불안요인/NNG;상존하/VVX,-1,-0.1780958300315063,40,17,23,82,0.41071222156526205,0.5873725703077808
금리/NNG;낮/VA;수준이/VVX,-1,-0.17886598879443993,24,10,14,41,0.35332088928048555,0.5060984802404322
금리인상/NNG;가능성/NNG;낮추/VV,-1,-0.17886598879443993,24,10,14,25,0.35332088928048555,0.5060984802404322
금리인상/NNG;전망했/VVX,-1,-0.17886598879443993,24,10,14,42,0.35332088928048555,0.5060984802404322
경제/NNG;악영향/NNG;미칠/VV,-1,-0.17886598879443993,24,10,14,40,0.35332088928048555,0.5060984802404322
금리/NNG;동결할/VVX;가능성/NNG,-1,-0.17886598879443993,24,10,14,25,0.35332088928048555,0.5060984802404322
경기선행지수/NNG;하락했/VVX,-1,-0.17886598879443993,24,10,14,30,0.35332088928048555,0.5060984802404322
금융시장/NNG;지표/NNG;상황/NNG;반영하/VVX;못하/VX,-1,-0.17886598879443993,24,10,14,33,0.35332088928048555,0.5060984802404322
경기/NNG;위축시/VVX,-1,-0.17886598879443993,24,10,14,33,0.35332088928048555,0.5060984802404322
경기회복세/NNG;보이/VV,-1,-0.17886598879443993,24,10,14,32,0.35332088928048555,0.5060984802404322
성장/NNG;둔화/NNG;따른/VV,-1,-0.17886598879443993,24,10,14,36,0.35332088928048555,0.5060984802404322
가계부채/NNG;증가세/NNG;점검해/VVX;나갈/VX,-1,-0.17886598879443993,24,10,14,14,0.35332088928048555,0.5060984802404322
소비자물가상승률/NNG;기록하/VVX,-1,-0.17886598879443993,24,10,14,44,0.35332088928048555,0.5060984802404322
기준금리/NNG;올리/VV;않/VX,-1,-0.17901256046659886,56,24,32,82,0.45378671604857973,0.6502027092971179
불확실성/NNG;부각되/VVX,-1,-0.17901256046659886,56,24,32,84,0.45378671604857973,0.6502027092971179
금리인상/NNG;지지하/VVX,-1,-0.18254572722201745,63,27,36,76,0.466750640649052,0.6736721287163218
금리인하/NNG;예상되/VVX,-1,-0.18254572722201745,63,27,36,49,0.466750640649052,0.6736721287163218
금리/NNG;안정되/VVX,-1,-0.1834690703854811,47,20,27,81,0.4282826769022149,0.6193304249145707
금리/NNG;인하되/VVX,-1,-0.1834690703854811,47,20,27,58,0.4282826769022149,0.6193304249145707
수출/NNG;늘리/VV,-1,-0.18419360016859088,31,13,18,45,0.3771187144694216,0.5461602707684957
하방위험/NNG;작용할/VVX,-1,-0.18419360016859088,31,13,18,30,0.3771187144694216,0.5461602707684957
소비자물가지수/NNG;상승하/VVX,-1,-0.18419360016859088,31,13,18,50,0.3771187144694216,0.5461602707684957
소비자물가/NNG;상승해/VVX,-1,-0.1892368235299171,38,16,22,34,0.39820413567315954,0.5827442586047649
경기회복/NNG;기대하/VVX,-1,-0.1892368235299171,38,16,22,43,0.39820413567315954,0.5827442586047649
금융시장/NNG;안정/NNG;되찾/VV,-1,-0.1892368235299171,38,16,22,42,0.39820413567315954,0.5827442586047649
고용지표/NNG;호조/NNG;따른/VV,-1,-0.1892368235299171,38,16,22,57,0.39820413567315954,0.5827442586047649
안전자산선호/NNG;약화되/VVX,-1,-0.1892368235299171,38,16,22,70,0.39820413567315954,0.5827442586047649
경제/NNG;발목/NNG;잡/VV,-1,-0.19240711461992965,68,29,39,98,0.46992729450738263,0.6922377084000008
채권시장/NNG;국채/NNG;가격/NNG;떨어진/VV,-1,-0.19339918563262581,45,19,26,35,0.41697092107882744,0.6154937712507539
경제성장/NNG;둔화될/VVX,-1,-0.19339918563262581,45,19,26,75,0.41697092107882744,0.6154937712507539
금리/NNG;큰/VA;하락하/VVX,0,-0.1936755738259065,96,41,55,144,0.5046975176959292,0.7454147784469899
경제/NNG;회복세/NNG;보이/VV,-1,-0.19407881097926993,82,35,47,111,0.489825804389886,0.7240552827354961
금리인상/NNG;단행했/VVX,0,-0.19659959803121507,153,65,88,146,0.5243111551090752,0.7790964474749222
리스크/NNG;감수하/VVX,-1,-0.19739307369484083,22,9,13,22,0.33607251411354616,0.5002081736144915
리스크/NNG;불거지/VV,-1,-0.19739307369484083,22,9,13,30,0.33607251411354616,0.5002081736144915
기준금리/NNG;인상할/VVX;있/VA,-1,-0.19739307369484083,22,9,13,31,0.33607251411354616,0.5002081736144915
실업률/NNG;기록하/VVX,-1,-0.19739307369484083,22,9,13,36,0.33607251411354616,0.5002081736144915
리스크/NNG;해소되/VVX,-1,-0.19739307369484083,22,9,13,48,0.33607251411354616,0.5002081736144915
성장률/NNG;개선될/VVX,-1,-0.19739307369484083,22,9,13,38,0.33607251411354616,0.5002081736144915
경제/NNG;부정적/VAX;영향/NNG;미칠/VV;있/VV,-1,-0.19739307369484083,22,9,13,27,0.33607251411354616,0.5002081736144915
경기/NNG;선행하/VVX,-1,-0.19739307369484083,22,9,13,18,0.33607251411354616,0.5002081736144915
유가/NNG;올랐/VV,-1,-0.19739307369484083,22,9,13,44,0.33607251411354616,0.5002081736144915
금리상승/NNG;억제하/VVX,-1,-0.19739307369484083,22,9,13,27,0.33607251411354616,0.5002081736144915
경제/NNG;성장세/NNG;이/VV;갈/VX,-1,-0.19739307369484083,22,9,13,19,0.33607251411354616,0.5002081736144915
양적완화/NNG;통한/VV,-1,-0.19739307369484083,22,9,13,39,0.33607251411354616,0.5002081736144915
경기/NNG;부진/NNG;이어지/VV,-1,-0.19739307369484083,22,9,13,25,0.33607251411354616,0.5002081736144915
금리하락/NNG;압력/NNG;작용할/VVX,-1,-0.19739307369484083,22,9,13,35,0.33607251411354616,0.5002081736144915
불안/NNG;이어질/VV,-1,-0.19739307369484083,22,9,13,28,0.33607251411354616,0.5002081736144915
경제지표/NNG;호전되/VVX,-1,-0.19739307369484083,22,9,13,51,0.33607251411354616,0.5002081736144915
경제성장률/NNG;전망치/NNG;하향조정하/VVX,-1,-0.19739307369484083,22,9,13,44,0.33607251411354616,0.5002081736144915
불확실성/NNG;영향/NNG;받/VV,-1,-0.19739307369484083,22,9,13,16,0.33607251411354616,0.5002081736144915
gdp/NNG;증가해/VVX,-1,-0.19739307369484083,22,9,13,30,0.33607251411354616,0.5002081736144915
금리/NNG;크/VA;하락했/VVX,-1,-0.19866718074239498,29,12,17,45,0.3622972548810131,0.5406702556729086
산업생산/NNG;감소하/VVX,-1,-0.19866718074239498,29,12,17,24,0.3622972548810131,0.5406702556729086
기준금리/NNG;유지하/VVX;바람직하/VAX,-1,-0.19866718074239498,29,12,17,28,0.3622972548810131,0.5406702556729086
양적완화/NNG;정책/NNG;따른/VV,-1,-0.19866718074239498,29,12,17,25,0.3622972548810131,0.5406702556729086
경기/NNG;활성화/NNG;위해/VV,-1,-0.19866718074239498,29,12,17,49,0.3622972548810131,0.5406702556729086
기준금리/NNG;인상할/VVX;가능성/NNG;크/VA,-1,-0.19866718074239498,29,12,17,36,0.3622972548810131,0.5406702556729086
물가상승/NNG;따른/VV,-1,-0.19877629512459627,59,25,34,108,0.448401471836103,0.6693186824857673
소비/NNG;늘/VV,-1,-0.19877629512459627,59,25,34,61,0.448401471836103,0.6693186824857673
자산/NNG;매입하/VVX,-1,-0.20140884264622416,36,15,21,71,0.38505950874814365,0.5779245912230032
성장률/NNG;높일/VV,0,-0.20287866222742823,15,6,9,16,0.30402476750409096,0.4576998667742743
경기/NNG;반영하/VVX,0,-0.20287866222742823,15,6,9,25,0.30402476750409096,0.4576998667742743
금리상승/NNG;키웠/VV,0,-0.20287866222742823,15,6,9,11,0.30402476750409096,0.4576998667742743
원자재/NNG;가격/NNG;급등하/VVX,0,-0.20287866222742823,15,6,9,28,0.30402476750409096,0.4576998667742743
성장세/NNG;보인/VV,0,-0.20287866222742823,15,6,9,28,0.30402476750409096,0.4576998667742743
디레버리징/NNG;진행되/VVX,0,-0.20287866222742823,15,6,9,25,0.30402476750409096,0.4576998667742743
경기과열/NNG;억제하/VVX,0,-0.20287866222742823,15,6,9,17,0.30402476750409096,0.4576998667742743
물가/NNG;반영되/VVX,0,-0.20287866222742823,15,6,9,23,0.30402476750409096,0.4576998667742743
불안심리/NNG;자극할/VVX,0,-0.20287866222742823,15,6,9,27,0.30402476750409096,0.4576998667742743
불안요인/NNG;해소되/VVX,0,-0.20287866222742823,15,6,9,31,0.30402476750409096,0.4576998667742743
경제/NNG;바닥/NNG;치/VV,0,-0.20287866222742823,15,6,9,11,0.30402476750409096,0.4576998667742743
기준금리/NNG;인하한/VAX;이/VV,0,-0.20287866222742823,15,6,9,17,0.30402476750409096,0.4576998667742743
경기회복세/NNG;지속하/VVX,0,-0.20287866222742823,15,6,9,20,0.30402476750409096,0.4576998667742743
수출/NNG;영향/NNG;미치/VV,0,-0.20287866222742823,15,6,9,19,0.30402476750409096,0.4576998667742743
인플레이션/NNG;지속되/VVX,0,-0.20287866222742823,15,6,9,20,0.30402476750409096,0.4576998667742743
수출/NNG;위축되/VVX,0,-0.20287866222742823,15,6,9,20,0.30402476750409096,0.4576998667742743
양적완화/NNG;내놓/VV,0,-0.20287866222742823,15,6,9,42,0.30402476750409096,0.4576998667742743
변동성/NNG;장세/NNG;예상되/VVX,0,-0.20287866222742823,15,6,9,17,0.30402476750409096,0.4576998667742743
경제/NNG;회복된/VVX,0,-0.20287866222742823,15,6,9,13,0.30402476750409096,0.4576998667742743
금리인상/NNG;시사해/VVX,0,-0.20287866222742823,15,6,9,17,0.30402476750409096,0.4576998667742743
수입/NNG;증가했/VVX,0,-0.20287866222742823,15,6,9,22,0.30402476750409096,0.4576998667742743
경기/NNG;확장/NNG;밑돌/VV,0,-0.20287866222742823,15,6,9,13,0.30402476750409096,0.4576998667742743
경기회복/NNG;기대/NNG;높이/VV,0,-0.20287866222742823,15,6,9,17,0.30402476750409096,0.4576998667742743
금리/NNG;안정세/NNG;보이/VV,0,-0.20287866222742823,15,6,9,13,0.30402476750409096,0.4576998667742743
금리/NNG;올리/VV;어렵/VA,0,-0.20287866222742823,15,6,9,30,0.30402476750409096,0.4576998667742743
금리인상/NNG;걸릴/VV,0,-0.20287866222742823,15,6,9,17,0.30402476750409096,0.4576998667742743
경제/NNG;침체되/VVX,0,-0.20287866222742823,15,6,9,31,0.30402476750409096,0.4576998667742743
기준금리/NNG;인하할/VVX;가능성/NNG;낮/VA,0,-0.20287866222742823,15,6,9,19,0.30402476750409096,0.4576998667742743
리스크관리/NNG;강화할/VVX,0,-0.20287866222742823,15,6,9,10,0.30402476750409096,0.4576998667742743
기준금리/NNG;인하해/VVX,0,-0.2125572479680844,109,46,63,143,0.5003702464669563,0.7686561704549516
유동성/NNG;따른/VV,-1,-0.21480452883574552,34,14,20,35,0.37119722267027216,0.5729103957745106
물가/NNG;영향/NNG;미칠/VV,-1,-0.215087072958562,27,11,16,18,0.34644626330490624,0.5350257237614706
금리상승/NNG;제한하/VVX;요인/NNG,-1,-0.215087072958562,27,11,16,26,0.34644626330490624,0.5350257237614706
금리인하/NNG;기대/NNG;선반영하/VVX,-1,-0.21560560330474932,41,17,24,83,0.3927662504567011,0.6072175395428981
변동성/NNG;확대/NNG;따른/VV,-1,-0.21560560330474932,41,17,24,53,0.3927662504567011,0.6072175395428981
실물경제/NNG;미치/VV;영향/NNG,-1,-0.21682335825551036,62,26,36,78,0.44331856250112783,0.6871214048309559
물가/NNG;안정된/VVX,-1,-0.21686121893253496,55,23,32,72,0.4285362226102224,0.6642621983120175
기준금리인하/NNG;단행하/VVX,0,-0.2195795894013145,20,8,12,45,0.31705194681908166,0.49426144712210307
긴축정책/NNG;펴/VV,0,-0.2195795894013145,20,8,12,42,0.31705194681908166,0.49426144712210307
기준금리인하/NNG;나서/VV,0,-0.2195795894013145,20,8,12,36,0.31705194681908166,0.49426144712210307
기준금리인상/NNG;가능성/NNG;커지/VV,0,-0.2195795894013145,20,8,12,12,0.31705194681908166,0.49426144712210307
금리인하/NNG;기대/NNG;지속되/VVX,0,-0.2195795894013145,20,8,12,33,0.31705194681908166,0.49426144712210307
유동성/NNG;관리하/VVX,0,-0.2195795894013145,20,8,12,23,0.31705194681908166,0.49426144712210307
투자심리/NNG;살아나/VV,0,-0.2195795894013145,20,8,12,33,0.31705194681908166,0.49426144712210307
기준금리인하/NNG;기대하/VVX,0,-0.2195795894013145,20,8,12,51,0.31705194681908166,0.49426144712210307
물가/NNG;낮추/VV,0,-0.2195795894013145,20,8,12,39,0.31705194681908166,0.49426144712210307
신용경색/NNG;지속되/VVX,0,-0.2195795894013145,20,8,12,10,0.31705194681908166,0.49426144712210307
기준금리/NNG;역할/NNG;하/VV,0,-0.2195795894013145,20,8,12,13,0.31705194681908166,0.49426144712210307
금리/NNG;상승세/NNG;이/VV,0,-0.2195795894013145,20,8,12,28,0.31705194681908166,0.49426144712210307
변동성/NNG;축소될/VVX,0,-0.2195795894013145,20,8,12,28,0.31705194681908166,0.49426144712210307
금리/NNG;오른/VV;나타냈/VV,0,-0.2195795894013145,20,8,12,31,0.31705194681908166,0.49426144712210307
원자재/NNG;가격/NNG;급락하/VVX,0,-0.2195795894013145,20,8,12,18,0.31705194681908166,0.49426144712210307
통화완화/NNG;기조/NNG;유지할/VVX,0,-0.2195795894013145,20,8,12,19,0.31705194681908166,0.49426144712210307
원자재/NNG;가격/NNG;오르/VV,0,-0.2195795894013145,20,8,12,22,0.31705194681908166,0.49426144712210307
변동성/NNG;요인/NNG;작용할/VVX,0,-0.2195795894013145,20,8,12,19,0.31705194681908166,0.49426144712210307
불안/NNG;남/VV,0,-0.2195795894013145,20,8,12,28,0.31705194681908166,0.49426144712210307
금리/NNG;큰/VA;상승하/VVX,-1,-0.22461213035495964,67,28,39,129,0.44758389995160514,0.7051632181995628
금리/NNG;상승세/NNG;보였/VV,-1,-0.22461213035495964,67,28,39,117,0.44758389995160514,0.7051632181995628
경제지표/NNG;둔화되/VVX,-1,-0.228126396795847,39,16,23,77,0.3797712906710917,0.6027652458455675
금리/NNG;하락세/NNG;이어질/VV,-1,-0.228126396795847,39,16,23,78,0.3797712906710917,0.6027652458455675
경제/NNG;성장세/NNG;둔화되/VVX,-1,-0.228126396795847,39,16,23,51,0.3797712906710917,0.6027652458455675
금리상승/NNG;요인/NNG;작용할/VVX,-1,-0.228126396795847,39,16,23,49,0.3797712906710917,0.6027652458455675
금리인하/NNG;단행할/VVX,-1,-0.22887480330570165,144,60,84,187,0.49919501548420636,0.7935618905359676
불안/NNG;심화되/VVX,-1,-0.2296746004628647,32,13,19,23,0.3565125032907758,0.5676976442142196
자산/NNG;축소하/VVX,-1,-0.2296746004628647,32,13,19,42,0.3565125032907758,0.5676976442142196
재할인율/NNG;인하하/VVX,-1,-0.2296746004628647,32,13,19,43,0.3565125032907758,0.5676976442142196
금리인상/NNG;중단될/VVX,-1,-0.2296746004628647,32,13,19,46,0.3565125032907758,0.5676976442142196
물가/NNG;자극하/VVX,-1,-0.2296746004628647,32,13,19,30,0.3565125032907758,0.5676976442142196
경기회복/NNG;나타나/VV,-1,-0.2296746004628647,32,13,19,36,0.3565125032907758,0.5676976442142196
금리/NNG;크/VA;상승하/VVX,-1,-0.2296746004628647,32,13,19,52,0.3565125032907758,0.5676976442142196
하방리스크/NNG;상존하/VVX,-1,-0.23399520173553234,25,10,15,20,0.32933785778401636,0.5292269609084536
경제/NNG;타격/NNG;받/VV,-1,-0.23399520173553234,25,10,15,37,0.32933785778401636,0.5292269609084536
수출/NNG;부진했/VVX,-1,-0.23399520173553234,25,10,15,26,0.32933785778401636,0.5292269609084536
금리/NNG;동결해/VVX;왔/VX,-1,-0.23399520173553234,25,10,15,6,0.32933785778401636,0.5292269609084536
생산/NNG;늘어나/VV,-1,-0.23399520173553234,25,10,15,17,0.32933785778401636,0.5292269609084536
경제/NNG;부담/NNG;주/VV,-1,-0.23399520173553234,25,10,15,34,0.32933785778401636,0.5292269609084536
경기/NNG;살아날/VV,-1,-0.23399520173553234,25,10,15,45,0.32933785778401636,0.5292269609084536
투자심리/NNG;개선되/VVX,-1,-0.23531441303436984,58,24,34,112,0.4237638064484883,0.6828641689494279
경기/NNG;위축되/VVX,-1,-0.23531441303436984,58,24,34,66,0.4237638064484883,0.6828641689494279
금리/NNG;인하하/VVX;않/VX,-1,-0.23663827141874505,77,32,45,84,0.4549717099314615,0.7352077461332982
정책금리/NNG;동결할/VVX,-1,-0.23719624632147762,51,21,30,36,0.406982494569389,0.6584364051715068
투자심리/NNG;안정시/VVX,-1,-0.23918387112235895,44,18,26,55,0.38789386697577477,0.6301987637890827
소비자물가지수/NNG;상승해/VVX,-1,-0.23918387112235895,44,18,26,51,0.38789386697577477,0.6301987637890827
금융시장/NNG;불안/NNG;따른/VV,-1,-0.24180766856465385,37,15,22,33,0.3660924327274982,0.5980938416287456
금리인하/NNG;가능성/NNG;배제할/VVX;없/VA,-1,-0.24180766856465385,37,15,22,89,0.3660924327274982,0.5980938416287456
경기/NNG;바닥/NNG;찍/VV,-1,-0.24180766856465385,37,15,22,31,0.3660924327274982,0.5980938416287456
변동성/NNG;확대될/VVX;가능성/NNG,-1,-0.2424785562046372,63,26,37,84,0.42909494154152145,0.7020203805897735
장단기/NNG;금리차/NNG;축소되/VVX,-1,-0.2424785562046372,63,26,37,95,0.42909494154152145,0.7020203805897735
기준금리/NNG;인상할/VVX;가능성/NNG;높/VA,-1,-0.2453511432652038,56,23,33,68,0.4133858249970599,0.6804549290924901
고용지표/NNG;호조/NNG;보일/VV,-1,-0.24635162773430475,30,12,18,18,0.340868147707177,0.5622807339562719
신용스프레드/NNG;확대될/VVX,-1,-0.24635162773430475,30,12,18,28,0.340868147707177,0.5622807339562719
경기침체/NNG;이어지/VV,-1,-0.24635162773430475,30,12,18,41,0.340868147707177,0.5622807339562719
경기/NNG;회복하/VVX,-1,-0.24635162773430475,30,12,18,49,0.340868147707177,0.5622807339562719
금리인하/NNG;기대하/VVX;어렵/VA,-1,-0.24635162773430475,30,12,18,36,0.340868147707177,0.5622807339562719
기준금리/NNG;내려도/VV,0,-0.24693240406805927,18,7,11,8,0.2956324226344795,0.48826417630360236
경제성장률/NNG;머물/VV,0,-0.24693240406805927,18,7,11,31,0.2956324226344795,0.48826417630360236
금리상승/NNG;견인할/VVX,0,-0.24693240406805927,18,7,11,25,0.2956324226344795,0.48826417630360236
금리/NNG;인하할/VVX;예상했/VVX,0,-0.24693240406805927,18,7,11,13,0.2956324226344795,0.48826417630360236
불안/NNG;키우/VV,0,-0.24693240406805927,18,7,11,14,0.2956324226344795,0.48826417630360236
양적완화/NNG;종료되/VVX,0,-0.24693240406805927,18,7,11,47,0.2956324226344795,0.48826417630360236
소비/NNG;진작시/VVX,0,-0.24693240406805927,18,7,11,25,0.2956324226344795,0.48826417630360236
금리상승/NNG;확대시/VVX,0,-0.24693240406805927,18,7,11,20,0.2956324226344795,0.48826417630360236
기준금리/NNG;내려야/VV;한다는/VX,0,-0.24693240406805927,18,7,11,31,0.2956324226344795,0.48826417630360236
경기/NNG;가늠할/VVX;있/VV,0,-0.24693240406805927,18,7,11,45,0.2956324226344795,0.48826417630360236
경제/NNG;침체/NNG;빠지/VV;않/VX,0,-0.24693240406805927,18,7,11,20,0.2956324226344795,0.48826417630360236
유동성/NNG;풀리/VV,0,-0.24693240406805927,18,7,11,14,0.2956324226344795,0.48826417630360236
경기부양/NNG;나서/VV,-1,-0.249134347817888,80,33,47,112,0.45043185727733215,0.7474215617903134
금융시장/NNG;안정되/VVX,-1,-0.249134347817888,80,33,47,103,0.45043185727733215,0.7474215617903134
양적완화/NNG;따른/VV,-1,-0.249134347817888,80,33,47,197,0.45043185727733215,0.7474215617903134
소비자물가지수/NNG;상승했/VVX,-1,-0.25191932587184573,42,17,25,57,0.37510346292499347,0.6261281120234148
실업률/NNG;상승하/VVX,-1,-0.25191932587184573,42,17,25,70,0.37510346292499347,0.6261281120234148
인플레이션/NNG;억제하/VVX,-1,-0.25191932587184573,42,17,25,73,0.37510346292499347,0.6261281120234148
기준금리/NNG;인하할/VVX,-1,-0.2551352538886065,257,105,152,376,0.48250413750956866,0.810946314371161
금리인하/NNG;나설/VV,-1,-0.25556167808582464,144,59,85,206,0.4793176234239545,0.8063244843719211
유동성/NNG;확대되/VVX,-1,-0.2561704458812444,23,9,14,28,0.3106524205732085,0.5232699687368129
채권시장/NNG;강세/NNG;보이/VV,-1,-0.2561704458812444,23,9,14,40,0.3106524205732085,0.5232699687368129
경기부양책/NNG;나올/VV,-1,-0.2561704458812444,23,9,14,41,0.3106524205732085,0.5232699687368129
금리/NNG;내릴/VV;가능성/NNG;있/VV,-1,-0.2561704458812444,23,9,14,8,0.3106524205732085,0.5232699687368129
경기부양/NNG;위한/VV;정부/NNG,-1,-0.2561704458812444,23,9,14,40,0.3106524205732085,0.5232699687368129
수출/NNG;증가/NNG;힘입/VV,-1,-0.2561704458812444,23,9,14,39,0.3106524205732085,0.5232699687368129
금리인하/NNG;기대/NNG;형성되/VVX,-1,-0.2561704458812444,23,9,14,46,0.3106524205732085,0.5232699687368129
경기/NNG;바닥/NNG;다지/VV,-1,-0.2561704458812444,23,9,14,24,0.3106524205732085,0.5232699687368129
물가상승압력/NNG;완화될/VVX,-1,-0.2561704458812444,23,9,14,32,0.3106524205732085,0.5232699687368129
기준금리인상/NNG;예상되/VVX,-1,-0.25686678043760447,35,14,21,55,0.3516414648175884,0.5931946335613062
금리인상/NNG;시작할/VVX,-1,-0.25686678043760447,35,14,21,68,0.3516414648175884,0.5931946335613062
금리/NNG;인하해/VVX;한다는/VX,-1,-0.2652860638206256,28,11,17,23,0.32408203869840374,0.5566513570167815
금리인상/NNG;의미하/VVX,-1,-0.2652860638206256,28,11,17,23,0.32408203869840374,0.5566513570167815
금리인상/NNG;가능성/NNG;따른/VV,-1,-0.2652860638206256,28,11,17,40,0.32408203869840374,0.5566513570167815
소비심리/NNG;위축시/VVX,-1,-0.2652860638206256,28,11,17,28,0.32408203869840374,0.5566513570167815
기준금리인하/NNG;단행했/VVX,-1,-0.2652860638206256,28,11,17,27,0.32408203869840374,0.5566513570167815
기준금리동결/NNG;예상되/VVX,-1,-0.2652860638206256,28,11,17,63,0.32408203869840374,0.5566513570167815
성장/NNG;달성하/VVX,-1,-0.26574592802264463,40,16,24,55,0.3616671559545828,0.6218221494498911
금리인상/NNG;가능성/NNG;반영하/VVX,-1,-0.26574592802264463,40,16,24,88,0.3616671559545828,0.6218221494498911
유동성/NNG;공급해/VVX,-1,-0.2659861069981124,76,31,45,81,0.4341890096373484,0.7468956766711631
추경/NNG;따른/VV,-1,-0.27161148548918157,69,28,41,83,0.42060612680536885,0.7323388022505519
투자심리/NNG;회복되/VVX,-1,-0.27301200710810547,57,23,34,130,0.3985075936850223,0.6959597266967306
기준금리/NNG;인하한/VVX,-1,-0.2731790900205928,45,18,27,73,0.3709630721019628,0.6480890270577824
금리인상/NNG;가능성/NNG;높이/VV,-1,-0.273585585646445,33,13,20,33,0.336306078891252,0.5880570673214635
기준금리인상/NNG;위한/VV,-1,-0.273585585646445,33,13,20,63,0.336306078891252,0.5880570673214635
안전자산선호/NNG;현상/NNG;약화되/VVX,-1,-0.273585585646445,33,13,20,46,0.336306078891252,0.5880570673214635
불안/NNG;완화되/VVX,-1,-0.273585585646445,33,13,20,63,0.336306078891252,0.5880570673214635
정책금리/NNG;인상했/VVX,-1,-0.273585585646445,33,13,20,59,0.336306078891252,0.5880570673214635
기준금리/NNG;내릴/VV,-1,-0.27721578790194834,131,53,78,146,0.4611042624199648,0.812621639722523
경제/NNG;회복될/VVX,-1,-0.2776660512799468,62,25,37,62,0.405123668947918,0.7146602766480048
변동성/NNG;키우/VV,-1,-0.27933987513166625,50,20,30,68,0.3795535673159346,0.6719821829386635
불안/NNG;진정되/VVX,-1,-0.27933987513166625,50,20,30,88,0.3795535673159346,0.6719821829386635
금리/NNG;하락세/NNG;보였/VV,-1,-0.2796596979355268,84,34,50,107,0.4342677829483059,0.7693836700040361
금리/NNG;인하할/VVX;전망/NNG,-1,-0.28085072000180966,38,15,23,36,0.3475113292180915,0.6172690979326486
불안요인/NNG;작용할/VVX,-1,-0.28085072000180966,38,15,23,46,0.3475113292180915,0.6172690979326486
양적완화/NNG;축소/NNG;따른/VV,-1,-0.28085072000180966,38,15,23,123,0.3475113292180915,0.6172690979326486
유동성/NNG;넘치/VV,0,-0.28193655604041357,16,6,10,14,0.27083441534953456,0.482204662222082
금리인상/NNG;단행함/VVX,0,-0.28193655604041357,16,6,10,14,0.27083441534953456,0.482204662222082
리스크/NNG;될/VV;있/VV,0,-0.28193655604041357,16,6,10,28,0.27083441534953456,0.482204662222082
금리인상/NNG;나타날/VV,0,-0.28193655604041357,16,6,10,17,0.27083441534953456,0.482204662222082
수출/NNG;악영향/NNG;미칠/VV,0,-0.28193655604041357,16,6,10,13,0.27083441534953456,0.482204662222082
불확실성/NNG;제거하/VVX,0,-0.28193655604041357,16,6,10,19,0.27083441534953456,0.482204662222082
불안요인/NNG;될/VV,0,-0.28193655604041357,16,6,10,15,0.27083441534953456,0.482204662222082
시장금리/NNG;미치/VV;영향/NNG,0,-0.28193655604041357,16,6,10,15,0.27083441534953456,0.482204662222082
금리/NNG;내릴/VV;없/VA,0,-0.28193655604041357,16,6,10,29,0.27083441534953456,0.482204662222082
유가/NNG;하락/NNG;의한/VV,0,-0.28193655604041357,16,6,10,11,0.27083441534953456,0.482204662222082
불안/NNG;요소/NNG;남/VV,0,-0.28193655604041357,16,6,10,20,0.27083441534953456,0.482204662222082
신용등급/NNG;하향조정했/VVX,0,-0.28193655604041357,16,6,10,28,0.27083441534953456,0.482204662222082
금리/NNG;폭등하/VVX,0,-0.28193655604041357,16,6,10,21,0.27083441534953456,0.482204662222082
경제상황/NNG;볼/VX;기준금리/NNG;유지해/VVX;나가/VX;바람직하/VAX,0,-0.28193655604041357,16,6,10,18,0.27083441534953456,0.482204662222082
금리/NNG;스프레드/NNG;확대될/VVX,0,-0.28193655604041357,16,6,10,17,0.27083441534953456,0.482204662222082
경제성장률/NNG;유지하/VVX,0,-0.28193655604041357,16,6,10,22,0.27083441534953456,0.482204662222082
금리인상/NNG;중단되/VVX,0,-0.28193655604041357,16,6,10,15,0.27083441534953456,0.482204662222082
기준금리/NNG;되/VV,0,-0.28193655604041357,16,6,10,21,0.27083441534953456,0.482204662222082
경제/NNG;지탱하/VVX,0,-0.28193655604041357,16,6,10,21,0.27083441534953456,0.482204662222082
경기침체/NNG;빠져/VV,0,-0.28193655604041357,16,6,10,9,0.27083441534953456,0.482204662222082
성장잠재력/NNG;높이/VV,0,-0.28193655604041357,16,6,10,46,0.27083441534953456,0.482204662222082
성장률/NNG;하향조정되/VVX,0,-0.28193655604041357,16,6,10,30,0.27083441534953456,0.482204662222082
경기회복/NNG;둔화될/VVX,0,-0.28193655604041357,16,6,10,42,0.27083441534953456,0.482204662222082
채권시장/NNG;우호적/VAX;지속될/VVX,0,-0.28193655604041357,16,6,10,24,0.27083441534953456,0.482204662222082
기준금리/NNG;인상할/VVX;관측/NNG,0,-0.28193655604041357,16,6,10,16,0.27083441534953456,0.482204662222082
성장/NNG;견인했/VVX,-1,-0.2827694738636015,21,8,13,17,0.2899334450989109,0.517142546402186
금리/NNG;높일/VV,-1,-0.2827694738636015,21,8,13,26,0.2899334450989109,0.517142546402186
금리상승/NNG;예상된/VVX,-1,-0.2827694738636015,21,8,13,41,0.2899334450989109,0.517142546402186
인플레이션/NNG;억제하/VVX;위해/VV;금리/NNG,-1,-0.2827694738636015,21,8,13,14,0.2899334450989109,0.517142546402186
불안/NNG;증폭되/VVX,-1,-0.2827694738636015,21,8,13,16,0.2899334450989109,0.517142546402186
유동성/NNG;늘리/VV,-1,-0.2827694738636015,21,8,13,19,0.2899334450989109,0.517142546402186
경기/NNG;반등할/VVX,-1,-0.2827694738636015,21,8,13,31,0.2899334450989109,0.517142546402186
동결/NNG;기조/NNG;유지하/VVX,-1,-0.2827694738636015,21,8,13,42,0.2899334450989109,0.517142546402186
경기둔화/NNG;가능성/NNG;시사하/VVX,-1,-0.2827694738636015,21,8,13,8,0.2899334450989109,0.517142546402186
경기둔화/NNG;반영하/VVX,-1,-0.2827694738636015,21,8,13,27,0.2899334450989109,0.517142546402186
인플레이션/NNG;막/VV,-1,-0.2827694738636015,21,8,13,29,0.2899334450989109,0.517142546402186
물가/NNG;인해/VV,-1,-0.2827694738636015,21,8,13,29,0.2899334450989109,0.517142546402186
성장률/NNG;낮췄/VV,-1,-0.2827694738636015,21,8,13,42,0.2899334450989109,0.517142546402186
인플레율/NNG;억제/NNG;목표치/NNG;설정하/VVX;허용한도/NNG;두/VV,-1,-0.2827694738636015,21,8,13,31,0.2899334450989109,0.517142546402186
양적완화/NNG;줄이/VV,-1,-0.2827694738636015,21,8,13,60,0.2899334450989109,0.517142546402186
금리인하/NNG;효과/NNG;지켜보/VV,-1,-0.2827694738636015,21,8,13,30,0.2899334450989109,0.517142546402186
정책금리/NNG;인하되/VVX,-1,-0.2827694738636015,21,8,13,28,0.2899334450989109,0.517142546402186
금리/NNG;동결할/VVX;전망/NNG,-1,-0.2827694738636015,21,8,13,46,0.2899334450989109,0.517142546402186
기준금리/NNG;인하해/VVX;한다는/VX,-1,-0.28704908430842735,43,17,26,38,0.35780763971664753,0.6441666004798574
금리/NNG;스프레드/NNG;확대되/VVX,-1,-0.2871021050445661,26,10,16,51,0.3059092973254064,0.5507967234240128
기준금리/NNG;오르/VV,-1,-0.2871021050445661,26,10,16,50,0.3059092973254064,0.5507967234240128
금리/NNG;내려야/VV,-1,-0.2871021050445661,26,10,16,31,0.3059092973254064,0.5507967234240128
변동성/NNG;축소된/VVX,-1,-0.2871021050445661,26,10,16,55,0.3059092973254064,0.5507967234240128
재정지출/NNG;늘리/VV,-1,-0.2871021050445661,26,10,16,46,0.3059092973254064,0.5507967234240128
경기/NNG;불확실성/NNG;지속되/VVX,-1,-0.2871021050445661,26,10,16,51,0.3059092973254064,0.5507967234240128
물가/NNG;올랐/VV,-1,-0.2923358003234069,31,12,19,42,0.3199418143898373,0.5826678215750699
재정적자/NNG;줄이/VV,-1,-0.2923358003234069,31,12,19,76,0.3199418143898373,0.5826678215750699
과잉유동성/NNG;따른/VV,-1,-0.2923358003234069,31,12,19,32,0.3199418143898373,0.5826678215750699
경제/NNG;위축될/VVX,-1,-0.2923358003234069,31,12,19,26,0.3199418143898373,0.5826678215750699
불안/NNG;따른/VV,-1,-0.29480041110968436,168,67,101,241,0.4517418821850522,0.8271375331418594
소비/NNG;위축시/VVX,-1,-0.296464653662724,53,21,32,53,0.3759630343336033,0.6908963669548948
시장금리/NNG;하락하/VVX,-1,-0.2965586400778143,120,48,72,161,0.44415941659689834,0.8163867331214825
침체/NNG;빠졌/VV,-1,-0.2974713270467705,36,14,22,34,0.3325445546658476,0.6124552771676757
경기/NNG;부진/NNG;지속되/VVX,-1,-0.2974713270467705,36,14,22,56,0.3325445546658476,0.6124552771676757
금리인하/NNG;단행할/VVX;있/VV,-1,-0.2974713270467705,36,14,22,42,0.3325445546658476,0.6124552771676757
금리/NNG;오를/VV;있/VV,-1,-0.2974713270467705,36,14,22,55,0.3325445546658476,0.6124552771676757
경제/NNG;침체/NNG;빠질/VV,-1,-0.2974713270467705,36,14,22,52,0.3325445546658476,0.6124552771676757
경기/NNG;살리/VV,-1,-0.2988000063003726,95,38,57,126,0.43052573870173183,0.795220268479725
금리/NNG;올릴/VV;전망/NNG,-1,-0.30210000228068856,41,16,25,52,0.34398410050445205,0.6399856693439914
금리/NNG;낮출/VV,-1,-0.3024871630657746,63,25,38,97,0.3912353546533955,0.7285162254014315
성장/NNG;위해/VV,-1,-0.3067365223180152,78,31,47,99,0.409542704395595,0.7697672217849687
기준금리/NNG;올렸/VV,-1,-0.3092019936403878,121,48,73,134,0.4352262620938735,0.8224996105274828
금리인하/NNG;단행하/VVX,-1,-0.3115766639887759,175,69,106,191,0.439374753176684,0.8347047846357635
금리인하/NNG;있/VV,-1,-0.3119175932290831,56,22,34,75,0.3726913407556656,0.7085562702769994
금리/NNG;내릴/VV,-1,-0.3121335249842936,221,87,134,247,0.4394804014534052,0.8359337430834284
내수/NNG;부양/NNG;위한/VV,-1,-0.3126862302461151,24,9,15,36,0.2860169020831554,0.544696762883295
금리하락/NNG;요인이/VVX,-1,-0.3126862302461151,24,9,15,32,0.2860169020831554,0.544696762883295
성장/NNG;이루/VV,-1,-0.3126862302461151,24,9,15,42,0.2860169020831554,0.544696762883295
시장금리/NNG;급락하/VVX,-1,-0.3126862302461151,24,9,15,27,0.2860169020831554,0.544696762883295
금리인하/NNG;될/VV,-1,-0.3126862302461151,24,9,15,23,0.2860169020831554,0.544696762883295
수출/NNG;늘어난/VV,-1,-0.3126862302461151,24,9,15,25,0.2860169020831554,0.544696762883295
금리인하/NNG;이어질/VV,-1,-0.3126862302461151,24,9,15,18,0.2860169020831554,0.544696762883295
시장금리/NNG;하/VV,-1,-0.3126862302461151,24,9,15,39,0.2860169020831554,0.544696762883295
물가/NNG;하락했/VVX,-1,-0.31361653989882865,29,11,18,36,0.30236118221926717,0.5770094762845149
금리인상/NNG;고려하/VVX,-1,-0.31361653989882865,29,11,18,41,0.30236118221926717,0.5770094762845149
하방압력/NNG;받/VV,-1,-0.31361653989882865,29,11,18,41,0.30236118221926717,0.5770094762845149
신용경색/NNG;해소하/VVX,-1,-0.31361653989882865,29,11,18,15,0.30236118221926717,0.5770094762845149
성장/NNG;미치/VV,-1,-0.31557282648190743,19,7,12,38,0.26651852469196885,0.5108174614376934
금리인상/NNG;가능성/NNG;배제하/VVX;않/VX,-1,-0.31557282648190743,19,7,12,35,0.26651852469196885,0.5108174614376934
경제/NNG;활성화/NNG;위해/VV,-1,-0.31557282648190743,19,7,12,40,0.26651852469196885,0.5108174614376934
기준금리/NNG;인하할/VVX;가능성/NNG;있/VV,-1,-0.31557282648190743,19,7,12,23,0.26651852469196885,0.5108174614376934
추경/NNG;집행/NNG;따른/VV,-1,-0.31557282648190743,19,7,12,16,0.26651852469196885,0.5108174614376934
투자심리/NNG;회복시/VVX,-1,-0.31557282648190743,19,7,12,32,0.26651852469196885,0.5108174614376934
금리하락/NNG;기대하/VVX,-1,-0.31557282648190743,19,7,12,43,0.26651852469196885,0.5108174614376934
듀레이션/NNG;축소하/VVX,-1,-0.31557282648190743,19,7,12,37,0.26651852469196885,0.5108174614376934
소비/NNG;미치/VV,-1,-0.31557282648190743,19,7,12,16,0.26651852469196885,0.5108174614376934
통화완화/NNG;기조/NNG;이/VV,-1,-0.31557282648190743,19,7,12,24,0.26651852469196885,0.5108174614376934
금리상승/NNG;나타나/VV,-1,-0.31557282648190743,19,7,12,39,0.26651852469196885,0.5108174614376934
물가목표/NNG;달성하/VVX,-1,-0.3159138327643852,34,13,21,47,0.31665239736882145,0.6073644001923472
경기회복/NNG;지원하/VVX,-1,-0.3159138327643852,34,13,21,53,0.31665239736882145,0.6073644001923472
기준금리/NNG;내려가/VV,-1,-0.3159138327643852,34,13,21,18,0.31665239736882145,0.6073644001923472
수출/NNG;개선될/VVX,-1,-0.3159138327643852,34,13,21,31,0.31665239736882145,0.6073644001923472
금리/NNG;내릴/VV;가능성/NNG,-1,-0.3185318110638272,39,15,24,62,0.3294181284940067,0.6355305916541016
채권시장/NNG;부담/NNG;될/VV,-1,-0.3185318110638272,39,15,24,28,0.3294181284940067,0.6355305916541016
불확실성/NNG;해소됐/VVX,-1,-0.3258827039402086,59,23,36,80,0.36969693082835253,0.7250074012638859
경기부양책/NNG;내놓/VV,-1,-0.33305256972958686,110,43,67,146,0.4143440070353659,0.8257085988866538
소비심리/NNG;위축되/VVX,-1,-0.3365781674029016,32,12,20,34,0.29969075770419146,0.6019765879690671
동결/NNG;예상하/VVX,-1,-0.33659675733589345,37,14,23,42,0.31401890706475233,0.6307833400175485
금리하락/NNG;요인/NNG;작용하/VVX,-1,-0.33659675733589345,37,14,23,62,0.31401890706475233,0.6307833400175485
정책금리/NNG;인하/VV,-1,-0.3371794049865836,42,16,26,28,0.32679916241454293,0.6573169371158829
기준금리/NNG;하회하/VVX,-1,-0.33784337657716734,47,18,29,108,0.3383205942604303,0.6815089840533425
소비/NNG;줄어들/VV,-1,-0.33811062393440594,27,10,17,44,0.2833192403436885,0.571058549743791
하방압력/NNG;작용할/VVX,-1,-0.33811062393440594,27,10,17,38,0.2833192403436885,0.571058549743791
투자심리/NNG;호전시/VVX,-1,-0.33811062393440594,27,10,17,42,0.2833192403436885,0.571058549743791
변동성/NNG;보였/VV,-1,-0.33851972385758766,62,24,38,48,0.3669443333265847,0.7402953737908047
금리/NNG;하락세/NNG;이끌/VV,-1,-0.3433301721545521,22,8,14,49,0.2639485482208008,0.5383196960282045
경제/NNG;성장했/VVX,-1,-0.3433301721545521,22,8,14,28,0.2639485482208008,0.5383196960282045
금리/NNG;인하함/VVX,-1,-0.3433301721545521,22,8,14,18,0.2639485482208008,0.5383196960282045
경기/NNG;영향/NNG;주/VV,-1,-0.3433301721545521,22,8,14,30,0.2639485482208008,0.5383196960282045
gdp/NNG;수준이/VVX,-1,-0.3433301721545521,22,8,14,26,0.2639485482208008,0.5383196960282045
기준금리/NNG;내려갈/VV,-1,-0.3433301721545521,22,8,14,33,0.2639485482208008,0.5383196960282045
불확실성/NNG;줄/VV,-1,-0.3433301721545521,22,8,14,23,0.2639485482208008,0.5383196960282045
수출/NNG;부진/NNG;심화되/VVX,-1,-0.3433301721545521,22,8,14,6,0.2639485482208008,0.5383196960282045
금리/NNG;올려야/VV,-1,-0.3433301721545521,22,8,14,32,0.2639485482208008,0.5383196960282045
경제/NNG;살리/VV,-1,-0.3473676985670695,132,51,81,183,0.4096225158496301,0.8430954407240261
경제/NNG;부양하/VVX,-1,-0.352065977104015,55,21,34,41,0.34639166026938034,0.7206065105608649
리스크/NNG;확대되/VVX,-1,-0.35290526112321785,50,19,31,86,0.3360260143011209,0.7003803715979521
금리/NNG;낮춘/VV,-1,-0.3566166903459751,35,13,22,22,0.2976750390785428,0.6257227709690236
소비/NNG;감소할/VVX,-1,-0.3574258632638685,17,6,11,10,0.23943889057733694,0.5042404574262915
경제/NNG;둔화할/VVX,-1,-0.3574258632638685,17,6,11,17,0.23943889057733694,0.5042404574262915
소비자물가/NNG;상승/NNG;영향/NNG;미칠/VV;품목/NNG,-1,-0.3574258632638685,17,6,11,14,0.23943889057733694,0.5042404574262915
성장률/NNG;끌어올릴/VV,-1,-0.3574258632638685,17,6,11,31,0.23943889057733694,0.5042404574262915
소비/NNG;위축/NNG;따른/VV,-1,-0.3574258632638685,17,6,11,10,0.23943889057733694,0.5042404574262915
자산매입/NNG;축소하/VVX,-1,-0.3574258632638685,17,6,11,45,0.23943889057733694,0.5042404574262915
자산매입/NNG;유지했/VVX,-1,-0.3574258632638685,17,6,11,33,0.23943889057733694,0.5042404574262915
금리차/NNG;확대/NNG;따른/VV,-1,-0.3574258632638685,17,6,11,14,0.23943889057733694,0.5042404574262915
불안심리/NNG;커지/VV,-1,-0.3574258632638685,17,6,11,13,0.23943889057733694,0.5042404574262915
유가/NNG;하락/NNG;부추겼/VV,-1,-0.3574258632638685,17,6,11,31,0.23943889057733694,0.5042404574262915
기준금리/NNG;유지하/VVX;좋/VA,-1,-0.3574258632638685,17,6,11,32,0.23943889057733694,0.5042404574262915
성장세/NNG;회복/NNG;이어지/VV,-1,-0.3574258632638685,17,6,11,4,0.23943889057733694,0.5042404574262915
금리인하/NNG;전망하/VVX,-1,-0.3574258632638685,17,6,11,24,0.23943889057733694,0.5042404574262915
금리인상/NNG;우려/NNG;완화시/VVX,-1,-0.3574258632638685,17,6,11,18,0.23943889057733694,0.5042404574262915
금리/NNG;큰/VA;오르/VV,-1,-0.3574258632638685,17,6,11,21,0.23943889057733694,0.5042404574262915
금리인상/NNG;재개될/VVX,-1,-0.3574258632638685,17,6,11,23,0.23943889057733694,0.5042404574262915
금리인하/NNG;기대감/NNG;유지될/VVX,-1,-0.3574258632638685,17,6,11,55,0.23943889057733694,0.5042404574262915
금리인하/NNG;대응하/VVX,-1,-0.3574258632638685,17,6,11,23,0.23943889057733694,0.5042404574262915
동결/NNG;기조/NNG;지속될/VVX,-1,-0.3574258632638685,17,6,11,19,0.23943889057733694,0.5042404574262915
금리인하/NNG;기대할/VVX,-1,-0.3574258632638685,17,6,11,20,0.23943889057733694,0.5042404574262915
기준금리인하/NNG;따른/VV,-1,-0.35819033828514446,73,28,45,121,0.3697824196490919,0.780097375511308
흑자/NNG;기록할/VVX,-1,-0.35999443264031905,30,11,19,34,0.2814775932669477,0.5962669879457154
경제/NNG;회복/NNG;위해/VV,-1,-0.35999443264031905,30,11,19,44,0.2814775932669477,0.5962669879457154
금리인상/NNG;단행할/VVX;가능성/NNG,-1,-0.3644078304476336,58,22,36,76,0.34425186701787674,0.7366719631159261
금리인하/NNG;가능성/NNG;열/VV,-1,-0.3644078304476336,58,22,36,55,0.34425186701787674,0.7366719631159261
변동성/NNG;높일/VV,-1,-0.3667697579983592,25,9,16,29,0.262495325411197,0.5647825963144364
변동성/NNG;확대되/VVX;모습/NNG,-1,-0.3667697579983592,25,9,16,39,0.262495325411197,0.5647825963144364
기준금리인상/NNG;가능성/NNG;열/VV,-1,-0.3667697579983592,25,9,16,33,0.262495325411197,0.5647825963144364
금리인하/NNG;단행되/VVX,-1,-0.3679266434824354,89,34,55,120,0.3784336380392768,0.8164094946084385
경제지표/NNG;부진하/VVX,-1,-0.3685053723398334,48,18,30,88,0.3227083394876653,0.6971215455975227
경기부양/NNG;위한/VV,-1,-0.37024127488979874,259,98,161,353,0.3960968948883987,0.8590949933627894
금리/NNG;인하하/VVX,-1,-0.37089255878449545,431,163,268,456,0.3956249641242692,0.8593646036013289
성장률/NNG;떨어질/VV,-1,-0.37096790879534625,43,16,27,58,0.3101744720714054,0.6738690585557018
금리인하/NNG;하/VV,-1,-0.3726422687729287,66,25,41,52,0.35149300278059864,0.7666009151979776
금리인하/NNG;가능성/NNG;열/VV;두/VX,-1,-0.3742074701606384,38,14,24,64,0.2961540253140826,0.6482550878627761
금융시장/NNG;안정시/VVX,-1,-0.3755280816901131,61,23,38,69,0.3423149507113324,0.7515973562201487
시장금리/NNG;오를/VV,-1,-0.37900685213550334,33,12,21,33,0.28024977105176685,0.6203236414086121
외환위기/NNG;겪/VV,-1,-0.37900685213550334,33,12,21,61,0.28024977105176685,0.6203236414086121
경기침체/NNG;지속되/VVX,-1,-0.37900685213550334,33,12,21,41,0.28024977105176685,0.6203236414086121
경기침체/NNG;벗어나/VV,-1,-0.37900685213550334,33,12,21,36,0.28024977105176685,0.6203236414086121
내수/NNG;회복세/NNG;약화되/VVX,-1,-0.37900685213550334,33,12,21,3,0.28024977105176685,0.6203236414086121
금리인하/NNG;나설/VV;있/VV,-1,-0.37900685213550334,33,12,21,43,0.28024977105176685,0.6203236414086121
침체/NNG;빠진/VV,-1,-0.37900685213550334,33,12,21,45,0.28024977105176685,0.6203236414086121
경제전망/NNG;내놓/VV,-1,-0.38096366975492857,20,7,13,29,0.2390798488872366,0.531614993035514
금융시장/NNG;변동성/NNG;확대될/VVX,-1,-0.38096366975492857,20,7,13,33,0.2390798488872366,0.531614993035514
금리/NNG;올릴/VV;예상하/VVX,-1,-0.38096366975492857,20,7,13,14,0.2390798488872366,0.531614993035514
성장세/NNG;지속할/VVX,-1,-0.38190237667356874,69,26,43,71,0.3495784326038205,0.7790233789376553
물가안정/NNG;유지하/VVX,-1,-0.38529490178090187,46,17,29,29,0.30877019380584175,0.6935647968189476
금리/NNG;상승세/NNG;지속되/VVX,-1,-0.3861234033592146,77,29,48,118,0.3558880776314235,0.8009551876206552
경기/NNG;침체되/VVX,-1,-0.38687492504163035,28,10,18,52,0.2617832961324475,0.5902038348790856
금리/NNG;상승세/NNG;이어질/VV,-1,-0.38687492504163035,28,10,18,33,0.2617832961324475,0.5902038348790856
통화완화/NNG;나서/VV,-1,-0.38687492504163035,28,10,18,28,0.2617832961324475,0.5902038348790856
리스크/NNG;완화하/VVX,-1,-0.38687492504163035,28,10,18,24,0.2617832961324475,0.5902038348790856
경제지표/NNG;부진/NNG;따른/VV,-1,-0.38687492504163035,28,10,18,44,0.2617832961324475,0.5902038348790856
침체/NNG;인해/VV,-1,-0.38687492504163035,28,10,18,16,0.2617832961324475,0.5902038348790856
수출/NNG;급감하/VVX,-1,-0.38971981919546994,41,15,26,18,0.2950107033478883,0.6695757368316194
금리상승/NNG;요인/NNG;작용하/VVX,-1,-0.39563897840744977,36,13,23,70,0.27946905686586965,0.643217138507899
실물경제/NNG;전이되/VVX,-1,-0.39563897840744977,36,13,23,25,0.27946905686586965,0.643217138507899
금리인하/NNG;나설/VV;가능성/NNG,-1,-0.39563897840744977,36,13,23,59,0.27946905686586965,0.643217138507899
동결/NNG;예상되/VVX,-1,-0.4009429242599787,23,8,15,33,0.23947254466180887,0.558135909498587
재정위기/NNG;부각되/VVX,-1,-0.4009429242599787,23,8,15,37,0.23947254466180887,0.558135909498587
고용지표/NNG;개선되/VVX,-1,-0.4009429242599787,23,8,15,55,0.23947254466180887,0.558135909498587
콜금리/NNG;동결했/VVX,-1,-0.4009429242599787,23,8,15,27,0.23947254466180887,0.558135909498587
금리차/NNG;확대되/VVX,-1,-0.4009429242599787,23,8,15,40,0.23947254466180887,0.558135909498587
기준금리인하/NNG;단행할/VVX,-1,-0.4009429242599787,23,8,15,38,0.23947254466180887,0.558135909498587
수입/NNG;증가하/VVX,-1,-0.4009429242599787,23,8,15,40,0.23947254466180887,0.558135909498587
내수/NNG;부양하/VVX,-1,-0.4009429242599787,23,8,15,26,0.23947254466180887,0.558135909498587
금리/NNG;인상될/VVX;전망/NNG,-1,-0.4009429242599787,23,8,15,17,0.23947254466180887,0.558135909498587
경기/NNG;미치/VV;영향/NNG,-1,-0.40279730040340855,70,26,44,56,0.33745052758524996,0.7899686919658195
채권시장/NNG;미치/VV;영향/NNG,-1,-0.40344750532005136,44,16,28,119,0.2941580415095447,0.6896884368046903
불안/NNG;확대되/VVX,-1,-0.4043083894856667,31,11,20,36,0.2615759160127468,0.6145552845478239
양적완화/NNG;종료하/VVX,-1,-0.41026402150547203,39,14,25,40,0.27901764551163966,0.6649348106378836
기준금리/NNG;인하할/VVX;기대/NNG,-1,-0.41026402150547203,39,14,25,41,0.27901764551163966,0.6649348106378836
경기부양/NNG;위한/VV;금리인하/NNG,-1,-0.41026402150547203,39,14,25,68,0.27901764551163966,0.6649348106378836
금리/NNG;인하할/VVX;있/VV,-1,-0.41107566161862785,81,30,51,74,0.34313442284768503,0.8193269876445044
변동성/NNG;키웠/VV,0,-0.4130277771973453,15,5,10,17,0.20729886431055808,0.49730908154831216
금리인하/NNG;하/VV;않/VX,0,-0.4130277771973453,15,5,10,17,0.20729886431055808,0.49730908154831216
하방리스크/NNG;확대되/VVX,0,-0.4130277771973453,15,5,10,14,0.20729886431055808,0.49730908154831216
불안/NNG;막/VV,0,-0.4130277771973453,15,5,10,22,0.20729886431055808,0.49730908154831216
경기/NNG;호전될/VVX,0,-0.4130277771973453,15,5,10,25,0.20729886431055808,0.49730908154831216
재정지출/NNG;따른/VV,0,-0.4130277771973453,15,5,10,11,0.20729886431055808,0.49730908154831216
자본확충/NNG;필요하/VVX,0,-0.4130277771973453,15,5,10,13,0.20729886431055808,0.49730908154831216
경기부양/NNG;위한/VV;통화정책/NNG,0,-0.4130277771973453,15,5,10,25,0.20729886431055808,0.49730908154831216
gdp갭/NNG;플러스/NNG;전환되/VVX,0,-0.4130277771973453,15,5,10,16,0.20729886431055808,0.49730908154831216
금융시장/NNG;충격/NNG;받/VV,0,-0.4130277771973453,15,5,10,12,0.20729886431055808,0.49730908154831216
경기부양/NNG;나선/VV,0,-0.4130277771973453,15,5,10,23,0.20729886431055808,0.49730908154831216
기준금리/NNG;밑도/VV,0,-0.4130277771973453,15,5,10,31,0.20729886431055808,0.49730908154831216
불안/NNG;커질/VV,0,-0.4130277771973453,15,5,10,22,0.20729886431055808,0.49730908154831216
인플레이션/NNG;억제할/VVX,0,-0.4130277771973453,15,5,10,15,0.20729886431055808,0.49730908154831216
금리인하/NNG;예상된/VVX,0,-0.4130277771973453,15,5,10,21,0.20729886431055808,0.49730908154831216
성장률/NNG;하향조정할/VVX,0,-0.4130277771973453,15,5,10,13,0.20729886431055808,0.49730908154831216
경제지표/NNG;개선된/VVX,0,-0.4130277771973453,15,5,10,47,0.20729886431055808,0.49730908154831216
금리/NNG;상승세/NNG;보일/VV,0,-0.4130277771973453,15,5,10,38,0.20729886431055808,0.49730908154831216
경제성장/NNG;힘입/VV,0,-0.4130277771973453,15,5,10,15,0.20729886431055808,0.49730908154831216
실물경제/NNG;미치/VV;영향/NNG;제한적/VAX,0,-0.4130277771973453,15,5,10,18,0.20729886431055808,0.49730908154831216
실물경제/NNG;확산되/VVX,0,-0.4130277771973453,15,5,10,12,0.20729886431055808,0.49730908154831216
기준금리/NNG;인상하/VVX;금리인상/NNG,0,-0.4130277771973453,15,5,10,16,0.20729886431055808,0.49730908154831216
불확실성/NNG;완화되/VVX,-1,-0.4154188972581575,155,57,98,288,0.36183560726191477,0.8730530117417571
불안/NNG;이어지/VV,-1,-0.4156288197242294,47,17,30,72,0.2935303446297065,0.708601502520735
시장금리/NNG;상승/NNG;따른/VV,-1,-0.41818772444594865,26,9,17,24,0.24032127214850407,0.5837457318218585
성장세/NNG;확대될/VVX,-1,-0.41818772444594865,26,9,17,21,0.24032127214850407,0.5837457318218585
금리/NNG;상승세/NNG;진정되/VVX,-1,-0.41818772444594865,26,9,17,47,0.24032127214850407,0.5837457318218585
금리인상/NNG;기조/NNG;유지할/VVX,-1,-0.41818772444594865,26,9,17,50,0.24032127214850407,0.5837457318218585
금리/NNG;하락세/NNG;제한되/VVX,-1,-0.41818772444594865,26,9,17,42,0.24032127214850407,0.5837457318218585
금리인상/NNG;시기/NNG;지연될/VVX,-1,-0.41818772444594865,26,9,17,33,0.24032127214850407,0.5837457318218585
실물경제/NNG;파급되/VVX,-1,-0.41954174309947256,34,12,22,24,0.2617176938448808,0.6378033120149383
경제성장/NNG;둔화되/VVX,-1,-0.42317386924020983,42,15,27,92,0.2788104409596304,0.6854682644859503
성장률/NNG;유지하/VVX,-1,-0.42317386924020983,42,15,27,74,0.2788104409596304,0.6854682644859503
기준금리/NNG;인하할/VVX;가능성/NNG;높/VA,-1,-0.42317386924020983,42,15,27,34,0.2788104409596304,0.6854682644859503
시장금리/NNG;큰/VA;하락하/VVX,-1,-0.4264602421236483,50,18,32,44,0.29307738422771656,0.726329129052031
기준금리/NNG;올릴/VV;가능성/NNG,-1,-0.4264602421236483,50,18,32,76,0.29307738422771656,0.726329129052031
기준금리/NNG;인하했/VVX,-1,-0.4275328821245611,289,105,184,341,0.35396297825222944,0.8795186444049548
금리인하/NNG;통한/VV,-1,-0.42843787116064314,82,30,52,77,0.3324780736198584,0.8279606504464285
금리상승/NNG;요인/NNG;될/VV,-1,-0.42852566558595484,18,6,12,12,0.21057532410731983,0.5245021755288304
동결/NNG;기조/NNG;유지될/VVX,-1,-0.42852566558595484,18,6,12,36,0.21057532410731983,0.5245021755288304
기준금리동결/NNG;따른/VV,-1,-0.42852566558595484,18,6,12,39,0.21057532410731983,0.5245021755288304
금리인상/NNG;기조/NNG;유지될/VVX,-1,-0.42852566558595484,18,6,12,27,0.21057532410731983,0.5245021755288304
금리/NNG;인상할/VVX;없/VA,-1,-0.42852566558595484,18,6,12,24,0.21057532410731983,0.5245021755288304
거시경제/NNG;열/VV,-1,-0.42852566558595484,18,6,12,44,0.21057532410731983,0.5245021755288304
장단기/NNG;금리/NNG;역전되/VVX,-1,-0.42852566558595484,18,6,12,39,0.21057532410731983,0.5245021755288304
경제전망/NNG;악화되/VVX,-1,-0.42852566558595484,18,6,12,10,0.21057532410731983,0.5245021755288304
양적완화/NNG;단행하/VVX,-1,-0.42852566558595484,18,6,12,22,0.21057532410731983,0.5245021755288304
경제성장/NNG;유지하/VVX,-1,-0.42852566558595484,18,6,12,13,0.21057532410731983,0.5245021755288304
저성장/NNG;따른/VV,-1,-0.42852566558595484,18,6,12,19,0.21057532410731983,0.5245021755288304
기준금리/NNG;인상한/VAX;있/VV,-1,-0.42852566558595484,18,6,12,30,0.21057532410731983,0.5245021755288304
경기/NNG;불확실성/NNG;해소되/VVX,-1,-0.42852566558595484,18,6,12,23,0.21057532410731983,0.5245021755288304
재정위기/NNG;확산되/VVX,-1,-0.42852566558595484,18,6,12,45,0.21057532410731983,0.5245021755288304
기준금리인상/NNG;지지하/VVX,-1,-0.42852566558595484,18,6,12,18,0.21057532410731983,0.5245021755288304
성장률/NNG;상향조정하/VVX,-1,-0.42852566558595484,18,6,12,40,0.21057532410731983,0.5245021755288304
개인소비지출/NNG;가격지수/NNG;상승해/VVX,-1,-0.42852566558595484,18,6,12,20,0.21057532410731983,0.5245021755288304
성장/NNG;견인하/VVX,-1,-0.4329257049363,37,13,24,57,0.26210286114497877,0.6599179618357972
불안요인/NNG;잠재해/VVX,-1,-0.4329257049363,37,13,24,32,0.26210286114497877,0.6599179618357972
듀레이션/NNG;유지하/VVX,-1,-0.4329257049363,37,13,24,60,0.26210286114497877,0.6599179618357972
기준금리/NNG;인하됐/VVX,-1,-0.43323194445311175,29,10,19,26,0.24145166363875523,0.6083798326130252
물가상승압력/NNG;작용하/VVX,-1,-0.43323194445311175,29,10,19,30,0.24145166363875523,0.6083798326130252
변동성/NNG;크/VA;확대된/VVX,-1,-0.43323194445311175,29,10,19,16,0.24145166363875523,0.6083798326130252
불안/NNG;해소되/VVX,-1,-0.43323194445311175,29,10,19,46,0.24145166363875523,0.6083798326130252
양적완화/NNG;지속하/VVX,-1,-0.43323194445311175,29,10,19,20,0.24145166363875523,0.6083798326130252
수출/NNG;증가하/VVX,-1,-0.4344827747399512,132,48,84,167,0.3464998943631901,0.8757538802066078
금리/NNG;낮추/VV,-1,-0.44016197949040936,211,76,135,317,0.34469484285893603,0.8834758834794948
투자심리/NNG;부담/NNG;줬/VV,-1,-0.44256355094866995,21,7,14,14,0.21372281878152208,0.5510531838381434
재정/NNG;확대/NNG;따른/VV,-1,-0.44256355094866995,21,7,14,16,0.21372281878152208,0.5510531838381434
투자심리/NNG;위축될/VVX,-1,-0.44256355094866995,21,7,14,48,0.21372281878152208,0.5510531838381434
투자심리/NNG;긍정적/VAX;영향/NNG;미쳤/VV,-1,-0.44256355094866995,21,7,14,29,0.21372281878152208,0.5510531838381434
금리인하/NNG;가능성/NNG;시사하/VVX,-1,-0.44256355094866995,21,7,14,34,0.21372281878152208,0.5510531838381434
금리인상/NNG;지지할/VVX,-1,-0.44256355094866995,21,7,14,24,0.21372281878152208,0.5510531838381434
불안/NNG;해소되/VVX;않/VX,-1,-0.44256355094866995,21,7,14,18,0.21372281878152208,0.5510531838381434
금리인하/NNG;기대/NNG;지속될/VVX,-1,-0.44256355094866995,21,7,14,45,0.21372281878152208,0.5510531838381434
경기회복세/NNG;지원하/VVX,-1,-0.44256355094866995,21,7,14,29,0.21372281878152208,0.5510531838381434
경제/NNG;악화되/VVX,-1,-0.44256355094866995,21,7,14,21,0.21372281878152208,0.5510531838381434
기준금리/NNG;동결할/VVX;예상되/VVX,-1,-0.44256355094866995,21,7,14,35,0.21372281878152208,0.5510531838381434
금리인하/NNG;위한/VV,-1,-0.44256355094866995,21,7,14,41,0.21372281878152208,0.5510531838381434
금리상승/NNG;압력/NNG;가중시/VVX,-1,-0.44256355094866995,21,7,14,32,0.21372281878152208,0.5510531838381434
불확실성/NNG;완화됨/VVX,-1,-0.44256355094866995,21,7,14,15,0.21372281878152208,0.5510531838381434
금리/NNG;하/VV;가능성/NNG,-1,-0.44256355094866995,21,7,14,35,0.21372281878152208,0.5510531838381434
유동성/NNG;공급되/VVX,-1,-0.4447306143289761,40,14,26,61,0.26265746835754283,0.6808770847434017
성장률/NNG;하향조정했/VVX,-1,-0.4447306143289761,40,14,26,76,0.26265746835754283,0.6808770847434017
기준금리/NNG;동결될/VVX;가능성/NNG,-1,-0.44644775051216556,32,11,21,53,0.24275498901866588,0.631978581536402
금리/NNG;내린/VV,-1,-0.4465722573663422,226,81,145,252,0.3401047788430514,0.8856896853034398
단기금리/NNG;하락하/VVX,-1,-0.45517099879445755,43,15,28,38,0.26332866176396236,0.7006679567072709
정책금리/NNG;낮추/VV,-1,-0.4552564472095856,24,8,16,18,0.21674361420479638,0.5768378624677322
변동성/NNG;완화하/VVX,-1,-0.4552564472095856,24,8,16,40,0.21674361420479638,0.5768378624677322
기준금리/NNG;인하할/VVX;가능성/NNG;크/VA,-1,-0.4552564472095856,24,8,16,26,0.21674361420479638,0.5768378624677322
금리상승/NNG;압력/NNG;지속될/VVX,-1,-0.4552564472095856,24,8,16,44,0.21674361420479638,0.5768378624677322
추경/NNG;편성해/VVX,-1,-0.4552564472095856,24,8,16,21,0.21674361420479638,0.5768378624677322
금리상승/NNG;제한됨/VVX,-1,-0.4552564472095856,24,8,16,28,0.21674361420479638,0.5768378624677322
금융시장/NNG;불안/NNG;지속되/VVX,-1,-0.4552564472095856,24,8,16,23,0.21674361420479638,0.5768378624677322
양적완화/NNG;실시하/VVX,-1,-0.4552564472095856,24,8,16,46,0.21674361420479638,0.5768378624677322
성장/NNG;기대하/VVX,-1,-0.4552564472095856,24,8,16,39,0.21674361420479638,0.5768378624677322
금리상승/NNG;요인/NNG;작용했/VVX,-1,-0.4552564472095856,24,8,16,41,0.21674361420479638,0.5768378624677322
금리/NNG;하락세/NNG;지속되/VVX,-1,-0.45639670639625163,70,25,45,117,0.3034695781535029,0.8099698014726809
금리/NNG;내려가/VV,-1,-0.45639670639625163,70,25,45,89,0.3034695781535029,0.8099698014726809
성장세/NNG;약화되/VVX,-1,-0.4581099622399947,35,12,23,44,0.24416053487212233,0.6544924781271713
유동성/NNG;의한/VV,-1,-0.4581099622399947,35,12,23,47,0.24416053487212233,0.6544924781271713
변동성/NNG;커질/VV;있/VV,-1,-0.46530032654614395,87,31,56,125,0.31158262927471214,0.8505788337080158
수출/NNG;감소했/VVX,-1,-0.4653308197849635,65,23,42,62,0.2923335448451302,0.7980933324911649
금리인하/NNG;따른/VV,-1,-0.46582711733643567,198,70,128,221,0.32615823155285595,0.8915628670050467
성장/NNG;모멘텀/NNG;약화되/VVX,-1,-0.46671325799042884,27,9,18,33,0.21964030466974516,0.601749851095233
투자심리/NNG;약화시/VVX,-1,-0.46671325799042884,27,9,18,23,0.21964030466974516,0.601749851095233
신용경색/NNG;따른/VV,-1,-0.4707810097864841,68,24,44,73,0.29235050688755704,0.8093217110999688
금리/NNG;내리/VV,-1,-0.473145614452944,484,170,314,481,0.32108238963125635,0.8942678553223885
금리/NNG;상승압력/NNG;작용할/VVX,-1,-0.477036273089828,30,10,20,27,0.22241575686656911,0.6257008427681761
기준금리/NNG;인하될/VVX;가능성/NNG;높/VA,-1,-0.477036273089828,30,10,20,52,0.22241575686656911,0.6257008427681761
불안심리/NNG;확산되/VVX,-1,-0.47758017702448596,41,14,27,59,0.24710328247324181,0.6961286046027528
기준금리인하/NNG;단행되/VVX,-1,-0.48632094069831144,33,11,22,77,0.22507305843158937,0.6486202271838702
경제/NNG;회복하/VVX,-1,-0.48632094069831144,33,11,22,78,0.22507305843158937,0.6486202271838702
수출/NNG;감소하/VVX,-1,-0.4865716163142403,117,41,76,149,0.30781468815421864,0.8876475750895579
소비자물가상승률/NNG;하락하/VVX,-1,-0.4904949909526881,16,5,11,19,0.17740066298348878,0.5168532445644014
금리/NNG;인하될/VVX;있/VV,-1,-0.4904949909526881,16,5,11,17,0.17740066298348878,0.5168532445644014
인플레이션기대심리/NNG;자극하/VVX,-1,-0.4904949909526881,16,5,11,15,0.17740066298348878,0.5168532445644014
기준금리인하/NNG;예상되/VVX,-1,-0.4904949909526881,16,5,11,23,0.17740066298348878,0.5168532445644014
물가/NNG;하락해/VVX,-1,-0.4904949909526881,16,5,11,28,0.17740066298348878,0.5168532445644014
경제지표/NNG;개선될/VVX,-1,-0.4904949909526881,16,5,11,35,0.17740066298348878,0.5168532445644014
금리동결/NNG;주장하/VVX,-1,-0.4904949909526881,16,5,11,16,0.17740066298348878,0.5168532445644014
불확실성/NNG;증대된/VVX,-1,-0.4904949909526881,16,5,11,25,0.17740066298348878,0.5168532445644014
경제성장률/NNG;마이너스/NNG;기록할/VVX,-1,-0.4904949909526881,16,5,11,12,0.17740066298348878,0.5168532445644014
주택가격/NNG;하락했/VVX,-1,-0.4904949909526881,16,5,11,22,0.17740066298348878,0.5168532445644014
가계부채/NNG;늘/VV,-1,-0.4904949909526881,16,5,11,28,0.17740066298348878,0.5168532445644014
금리인하/NNG;가능성/NNG;높이/VV,-1,-0.4904949909526881,16,5,11,30,0.17740066298348878,0.5168532445644014
신용등급/NNG;하향조정되/VVX,-1,-0.4904949909526881,16,5,11,22,0.17740066298348878,0.5168532445644014
수출/NNG;지원하/VVX,-1,-0.4904949909526881,16,5,11,9,0.17740066298348878,0.5168532445644014
성장률/NNG;개선되/VVX,-1,-0.4943921539501389,19,6,13,29,0.18462333062182446,0.543440316393317
금리상승/NNG;대비하/VVX,-1,-0.4943921539501389,19,6,13,33,0.18462333062182446,0.543440316393317
정책금리/NNG;인하했/VVX,-1,-0.4943921539501389,19,6,13,25,0.18462333062182446,0.543440316393317
더블딥/NNG;빠질/VV,-1,-0.4943921539501389,19,6,13,23,0.18462333062182446,0.543440316393317
불확실성/NNG;확대/NNG;따른/VV,-1,-0.4943921539501389,19,6,13,29,0.18462333062182446,0.543440316393317
금리인하/NNG;가능성/NNG;배제하/VVX;않/VX,-1,-0.4943921539501389,19,6,13,15,0.18462333062182446,0.543440316393317
경기부양/NNG;위해서/VV,-1,-0.4943921539501389,19,6,13,28,0.18462333062182446,0.543440316393317
금리인하/NNG;점치/VV,-1,-0.4943921539501389,19,6,13,15,0.18462333062182446,0.543440316393317
경기/NNG;부진/NNG;지속될/VVX,-1,-0.4998797042113915,22,7,15,20,0.19065506567022106,0.5694068089998693
경기/NNG;판단/NNG;있/VV,-1,-0.4998797042113915,22,7,15,24,0.19065506567022106,0.5694068089998693
변동성/NNG;확대할/VVX,-1,-0.4998797042113915,22,7,15,18,0.19065506567022106,0.5694068089998693
물가/NNG;영향/NNG;주/VV,-1,-0.4998797042113915,22,7,15,39,0.19065506567022106,0.5694068089998693
기준금리인상/NNG;가능할/VVX,-1,-0.4998797042113915,22,7,15,45,0.19065506567022106,0.5694068089998693
기준금리/NNG;유지키/VVX,-1,-0.4998797042113915,22,7,15,18,0.19065506567022106,0.5694068089998693
성장률/NNG;하향조정될/VVX,-1,-0.4998797042113915,22,7,15,29,0.19065506567022106,0.5694068089998693
기준금리/NNG;내리/VV,-1,-0.49996217085197237,247,85,162,263,0.3020495914337722,0.9022932733588384
금리/NNG;내렸/VV,-1,-0.5037520682953895,148,51,97,141,0.29856448578425215,0.9009322365059278
금융안정/NNG;유의하/VVX;통화정책/NNG;운용해/VVX;나갈/VX,-1,-0.5056133264545764,67,23,44,55,0.26983829409362203,0.8183121475233676
금리인하/NNG;가능성/NNG;제기되/VVX,-1,-0.5059754290945153,25,8,17,34,0.19588094555031998,0.5946052492081838
금리인상/NNG;대응하/VVX,-1,-0.5059754290945153,25,8,17,20,0.19588094555031998,0.5946052492081838
경상수지/NNG;흑자/NNG;기록하/VVX,-1,-0.5059754290945153,25,8,17,26,0.19588094555031998,0.5946052492081838
금리인하/NNG;결정했/VVX,-1,-0.5059754290945153,25,8,17,20,0.19588094555031998,0.5946052492081838
경상수지/NNG;흑자/NNG;지속되/VVX,-1,-0.5059754290945153,25,8,17,33,0.19588094555031998,0.5946052492081838
리스크/NNG;부각되/VVX,-1,-0.509947692054986,56,19,37,86,0.25424820560672845,0.7800597333966032
금리/NNG;내릴/VV;있/VV,-1,-0.514363323960614,59,20,39,60,0.2555625499203381,0.7935009183391373
유가/NNG;오를/VV,-1,-0.5147488401564357,45,15,30,42,0.23458775140316454,0.7291373246868753
경기/NNG;살아나/VV;않/VX,-1,-0.5181809659030772,31,10,21,39,0.2047169659540085,0.6422564089649244
경기침체/NNG;심화되/VVX,-1,-0.5181809659030772,31,10,21,30,0.2047169659540085,0.6422564089649244
원자재/NNG;가격/NNG;상승/NNG;따른/VV,-1,-0.5182495711872301,62,21,41,89,0.25682920823806765,0.805898208615955
기준금리/NNG;인하되/VVX,-1,-0.5209652489780587,85,29,56,218,0.2740665584777028,0.8663852996612994
금리/NNG;인하할/VVX;가능성/NNG;높/VA,-1,-0.5238661432662935,34,11,23,25,0.20855395162501905,0.6645474744428682
경기회복/NNG;이끌/VV,-1,-0.5238661432662935,34,11,23,35,0.20855395162501905,0.6645474744428682
성장세/NNG;지속될/VVX,-1,-0.5247309626691844,51,17,34,65,0.23872560930814127,0.7624979113907414
경기/NNG;악화될/VVX,-1,-0.5247309626691844,51,17,34,55,0.23872560930814127,0.7624979113907414
금리/NNG;인하했/VVX,-1,-0.5356587176832512,170,57,113,177,0.2768635961435669,0.9115047982247191
정책금리/NNG;인하하/VVX,-1,-0.5373060668857397,92,31,61,88,0.2668272928261938,0.8825202940791372
리스크/NNG;요인이/VVX,-1,-0.5383804560244088,43,14,29,46,0.2184565460661958,0.7247153234023315
금융시장/NNG;안정/NNG;위한/VV,-1,-0.542934676152616,69,23,46,67,0.24900096200639305,0.8367028144642517
금리인상/NNG;가능성/NNG;부각되/VVX,-1,-0.5517081422158009,55,18,37,70,0.22898969922294107,0.7889013864362994
경기침체/NNG;대응하/VVX,-1,-0.5525722113989688,23,7,16,16,0.16992582645662094,0.586869408341223
유동성/NNG;위기/NNG;겪/VV,-1,-0.5525722113989688,23,7,16,32,0.16992582645662094,0.586869408341223
디플레이션/NNG;빠질/VV,-1,-0.5525722113989688,23,7,16,28,0.16992582645662094,0.586869408341223
금리/NNG;인하할/VVX;가능성/NNG;낮/VA,-1,-0.5525722113989688,23,7,16,9,0.16992582645662094,0.586869408341223
금리/NNG;낮출/VV;있/VV,-1,-0.5525722113989688,23,7,16,43,0.16992582645662094,0.586869408341223
성장률/NNG;나타내/VV,-1,-0.5525722113989688,23,7,16,34,0.16992582645662094,0.586869408341223
경제/NNG;개선될/VVX,-1,-0.5525722113989688,23,7,16,34,0.16992582645662094,0.586869408341223
금리/NNG;유지해/VVX,-1,-0.5525722113989688,23,7,16,29,0.16992582645662094,0.586869408341223
고용사정/NNG;개선되/VVX,-1,-0.5529059622614116,26,8,18,17,0.17690852578070182,0.6115705728245229
경기회복세/NNG;유지되/VVX,-1,-0.5529059622614116,26,8,18,24,0.17690852578070182,0.6115705728245229
양적완화/NNG;시행하/VVX,-1,-0.5529059622614116,26,8,18,49,0.17690852578070182,0.6115705728245229
기준금리/NNG;위한/VV,-1,-0.5529059622614116,26,8,18,53,0.17690852578070182,0.6115705728245229
소비/NNG;회복될/VVX,-1,-0.5544194177670886,20,6,14,19,0.16167796402438195,0.5613537651248243
금리인하/NNG;지속될/VVX,-1,-0.5544194177670886,20,6,14,10,0.16167796402438195,0.5613537651248243
흑자/NNG;전환했/VVX,-1,-0.5544194177670886,20,6,14,13,0.16167796402438195,0.5613537651248243
금리/NNG;상승세/NNG;나타나/VV,-1,-0.5544194177670886,20,6,14,25,0.16167796402438195,0.5613537651248243
신용스프레드/NNG;축소될/VVX,-1,-0.5544194177670886,20,6,14,28,0.16167796402438195,0.5613537651248243
금리인하/NNG;주장하/VVX;소수의견/NNG,-1,-0.5544194177670886,20,6,14,21,0.16167796402438195,0.5613537651248243
금리인하/NNG;가능성/NNG;낮추/VV,-1,-0.5544194177670886,20,6,14,16,0.16167796402438195,0.5613537651248243
금리/NNG;변동성/NNG;확대될/VVX,-1,-0.5544194177670886,20,6,14,24,0.16167796402438195,0.5613537651248243
기준금리/NNG;내렸/VV,-1,-0.5544924861749494,142,47,95,108,0.26342089810020614,0.9148024097553926
금리/NNG;내리/VV;않/VX,-1,-0.55613145085378,61,20,41,68,0.23340757890924688,0.8144078618775632
리스크/NNG;확대될/VVX,-1,-0.5566074182954412,32,10,22,38,0.18835624125776027,0.6581173491102968
성장/NNG;할/VV;있/VV,-1,-0.5590559691341015,35,11,24,26,0.19319353063185882,0.6798150997618695
주택시장/NNG;침체/NNG;따른/VV,-1,-0.5590559691341015,35,11,24,49,0.19319353063185882,0.6798150997618695
유동성/NNG;부족하/VVX,-1,-0.5602054610464866,17,5,12,21,0.1515790014156207,0.5351616698981884
국제금융시장/NNG;불안/NNG;따른/VV,-1,-0.5602054610464866,17,5,12,16,0.1515790014156207,0.5351616698981884
경제/NNG;미칠/VV;악영향/NNG,-1,-0.5602054610464866,17,5,12,9,0.1515790014156207,0.5351616698981884
수출/NNG;부진할/VVX,-1,-0.5602054610464866,17,5,12,35,0.1515790014156207,0.5351616698981884
금리/NNG;올리/VV;적절하/VAX,-1,-0.5602054610464866,17,5,12,14,0.1515790014156207,0.5351616698981884
경기둔화/NNG;막/VV;위해/VV,-1,-0.5602054610464866,17,5,12,23,0.1515790014156207,0.5351616698981884
금리인상/NNG;시점/NNG;앞당겨질/VV,-1,-0.5602054610464866,17,5,12,20,0.1515790014156207,0.5351616698981884
기준금리인상/NNG;그칠/VV,-1,-0.5602054610464866,17,5,12,12,0.1515790014156207,0.5351616698981884
경제성장/NNG;지속하/VVX,-1,-0.5602054610464866,17,5,12,15,0.1515790014156207,0.5351616698981884
정책금리/NNG;인상/NNG;단행되/VVX,-1,-0.5602054610464866,17,5,12,18,0.1515790014156207,0.5351616698981884
경제성장률/NNG;떨어지/VV,-1,-0.5602054610464866,17,5,12,32,0.1515790014156207,0.5351616698981884
불안/NNG;초래할/VVX,-1,-0.5602054610464866,17,5,12,10,0.1515790014156207,0.5351616698981884
주택가격/NNG;하락/NNG;따른/VV,-1,-0.5602054610464866,17,5,12,33,0.1515790014156207,0.5351616698981884
리스크/NNG;따른/VV,-1,-0.564029365405146,41,13,28,82,0.20162831860670305,0.7198351308533212
기준금리/NNG;인하하/VVX,-1,-0.5643664559815547,536,175,361,648,0.2575019979660214,0.920216118917909
성장률/NNG;떨어지/VV,-1,-0.5663407743298965,44,14,30,50,0.20535519918263714,0.7381164117488637
경제성장/NNG;촉진하/VVX,-1,-0.5684601817198427,47,15,32,30,0.20881535994183237,0.755240244345065
금리인하/NNG;인해/VV,-1,-0.5734688333076406,56,18,38,61,0.2178912036731262,0.7998152246866228
물가/NNG;하락하/VVX,-1,-0.5764396846241517,65,21,44,87,0.22542734676045684,0.8348235671819408
금리인하/NNG;단행했/VVX,-1,-0.5800423481422032,164,53,111,145,0.24660264900861972,0.9231378271352968
성장세/NNG;유지하/VVX,-1,-0.5903748204514871,87,28,59,131,0.23086220367551352,0.8916835389890337
금융시장/NNG;안정/NNG;위해/VV,-1,-0.5911948660111519,84,27,57,103,0.22904890671860806,0.8869014937190985
금융안정/NNG;위한/VV,-1,-0.5918977078829446,36,11,25,30,0.17896591354464805,0.6944681606319784
성장세/NNG;둔화됐/VVX,-1,-0.5918977078829446,36,11,25,30,0.17896591354464805,0.6944681606319784
리스크/NNG;작용할/VVX,-1,-0.5919549637000033,39,12,27,65,0.1840852007733086,0.7144586553745105
금리인하/NNG;나섰/VV,-1,-0.5919549637000033,39,12,27,47,0.1840852007733086,0.7144586553745105
소비/NNG;늘어날/VV,-1,-0.5919549637000033,39,12,27,37,0.1840852007733086,0.7144586553745105
동결/NNG;기조/NNG;유지할/VVX,-1,-0.5919549637000033,39,12,27,48,0.1840852007733086,0.7144586553745105
물가안정기조/NNG;유지되/VVX;하/VV;금융안정/NNG;유의하/VVX;통화정책/NNG;운용해/VVX,-1,-0.5922697336495146,42,13,29,29,0.18875537703856302,0.7332915235295895
경제/NNG;살리/VV;위해/VV,-1,-0.5923072050481059,33,10,23,35,0.1733034931813821,0.6733402210032581
경기부양책/NNG;힘입/VV,-1,-0.5923072050481059,33,10,23,54,0.1733034931813821,0.6733402210032581
금리인하/NNG;이뤄질/VV,-1,-0.5923072050481059,33,10,23,49,0.1733034931813821,0.6733402210032581
성장세/NNG;유지되/VVX,-1,-0.5923072050481059,33,10,23,48,0.1733034931813821,0.6733402210032581
침체/NNG;지속될/VVX,-1,-0.5923072050481059,33,10,23,25,0.1733034931813821,0.6733402210032581
경기침체/NNG;막/VV;위한/VV,-1,-0.5923072050481059,33,10,23,5,0.1733034931813821,0.6733402210032581
경제지표/NNG;혼조세/NNG;보이/VV,-1,-0.5923072050481059,33,10,23,50,0.1733034931813821,0.6733402210032581
물가/NNG;떨어지/VV,-1,-0.5935010873877518,30,9,21,34,0.1669689160193819,0.6511106049461073
금리인하/NNG;기대/NNG;반영하/VVX,-1,-0.5935010873877518,30,9,21,55,0.1669689160193819,0.6511106049461073
금리인하/NNG;가능성/NNG;시사했/VVX,-1,-0.5943115415341916,60,19,41,40,0.2103562810572337,0.82235103015442
금리인하/NNG;배경/NNG;설명했/VVX,-1,-0.5959697456125987,27,8,19,14,0.15977987914093417,0.627832645901527
금리/NNG;상승세/NNG;제한되/VVX,-1,-0.5959697456125987,27,8,19,45,0.15977987914093417,0.627832645901527
경제/NNG;회복세/NNG;나타내/VV,-1,-0.5959697456125987,27,8,19,22,0.15977987914093417,0.627832645901527
금리인상/NNG;우려/NNG;완화된/VVX,-1,-0.6004892278478617,24,7,17,17,0.1514701864984223,0.603579241027304
금리/NNG;하락세/NNG;이어지/VV,-1,-0.6004892278478617,24,7,17,33,0.1514701864984223,0.603579241027304
금리/NNG;내려야/VV;한다는/VX,-1,-0.6004892278478617,24,7,17,16,0.1514701864984223,0.603579241027304
기준금리/NNG;동결될/VVX;전망했/VVX,-1,-0.6004892278478617,24,7,17,30,0.1514701864984223,0.603579241027304
유가/NNG;반등했/VVX,-1,-0.6004892278478617,24,7,17,23,0.1514701864984223,0.603579241027304
기준금리인하/NNG;가능성/NNG;열/VV,-1,-0.6004892278478617,24,7,17,34,0.1514701864984223,0.603579241027304
단기금리/NNG;급등하/VVX,-1,-0.6004892278478617,24,7,17,19,0.1514701864984223,0.603579241027304
가계부채/NNG;증가하/VVX,-1,-0.6004892278478617,24,7,17,21,0.1514701864984223,0.603579241027304
실업률/NNG;상승했/VVX,-1,-0.6004892278478617,24,7,17,29,0.1514701864984223,0.603579241027304
자산매입/NNG;줄이/VV,-1,-0.6004892278478617,24,7,17,66,0.1514701864984223,0.603579241027304
금리인하/NNG;더불/VV,-1,-0.6083295163842821,21,6,15,17,0.1416365057016915,0.5784447688026102
금리인하/NNG;가능성/NNG;남/VV,-1,-0.6083295163842821,21,6,15,25,0.1416365057016915,0.5784447688026102
성장세/NNG;둔화하/VVX,-1,-0.6083295163842821,21,6,15,31,0.1416365057016915,0.5784447688026102
금리상승/NNG;압력/NNG;우세할/VVX,-1,-0.6083295163842821,21,6,15,17,0.1416365057016915,0.5784447688026102
금융시장/NNG;요동치/VV,-1,-0.6164694575969611,49,15,34,59,0.1859061346812461,0.7791827958066174
리스크/NNG;커졌/VV,-1,-0.6203282096329157,40,12,28,32,0.1715379218676124,0.7279579551642847
기준금리인상/NNG;단행할/VVX,-1,-0.6203282096329157,40,12,28,59,0.1715379218676124,0.7279579551642847
추경/NNG;따른/VV;국채발행/NNG,-1,-0.6216615819886697,18,5,13,14,0.12964236124986855,0.5525465768664601
채권시장/NNG;강세/NNG;나타냈/VV,-1,-0.6216615819886697,18,5,13,12,0.12964236124986855,0.5525465768664601
금리인하/NNG;반대하/VVX,-1,-0.6216615819886697,18,5,13,23,0.12964236124986855,0.5525465768664601
신용경색/NNG;발생하/VVX,-1,-0.6216615819886697,18,5,13,22,0.12964236124986855,0.5525465768664601
금리인상/NNG;시작해/VVX,-1,-0.6216615819886697,18,5,13,17,0.12964236124986855,0.5525465768664601
유동성함정/NNG;빠지/VV;않/VX,-1,-0.6216615819886697,18,5,13,10,0.12964236124986855,0.5525465768664601
재정위기/NNG;지속되/VVX,-1,-0.6216615819886697,18,5,13,19,0.12964236124986855,0.5525465768664601
경제/NNG;활력/NNG;불어넣/VV,-1,-0.6216615819886697,18,5,13,13,0.12964236124986855,0.5525465768664601
경제/NNG;회복세/NNG;나타낼/VV,-1,-0.6216615819886697,18,5,13,23,0.12964236124986855,0.5525465768664601
경제/NNG;부담/NNG;될/VV,-1,-0.6216615819886697,18,5,13,24,0.12964236124986855,0.5525465768664601
변동성/NNG;제한된/VVX,-1,-0.6216615819886697,18,5,13,37,0.12964236124986855,0.5525465768664601
경제성장률/NNG;상향조정했/VVX,-1,-0.6216615819886697,18,5,13,27,0.12964236124986855,0.5525465768664601
금리/NNG;재할인율/NNG;인하했/VVX,-1,-0.6216615819886697,18,5,13,10,0.12964236124986855,0.5525465768664601
금융안정/NNG;유의할/VVX,-1,-0.6216615819886697,18,5,13,9,0.12964236124986855,0.5525465768664601
금리상승/NNG;영향/NNG;받/VV,-1,-0.6224305760440212,37,11,26,20,0.1658291259135298,0.7085441089741342
지정학적리스크/NNG;따른/VV,-1,-0.6253184850224236,34,10,24,55,0.15950614093297508,0.6879706552901756
금리인하/NNG;예상했/VVX,-1,-0.6293805893538268,31,9,22,39,0.15242805853880384,0.6662638721360388
불확실성/NNG;계속되/VVX,-1,-0.6293805893538268,31,9,22,48,0.15242805853880384,0.6662638721360388
경기둔화/NNG;막/VV,-1,-0.6293805893538268,31,9,22,22,0.15242805853880384,0.6662638721360388
마이너스성장/NNG;할/VV,-1,-0.6293805893538268,31,9,22,16,0.15242805853880384,0.6662638721360388
실물경제/NNG;영향/NNG;미치/VV,-1,-0.6293805893538268,31,9,22,38,0.15242805853880384,0.6662638721360388
변동성/NNG;나타내/VV,-1,-0.6325622643255575,59,18,41,49,0.18783590105410813,0.8297134928644128
기준금리/NNG;역전되/VVX,-1,-0.6351976746631485,28,8,20,56,0.14440061523748007,0.6434659335709539
경기침체/NNG;인해/VV,-1,-0.6351976746631485,28,8,20,35,0.14440061523748007,0.6434659335709539
경기/NNG;영향/NNG;받/VV,-1,-0.6351976746631485,28,8,20,16,0.14440061523748007,0.6434659335709539
국제금융시장/NNG;불안/NNG;완화되/VVX,-1,-0.6351976746631485,28,8,20,5,0.14440061523748007,0.6434659335709539
수출/NNG;줄/VV,-1,-0.6363167003637213,53,16,37,56,0.17988547465188814,0.8045916185072087
금리/NNG;하락세/NNG;지속될/VVX,-1,-0.6384250761779938,50,15,35,82,0.175468227826147,0.7903985181817753
침체/NNG;지속되/VVX,-1,-0.6407866317004609,47,14,33,46,0.17070299340333273,0.7750717230179698
금리인하/NNG;가능성/NNG;있/VV,-1,-0.6435114339220622,44,13,31,31,0.16553793628673913,0.7585854312238394
소비자물가/NNG;올라/VV,-1,-0.6436577347319222,25,7,18,26,0.1351493960362831,0.6196362885564812
국제유가/NNG;오르/VV,-1,-0.6436577347319222,25,7,18,32,0.1351493960362831,0.6196362885564812
시장금리/NNG;반영되/VVX,-1,-0.6436577347319222,25,7,18,36,0.1351493960362831,0.6196362885564812
경기/NNG;발간하/VVX,-1,-0.6436577347319222,25,7,18,9,0.1351493960362831,0.6196362885564812
투자심리/NNG;부정적/VAX;작용했/VVX,-1,-0.644403097141526,15,4,11,10,0.11444135955730432,0.5260246799734664
경제상황/NNG;변화/NNG;고려한/VAX;결과/NNG;통화정책방향/NNG;기준금리/NNG;유지하/VVX,-1,-0.644403097141526,15,4,11,27,0.11444135955730432,0.5260246799734664
콜금리/NNG;인상하/VVX;않/VX,-1,-0.644403097141526,15,4,11,10,0.11444135955730432,0.5260246799734664
금리/NNG;상승세/NNG;나타났/VV,-1,-0.644403097141526,15,4,11,11,0.11444135955730432,0.5260246799734664
금리하락/NNG;이어질/VV,-1,-0.644403097141526,15,4,11,21,0.11444135955730432,0.5260246799734664
통화완화/NNG;정책/NNG;종료하/VVX,-1,-0.644403097141526,15,4,11,20,0.11444135955730432,0.5260246799734664
투자심리/NNG;악화됐/VVX,-1,-0.644403097141526,15,4,11,17,0.11444135955730432,0.5260246799734664
경제/NNG;부양할/VVX,-1,-0.644403097141526,15,4,11,20,0.11444135955730432,0.5260246799734664
재정적자/NNG;확대/NNG;따른/VV,-1,-0.644403097141526,15,4,11,8,0.11444135955730432,0.5260246799734664
경제/NNG;성장세/NNG;이/VV;가/VX,-1,-0.644403097141526,15,4,11,30,0.11444135955730432,0.5260246799734664
금리/NNG;급락한/VAX;따른/VV,-1,-0.644403097141526,15,4,11,12,0.11444135955730432,0.5260246799734664
기준금리동결/NNG;결정했/VVX,-1,-0.644403097141526,15,4,11,24,0.11444135955730432,0.5260246799734664
근원인플레이션율/NNG;하락하/VVX,-1,-0.644403097141526,15,4,11,14,0.11444135955730432,0.5260246799734664
물가안정/NNG;목표/NNG;하회하/VVX,-1,-0.644403097141526,15,4,11,17,0.11444135955730432,0.5260246799734664
정책금리/NNG;인상/NNG;나설/VV,-1,-0.644403097141526,15,4,11,12,0.11444135955730432,0.5260246799734664
성장률/NNG;달성/NNG;가능할/VVX,-1,-0.644403097141526,15,4,11,12,0.11444135955730432,0.5260246799734664
금리/NNG;인하한/VVX,-1,-0.6467519862527746,41,12,29,75,0.15990795028617336,0.7409221984433354
경제지표/NNG;악화되/VVX,-1,-0.6557191796358175,35,10,25,31,0.14689644881832972,0.7020458637158833
수출/NNG;이/VV,-1,-0.6561566497324374,22,6,16,19,0.12427729660992058,0.594852407450784
인플레이션리스크/NNG;남/VV,-1,-0.6561566497324374,22,6,16,12,0.12427729660992058,0.594852407450784
물가안정/NNG;목표/NNG;달성하/VVX,-1,-0.6561566497324374,22,6,16,25,0.12427729660992058,0.594852407450784
금리/NNG;하향/NNG;안정화되/VVX,-1,-0.6561566497324374,22,6,16,22,0.12427729660992058,0.594852407450784
내수/NNG;부진/NNG;따른/VV,-1,-0.6621750840315452,32,9,23,38,0.13926548691942306,0.6808531575948221
금리/NNG;큰/VA;상승했/VVX,-1,-0.6626086036333887,48,14,34,86,0.1606039689039291,0.7863816248457169
불안요인/NNG;있/VV,-1,-0.6666270875035607,45,13,32,41,0.1551178179735117,0.7704690392504314
유동성/NNG;조이/VV,-1,-0.6707118233947593,29,8,21,12,0.13064717649015847,0.6585271165098977
금리상승/NNG;압력/NNG;작용할/VVX,-1,-0.6707118233947593,29,8,21,44,0.13064717649015847,0.6585271165098977
금리인상/NNG;나설/VV;전망/NNG,-1,-0.6707118233947593,29,8,21,48,0.13064717649015847,0.6585271165098977
수출/NNG;증가했/VVX,-1,-0.6713000690108378,42,12,30,56,0.14914673207952764,0.7533752712454572
경기/NNG;부진할/VVX,-1,-0.6713000690108378,42,12,30,35,0.14914673207952764,0.7533752712454572
경기회복/NNG;걸림돌/NNG;작용할/VVX,-1,-0.6749586940165802,19,5,14,14,0.11119815550905143,0.56920899603606
국제유가/NNG;상승할/VVX,-1,-0.6749586940165802,19,5,14,18,0.11119815550905143,0.56920899603606
만장일치/NNG;기준금리/NNG;동결했/VVX,-1,-0.6749586940165802,19,5,14,33,0.11119815550905143,0.56920899603606
금리/NNG;계속/MAG;오를/VV,-1,-0.6749586940165802,19,5,14,7,0.11119815550905143,0.56920899603606
금리인하/NNG;예상됨/VVX,-1,-0.6749586940165802,19,5,14,17,0.11119815550905143,0.56920899603606
물가/NNG;안정세/NNG;유지할/VVX,-1,-0.6749586940165802,19,5,14,7,0.11119815550905143,0.56920899603606
수출/NNG;부진/NNG;따른/VV,-1,-0.676858005518874,39,11,28,30,0.14260823309591525,0.7350858600713834
추경/NNG;편성/NNG;따른/VV,-1,-0.6791043910878182,65,19,46,60,0.16646708791554646,0.8651895735325243
수출/NNG;감소세/NNG;지속되/VVX,-1,-0.6822504540720247,26,7,19,10,0.12078347250464662,0.6351136212261471
시장금리/NNG;급등했/VVX,-1,-0.6822504540720247,26,7,19,20,0.12078347250464662,0.6351136212261471
소비자물가상승률/NNG;물가안정/NNG;목표/NNG;안정되/VVX;통화정책/NNG;운용해/VVX;나갈/VX,-1,-0.6822504540720247,26,7,19,46,0.12078347250464662,0.6351136212261471
금리인하/NNG;단행하/VVX;않/VX,-1,-0.6836186645541242,36,10,26,50,0.13539752535252658,0.7155965421338345
금리/NNG;내려/VV,-1,-0.6858081101347266,82,24,58,101,0.17084559431024116,0.9103735341427278
금리/NNG;인하될/VVX;가능성/NNG,-1,-0.6881649196534682,46,13,33,55,0.14543412407743783,0.7818706593548331
투자심리/NNG;크/VA;위축되/VVX,-1,-0.6981788195432965,23,6,17,24,0.10932077417105153,0.6106735537294882
통화완화/NNG;정책/NNG;펴/VV,-1,-0.6981788195432965,23,6,17,17,0.10932077417105153,0.6106735537294882
유동성/NNG;힘입/VV,-1,-0.6981788195432965,23,6,17,46,0.10932077417105153,0.6106735537294882
설비투자/NNG;감소하/VVX,-1,-0.6981788195432965,23,6,17,29,0.10932077417105153,0.6106735537294882
수출/NNG;위축될/VVX,-1,-0.6981788195432965,23,6,17,12,0.10932077417105153,0.6106735537294882
인플레이션압력/NNG;완화될/VVX,-1,-0.7009460480591378,40,11,29,23,0.13239968951495482,0.7476014655230477
금리인하/NNG;단행된/VVX,-1,-0.7009460480591378,40,11,29,78,0.13239968951495482,0.7476014655230477
금리/NNG;하락세/NNG;예상된/VVX,-1,-0.7009460480591378,40,11,29,31,0.13239968951495482,0.7476014655230477
금리인하/NNG;단행될/VVX,-1,-0.7012445993033714,80,23,57,120,0.16110535172851098,0.9107513431718001
금리/NNG;인상될/VVX;있/VV,-1,-0.7027027196378063,30,8,22,46,0.11838133154657689,0.6730597682886432
물가/NNG;영향/NNG;미치/VV,-1,-0.7027027196378063,30,8,22,35,0.11838133154657689,0.6730597682886432
유가/NNG;낙폭/NNG;제한됐/VVX,-1,-0.7038479698119626,16,4,12,25,0.09504401291343277,0.5428132792339788
금리동결/NNG;지속될/VVX,-1,-0.7038479698119626,16,4,12,23,0.09504401291343277,0.5428132792339788
유가/NNG;최고치/NNG;경신하/VVX,-1,-0.7038479698119626,16,4,12,10,0.09504401291343277,0.5428132792339788
경기회복/NNG;찬물/NNG;끼얹/VV,-1,-0.7038479698119626,16,4,12,28,0.09504401291343277,0.5428132792339788
자금이탈/NNG;나타나/VV,-1,-0.7038479698119626,16,4,12,36,0.09504401291343277,0.5428132792339788
성장경로/NNG;불확실성/NNG;높/VA;진/VX;판단된/VVX,-1,-0.7038479698119626,16,4,12,12,0.09504401291343277,0.5428132792339788
금리/NNG;변동성/NNG;확대될/VVX;있/VV,-1,-0.7038479698119626,16,4,12,18,0.09504401291343277,0.5428132792339788
경제지표/NNG;호조/NNG;따른/VV,-1,-0.7038479698119626,16,4,12,47,0.09504401291343277,0.5428132792339788
기준금리/NNG;인하돼/VVX,-1,-0.7038479698119626,16,4,12,9,0.09504401291343277,0.5428132792339788
시장금리/NNG;상승/NNG;제한할/VVX,-1,-0.7038479698119626,16,4,12,28,0.09504401291343277,0.5428132792339788
시장금리/NNG;하락/NNG;제한될/VVX,-1,-0.7038479698119626,16,4,12,24,0.09504401291343277,0.5428132792339788
경기/NNG;진작/NNG;위한/VV,-1,-0.7038479698119626,16,4,12,20,0.09504401291343277,0.5428132792339788
불안심리/NNG;완화될/VVX,-1,-0.7038479698119626,16,4,12,22,0.09504401291343277,0.5428132792339788
금리상승/NNG;예상되/VVX,-1,-0.7165443167916736,27,7,20,46,0.10817524558307935,0.6500651456498404
신용경색/NNG;완화하/VVX,-1,-0.7191035756834816,34,9,25,28,0.11666561445010007,0.708477229710044
경기회복/NNG;지속되/VVX,-1,-0.7191035756834816,34,9,25,59,0.11666561445010007,0.708477229710044
채권시장/NNG;반영되/VVX,-1,-0.7206208035553336,20,5,15,27,0.09577785790302414,0.5852806998597289
수출/NNG;증가세/NNG;보이/VV,-1,-0.7206208035553336,20,5,15,10,0.09577785790302414,0.5852806998597289
수출경쟁력/NNG;높이/VV,-1,-0.7206208035553336,20,5,15,21,0.09577785790302414,0.5852806998597289
지정학적리스크/NNG;영향/NNG;받/VV,-1,-0.7206208035553336,20,5,15,12,0.09577785790302414,0.5852806998597289
잠재성장률/NNG;밑돌/VV,-1,-0.7206208035553336,20,5,15,34,0.09577785790302414,0.5852806998597289
금리차/NNG;축소/NNG;따른/VV,-1,-0.7206208035553336,20,5,15,18,0.09577785790302414,0.5852806998597289
금융시장/NNG;안정/NNG;찾/VV,-1,-0.7268210972676246,48,13,35,59,0.12810007103533116,0.8032982663873116
내수/NNG;위축되/VVX,-1,-0.7314065920735155,31,8,23,36,0.10746068047544986,0.6870977340928137
소비자물가상승률/NNG;물가안정/NNG;목표/NNG;유지되/VVX;통화정책/NNG;운용해/VVX;나갈/VX,-1,-0.734835001405753,24,6,18,37,0.09647138603240588,0.6259763514604172
잠재성장률/NNG;하회하/VVX,-1,-0.734835001405753,24,6,18,38,0.09647138603240588,0.6259763514604172
금리인하/NNG;힘입/VV,-1,-0.734835001405753,24,6,18,19,0.09647138603240588,0.6259763514604172
유동성/NNG;공급하/VVX;위해/VV,-1,-0.734835001405753,24,6,18,21,0.09647138603240588,0.6259763514604172
고용지표/NNG;호조/NNG;보이/VV,-1,-0.7434465364987718,42,11,31,56,0.11446098536589216,0.7712231774114537
경기부양/NNG;위해/VV;금리인하/NNG,-1,-0.7434465364987718,42,11,31,37,0.11446098536589216,0.7712231774114537
성장세/NNG;회복/NNG;지원하/VVX,-1,-0.743603185517997,35,9,26,21,0.10701654663477717,0.721564967579009
금리인하/NNG;가능성/NNG;열/VV;놓/VX,-1,-0.7448280721303053,63,17,46,48,0.12928030771381338,0.8764417039044674
지준율/NNG;인하/VV,-1,-0.7468803158376859,28,7,21,21,0.09712669143106029,0.6645309810570841
금리/NNG;낮/VA;유지할/VVX,-1,-0.7468803158376859,28,7,21,42,0.09712669143106029,0.6645309810570841
소비/NNG;촉진하/VVX,-1,-0.7528254366481115,17,4,13,21,0.07953228707764777,0.559015154182513
경제/NNG;살리/VV;위한/VV,-1,-0.7528254366481115,17,4,13,20,0.07953228707764777,0.559015154182513
성장세/NNG;회복/NNG;이어지/VV;물가상승률/NNG;목표/NNG;접근하/VVX,-1,-0.7528254366481115,17,4,13,19,0.07953228707764777,0.559015154182513
기준금리인하/NNG;인해/VV,-1,-0.7528254366481115,17,4,13,27,0.07953228707764777,0.559015154182513
주택가격/NNG;떨어지/VV,-1,-0.7528254366481115,17,4,13,9,0.07953228707764777,0.559015154182513
인플레이션압력/NNG;높이/VV,-1,-0.7528254366481115,17,4,13,28,0.07953228707764777,0.559015154182513
캐리트레이드/NNG;청산/NNG;매물/NNG;나와/VV,-1,-0.7528254366481115,17,4,13,8,0.07953228707764777,0.559015154182513
안전자산선호/NNG;심리/NNG;강해/VV,-1,-0.7528254366481115,17,4,13,20,0.07953228707764777,0.559015154182513
안전자산선호/NNG;현상/NNG;약화시/VVX,-1,-0.7528254366481115,17,4,13,12,0.07953228707764777,0.559015154182513
기준금리/NNG;인하/VV,-1,-0.7528254366481115,17,4,13,28,0.07953228707764777,0.559015154182513
금리인하/NNG;따른/VV;가계부채/NNG,-1,-0.7594174157721904,21,5,16,10,0.08291351715285432,0.6008491318189448
유동성함정/NNG;빠질/VV,-1,-0.7594174157721904,21,5,16,7,0.08291351715285432,0.6008491318189448
신용등급/NNG;강등/NNG;따른/VV,-1,-0.7594174157721904,21,5,16,38,0.08291351715285432,0.6008491318189448
금리인하/NNG;압박하/VVX,-1,-0.7736298362530413,29,7,22,37,0.08744910180017923,0.6785412507831763
침체/NNG;이어질/VV,-1,-0.7906163716019577,41,10,31,49,0.09173255517471676,0.7762581891007286
경제성장/NNG;촉진하/VVX;위해/VV,-1,-0.7922139648731411,22,5,17,10,0.07217742356538417,0.6159727295715062
가계대출/NNG;상회하/VVX,-1,-0.7922139648731411,22,5,17,25,0.07217742356538417,0.6159727295715062
gdp/NNG;감소하/VVX,-1,-0.7928351298784636,18,4,14,36,0.0671238440687277,0.5747426423729957
gdp갭/NNG;축소되/VVX,-1,-0.7928351298784636,18,4,14,19,0.0671238440687277,0.5747426423729957
인플레이션/NNG;잘/MAG;제어되/VVX,-1,-0.7928351298784636,18,4,14,13,0.0671238440687277,0.5747426423729957
금리상승/NNG;압력/NNG;확대될/VVX,-1,-0.7928351298784636,18,4,14,10,0.0671238440687277,0.5747426423729957
금리인하/NNG;나설/VV;전망/NNG,-1,-0.7928351298784636,18,4,14,20,0.0671238440687277,0.5747426423729957
실물경제/NNG;개선되/VVX,-1,-0.7928351298784636,18,4,14,7,0.0671238440687277,0.5747426423729957
금리인하/NNG;나설/VV;가능성/NNG;높/VA,-1,-0.7928351298784636,18,4,14,21,0.0671238440687277,0.5747426423729957
경기과열/NNG;막/VV;위해/VV,-1,-0.7928351298784636,18,4,14,40,0.0671238440687277,0.5747426423729957
경기둔화/NNG;우려/NNG;반영하/VVX,-1,-0.7941756779881802,26,6,20,20,0.07597459867252739,0.6552062050160953
금리인하/NNG;여력/NNG;있/VV,-1,-0.7941756779881802,26,6,20,14,0.07597459867252739,0.6552062050160953
유동성함정/NNG;빠지/VV,-1,-0.7941756779881802,26,6,20,4,0.07597459867252739,0.6552062050160953
내수/NNG;부진/NNG;심화되/VVX,-1,-0.7941756779881802,26,6,20,6,0.07597459867252739,0.6552062050160953
실물경제/NNG;미칠/VV;영향/NNG,-1,-0.7941756779881802,26,6,20,16,0.07597459867252739,0.6552062050160953
불안/NNG;진정시/VVX,-1,-0.7971691790402339,30,7,23,26,0.07896872069701763,0.6921187944912885
유동성/NNG;지원하/VVX,-1,-0.8065958768329503,42,10,32,42,0.08523048688146201,0.7870887187646408
신용경색/NNG;완화되/VVX,-1,-0.8092065542405011,46,11,35,30,0.08676512480076584,0.8132677737092696
금리인하/NNG;이/VV,-1,-0.8114579589541422,50,12,38,47,0.08812017149445914,0.836753145876407
가계부채/NNG;늘어날/VV,-1,-0.8179520469073996,27,6,21,10,0.06783265410918335,0.6691923283767626
유동성/NNG;확보하/VVX,-1,-0.821116687828563,43,10,33,70,0.0793143199144349,0.7975159084465342
물가/NNG;높이/VV,-1,-0.8253999163801624,19,4,15,16,0.05716125298899668,0.5900653323546249
재고조정/NNG;진행되/VVX,-1,-0.8253999163801624,19,4,15,8,0.05716125298899668,0.5900653323546249
성장/NNG;머물/VV,-1,-0.8253999163801624,19,4,15,16,0.05716125298899668,0.5900653323546249
경제지표/NNG;약화된/VVX,-1,-0.8381006270667444,15,3,12,11,0.04890795944666754,0.5477047087611134
채권시장/NNG;유입될/VVX,-1,-0.8381006270667444,15,3,12,31,0.04890795944666754,0.5477047087611134
고용지표/NNG;양호하/VVX,-1,-0.8381006270667444,15,3,12,21,0.04890795944666754,0.5477047087611134
불안/NNG;완화시/VVX,-1,-0.8381006270667444,15,3,12,27,0.04890795944666754,0.5477047087611134
흑자/NNG;돌아섰/VV,-1,-0.8381006270667444,15,3,12,31,0.04890795944666754,0.5477047087611134
기준금리/NNG;동결할/VVX;가능성/NNG;높/VA,-1,-0.8384820790448563,28,6,22,31,0.060815871502387396,0.6827851947950675
하방위험/NNG;커졌/VV,-1,-0.8384820790448563,28,6,22,20,0.060815871502387396,0.6827851947950675
불안/NNG;반영하/VVX,-1,-0.8519032874673157,20,4,16,14,0.049116101950038404,0.6050262076363893
경기/NNG;활성화/NNG;위한/VV,-1,-0.8519032874673157,20,4,16,40,0.049116101950038404,0.6050262076363893
인플레이션압력/NNG;커질/VV,-1,-0.8520384298867046,33,7,26,33,0.059237324470547637,0.7304119263139269
기준금리/NNG;내릴/VV;가능성/NNG,-1,-0.8661112509244555,34,7,27,44,0.05415887005915075,0.7423999886680805
기준금리/NNG;내린/VV;이/VV,-1,-0.8678247060646881,16,3,13,14,0.04052626524053953,0.563122015420483
성장률/NNG;전망치/NNG;상향조정하/VVX,-1,-0.8678247060646881,16,3,13,22,0.04052626524053953,0.563122015420483
금리인하/NNG;기대/NNG;약화된/VVX,-1,-0.8678247060646881,16,3,13,17,0.04052626524053953,0.563122015420483
불확실성/NNG;증폭시/VVX,-1,-0.8678247060646881,16,3,13,21,0.04052626524053953,0.563122015420483
금리상승/NNG;제한될/VVX,-1,-0.8705877102279118,56,12,44,98,0.062159845742789196,0.8831499304692233
경기부양/NNG;위한/VV;정책/NNG,-1,-0.8735261993701787,21,4,17,52,0.04257375327546796,0.6196513656318517
기준금리/NNG;밑돌/VV,-1,-0.8735261993701787,21,4,17,54,0.04257375327546796,0.6196513656318517
기준금리/NNG;하향조정하/VVX,-1,-0.8737623509673146,39,8,31,11,0.05375475868433144,0.7839246630526311
경기침체/NNG;지속될/VVX,-1,-0.8794895164910822,26,5,21,17,0.04393365440472286,0.6726297820908264
기준금리/NNG;내릴/VV;있/VA,-1,-0.890848344876451,17,3,14,9,0.034069189503978976,0.5782408851372901
불안/NNG;진정될/VVX,-1,-0.890848344876451,17,3,14,18,0.034069189503978976,0.5782408851372901
불안요인/NNG;부각되/VVX,-1,-0.890848344876451,17,3,14,34,0.034069189503978976,0.5782408851372901
물가/NNG;억제하/VVX,-1,-0.890848344876451,17,3,14,26,0.034069189503978976,0.5782408851372901
성장세/NNG;꺾이/VV,-1,-0.891240369383717,22,4,18,14,0.037212746602792675,0.633956046515826
기준금리/NNG;내린/VV,-1,-0.8932570244305509,175,36,139,149,0.05671114765820306,0.9850488391992134
성장세/NNG;회복/NNG;지원하/VVX;물가안정기조/NNG;유지되/VVX,-1,-0.8936017714199602,27,5,22,17,0.03935717274896564,0.6859107585152632
금리인하/NNG;시사했/VVX,-1,-0.8936017714199602,27,5,22,27,0.03935717274896564,0.6859107585152632
수출/NNG;증가세/NNG;둔화되/VVX,-1,-0.9058282037978775,23,4,19,42,0.03278503955192472,0.6479484711200587
기준금리/NNG;인하함/VVX,-1,-0.9077321119240348,38,7,31,47,0.0389793752746073,0.7866664979094407
마이너스성장/NNG;했/VV,-1,-0.908840242067715,18,3,15,13,0.029026082685060604,0.5930835354918326
소비자물가상승률/NNG;머물/VV,-1,-0.908840242067715,18,3,15,12,0.029026082685060604,0.5930835354918326
마이너스성장/NNG;하/VV,-1,-0.908840242067715,18,3,15,20,0.029026082685060604,0.5930835354918326
투자심리/NNG;개선된/VVX,-1,-0.908840242067715,18,3,15,24,0.029026082685060604,0.5930835354918326
신용경색/NNG;해소되/VVX,-1,-0.908840242067715,18,3,15,17,0.029026082685060604,0.5930835354918326
소비/NNG;회복세/NNG;이어지/VV,-1,-0.908840242067715,18,3,15,8,0.029026082685060604,0.5930835354918326
불안/NNG;완화하/VVX,-1,-0.908840242067715,18,3,15,13,0.029026082685060604,0.5930835354918326
금리인하/NNG;단행함/VVX,-1,-0.917912027093854,24,4,20,23,0.029099268656225728,0.6616323392077554
경기침체/NNG;이어질/VV,-1,-0.9221510791577723,40,7,33,25,0.03362131338301225,0.8066651183977849
가계부채/NNG;자본유출입/NNG;점검해/VVX;나갈/VX,-1,-0.923042286366657,19,3,16,11,0.025033647048766188,0.6076600529116982
추경/NNG;따른/VV;국고채/NNG;발행/NNG;한도/NNG;증액/NNG,-1,-0.923042286366657,19,3,16,15,0.025033647048766188,0.6076600529116982
성장/NNG;도모하/VVX,-1,-0.923042286366657,19,3,16,21,0.025033647048766188,0.6076600529116982
경기/NNG;하강/NNG;위험/NNG;남/VV,-1,-0.923042286366657,19,3,16,13,0.025033647048766188,0.6076600529116982
기준금리/NNG;내린/VV;뒤/NNG,-1,-0.923042286366657,19,3,16,24,0.025033647048766188,0.6076600529116982
금리인하/NNG;나선/VV,-1,-0.927983841632663,25,4,21,41,0.02600739020897917,0.675008486861764
경기/NNG;위축/NNG;의미한/VVX,-1,-0.927983841632663,25,4,21,15,0.02600739020897917,0.675008486861764
기준금리/NNG;내려/VV,-1,-0.9282141341296442,41,7,34,49,0.031344166509875725,0.8161483395106961
유동성함정/NNG;빠진/VV,-1,-0.9343713724618081,20,3,17,8,0.02183170602547607,0.6219732343088649
실물경제/NNG;미치/VV;효과/NNG,-1,-0.9343713724618081,20,3,17,7,0.02183170602547607,0.6219732343088649
기대인플레이션/NNG;낮추/VV,-1,-0.9343713724618081,20,3,17,11,0.02183170602547607,0.6219732343088649
경기/NNG;과도하/VVX,-1,-0.9343713724618081,20,3,17,8,0.02183170602547607,0.6219732343088649
물가안정/NNG;목표/NNG;하회할/VVX,-1,-0.9343713724618081,20,3,17,8,0.02183170602547607,0.6219732343088649
정책금리/NNG;인하할/VVX,-1,-0.9356643226047994,75,13,62,52,0.03307631031662643,0.9612544412676964
금리/NNG;내려도/VV,-1,-0.9364318503959079,26,4,22,22,0.02339434709164883,0.6880760033541055
기준금리/NNG;만장일치/NNG;동결되/VVX,-1,-0.9435041703271078,21,3,18,31,0.019232122212357435,0.636021519403276
금리/NNG;상승세/NNG;지속될/VVX;예상된/VVX,-1,-0.9466741092340533,15,2,13,11,0.016146963507305198,0.5653488299924332
경제지표/NNG;악화된/VVX,-1,-0.9466741092340533,15,2,13,12,0.016146963507305198,0.5653488299924332
경제지표/NNG;악화/NNG;따른/VV,-1,-0.9466741092340533,15,2,13,17,0.016146963507305198,0.5653488299924332
신용등급/NNG;하향조정할/VVX,-1,-0.9466741092340533,15,2,13,13,0.016146963507305198,0.5653488299924332
흑자/NNG;낼/VV,-1,-0.9466741092340533,15,2,13,14,0.016146963507305198,0.5653488299924332
통화완화/NNG;정책/NNG;지속될/VVX,-1,-0.9466741092340533,15,2,13,18,0.016146963507305198,0.5653488299924332
재정지출/NNG;확대/NNG;따른/VV,-1,-0.9496187373886198,28,4,24,24,0.019264224507188343,0.7132770989364191
유가/NNG;올라/VV,-1,-0.9509421013218301,22,3,19,11,0.017097318006309946,0.6498008166842684
수출/NNG;감소세/NNG;확대되/VVX,-1,-0.9539467233203232,35,5,30,5,0.01929418800336211,0.780069229909291
추경/NNG;따른/VV;국고채/NNG,-1,-0.9556800483351686,16,2,14,8,0.013822580031899135,0.580146844791176
불안요인/NNG;작용했/VVX,-1,-0.9621368637265161,24,3,21,22,0.013840411031042794,0.6765299998898172
물가/NNG;고려하/VVX,-1,-0.9626308421345614,17,2,15,16,0.012014426799665344,0.594738855241241
금리인하/NNG;했/VV,-1,-0.9680901427740882,18,2,16,21,0.010581634056245282,0.609116051547795
금리동결/NNG;주장했/VVX,-1,-0.972446401625597,19,2,17,47,0.009427484287529942,0.6232681723859099
불확실성/NNG;증대/NNG;따른/VV,-1,-0.972446401625597,19,2,17,26,0.009427484287529942,0.6232681723859099
불안/NNG;계속될/VVX,-1,-0.972446401625597,19,2,17,10,0.009427484287529942,0.6232681723859099
침체/NNG;막/VV,-1,-0.979859541925916,30,3,27,33,0.00849080502522189,0.7496638716428461
금리상승/NNG;압력/NNG;높/VA;질/VX;예상된/VVX,-1,-0.9878765479060222,15,1,14,20,0.004211492131631199,0.580993563325227
금리상승/NNG;압력/NNG;커질/VV,-1,-0.9878765479060222,15,1,14,79,0.004211492131631199,0.580993563325227
경제성장률/NNG;전망치/NNG;낮춘/VV,-1,-0.9894443939409218,16,1,15,11,0.003844028556666254,0.5954910502425047
유동성/NNG;가늠하/VVX;라이보/NNG,-1,-0.9897054165216428,28,2,26,15,0.004671998830106848,0.7388624838507731
하방리스크/NNG;커졌/VV,-1,-0.99671541742278,28,1,27,27,0.002095147275678614,0.7505862796327838
경기부양/NNG;위한/VV;추경/NNG;편성/NNG,-1,-0.999321163612147,15,0,15,15,0.0008845758150877532,0.595756709259929
기준금리/NNG;하향조정하/VVX;통화정책/NNG,-1,-1.0,29,0,29,3,0.0008845758150877532,0.7725718827010064
