word,label,polarity,count,pos_count,neg_count,neu_count,pos_score,neg_score
석유류/NNG@$가격/NNG@$상승/NNG,0,1.0,11,11,0,25,0.4213908701139455,5.4764865015932194e-05
경기/NNG@$물가/NNG@$금융시장/NNG,1,0.9997885908762716,30,29,1,8,0.7042146715587088,0.00016597139609396156
해외/NNG@$불안/NNG@$요인/NNG,1,0.9994976714006876,23,22,1,20,0.6018388990543783,0.0002294219455493089
통화정책/NNG@$금융/NNG@$경제/NNG,1,0.9989772765794103,18,17,1,50,0.5213399069616447,0.00033449689384816675
소비자/NNG@$물가/NNG@$석유류/NNG,1,0.9989772765794103,18,17,1,15,0.5213399069616447,0.00033449689384816675
유동성/NNG@$증가세/NNG@$둔화/NNG,1,0.99800076219333,25,23,2,16,0.6172721954297093,0.0006979059555688218
공급/NNG@$물가/NNG@$상승/NNG@$압력/NNG,1,0.9973475322676413,23,21,2,35,0.5860699133106333,0.000854502104491266
주가/NNG@$환율/NNG@$등가격/NNG@$변수/NNG,1,0.9947696988769088,19,17,2,10,0.5212646776720747,0.001434569801586275
상승/NNG@$압력/NNG@$증대/NNG,1,0.9941407377354659,26,23,3,19,0.6171572795929606,0.0018936492213996565
지속/NNG@$수요/NNG@$압력/NNG,1,0.9941407377354659,26,23,3,23,0.6171572795929606,0.0018936492213996565
초과/NNG@$지준/NNG@$금리/NNG@$인하/NNG,1,0.9936029254214569,18,16,2,39,0.5047067691750647,0.0016851734496592197
금리/NNG@$상승/NNG@$주가/NNG,1,0.9936029254214569,18,16,2,14,0.5047067691750647,0.0016851734496592197
전망/NNG@$통화정책/NNG@$완화/NNG@$기조/NNG@$유지/NNG,1,0.9931559772047025,25,22,3,30,0.6016641014631398,0.002144263206084837
견조/NNG@$성장/NNG@$지속/NNG@$물가/NNG@$기조/NNG,1,0.9921509047630606,44,38,6,37,0.8107927054134327,0.003300056141857015
달러화/NNG@$약세/NNG@$지속/NNG,1,0.9919319113402214,24,21,3,26,0.5859313916264396,0.0024495088743917135
지속/NNG@$물가/NNG@$기조/NNG@$유지/NNG,1,0.9902992834198301,48,41,7,48,0.8396095562036201,0.004201568078981264
성장/NNG@$지속/NNG@$물가/NNG@$기조/NNG@$유지/NNG,1,0.9893782719308035,47,40,7,47,0.8302623968726417,0.004541066765242544
물가/NNG@$경기/NNG@$금융시장/NNG,1,0.9881755080645545,40,34,6,15,0.7667322158170411,0.004659932245269026
유동성/NNG@$증가/NNG@$속도/NNG,1,0.9864631595655577,73,61,12,20,0.9571296190947554,0.006647101464148829
자본/NNG@$유출입/NNG@$규제/NNG,1,0.983897936742584,104,86,18,48,0.9940979372735097,0.008198049983694458
환율/NNG@$등가격/NNG@$변수/NNG,1,0.983384335036902,26,22,4,21,0.601388683304583,0.005116487878245271
제조업/NNG@$서비스업/NNG@$생산/NNG,0,0.9826683295158158,14,12,2,6,0.4378766719584691,0.0038848257792520684
금리/NNG@$인상/NNG@$의미/NNG,1,0.9818699979947421,31,26,5,39,0.6614778406534355,0.006137403595099628
중소기업/NNG@$금융/NNG@$지원/NNG,1,0.980365292996964,41,34,7,17,0.7662702717528426,0.007697275975316728
수출/NNG@$민간/NNG@$소비/NNG,1,0.9789059962668063,30,25,5,13,0.6467609665618743,0.006978480121126012
기조/NNG@$유지/NNG@$필요/NNG@$있/VA,1,0.97571615366372,74,60,14,54,0.9525563213747832,0.011832369302215368
통화정책/NNG@$금융완화/NNG@$기조/NNG@$유지/NNG,1,0.9756320539716212,54,44,10,38,0.8640310162931809,0.010769968767331193
경로/NNG@$크/VA@$벗어나/VV@$않/VX,1,0.9752824768966182,29,24,5,32,0.6317423766895646,0.007987725964553887
수요/NNG@$물가/NNG@$상승/NNG@$압력/NNG@$크/VA,1,0.9724615678342623,43,35,8,37,0.7772579430135044,0.010953173183232535
엔/NNG@$캐리/NNG@$자금/NNG,1,0.9712758696101109,33,27,6,17,0.67534239709005,0.009928872418808693
경기/NNG@$완만/XR@$회복/NNG,1,0.970880506021546,52,42,10,42,0.8469542772201119,0.01262429205225805
부동산/NNG@$문제/NNG@$심각/XR,1,0.970880506021546,52,42,10,20,0.8469542772201119,0.01262429205225805
경제/NNG@$내수/NNG@$회복세/NNG,1,0.9708188144526153,28,23,5,26,0.6164365337255818,0.009207887719834667
시중/NNG@$유동성/NNG@$증가세/NNG,1,0.9691627955484188,42,34,8,6,0.7655908533069009,0.012089254661445642
성장/NNG@$경로/NNG@$불확실성/NNG@$상존/NNG,1,0.9691627955484188,42,34,8,18,0.7655908533069009,0.012089254661445642
경로/NNG@$불확실성/NNG@$상존/NNG,1,0.9691627955484188,42,34,8,18,0.7655908533069009,0.012089254661445642
요인/NNG@$크/VA@$않/VX,1,0.965277262222149,27,22,5,25,0.6008589253758995,0.010694624917303313
경기/NNG@$상승세/NNG@$지속/NNG@$수요/NNG,1,0.9640607238722343,22,18,4,21,0.5370571165449101,0.009897568742475906
기조/NNG@$유지/NNG@$경기/NNG@$회복세/NNG,1,0.9640607238722343,22,18,4,30,0.5370571165449101,0.009897568742475906
기준금리/NNG@$유지/NNG@$경제/NNG,1,0.9640607238722343,22,18,4,13,0.5370571165449101,0.009897568742475906
물가/NNG@$낮/VA@$유지/NNG,1,0.9611316442635824,31,25,6,15,0.6461054539558737,0.012889952839761343
경제/NNG@$성장/NNG@$가능/NNG,1,0.9600697831006895,62,49,13,38,0.8982263197487707,0.018416099800758794
투자/NNG@$증권/NNG@$동결/NNG,1,0.9557094135190236,39,31,8,54,0.7282796170567735,0.01658862149466465
경기/NNG@$회복/NNG@$진행/NNG,1,0.9524531219761396,47,37,10,19,0.7976443125928103,0.019529092374241698
전망/NNG@$불확실성/NNG@$높/VA,1,0.9524531219761396,47,37,10,13,0.7976443125928103,0.019529092374241698
소비자/NNG@$물가/NNG@$경기/NNG,0,0.9520419005831497,16,13,3,24,0.45417259230889045,0.01121772760939066
등가격/NNG@$변수/NNG@$변동성/NNG,0,0.9506683188377765,11,9,2,12,0.3879047090942727,0.00986082963280072
물가/NNG@$농산물/NNG@$가격/NNG,0,0.9506683188377765,11,9,2,19,0.3879047090942727,0.00986082963280072
수요/NNG@$압력/NNG@$증대/NNG,1,0.9502173272922341,55,43,12,51,0.8536536883829214,0.021902929532856108
상승/NNG@$압력/NNG@$크/VA@$않/VX@$전망/NNG,1,0.9496365357862528,38,30,8,27,0.7150793587777351,0.018565875833730486
경제/NNG@$성장세/NNG@$약화/NNG,1,0.9496000424647586,25,20,5,33,0.5689540503617858,0.014782894663280987
경기동행지수/NNG@$순환/NNG@$변동치/NNG,1,0.9433738339798825,20,16,4,23,0.5038286572367423,0.014746742826399175
성장/NNG@$하향/NNG@$리스크/NNG,1,0.9433738339798825,20,16,4,9,0.5038286572367423,0.014746742826399175
잠재적/NNG@$불안/NNG@$요인/NNG,1,0.938493241691265,24,19,5,26,0.5526603331293468,0.017608066903483044
채무/NNG@$상환/NNG@$능력/NNG,1,0.9358915383496336,28,22,6,26,0.5999439696496187,0.019946450996627403
상승/NNG@$기조/NNG@$갈/VX@$전망/NNG,1,0.9358915383496336,28,22,6,25,0.5999439696496187,0.019946450996627403
경제/NNG@$견조/NNG@$성장/NNG@$지속/NNG@$물가/NNG,1,0.9345773690137851,56,43,13,36,0.8522256602683244,0.028932226742049223
콜금리/NNG@$인상/NNG@$결정/NNG,1,0.9301509647857611,75,57,18,32,0.9358900864398652,0.03399149873046953
상승세/NNG@$지속/NNG@$수요/NNG,1,0.9242894096602481,23,18,5,22,0.5361608139984239,0.021165710371205904
개별소비세/NNG@$인하/NNG@$종료/NNG,1,0.9242894096602481,23,18,5,18,0.5361608139984239,0.021165710371205904
지준/NNG@$금리/NNG@$인하/NNG,1,0.9242894096602481,23,18,5,43,0.5361608139984239,0.021165710371205904
경제/NNG@$전망/NNG@$물가/NNG,1,0.923448175520418,31,24,7,21,0.6298607957391054,0.02515097490717284
동결/NNG@$기준금리/NNG@$인상/NNG,1,0.923448175520418,31,24,7,37,0.6298607957391054,0.02515097490717284
경제/NNG@$심리/NNG@$위축/NNG,1,0.9217730506914021,54,41,13,27,0.8339041227880086,0.03405446800695011
경제/NNG@$성장/NNG@$뒷받침/NNG,1,0.9187835894818803,46,35,11,31,0.7735936926259065,0.032845917284082954
압력/NNG@$크/VA@$않/VX@$전망/NNG,1,0.9168979620717419,42,32,10,31,0.7384432535715871,0.0321106433672575
물가/NNG@$상승/NNG@$압력/NNG@$크/VA@$않/VX,1,0.9139395800492636,68,51,17,69,0.9051071434061407,0.04081763315281619
전망/NNG@$대외/NNG@$경제/NNG,0,0.9105098788568526,14,11,3,36,0.42045329226272055,0.019749948235976835
물가/NNG@$수요/NNG@$압력/NNG,1,0.9099466112214385,30,23,7,16,0.6143341242431656,0.029046779606327903
유지/NNG@$민간/NNG@$소비/NNG,1,0.9099466112214385,30,23,7,17,0.6143341242431656,0.029046779606327903
금리/NNG@$인상/NNG@$확대/NNG,1,0.9099466112214385,30,23,7,25,0.6143341242431656,0.029046779606327903
물가/NNG@$상승/NNG@$압력/NNG@$지속/NNG,1,0.9084609997881559,56,42,14,32,0.8413823226648555,0.040467880559478905
시장/NNG@$콜금리/NNG@$인상/NNG,1,0.9084609997881559,56,42,14,23,0.8413823226648555,0.040467880559478905
기준금리/NNG@$결정/NNG@$전문가별/NNG,1,0.9063301954153953,41,31,10,47,0.7253893369904225,0.03573870712719761
체감/NNG@$경기/NNG@$개선/NNG,1,0.905528176831718,63,47,16,33,0.8793469336159818,0.04371224772567257
금리/NNG@$인상/NNG@$부작용/NNG,1,0.9026858696524087,37,28,9,31,0.685950784846658,0.035174089951722456
콜/NNG@$목표/NNG@$금리/NNG,1,0.9000315018192144,55,41,14,23,0.8318941397101127,0.04387940770586034
실물/NNG@$지표/NNG@$개선/NNG,1,0.8984467815346513,33,25,8,15,0.6435372283959243,0.03450973763785518
필요/NNG@$있/VA@$통화정책/NNG,1,0.8984467815346513,33,25,8,17,0.6435372283959243,0.03450973763785518
콜금리/NNG@$인상/NNG@$경기/NNG,1,0.8963962116360429,51,38,13,30,0.8033926967196834,0.04399721291976674
금융완화/NNG@$기조/NNG@$유지/NNG@$경기/NNG,1,0.894158648054781,40,30,10,24,0.7119291418268064,0.039875257832463866
시장/NNG@$금리/NNG@$인상/NNG@$전망/NNG,1,0.8935929520028236,29,22,7,22,0.5984984368386512,0.03371078185414511
수출/NNG@$높/VA@$신장세/NNG,1,0.8919953660278221,47,35,12,22,0.7715787056586456,0.0441477836345429
동결/NNG@$경기/NNG@$회복/NNG,1,0.8885913205958262,36,27,9,30,0.671478892920423,0.039699754744069386
콜금리/NNG@$목표/NNG@$인상/NNG,1,0.8880036045536128,108,79,29,36,0.9765386620847832,0.058057692736732544
경제/NNG@$완만/XR@$회복세/NNG@$갈/VX,1,0.8824554345133513,21,16,5,23,0.5025993068949233,0.03145004412160521
자금/NNG@$단기화/NNG@$현상/NNG,1,0.8824554345133513,21,16,5,20,0.5025993068949233,0.03145004412160521
서비스/NNG@$금리/NNG@$비교/NNG@$장기금리/NNG@$국채/NNG,1,0.8818782329223247,32,24,8,65,0.628159060487731,0.03951162329310806
상승/NNG@$수요/NNG@$압력/NNG,1,0.8818782329223247,32,24,8,43,0.628159060487731,0.03951162329310806
경기/NNG@$회복/NNG@$확신/NNG,1,0.8795167961376735,99,72,27,47,0.9676011537665532,0.06215481283689491
규모/NNG@$축소/NNG@$시작/NNG,0,0.8739934211790339,13,10,3,41,0.4035630332982999,0.02718901830916376
물가/NNG@$보/VV@$소비자/NNG,0,0.8739934211790339,13,10,3,4,0.4035630332982999,0.02718901830916376
물가/NNG@$잡/VV@$금리/NNG,1,0.8721278525630083,35,26,9,35,0.6566260335306846,0.04493683289018944
인상/NNG@$물가/NNG@$상승/NNG@$압력/NNG,1,0.8721278525630083,35,26,9,16,0.6566260335306846,0.04493683289018944
기준금리/NNG@$인상/NNG@$물가/NNG,1,0.8715182664441521,66,48,18,52,0.8820542694424046,0.060671165827660974
경제/NNG@$활력/NNG@$제고/NNG,1,0.8639462806895692,24,18,6,33,0.5346109650939785,0.03909359818359304
금융시장/NNG@$불안/NNG@$모습/NNG,1,0.8622066303461147,31,23,8,30,0.6124374543787968,0.045398599851886635
수출/NNG@$높/VA@$증가세/NNG,1,0.8622066303461147,31,23,8,7,0.6124374543787968,0.045398599851886635
기준금리/NNG@$동결/NNG@$물가/NNG,1,0.8622066303461147,31,23,8,39,0.6124374543787968,0.045398599851886635
원자재/NNG@$가격/NNG@$오르/VV,1,0.8558982539671551,51,37,14,24,0.7897374833718293,0.061424575698546306
결정/NNG@$영향/NNG@$않/VX,1,0.8529080247464171,34,25,9,20,0.6413949236710357,0.051002211779265734
비교/NNG@$장기금리/NNG@$국채/NNG,1,0.8529080247464171,34,25,9,73,0.6413949236710357,0.051002211779265734
금리/NNG@$비교/NNG@$장기금리/NNG@$국채/NNG,1,0.8529080247464171,34,25,9,73,0.6413949236710357,0.051002211779265734
호조/NNG@$지속/NNG@$경제/NNG,1,0.8529080247464171,34,25,9,21,0.6413949236710357,0.051002211779265734
성장/NNG@$모멘텀/NNG@$유지/NNG,0,0.8520196556155237,20,15,5,19,0.48555503674083106,0.038861598616454926
기조/NNG@$유지/NNG@$바람직/XR,0,0.8520196556155237,20,15,5,24,0.48555503674083106,0.038861598616454926
요인/NNG@$자본/NNG@$유출입/NNG,0,0.8520196556155237,20,15,5,31,0.48555503674083106,0.038861598616454926
유지/NNG@$기준금리/NNG@$동결/NNG,0,0.8520196556155237,20,15,5,35,0.48555503674083106,0.038861598616454926
채권/NNG@$기준금리/NNG@$전망/NNG,1,0.8497512583836107,27,20,7,33,0.5659310848421271,0.046044024059921175
자금/NNG@$채권/NNG@$시장/NNG,1,0.8497512583836107,27,20,7,22,0.5659310848421271,0.046044024059921175
금리/NNG@$인상/NNG@$이어지/VV,1,0.845365279858157,37,27,10,24,0.669112497295277,0.05615839062627965
부진/NNG@$경기/NNG@$회복세/NNG,1,0.845365279858157,37,27,10,23,0.669112497295277,0.05615839062627965
금융/NNG@$경제/NNG@$고려/NNG,1,0.8410623422060826,83,59,24,66,0.9312913488944542,0.08052206508375397
인상/NNG@$시장/NNG@$금리/NNG,1,0.8401727147408453,93,66,27,51,0.9507712203883755,0.08270569569981119
장기금리/NNG@$단기금리/NNG@$등락/NNG,1,0.8400919788004382,63,45,18,118,0.8577139196066418,0.07465172942687179
단기금리/NNG@$등락/NNG@$장기금리/NNG@$국채/NNG,1,0.8400919788004382,63,45,18,118,0.8577139196066418,0.07465172942687179
통화정책/NNG@$완화/NNG@$기조/NNG@$유지/NNG,1,0.8400919788004382,63,45,18,88,0.8577139196066418,0.07465172942687179
동결/NNG@$인상/NNG@$가능성/NNG,1,0.8391711762089613,40,29,11,16,0.6954939453697025,0.06091128067459372
금리/NNG@$인상/NNG@$늦/VA,1,0.8388820320732866,30,22,8,24,0.5963766880408119,0.0523325798673239
금융/NNG@$외환시장/NNG@$불안/NNG,0,0.8374956236603142,16,12,4,29,0.4359499791718942,0.038612755155494616
인하/NNG@$효과/NNG@$지켜볼/VV,1,0.8338208516793373,23,17,6,44,0.5176700016197566,0.046979954022130926
저축/NNG@$은행/NNG@$부실/NNG,1,0.8338208516793373,23,17,6,27,0.5176700016197566,0.046979954022130926
동결/NNG@$금리/NNG@$인상/NNG@$가능성/NNG,1,0.8305060006772322,33,24,9,26,0.6257876190545597,0.058027888420961966
정책/NNG@$기조/NNG@$전환/NNG,1,0.8305060006772322,33,24,9,39,0.6257876190545597,0.058027888420961966
회복세/NNG@$갈/VX@$전망/NNG,1,0.8296325682864609,46,33,13,55,0.7439860478092473,0.06937622866197032
점진적/NNG@$기준금리/NNG@$인상/NNG,1,0.8239777775709505,36,26,10,24,0.6540286969478087,0.06320429440467618
동결/NNG@$경기/NNG@$둔화/NNG,1,0.8239777775709505,36,26,10,22,0.6540286969478087,0.06320429440467618
물가/NNG@$상승/NNG@$기대/NNG,1,0.8222029953400003,68,48,20,61,0.8758114570804819,0.08557239775838794
가계부채/NNG@$문제/NNG@$해결/NNG,1,0.8207337354901392,26,19,7,42,0.5492096945600822,0.05414775952539679
경제/NNG@$소비/NNG@$투자/NNG,1,0.8207337354901392,26,19,7,18,0.5492096945600822,0.05414775952539679
지속/NNG@$경제/NNG@$성장/NNG,1,0.8207337354901392,26,19,7,19,0.5492096945600822,0.05414775952539679
내수/NNG@$회복세/NNG@$약화/NNG,0,0.81975912988885,12,9,3,37,0.3866269699428662,0.03834584036143451
필요/NNG@$의견/NNG@$제시/NNG,0,0.81975912988885,12,9,3,18,0.3866269699428662,0.03834584036143451
필요/NNG@$있/VA@$의견/NNG@$제시/NNG,0,0.81975912988885,12,9,3,12,0.3866269699428662,0.03834584036143451
통화정책/NNG@$기준금리/NNG@$인상/NNG,1,0.8143736279123803,61,43,18,60,0.839426018234275,0.08599315077177302
기준금리/NNG@$동결/NNG@$통화정책/NNG@$방향/NNG,0,0.8128577900259508,19,14,5,33,0.46833504316931235,0.048409233154510435
제로/NNG@$금리/NNG@$유지/NNG,1,0.8113063382855898,29,21,8,25,0.5799791450966297,0.06049734667242396
물가/NNG@$기준금리/NNG@$인상/NNG,1,0.8113063382855898,29,21,8,36,0.5799791450966297,0.06049734667242396
경기/NNG@$해외/NNG@$위험/NNG@$요인/NNG@$상존/NNG,1,0.8113063382855898,29,21,8,29,0.5799791450966297,0.06049734667242396
위험/NNG@$금리/NNG@$인상/NNG,1,0.8112308173316247,45,32,13,23,0.7307634955913442,0.07625923512320308
해외/NNG@$위험/NNG@$요인/NNG@$상존/NNG,1,0.8044687912223663,32,23,9,30,0.6098049476292571,0.06615994810025294
인상/NNG@$원화/NNG@$강세/NNG,1,0.8036758847065562,54,38,16,17,0.7944692038311926,0.08658195217816032
상승/NNG@$압력/NNG@$지속/NNG,1,0.8035921259076368,92,64,28,50,0.940177705939834,0.1025098085618153
요인/NNG@$금리/NNG@$인상/NNG,1,0.8016131415145857,79,55,24,58,0.9097392241814259,0.10029918849217025
매파적/NNG@$금리/NNG@$인상/NNG,1,0.7994582051354864,35,25,10,16,0.6385382028357302,0.07124805365476693
금리/NNG@$인상/NNG@$시기/NNG@$결정/NNG,1,0.7965609609352728,22,16,6,29,0.500491531978374,0.05674191469619281
거시/NNG@$정책/NNG@$기조/NNG@$유지/NNG,1,0.795734964614861,38,27,11,18,0.6660557914176006,0.07585340128171289
주택/NNG@$가격/NNG@$상승세/NNG,1,0.7932598618250029,72,50,22,48,0.8836869002487509,0.1019966678848872
경기/NNG@$회복/NNG@$물가/NNG@$상승/NNG,1,0.7907320641844442,44,31,13,28,0.7170795833433196,0.0838955232040106
장단기/NNG@$금리/NNG@$격차/NNG,1,0.7889860265113282,47,33,14,18,0.7404642587564494,0.08743860482737703
금리/NNG@$인상/NNG@$가계/NNG,1,0.7841199945769557,59,41,18,37,0.8193744862576282,0.09925525174969656
경기/NNG@$상승/NNG@$수요/NNG@$압력/NNG,0,0.7839370886940205,15,11,4,37,0.41869809961588356,0.05076728414541152
물가/NNG@$안정세/NNG@$보이/VV,1,0.7790164558104256,74,51,23,31,0.8870303219909209,0.11030341448320065
동결/NNG@$기준금리/NNG@$인하/NNG,1,0.7788613292983122,28,20,8,45,0.563244229350759,0.0700953988453384
기록/NNG@$소비자/NNG@$물가/NNG,1,0.7788613292983122,28,20,8,30,0.563244229350759,0.0700953988453384
물가/NNG@$상방/NNG@$리스크/NNG,1,0.7788613292983122,28,20,8,13,0.563244229350759,0.0700953988453384
장단기/NNG@$금리/NNG@$역전/NNG,1,0.7743364931460612,31,22,9,32,0.5934457545180017,0.0755555216711427
기조/NNG@$유지/NNG@$기준금리/NNG,1,0.7696591050055204,37,26,11,23,0.6506865677575374,0.08478184369306041
문제/NNG@$경기/NNG@$회복/NNG,1,0.7696591050055204,37,26,11,9,0.6506865677575374,0.08478184369306041
금리/NNG@$올릴/VV@$있/VA,1,0.7696591050055204,37,26,11,15,0.6506865677575374,0.08478184369306041
인상/NNG@$가능성/NNG@$배제/NNG@$않/VX,1,0.7685776628641316,40,28,12,28,0.6774780215695227,0.08874085686493137
국면/NNG@$예고/NNG@$선행지수/NNG,1,0.767420949196471,49,34,15,28,0.7495818264592258,0.09874030441376325
경기/NNG@$국면/NNG@$예고/NNG@$선행지수/NNG,1,0.767420949196471,49,34,15,28,0.7495818264592258,0.09874030441376325
기준금리/NNG@$인상/NNG@$적절/XR,1,0.7673076937329764,52,36,16,54,0.7707285887256612,0.10158179992496882
경제/NNG@$전망/NNG@$개선/NNG,0,0.7629434220507267,18,13,5,27,0.4509237387786612,0.06069491293122853
개선/NNG@$추세/NNG@$이어지/VV,0,0.7629434220507267,18,13,5,21,0.4509237387786612,0.06069491293122853
금리/NNG@$인상/NNG@$유동성/NNG,1,0.7509559161303101,69,47,22,98,0.8593600029006301,0.12234565106956892
유로존/NNG@$국채/NNG@$금리/NNG,0,0.7509009843624843,21,15,6,39,0.4830649403006882,0.06879046171809218
체감/NNG@$경기/NNG@$회복/NNG,1,0.7486829421189114,57,39,18,31,0.7974609827812266,0.11471720862934459
인플레이션/NNG@$압력/NNG@$증가/NNG,1,0.7477241451322081,54,37,17,34,0.7785189542718184,0.11248082608628361
경기/NNG@$회복/NNG@$자신감/NNG,1,0.7457685771992686,108,73,35,61,0.9462789068645057,0.13793190591897198
경기/NNG@$회복/NNG@$불확실성/NNG,1,0.7453898293066372,48,33,15,31,0.7362885318095241,0.10750624584864174
발생/NNG@$가능성/NNG@$낮/VA,1,0.7442731071963538,24,17,7,27,0.5148863375845887,0.07555682111446332
채권/NNG@$투자/NNG@$과세/NNG,1,0.7442731071963538,24,17,7,26,0.5148863375845887,0.07555682111446332
통화정책/NNG@$완화/NNG@$축소/NNG,1,0.7442731071963538,24,17,7,17,0.5148863375845887,0.07555682111446332
성장세/NNG@$둔화/NNG@$우려/NNG,1,0.7442731071963538,24,17,7,30,0.5148863375845887,0.07555682111446332
문제/NNG@$국제금융시장/NNG@$불안/NNG,1,0.7440698309565656,45,31,14,13,0.7130028215304006,0.10472464577511865
주택/NNG@$가격/NNG@$상승률/NNG,1,0.7427170719814475,42,29,13,42,0.6883020029310433,0.1017093330337966
물가/NNG@$상승/NNG@$압력/NNG@$커질/VV,1,0.7414215471257124,39,27,12,29,0.6622360144198672,0.09842301771763143
선제적/NNG@$대응/NNG@$필요/NNG,1,0.7414215471257124,39,27,12,19,0.6622360144198672,0.09842301771763143
확장적/NNG@$정책/NNG@$기조/NNG,1,0.7414215471257124,39,27,12,42,0.6622360144198672,0.09842301771763143
경제/NNG@$호조/NNG@$지속/NNG,1,0.740321950364293,36,25,11,32,0.6348781229938966,0.09481773892354375
콜금리/NNG@$동결/NNG@$경기/NNG,1,0.740321950364293,36,25,11,14,0.6348781229938966,0.09481773892354375
경기/NNG@$회복세/NNG@$유지/NNG,1,0.740321950364293,36,25,11,31,0.6348781229938966,0.09481773892354375
증가/NNG@$경기/NNG@$회복/NNG,1,0.7396738246293995,30,21,9,23,0.5767058931498258,0.08637675638684011
수요/NNG@$압력/NNG@$높/VA,1,0.7396738246293995,30,21,9,14,0.5767058931498258,0.08637675638684011
기준금리/NNG@$인상/NNG@$지연/NNG,1,0.7396738246293995,30,21,9,40,0.5767058931498258,0.08637675638684011
채권/NNG@$시장/NNG@$기준금리/NNG@$인상/NNG,1,0.7396306972121698,33,23,10,22,0.6063266095927176,0.09083051287122287
통화정책/NNG@$방향/NNG@$경기/NNG,1,0.7371589899983981,77,52,25,39,0.8854544630643303,0.1340936089381481
금리/NNG@$인상/NNG@$요인/NNG,1,0.7337763232761545,65,44,21,36,0.8362599764579898,0.12852205997195443
금리/NNG@$인상/NNG@$시그널/NNG,1,0.7329431842481915,122,82,40,95,0.9518942434600633,0.14682143281352605
고용/NNG@$시장/NNG@$호조/NNG,1,0.7257957421893815,94,63,31,78,0.9238274324412763,0.14690815077025415
가격/NNG@$경쟁력/NNG@$약화/NNG,1,0.7241252916840692,50,34,16,41,0.7450332547500294,0.11931263264680593
시중/NNG@$유동성/NNG@$흡수/NNG,1,0.7233879008274977,79,53,26,27,0.8879010006105529,0.14263275701467903
금리/NNG@$인상/NNG@$배경/NNG,1,0.7213287871856251,47,32,15,34,0.7224973729567302,0.11706527361936798
임금/NNG@$인상/NNG@$요구/NNG,1,0.7182358247104133,44,30,14,36,0.6985379224135725,0.11464417984859233
상승/NNG@$압력/NNG@$커질/VV,1,0.7157949195923086,64,43,21,49,0.8261711064103245,0.13695944390601344
소폭/NNG@$하향/NNG@$조정/NNG,1,0.7148651678787241,41,28,13,46,0.6731941680339952,0.11202497236725929
인플레/NNG@$기대/NNG@$심리/NNG,1,0.7085424246384255,255,170,85,273,0.9536061989343838,0.16280364217428325
경제/NNG@$리스크/NNG@$요인/NNG,1,0.7074932248463734,35,24,11,34,0.6186239481807901,0.10605904832673184
제시/NNG@$금리/NNG@$인상/NNG,1,0.7074932248463734,35,24,11,17,0.6186239481807901,0.10605904832673184
증권/NNG@$기준금리/NNG@$인상/NNG,1,0.7074932248463734,35,24,11,31,0.6186239481807901,0.10605904832673184
지속/NNG@$소비자/NNG@$물가/NNG,1,0.7074932248463734,35,24,11,22,0.6186239481807901,0.10605904832673184
금리/NNG@$인상/NNG@$기준금리/NNG,1,0.7067461368264885,75,50,25,63,0.8699054591106493,0.14958564756632164
금리/NNG@$인상/NNG@$앞두/VV,1,0.703819826045343,52,35,17,49,0.753225947695272,0.13103785431987422
경기/NNG@$위축/NNG@$가능성/NNG,1,0.7037034964362865,32,22,10,22,0.5895944400258772,0.10261832539257722
유지/NNG@$경기/NNG@$회복세/NNG,1,0.7037034964362865,32,22,10,47,0.5895944400258772,0.10261832539257722
고용/NNG@$지표/NNG@$부진/NNG,1,0.7031567509041834,101,67,34,64,0.9283959474629653,0.16193626176113865
거시/NNG@$건전성/NNG@$조치/NNG,0,0.7004165174032546,17,12,5,38,0.4332839970659861,0.07639588625974444
재정위기/NNG@$경기/NNG@$둔화/NNG,1,0.7001141483142557,29,20,9,29,0.5595768691824179,0.09878068565950426
목표/NNG@$하향/NNG@$조정/NNG,1,0.7001141483142557,29,20,9,31,0.5595768691824179,0.09878068565950426
비용/NNG@$상승/NNG@$압력/NNG,1,0.7001141483142557,29,20,9,26,0.5595768691824179,0.09878068565950426
제기/NNG@$금리/NNG@$인하/NNG,1,0.697099264395078,26,18,8,25,0.5287355513093471,0.09444134520545738
금융/NNG@$위기/NNG@$낮/VA,1,0.697099264395078,26,18,8,32,0.5287355513093471,0.09444134520545738
경제/NNG@$금리/NNG@$동결/NNG,1,0.697099264395078,26,18,8,27,0.5287355513093471,0.09444134520545738
고용/NNG@$취업자/NNG@$증가/NNG,0,0.6952863756245968,23,16,7,28,0.49726045352079135,0.08944602216471038
경기/NNG@$회복/NNG@$긍정적/NNG,1,0.6951341587036663,46,31,15,31,0.7081986076782224,0.1274640987866173
가계/NNG@$대출/NNG@$증가세/NNG,1,0.6899886662811237,43,29,14,34,0.6835717950197369,0.12548729720690163
재정/NNG@$건전성/NNG@$확보/NNG,1,0.6899886662811237,43,29,14,43,0.6835717950197369,0.12548729720690163
불안/NNG@$요인/NNG@$남/VV,1,0.6842640460072715,40,27,13,29,0.6575960003923477,0.12336391269873101
인상/NNG@$시기/NNG@$지연/NNG,1,0.6842640460072715,40,27,13,27,0.6575960003923477,0.12336391269873101
미/NNG@$금리/NNG@$역전/NNG,1,0.6842640460072715,40,27,13,11,0.6575960003923477,0.12336391269873101
기준금리/NNG@$인상/NNG@$결정/NNG,1,0.6805764315611573,152,100,52,62,0.9464336740961454,0.18001544398378608
고용/NNG@$지표/NNG@$예상/NNG,1,0.678690451429284,99,65,34,40,0.9192318924284223,0.17607060984983797
완화적/NNG@$기조/NNG@$유지/NNG,1,0.6779366396213145,37,25,12,29,0.6303443842763544,0.1210741929585363
가능성/NNG@$낮/VA@$보/VX,1,0.6779366396213145,37,25,12,31,0.6303443842763544,0.1210741929585363
물가/NNG@$상승/NNG@$압력/NNG@$금리/NNG,1,0.6779366396213145,37,25,12,21,0.6303443842763544,0.1210741929585363
물가/NNG@$자산/NNG@$가격/NNG,1,0.6762229896656147,62,41,21,23,0.8045293063544167,0.1555113600376371
금리/NNG@$인상/NNG@$자제/NNG,1,0.6762229896656147,62,41,21,50,0.8045293063544167,0.1555113600376371
동향/NNG@$금리/NNG@$인상/NNG,1,0.6733632345334597,48,32,16,25,0.7172988248884067,0.1401128203065174
경제/NNG@$회복세/NNG@$지속/NNG,1,0.672843932222754,73,48,25,99,0.8526374269693291,0.16686540132355063
경상수지/NNG@$흑자/NNG@$기조/NNG,1,0.672843932222754,73,48,25,68,0.8526374269693291,0.16686540132355063
금리/NNG@$인상/NNG@$인플레이션/NNG,1,0.6714255737721602,59,39,20,61,0.7869783543939038,0.15481403462934437
주의/NNG@$필요/NNG@$있/VA,1,0.6709983398919648,34,23,11,32,0.6019148677403557,0.11859257836734392
상향/NNG@$조정/NNG@$예상/NNG,1,0.663468559112826,31,21,10,22,0.5724313098076635,0.11588492210319414
정책/NNG@$기조/NNG@$변경/NNG,1,0.663468559112826,31,21,10,34,0.5724313098076635,0.11588492210319414
강구/NNG@$필요/NNG@$있/VA,1,0.663468559112826,31,21,10,25,0.5724313098076635,0.11588492210319414
통화정책/NNG@$방향/NNG@$논의/NNG@$기준금리/NNG,1,0.6554146287905112,28,19,9,32,0.5420440005963644,0.11290392797402367
소비/NNG@$회복/NNG@$조짐/NNG,1,0.6554146287905112,28,19,9,19,0.5420440005963644,0.11290392797402367
시중/NNG@$자금/NNG@$단기/NNG@$부동화/NNG,1,0.6554146287905112,28,19,9,22,0.5420440005963644,0.11290392797402367
방향/NNG@$논의/NNG@$기준금리/NNG,1,0.6554146287905112,28,19,9,32,0.5420440005963644,0.11290392797402367
콜금리/NNG@$인상/NNG@$단행/NNG,1,0.6545095140518742,72,47,25,28,0.8433199437833829,0.17621495990013664
결정/NNG@$금융/NNG@$통화/NNG,1,0.6528477234011394,50,33,17,46,0.7258547465225377,0.15255233847388217
회복/NNG@$찬물/NNG@$끼얹/VV,1,0.6508187822410461,39,26,13,15,0.6414974776561196,0.13577707863604918
경기/NNG@$부정적/NNG@$영향/NNG,1,0.6497628182764879,69,45,24,50,0.8296545504409648,0.17624510724224593
물가/NNG@$목표/NNG@$하단/NNG,1,0.6469878029259188,25,17,8,29,0.5109293215268791,0.10958133375592581
회복세/NNG@$찬물/NNG@$끼얹/VV,1,0.6469878029259188,25,17,8,32,0.5109293215268791,0.10958133375592581
건강/NNG@$보험/NNG@$개혁/NNG,1,0.6469878029259188,25,17,8,33,0.5109293215268791,0.10958133375592581
개선/NNG@$모습/NNG@$보이/VV,1,0.6449573710908791,47,31,16,37,0.7026393047579006,0.1517514463061926
주택/NNG@$착공/NNG@$실적/NNG,1,0.6449573710908791,47,31,16,46,0.7026393047579006,0.1517514463061926
기준금리/NNG@$인상/NNG@$가능성/NNG@$시사/NNG,1,0.6449573710908791,47,31,16,35,0.7026393047579006,0.1517514463061926
경기/NNG@$완만/XR@$회복세/NNG,1,0.6413591634580604,36,24,12,48,0.6136754303111457,0.13417330383048326
동결/NNG@$결정/NNG@$금리/NNG,1,0.6413591634580604,36,24,12,19,0.6136754303111457,0.13417330383048326
광/NNG@$통화/NNG@$증가율/NNG,1,0.6413591634580604,36,24,12,25,0.6136754303111457,0.13417330383048326
성장/NNG@$경로/NNG@$불확실성/NNG@$높/VA,1,0.6401267329828322,85,55,30,94,0.8806349400415867,0.19334735935284011
결정/NNG@$기준금리/NNG@$유지/NNG,0,0.6384899090171001,22,15,7,28,0.4792884822086669,0.10581380622352492
성장세/NNG@$보일/VV@$전망/NNG,0,0.6384899090171001,22,15,7,30,0.4792884822086669,0.10581380622352492
변수/NNG@$변동성/NNG@$확대/NNG,0,0.6384899090171001,22,15,7,23,0.4792884822086669,0.10581380622352492
대외/NNG@$불확실성/NNG@$확대/NNG,1,0.6360310966844127,44,29,15,23,0.6780362668998269,0.15093576739800757
금리/NNG@$격차/NNG@$축소/NNG,1,0.6335003896069589,52,34,18,17,0.7338835444413014,0.16475770515851648
소수/NNG@$의견/NNG@$등장/NNG,1,0.6307431312707279,33,22,11,35,0.5847379714720752,0.13248486232003692
상승률/NNG@$높/VA@$않/VX,1,0.6307431312707279,33,22,11,24,0.5847379714720752,0.13248486232003692
자본/NNG@$유출/NNG@$환율/NNG,1,0.6307431312707279,33,22,11,16,0.5847379714720752,0.13248486232003692
경로/NNG@$불확실성/NNG@$높/VA,1,0.6278321565199159,87,56,31,97,0.8819177882293919,0.2017515103068677
물가/NNG@$목표/NNG@$근접/NNG,0,0.6241805180848932,16,11,5,17,0.4153437502131486,0.09616324242233855
금융시장/NNG@$기준금리/NNG@$인하/NNG,0,0.6241805180848932,16,11,5,17,0.4153437502131486,0.09616324242233855
저금리/NNG@$기조/NNG@$유지/NNG,1,0.6221404016975136,216,139,77,206,0.9347422064618345,0.2178655787668761
소매/NNG@$판매/NNG@$설비투자/NNG,0,0.6219053900585052,13,9,4,23,0.38354470321344014,0.08946342416649196
방안/NNG@$강구/NNG@$필요/NNG@$있/VA,0,0.6219053900585052,13,9,4,6,0.38354470321344014,0.08946342416649196
인상/NNG@$쉽/VA@$않/VX,1,0.6199801015093946,117,75,42,73,0.9218505448685517,0.2163765382676724
정책/NNG@$결정/NNG@$영향/NNG,1,0.6188426267833047,30,20,10,23,0.5548204527655985,0.13070862120073384
인플레이션/NNG@$목표/NNG@$달성/NNG,1,0.6188426267833047,30,20,10,25,0.5548204527655985,0.13070862120073384
인상/NNG@$강하/VA@$시사/NNG,1,0.6188426267833047,30,20,10,24,0.5548204527655985,0.13070862120073384
대내외/NNG@$위험/NNG@$요인/NNG,1,0.6188426267833047,30,20,10,22,0.5548204527655985,0.13070862120073384
통화정책/NNG@$변화/NNG@$가능성/NNG,1,0.6188426267833047,30,20,10,20,0.5548204527655985,0.13070862120073384
원유/NNG@$재고/NNG@$증가/NNG,1,0.6188426267833047,30,20,10,27,0.5548204527655985,0.13070862120073384
영향/NNG@$금리/NNG@$인상/NNG,1,0.6188116954476595,81,52,29,61,0.8631573463894477,0.20336923622324599
금리/NNG@$인상/NNG@$단행/NNG@$예상/NNG,1,0.6152310828265395,54,35,19,41,0.7414030751188089,0.17671316343014282
소비자/NNG@$물가/NNG@$낮/VA,1,0.6144842713148342,38,25,13,37,0.6248864351063121,0.1492993760446319
공개/NNG@$금리/NNG@$인상/NNG,1,0.6144842713148342,38,25,13,64,0.6248864351063121,0.1492993760446319
필요성/NNG@$크/VA@$않/VX,1,0.6144776698670666,46,30,16,52,0.6874357132754916,0.16424728271198144
민간/NNG@$소비/NNG@$투자/NNG,1,0.6079725821077828,67,43,24,43,0.8081886862777891,0.19714880191080772
생산자/NNG@$물가/NNG@$소비자/NNG,1,0.6055168996757365,27,18,9,19,0.5240838896676074,0.12884158080961405
회복/NNG@$기조/NNG@$유지/NNG,1,0.6055168996757365,27,18,9,19,0.5240838896676074,0.12884158080961405
민간/NNG@$자생력/NNG@$회복/NNG,1,0.6055168996757365,27,18,9,64,0.5240838896676074,0.12884158080961405
필요/NNG@$있/VA@$권고/NNG,1,0.6055168996757365,27,18,9,37,0.5240838896676074,0.12884158080961405
금융/NNG@$경제/NNG@$위험/NNG@$요인/NNG,1,0.6055168996757365,27,18,9,34,0.5240838896676074,0.12884158080961405
금리/NNG@$인상/NNG@$원화/NNG,1,0.6054577269898711,51,33,18,24,0.7195600513666383,0.17693077536477128
부진/NNG@$금리/NNG@$인하/NNG,1,0.6054577269898711,51,33,18,35,0.7195600513666383,0.17693077536477128
금리/NNG@$동결/NNG@$요인/NNG,1,0.6054577269898711,51,33,18,26,0.7195600513666383,0.17693077536477128
불안/NNG@$모습/NNG@$보이/VV,1,0.6042159362486899,91,58,33,60,0.8837545816054326,0.21815636714094844
금리/NNG@$인상/NNG@$인하/NNG,1,0.6042159362486899,91,58,33,45,0.8837545816054326,0.21815636714094844
고용/NNG@$지표/NNG@$금리/NNG@$인상/NNG,1,0.6030351001658794,43,28,15,35,0.6621493218432817,0.1640608174900671
물가/NNG@$상승률/NNG@$기준/NNG,1,0.6015006495727835,35,23,12,26,0.5965065427906553,0.14850956644363994
마지막/NNG@$금리/NNG@$인상/NNG,1,0.6015006495727835,35,23,12,33,0.5965065427906553,0.14850956644363994
금리/NNG@$인상/NNG@$계획/NNG,1,0.6010254386534062,72,46,26,63,0.82692542296234,0.20618244580368753
금리/NNG@$인상/NNG@$가계부채/NNG,1,0.5979519966478475,56,36,20,36,0.7484316331213782,0.18840934436914075
전망/NNG@$물가/NNG@$상승률/NNG,1,0.5944130666902738,48,31,17,28,0.696308247295938,0.1772222410633371
인플레이션/NNG@$금리/NNG@$인상/NNG,1,0.5914039177041459,61,39,22,25,0.7740985188243047,0.19885726115661684
경제/NNG@$영향/NNG@$제한적/NNG,1,0.5914039177041459,61,39,22,41,0.7740985188243047,0.19885726115661684
기준금리/NNG@$인상/NNG@$이뤄질/VV,0,0.5906121474178476,24,16,8,38,0.4927138808482588,0.12688092620532077
원자재/NNG@$가격/NNG@$불안/NNG,0,0.5906121474178476,24,16,8,21,0.4927138808482588,0.12688092620532077
금리/NNG@$동반/NNG@$상승/NNG,0,0.5906121474178476,24,16,8,26,0.4927138808482588,0.12688092620532077
기조/NNG@$금리/NNG@$인상/NNG,0,0.5906121474178476,24,16,8,36,0.4927138808482588,0.12688092620532077
흑자/NNG@$기조/NNG@$지속/NNG,0,0.5906121474178476,24,16,8,16,0.4927138808482588,0.12688092620532077
건전성/NNG@$종/NNG@$세트/NNG,0,0.5906121474178476,24,16,8,28,0.4927138808482588,0.12688092620532077
콜금리/NNG@$인상/NNG@$예상/NNG,1,0.5900484029131112,40,26,14,17,0.6355595248744147,0.16394907098173206
금리/NNG@$인상/NNG@$증시/NNG,1,0.5900484029131112,40,26,14,29,0.6355595248744147,0.16394907098173206
대응/NNG@$금리/NNG@$인상/NNG,1,0.5876076515893034,74,47,27,55,0.8302528575033561,0.21577771377896218
금리/NNG@$인상/NNG@$이유/NNG,1,0.5874844327502633,53,34,19,19,0.7272574484922416,0.189080940059215
중소기업/NNG@$대출/NNG@$증가/NNG,1,0.5867378698917809,32,21,11,8,0.5670751960498164,0.14777101864371697
금리/NNG@$인상/NNG@$대외/NNG,1,0.5867378698917809,32,21,11,29,0.5670751960498164,0.14777101864371697
금리/NNG@$인상/NNG@$물가/NNG@$상승/NNG,1,0.5867378698917809,32,21,11,20,0.5670751960498164,0.14777101864371697
자금/NNG@$유입/NNG@$지속/NNG,1,0.5867378698917809,32,21,11,30,0.5670751960498164,0.14777101864371697
동결/NNG@$기조/NNG@$유지/NNG,1,0.5847166894759166,106,67,39,107,0.9019081590262349,0.23647322189665915
금리/NNG@$인상/NNG@$신중/NNG,1,0.5832129920780134,136,86,50,88,0.9204469479610824,0.24243726353573739
유지/NNG@$필요/NNG@$있/VA,1,0.5830137733916145,147,93,54,97,0.9225979272663033,0.24315048483972299
금리/NNG@$인상/NNG@$경로/NNG,1,0.5799348952611119,71,45,26,55,0.8163230399452845,0.21715160649284493
상승/NNG@$소비자/NNG@$물가/NNG,1,0.578766156904527,111,70,41,80,0.9054425508101891,0.24170695526229138
경기/NNG@$선행/NNG@$지표/NNG,1,0.5756829292192918,50,32,18,28,0.7046699387352328,0.1898576863098741
부동산/NNG@$경기/NNG@$회복/NNG,0,0.5739615238333504,21,14,7,25,0.46091839298984405,0.12482408496274316
자금/NNG@$해외/NNG@$유출/NNG,0,0.5739615238333504,21,14,7,51,0.46091839298984405,0.12482408496274316
금리/NNG@$동결/NNG@$인상/NNG,1,0.571393209977477,68,43,25,39,0.8011278812551164,0.21862206967123776
소비자/NNG@$물가/NNG@$안정세/NNG,1,0.5705493948539566,55,35,20,31,0.7344696157253732,0.20093375117057632
금리/NNG@$인상/NNG@$조건/NNG,1,0.5698983836077482,29,19,10,47,0.5367371861155972,0.14712220984542032
증가/NNG@$속도/NNG@$둔화/NNG,1,0.5698983836077482,29,19,10,27,0.5367371861155972,0.14712220984542032
금리/NNG@$인상/NNG@$걸림돌/NNG,1,0.5677414747942762,42,27,15,26,0.6457072487519291,0.17812317684375994
기준금리/NNG@$동결/NNG@$기조/NNG,1,0.5677414747942762,42,27,15,64,0.6457072487519291,0.17812317684375994
예상/NNG@$기준금리/NNG@$동결/NNG,1,0.5660405628438518,60,38,22,70,0.7610900664861352,0.2110069512378168
긴축/NNG@$기조/NNG@$전환/NNG,1,0.5660405628438518,60,38,22,34,0.7610900664861352,0.2110069512378168
인상/NNG@$시기/NNG@$전망/NNG,1,0.5660405628438518,60,38,22,52,0.7610900664861352,0.2110069512378168
금융/NNG@$통화정책/NNG@$열/VV@$기준금리/NNG,1,0.5623577158948296,47,30,17,53,0.6806865288616395,0.19076479864925996
기준금리/NNG@$인상/NNG@$시장/NNG,1,0.55981186820213,91,57,34,70,0.8698478914175896,0.2455953509631256
하향/NNG@$조정/NNG@$성장률/NNG,1,0.5584213137878318,34,22,12,27,0.5788189377243985,0.16408762368949253
체감/NNG@$경기/NNG@$좋/VA,1,0.5584213137878318,34,22,12,21,0.5788189377243985,0.16408762368949253
상승/NNG@$압력/NNG@$금리/NNG,1,0.5581471534722975,52,33,19,35,0.7125373190806474,0.20215593929430178
기준금리/NNG@$유지/NNG@$했/VV,1,0.5581471534722975,52,33,19,91,0.7125373190806474,0.20215593929430178
금리/NNG@$인상/NNG@$보/VV,1,0.5581471534722975,52,33,19,47,0.7125373190806474,0.20215593929430178
인플레/NNG@$우려/NNG@$금리/NNG,1,0.5545553346329328,57,36,21,26,0.7412144091755809,0.21249023112415294
물가/NNG@$하락/NNG@$압력/NNG,1,0.5545553346329328,57,36,21,47,0.7412144091755809,0.21249023112415294
재정/NNG@$문제/NNG@$국제금융시장/NNG,1,0.5516349412947212,39,25,14,7,0.6184730039970414,0.17880051275340347
인플레이션/NNG@$물가/NNG@$상승/NNG,1,0.5516349412947212,39,25,14,27,0.6184730039970414,0.17880051275340347
상승/NNG@$기준금리/NNG@$인상/NNG,1,0.5516349412947212,39,25,14,52,0.6184730039970414,0.17880051275340347
인플레이션/NNG@$압력/NNG@$증대/NNG,1,0.5506019744706405,26,17,9,16,0.5056608944710423,0.14662073409316484
속도/NNG@$완만/XR@$예상/NNG,1,0.5506019744706405,26,17,9,30,0.5056608944710423,0.14662073409316484
가능/NNG@$금리/NNG@$인상/NNG,1,0.5506019744706405,26,17,9,45,0.5056608944710423,0.14662073409316484
중단/NNG@$가능성/NNG@$시사/NNG,1,0.5506019744706405,26,17,9,24,0.5056608944710423,0.14662073409316484
정책금리/NNG@$인상/NNG@$시기/NNG,1,0.5506019744706405,26,17,9,13,0.5056608944710423,0.14662073409316484
장기/NNG@$시장/NNG@$금리/NNG@$하락/NNG,1,0.5506019744706405,26,17,9,25,0.5056608944710423,0.14662073409316484
기준금리/NNG@$낮/VA@$유지/NNG,1,0.5472848528802459,44,28,16,37,0.6553428007860119,0.19183442292710517
소비자/NNG@$물가/NNG@$수요/NNG,1,0.5391161304040761,31,20,11,12,0.548901422906681,0.16444212086906101
은행/NNG@$대출/NNG@$증가/NNG,1,0.5391161304040761,31,20,11,25,0.548901422906681,0.16444212086906101
압력/NNG@$선제적/NNG@$대응/NNG,1,0.5391161304040761,31,20,11,18,0.548901422906681,0.16444212086906101
콜금리/NNG@$인상/NNG@$시장/NNG,1,0.5391161304040761,31,20,11,19,0.548901422906681,0.16444212086906101
상승/NNG@$인플레/NNG@$압력/NNG,1,0.5391161304040761,31,20,11,25,0.548901422906681,0.16444212086906101
경제/NNG@$경기/NNG@$부양/NNG,1,0.5391161304040761,31,20,11,31,0.548901422906681,0.16444212086906101
성장/NNG@$둔화/NNG@$가능성/NNG,1,0.5332765398279709,36,23,13,44,0.5900623804602383,0.17969352261272786
동결/NNG@$기조/NNG@$이어질/VV,1,0.5332765398279709,36,23,13,48,0.5900623804602383,0.17969352261272786
원유/NNG@$원자재/NNG@$가격/NNG@$상승/NNG,1,0.5332765398279709,36,23,13,28,0.5900623804602383,0.17969352261272786
경제/NNG@$견실/XR@$성장세/NNG,1,0.5332765398279709,36,23,13,38,0.5900623804602383,0.17969352261272786
통화정책/NNG@$긴축/NNG@$기조/NNG,1,0.5332765398279709,36,23,13,18,0.5900623804602383,0.17969352261272786
민간/NNG@$소비/NNG@$회복세/NNG,1,0.5332765398279709,36,23,13,23,0.5900623804602383,0.17969352261272786
물가/NNG@$상승/NNG@$위험/NNG,1,0.5317728017421648,92,57,35,46,0.8627767082774064,0.26384886376727
경기/NNG@$둔화/NNG@$전망/NNG,1,0.5301981635479585,41,26,15,27,0.6286940200944915,0.19310789967688757
예상/NNG@$물가/NNG@$상승률/NNG,1,0.5301981635479585,41,26,15,36,0.6286940200944915,0.19310789967688757
금리/NNG@$인상/NNG@$할/VV,1,0.5297405039905085,134,83,51,92,0.90478836211177,0.27826606290792144
선제적/NNG@$금리/NNG@$인상/NNG,1,0.529341623132839,126,78,48,55,0.901334746739634,0.27751126152381267
경기/NNG@$불확실성/NNG@$높/VA,1,0.5284359203027318,46,29,17,41,0.6644798532410671,0.20510111645427473
금리/NNG@$인상/NNG@$인플레/NNG,1,0.5284359203027318,46,29,17,34,0.6644798532410671,0.20510111645427473
금리/NNG@$상승/NNG@$마감/NNG,0,0.5283431829033642,23,15,8,30,0.474035628542835,0.14635544761179514
상하/NNG@$종합/NNG@$지수/NNG,0,0.5283431829033642,23,15,8,28,0.474035628542835,0.14635544761179514
기준금리/NNG@$인상/NNG@$어려울/VA,0,0.5283431829033642,23,15,8,30,0.474035628542835,0.14635544761179514
저금리/NNG@$기조/NNG@$지속/NNG,1,0.5261746613370479,56,35,21,50,0.7268566279327214,0.22576380333726817
금리/NNG@$인상/NNG@$명분/NNG,1,0.5250517558671925,61,38,23,42,0.7533735245106046,0.23472696063158183
인상/NNG@$경기/NNG@$회복/NNG,1,0.5248135795465156,123,76,47,62,0.898317400269372,0.28007082674926975
성장률/NNG@$상향/NNG@$조정/NNG,1,0.5237525130479916,66,41,25,76,0.7768591682070151,0.24291301661345052
물가/NNG@$상승/NNG@$예상/NNG,1,0.5237525130479916,66,41,25,39,0.7768591682070151,0.24291301661345052
규모/NNG@$자본/NNG@$유출/NNG,1,0.5168894669632143,28,18,10,21,0.518145878877247,0.16509399294845722
기조/NNG@$유지/NNG@$금리/NNG@$인상/NNG,1,0.5168894669632143,28,18,10,23,0.518145878877247,0.16509399294845722
전망/NNG@$기준금리/NNG@$동결/NNG,1,0.5168894669632143,28,18,10,33,0.518145878877247,0.16509399294845722
경제/NNG@$성장/NNG@$경로/NNG,1,0.5168894669632143,28,18,10,43,0.518145878877247,0.16509399294845722
경제성장률/NNG@$상향/NNG@$조정/NNG,1,0.5168894669632143,28,18,10,46,0.518145878877247,0.16509399294845722
콜/NNG@$인상/NNG@$가능성/NNG,1,0.516306570249303,86,53,33,38,0.843694982235941,0.2692495527784574
자산/NNG@$가격/NNG@$상승/NNG,1,0.5129672069699105,256,158,98,180,0.9065289398728413,0.29194094680557886
확장/NNG@$기조/NNG@$유지/NNG,1,0.5122755355002053,33,21,12,35,0.5605876382095308,0.1808720373555002
기대/NNG@$심리/NNG@$확산/NNG,1,0.5122755355002053,33,21,12,25,0.5605876382095308,0.1808720373555002
인상/NNG@$시기/NNG@$결정/NNG,1,0.5122755355002053,33,21,12,32,0.5605876382095308,0.1808720373555002
회복세/NNG@$지속/NNG@$경제/NNG,0,0.5116864917647326,12,8,4,40,0.3653138239680112,0.11805574202297722
생각/NNG@$금리/NNG@$인상/NNG,1,0.5109870089919368,48,30,18,43,0.6731324423031304,0.21794345862184222
인상/NNG@$시중/NNG@$유동성/NNG,1,0.5109870089919368,48,30,18,13,0.6731324423031304,0.21794345862184222
해외/NNG@$자금/NNG@$유입/NNG,1,0.5107786593524268,38,24,14,49,0.6008161222666699,0.19463891507394926
장단기/NNG@$금리차/NNG@$축소/NNG,1,0.5107786593524268,38,24,14,21,0.6008161222666699,0.19463891507394926
금리/NNG@$올릴/VV@$필요/NNG,1,0.5107786593524268,38,24,14,28,0.6008161222666699,0.19463891507394926
정책/NNG@$공조/NNG@$차원/NNG,1,0.5107786593524268,38,24,14,50,0.6008161222666699,0.19463891507394926
물가/NNG@$오르/VV@$않/VX,1,0.5106425862545882,43,27,16,31,0.6384228922660387,0.20689804016186208
자산/NNG@$축소/NNG@$시작/NNG,1,0.5106425862545882,43,27,16,41,0.6384228922660387,0.20689804016186208
금리/NNG@$인상/NNG@$쉽/VA@$않/VX,1,0.5100829815195727,73,45,28,45,0.8010098171882826,0.25998168115050074
소비자/NNG@$물가/NNG@$상승률/NNG@$높/VA,1,0.5062057467041732,106,65,41,61,0.8772217020813498,0.28770828267857246
주시/NNG@$필요/NNG@$있/VA,1,0.5038406234342949,93,57,36,60,0.8553687859059698,0.28232731079654866
기준금리/NNG@$인하/NNG@$추가경정예산/NNG,0,0.50241372615122,20,13,7,47,0.44206676505513587,0.14646913607024659
통화정책/NNG@$방향/NNG@$의결/NNG,1,0.5017476049261709,98,60,38,98,0.8639532192427901,0.2867621022519335
금리/NNG@$인상/NNG@$경기/NNG@$회복/NNG,1,0.49862521539320914,70,43,27,36,0.7854382445228298,0.2628809218356726
금리/NNG@$인상/NNG@$지지/NNG,1,0.4968253097134103,85,52,33,85,0.8343548961550731,0.28059194448040636
환율/NNG@$상승/NNG@$수출/NNG,1,0.49645190577916787,55,34,21,43,0.7118994456363101,0.23964776303945162
기준금리/NNG@$인상/NNG@$필요/NNG,1,0.49476194146253816,50,31,19,34,0.68131488213933,0.23038151499714904
규모/NNG@$경상수지/NNG@$흑자/NNG,1,0.49476194146253816,50,31,19,47,0.68131488213933,0.23038151499714904
기준금리/NNG@$인상/NNG@$전망/NNG,1,0.4935854666650217,284,174,110,243,0.9008866777966188,0.30557753163873275
우려/NNG@$금리/NNG@$동결/NNG,1,0.4926981855100472,45,28,17,34,0.6476719638532252,0.22020352290701756
제시/NNG@$성장률/NNG@$전망치/NNG,0,0.4911226103687425,25,16,9,26,0.4867221118959164,0.16617086895254127
유로존/NNG@$부채/NNG@$위기/NNG,0,0.4911226103687425,25,16,9,34,0.4867221118959164,0.16617086895254127
경제/NNG@$금융/NNG@$기준금리/NNG,0,0.4911226103687425,25,16,9,24,0.4867221118959164,0.16617086895254127
정책/NNG@$수단/NNG@$활용/NNG,1,0.4904940993867999,40,25,15,31,0.6110906936445917,0.20897693153067096
상승/NNG@$압력/NNG@$가능성/NNG,1,0.48864042705112776,35,22,13,18,0.5718058171635287,0.19649794366151843
성장률/NNG@$전망치/NNG@$제시/NNG,1,0.48864042705112776,35,22,13,41,0.5718058171635287,0.19649794366151843
소비/NNG@$지출/NNG@$기업/NNG,1,0.48864042705112776,35,22,13,20,0.5718058171635287,0.19649794366151843
동결/NNG@$통화정책/NNG@$방향/NNG,1,0.48814299426798646,30,19,11,42,0.5301818985093946,0.18243220700818719
기준금리/NNG@$인상/NNG@$출구전략/NNG,1,0.48814299426798646,30,19,11,39,0.5301818985093946,0.18243220700818719
소비/NNG@$투자/NNG@$위축/NNG,1,0.48814299426798646,30,19,11,24,0.5301818985093946,0.18243220700818719
우려/NNG@$경기/NNG@$회복/NNG,1,0.48814299426798646,30,19,11,23,0.5301818985093946,0.18243220700818719
동행지수/NNG@$순환/NNG@$변동/NNG,1,0.48240423896888274,57,35,22,37,0.7185735205971527,0.25099511624436177
내외/NNG@$금리/NNG@$역전/NNG,1,0.48240423896888274,57,35,22,28,0.7185735205971527,0.25099511624436177
필요/NNG@$있/VA@$금리/NNG@$인상/NNG,1,0.48240423896888274,57,35,22,31,0.7185735205971527,0.25099511624436177
가능성/NNG@$높/VA@$진단/NNG,1,0.47961183653807327,52,32,20,36,0.6890416941206627,0.24243418214007825
물가/NNG@$고공/NNG@$행진/NNG,1,0.47961183653807327,52,32,20,45,0.6890416941206627,0.24243418214007825
인상/NNG@$속도/NNG@$완만/XR,1,0.47961183653807327,52,32,20,28,0.6890416941206627,0.24243418214007825
문제/NNG@$금리/NNG@$인상/NNG,1,0.47669691873928843,84,51,33,50,0.8245350003866267,0.2923064877032488
지표/NNG@$금리/NNG@$인상/NNG,1,0.47669691873928843,84,51,33,68,0.8245350003866267,0.2923064877032488
압력/NNG@$높/VA@$금리/NNG,1,0.4761407540194511,47,29,18,30,0.6564538198871757,0.23305488546909206
성장률/NNG@$기록/NNG@$전망/NNG,1,0.4761407540194511,47,29,18,65,0.6564538198871757,0.23305488546909206
기조/NNG@$유지/NNG@$예상/NNG,1,0.4761407540194511,47,29,18,26,0.6564538198871757,0.23305488546909206
소비자/NNG@$물가/NNG@$급등/NNG,1,0.475542956912109,74,45,29,49,0.7926333385322872,0.28183655600341995
연속적/NNG@$금리/NNG@$인상/NNG,1,0.475542956912109,74,45,29,62,0.7926333385322872,0.28183655600341995
물가/NNG@$상승률/NNG@$높/VA,1,0.4725008230648031,385,234,151,268,0.8944943005057759,0.3205600527468386
위안화/NNG@$가치/NNG@$하락/NNG,1,0.4720696850353263,42,26,16,40,0.6208966387037578,0.22275780749558993
통화정책/NNG@$기조/NNG@$전환/NNG,1,0.4720696850353263,42,26,16,22,0.6208966387037578,0.22275780749558993
원화/NNG@$가치/NNG@$절상/NNG,1,0.4720696850353263,42,26,16,57,0.6208966387037578,0.22275780749558993
상품/NNG@$가격/NNG@$급등/NNG,1,0.4720696850353263,42,26,16,33,0.6208966387037578,0.22275780749558993
콜금리/NNG@$동결/NNG@$가능성/NNG,1,0.4720696850353263,42,26,16,18,0.6208966387037578,0.22275780749558993
수단/NNG@$금리/NNG@$인상/NNG,1,0.4720696850353263,42,26,16,16,0.6208966387037578,0.22275780749558993
생산자/NNG@$물가/NNG@$상승/NNG,1,0.47200263515196306,64,39,25,65,0.75030953864708,0.26923343991441956
국채/NNG@$매입/NNG@$방안/NNG,0,0.47175005425166017,17,11,6,39,0.40996726722940113,0.14720407682942824
인플레율/NNG@$억제/NNG@$기준치/NNG@$허용/NNG@$한도/NNG,0,0.47175005425166017,17,11,6,53,0.40996726722940113,0.14720407682942824
역전/NNG@$자본/NNG@$유출/NNG,1,0.467622514630738,37,23,14,36,0.5825651728991941,0.21140404607843602
경기/NNG@$회복세/NNG@$이어지/VV,1,0.467622514630738,37,23,14,23,0.5825651728991941,0.21140404607843602
금리/NNG@$인상/NNG@$신호/NNG,1,0.4666874295522767,86,52,34,78,0.826184929727224,0.30052774934643567
동향/NNG@$그린북/NNG@$경제/NNG,1,0.4654109696681985,54,33,21,41,0.6963275443073564,0.2541187389001194
인상/NNG@$가능성/NNG@$제기/NNG,1,0.4646820808025558,76,46,30,58,0.7957534987194166,0.29094384237389487
원화/NNG@$강세/NNG@$요인/NNG,1,0.4633114273719787,32,20,12,31,0.5417792962454613,0.19877858987903343
인상/NNG@$기대/NNG@$높/VA,1,0.4633114273719787,32,20,12,20,0.5417792962454613,0.19877858987903343
인상/NNG@$전망/NNG@$힘/NNG,1,0.4633114273719787,32,20,12,28,0.5417792962454613,0.19877858987903343
시장/NNG@$안정화/NNG@$조치/NNG,1,0.4633114273719787,32,20,12,36,0.5417792962454613,0.19877858987903343
동결/NNG@$기조/NNG@$지속/NNG,1,0.4633114273719787,32,20,12,30,0.5417792962454613,0.19877858987903343
유지/NNG@$금융/NNG@$경제/NNG@$고려/NNG,1,0.4633114273719787,32,20,12,19,0.5417792962454613,0.19877858987903343
회복/NNG@$물가/NNG@$상승/NNG@$압력/NNG,1,0.4633114273719787,32,20,12,26,0.5417792962454613,0.19877858987903343
기준금리/NNG@$인상/NNG@$관측/NNG,1,0.4633114273719787,32,20,12,33,0.5417792962454613,0.19877858987903343
금리/NNG@$인상/NNG@$고려/NNG,1,0.4624666529136521,121,73,48,75,0.8767578160385128,0.3223742494185535
회복세/NNG@$지속/NNG@$도움/NNG@$방향/NNG,0,0.46097183650446705,22,14,8,29,0.4548129266805444,0.16786611475363658
지속/NNG@$도움/NNG@$방향/NNG,0,0.46097183650446705,22,14,8,30,0.4548129266805444,0.16786611475363658
가계/NNG@$실질/NNG@$구매력/NNG,0,0.46097183650446705,22,14,8,38,0.4548129266805444,0.16786611475363658
경기/NNG@$회복세/NNG@$지속/NNG@$도움/NNG@$방향/NNG,0,0.46097183650446705,22,14,8,29,0.4548129266805444,0.16786611475363658
가계/NNG@$대출/NNG@$주택/NNG@$담보대출/NNG@$크/VA,0,0.46097183650446705,22,14,8,22,0.4548129266805444,0.16786611475363658
금리/NNG@$인상/NNG@$부동산/NNG,1,0.46078453423031474,49,30,19,22,0.6647812660115687,0.24547965105597483
인상/NNG@$소비자/NNG@$물가/NNG,1,0.46078453423031474,49,30,19,35,0.6647812660115687,0.24547965105597483
관심/NNG@$금리/NNG@$인상/NNG,1,0.46078453423031474,49,30,19,23,0.6647812660115687,0.24547965105597483
해외/NNG@$자본/NNG@$유입/NNG,1,0.46078453423031474,49,30,19,36,0.6647812660115687,0.24547965105597483
기준금리/NNG@$인상/NNG@$여부/NNG@$결정/NNG,1,0.46078453423031474,49,30,19,22,0.6647812660115687,0.24547965105597483
경기/NNG@$회복/NNG@$불씨/NNG,1,0.46078453423031474,49,30,19,30,0.6647812660115687,0.24547965105597483
사상/NNG@$최대/NNG@$기록/NNG,1,0.46078453423031474,49,30,19,39,0.6647812660115687,0.24547965105597483
주택/NNG@$매매가격/NNG@$수도권/NNG,0,0.460254612399118,27,17,10,37,0.49899571897353123,0.18450897521165144
금리/NNG@$하락/NNG@$마감/NNG,0,0.460254612399118,27,17,10,41,0.49899571897353123,0.18450897521165144
기준금리/NNG@$인상/NNG@$않/VX,1,0.4600791239001598,66,40,26,81,0.7551906076542512,0.27936407594698504
금리/NNG@$인상/NNG@$경기/NNG@$둔화/NNG,1,0.4600791239001598,66,40,26,69,0.7551906076542512,0.27936407594698504
거시/NNG@$건전성/NNG@$정책/NNG,1,0.4557982212125611,118,71,47,120,0.8721925508376204,0.32615918138453354
시장/NNG@$경기/NNG@$둔화/NNG,1,0.4552191949124489,44,27,17,49,0.6302445965968919,0.23602648367402873
금리/NNG@$인상/NNG@$가능성/NNG@$제기/NNG,1,0.4552191949124489,44,27,17,42,0.6302445965968919,0.23602648367402873
기준금리/NNG@$동결/NNG@$배경/NNG,1,0.45423560951305286,78,47,31,81,0.7985766744072947,0.29980913272361337
금리/NNG@$인상/NNG@$임박/XR,1,0.45205302633658606,56,34,22,52,0.7031871858568066,0.265450729756441
경기/NNG@$회복/NNG@$기조/NNG,1,0.45095389826355037,143,86,57,82,0.8826533373443747,0.3341195102844619
경기/NNG@$상승/NNG@$국면/NNG,1,0.4487570399676284,39,24,15,29,0.5928744450143926,0.2256658302103431
인플레이션/NNG@$압력/NNG@$커지/VV,1,0.4487570399676284,39,24,15,41,0.5928744450143926,0.2256658302103431
부진/NNG@$금리/NNG@$인상/NNG,1,0.4485766260585742,95,57,38,50,0.8395773017004659,0.3197127013144618
채권/NNG@$시장/NNG@$통화정책/NNG,1,0.44647548225313627,51,31,20,38,0.6726673041963629,0.2575020905751438
경기/NNG@$둔화/NNG@$금리/NNG@$인상/NNG,1,0.4462235689832419,85,51,34,40,0.8160517631359305,0.3125872748278612
완화/NNG@$기조/NNG@$유지/NNG,1,0.4462214659073087,173,104,69,180,0.8850090811073846,0.33900304088087957
인상/NNG@$가능성/NNG@$시사/NNG,1,0.44507945882790545,271,163,108,188,0.8857774726628529,0.3402654070523846
경제/NNG@$체질/NNG@$개선/NNG,1,0.44417791965978837,80,48,32,82,0.8011182183397799,0.3084362660534007
인플레/NNG@$상승/NNG@$압력/NNG,1,0.44158748672749004,34,21,13,35,0.5529464272725991,0.21426434012800516
물가/NNG@$상승률/NNG@$금리/NNG,1,0.44158748672749004,34,21,13,37,0.5529464272725991,0.21426434012800516
지준율/NNG@$인상/NNG@$조치/NNG,1,0.44158748672749004,34,21,13,19,0.5529464272725991,0.21426434012800516
금리/NNG@$하락/NNG@$추세/NNG,1,0.44158748672749004,34,21,13,17,0.5529464272725991,0.21426434012800516
에너지/NNG@$가격/NNG@$급등/NNG,1,0.44158748672749004,34,21,13,33,0.5529464272725991,0.21426434012800516
금리/NNG@$인상/NNG@$예고/NNG,1,0.4411323942725567,112,67,45,79,0.8614557173501775,0.33418775857445854
물가/NNG@$압력/NNG@$완화/NNG,1,0.4397106755029787,46,28,18,16,0.6391453652443336,0.2488219727490564
제조업/NNG@$평균/NNG@$가동률/NNG,1,0.4397106755029787,46,28,18,27,0.6391453652443336,0.2488219727490564
경제/NNG@$전망/NNG@$통화정책/NNG,1,0.4394478589271591,58,35,23,39,0.7096354049612716,0.27644402751590547
상승/NNG@$압력/NNG@$커지/VV,1,0.4394478589271591,58,35,23,47,0.7096354049612716,0.27644402751590547
소비/NNG@$심리/NNG@$회복/NNG,1,0.4386059250422454,92,55,37,80,0.8297938735960164,0.3239274350214825
경기/NNG@$상승/NNG@$기조/NNG,1,0.4386059250422454,92,55,37,56,0.8297938735960164,0.3239274350214825
소비자/NNG@$물가/NNG@$상승률/NNG@$낮/VA,1,0.4386059250422454,92,55,37,87,0.8297938735960164,0.3239274350214825
수출/NNG@$감소세/NNG@$지속/NNG,1,0.43780849096369456,70,42,28,69,0.7638887052253375,0.2987889568688662
채권/NNG@$시장/NNG@$금리/NNG@$인상/NNG,1,0.4368609228773581,87,52,35,63,0.8176482470951743,0.3205666110730948
완화적/NNG@$정책/NNG@$기조/NNG@$유지/NNG,0,0.4346052924291419,14,9,5,17,0.37794154877019,0.14900262391088182
국제금융시장/NNG@$불안/NNG@$경기/NNG,1,0.4342068263833603,29,18,11,24,0.5108686911599054,0.20160672690035442
인상/NNG@$단행/NNG@$예상/NNG,1,0.43322810821523916,65,39,26,53,0.7412312824784502,0.2932217367516715
경제/NNG@$안정적/NNG@$성장/NNG,1,0.4330854846941887,53,32,21,46,0.6801251031199705,0.26914335658378163
확대/NNG@$해석/NNG@$경계/NNG,1,0.4330854846941887,53,32,21,49,0.6801251031199705,0.26914335658378163
기조/NNG@$갈/VX@$전망/NNG,1,0.4330854846941887,53,32,21,49,0.6801251031199705,0.26914335658378163
기준금리/NNG@$유지/NNG@$결정/NNG,1,0.43189568687458024,154,92,62,115,0.8784043551103896,0.34862626867587215
시장/NNG@$경기/NNG@$회복/NNG,1,0.4316776569156042,41,25,16,34,0.6027421582555781,0.2393480479325085
체감/NNG@$경기/NNG@$악화/NNG,1,0.4316776569156042,41,25,16,28,0.6027421582555781,0.2393480479325085
지수/NNG@$낮/VA@$기술/NNG,1,0.4316776569156042,41,25,16,35,0.6027421582555781,0.2393480479325085
대응/NNG@$한계/NNG@$있/VA,0,0.42779357233685245,24,15,9,30,0.46719009404155504,0.1872959084249934
역할/NNG@$할/VV@$기대/NNG,0,0.42779357233685245,24,15,9,44,0.46719009404155504,0.1872959084249934
성장세/NNG@$둔화/NNG@$가능성/NNG,0,0.42779357233685245,24,15,9,18,0.46719009404155504,0.1872959084249934
금리/NNG@$인상/NNG@$하지/NNG@$않/VX,1,0.42751874844774007,60,36,24,42,0.7156869699293896,0.28711098459240975
경기/NNG@$수출/NNG@$호조/NNG,1,0.42535559501529097,48,29,19,29,0.6476099420928993,0.2611775827265686
외환/NNG@$건전성/NNG@$부담금/NNG,0,0.4252327583870119,19,12,7,46,0.42260239732881716,0.1704843644981545
방향/NNG@$기준금리/NNG@$유지/NNG@$통화정책/NNG@$경제/NNG,0,0.4252327583870119,19,12,7,26,0.42260239732881716,0.1704843644981545
성장세/NNG@$둔화/NNG@$경제/NNG,0,0.4252327583870119,19,12,7,20,0.42260239732881716,0.1704843644981545
실업률/NNG@$물가/NNG@$상승률/NNG,0,0.4252327583870119,19,12,7,33,0.42260239732881716,0.1704843644981545
경제/NNG@$보/VV@$회복세/NNG,0,0.4252327583870119,19,12,7,23,0.42260239732881716,0.1704843644981545
성장/NNG@$하방/NNG@$리스크/NNG,1,0.42513872372180583,84,50,34,63,0.8054153493938243,0.3249916233039671
금리/NNG@$인상/NNG@$통화정책/NNG,1,0.4231051924989664,101,60,41,101,0.8404842349514585,0.34082762347629014
채권/NNG@$가격/NNG@$하락/NNG,1,0.42235599439263316,36,22,14,41,0.5636903363288301,0.22900125415063222
시장/NNG@$고용/NNG@$지표/NNG,1,0.42235599439263316,36,22,14,25,0.5636903363288301,0.22900125415063222
인플레이션/NNG@$우려/NNG@$금리/NNG@$인상/NNG,1,0.42235599439263316,36,22,14,28,0.5636903363288301,0.22900125415063222
경제/NNG@$기준금리/NNG@$동결/NNG,1,0.42235599439263316,36,22,14,35,0.5636903363288301,0.22900125415063222
상승률/NNG@$목표/NNG@$달성/NNG,1,0.42235599439263316,36,22,14,25,0.5636903363288301,0.22900125415063222
물가/NNG@$상승률/NNG@$목표/NNG@$달성/NNG,1,0.42235599439263316,36,22,14,25,0.5636903363288301,0.22900125415063222
성장/NNG@$부정적/NNG@$영향/NNG,1,0.42235599439263316,36,22,14,36,0.5636903363288301,0.22900125415063222
가격/NNG@$상승/NNG@$기대/NNG,1,0.42235599439263316,36,22,14,30,0.5636903363288301,0.22900125415063222
상승/NNG@$압력/NNG@$가중/NNG,1,0.42050755306967247,55,33,22,33,0.6871679634253934,0.2804217892175731
장기/NNG@$국채/NNG@$수익률/NNG,1,0.4173805883802353,74,44,30,27,0.7712725955878734,0.31713913255291154
경기/NNG@$둔화/NNG@$인플레/NNG,1,0.4160947915536992,43,26,17,31,0.61217682406344,0.25250495178026544
신호/NNG@$보내/VV@$않/VX,1,0.4160947915536992,43,26,17,23,0.61217682406344,0.25250495178026544
목표/NNG@$금리/NNG@$인상/NNG,1,0.41199998641813673,50,30,20,31,0.6556495426612643,0.27312151078979297
규모/NNG@$크/VA@$않/VX,1,0.41199998641813673,50,30,20,46,0.6556495426612643,0.27312151078979297
상태/NNG@$금리/NNG@$인상/NNG,1,0.41199998641813673,50,30,20,28,0.6556495426612643,0.27312151078979297
원자재/NNG@$가격/NNG@$급락/NNG,1,0.41199998641813673,50,30,20,43,0.6556495426612643,0.27312151078979297
필요/NNG@$있/VA@$경기/NNG,1,0.4118582594869835,31,19,12,19,0.5223492461648169,0.2176673673193742
경기/NNG@$부양/NNG@$통화정책/NNG,1,0.4118582594869835,31,19,12,40,0.5223492461648169,0.2176673673193742
경제/NNG@$성장세/NNG@$완만/XR,1,0.4118582594869835,31,19,12,23,0.5223492461648169,0.2176673673193742
상승/NNG@$주택/NNG@$가격/NNG,1,0.4118582594869835,31,19,12,19,0.5223492461648169,0.2176673673193742
시장/NNG@$금리/NNG@$역전/NNG,1,0.4118582594869835,31,19,12,45,0.5223492461648169,0.2176673673193742
금리/NNG@$내린/VV@$마감/NNG,1,0.4118582594869835,31,19,12,47,0.5223492461648169,0.2176673673193742
인상/NNG@$크/VA@$않/VX,1,0.4118582594869835,31,19,12,24,0.5223492461648169,0.2176673673193742
물가/NNG@$상승/NNG@$억제/NNG,1,0.41050120929367684,115,68,47,102,0.8530776838385344,0.35664734490765815
인플레이션/NNG@$압력/NNG@$낮/VA,1,0.4086519003160154,57,34,23,26,0.6938092790764004,0.29135328382341324
경제/NNG@$동향/NNG@$그린북/NNG,1,0.40838808454812314,147,87,60,117,0.868859983642342,0.3650938899925934
통화정책/NNG@$기조/NNG@$유지/NNG,1,0.40571483394757357,127,75,52,87,0.8602845127376401,0.36381366848674745
기업/NNG@$경기/NNG@$전망/NNG,1,0.4054356880904244,64,38,26,40,0.7266588386043159,0.30750881247920014
하락/NNG@$금리/NNG@$인상/NNG,1,0.4054356880904244,64,38,26,49,0.7266588386043159,0.30750881247920014
반영/NNG@$금리/NNG@$인상/NNG@$가능성/NNG,1,0.4051473631723901,38,23,15,22,0.5740173100435046,0.24308130015332954
호흡기/NNG@$증후군/NNG@$메르스/NNG@$사태/NNG,1,0.4051473631723901,38,23,15,49,0.5740173100435046,0.24308130015332954
대외/NNG@$경제/NNG@$불확실성/NNG,1,0.4051473631723901,38,23,15,33,0.5740173100435046,0.24308130015332954
강세/NNG@$금리/NNG@$인상/NNG,1,0.4051473631723901,38,23,15,42,0.5740173100435046,0.24308130015332954
금리/NNG@$상승/NNG@$가계부채/NNG,1,0.4051473631723901,38,23,15,20,0.5740173100435046,0.24308130015332954
금리/NNG@$상승/NNG@$경제/NNG,1,0.4051473631723901,38,23,15,34,0.5740173100435046,0.24308130015332954
증후군/NNG@$메르스/NNG@$사태/NNG,1,0.4051473631723901,38,23,15,49,0.5740173100435046,0.24308130015332954
유지/NNG@$소비자/NNG@$물가/NNG,1,0.4051473631723901,38,23,15,28,0.5740173100435046,0.24308130015332954
고려/NNG@$필요/NNG@$있/VA,1,0.40240908939436437,95,56,39,79,0.8219411155137155,0.35035477887246536
예상/NNG@$소비자/NNG@$물가/NNG,1,0.4017782825712748,45,27,18,47,0.6211870852311872,0.26518143652133086
부동산/NNG@$대책/NNG@$효과/NNG,1,0.4017782825712748,45,27,18,11,0.6211870852311872,0.26518143652133086
완화적/NNG@$통화정책/NNG@$기조/NNG@$유지/NNG,1,0.4017782825712748,45,27,18,35,0.6211870852311872,0.26518143652133086
경기/NNG@$회복세/NNG@$가시화/NNG,0,0.40059113010119063,26,16,10,23,0.4792147014022057,0.20515370413982803
자본/NNG@$유출입/NNG@$변동성/NNG,0,0.40059113010119063,26,16,10,63,0.4792147014022057,0.20515370413982803
상승률/NNG@$물가/NNG@$목표치/NNG,0,0.40059113010119063,26,16,10,31,0.4792147014022057,0.20515370413982803
물가/NNG@$상승률/NNG@$고려/NNG,0,0.40059113010119063,26,16,10,35,0.4792147014022057,0.20515370413982803
경기/NNG@$나쁘/VA@$않/VX,0,0.40059113010119063,26,16,10,24,0.4792147014022057,0.20515370413982803
소비자/NNG@$물가/NNG@$상승률/NNG@$목표치/NNG,0,0.40059113010119063,26,16,10,39,0.4792147014022057,0.20515370413982803
위험/NNG@$선호/NNG@$심리/NNG,0,0.40059113010119063,26,16,10,19,0.4792147014022057,0.20515370413982803
고려/NNG@$기준금리/NNG@$인상/NNG,1,0.3995173789440374,52,31,21,56,0.6632756001408843,0.28467755603190087
증가/NNG@$속도/NNG@$빠르/VA,1,0.3995173789440374,52,31,21,24,0.6632756001408843,0.28467755603190087
물가/NNG@$오름세/NNG@$확대/NNG,1,0.3995173789440374,52,31,21,31,0.6632756001408843,0.28467755603190087
농산물/NNG@$가격/NNG@$상승/NNG,1,0.3995173789440374,52,31,21,58,0.6632756001408843,0.28467755603190087
인상/NNG@$경기/NNG@$둔화/NNG,1,0.39854427065257725,78,46,32,90,0.7774625212841181,0.3344595732839593
경제/NNG@$완만/XR@$성장/NNG,1,0.3974427671161813,59,35,24,30,0.7000624963634106,0.30195166176811195
금융/NNG@$금리/NNG@$인상/NNG,1,0.3974427671161813,59,35,24,40,0.7000624963634106,0.30195166176811195
충격/NNG@$크/VA@$않/VX,1,0.39478080100769164,85,50,35,56,0.7962399493884047,0.3456098536860667
완화/NNG@$필요/NNG@$있/VA,1,0.392390760045199,33,20,13,19,0.5334429334034674,0.23285512408788378
기준금리/NNG@$동결/NNG@$시장/NNG,1,0.392390760045199,33,20,13,52,0.5334429334034674,0.23285512408788378
경제/NNG@$전망/NNG@$경기/NNG,1,0.392390760045199,33,20,13,38,0.5334429334034674,0.23285512408788378
금리/NNG@$인상/NNG@$그칠/VV,1,0.392390760045199,33,20,13,20,0.5334429334034674,0.23285512408788378
경기/NNG@$상승세/NNG@$둔화/NNG,1,0.392390760045199,33,20,13,12,0.5334429334034674,0.23285512408788378
금리/NNG@$인상/NNG@$가능성/NNG@$크/VA,1,0.38996221644844953,104,61,43,61,0.8321110934815064,0.3653161051328227
유지/NNG@$통화정책/NNG@$경제/NNG,0,0.38965962726168235,21,13,8,28,0.4349227248749295,0.1910774438072983
경기/NNG@$회복세/NNG@$이어질/VV,0,0.38965962726168235,21,13,8,24,0.4349227248749295,0.1910774438072983
기준금리/NNG@$유지/NNG@$통화정책/NNG@$경제/NNG,0,0.38965962726168235,21,13,8,28,0.4349227248749295,0.1910774438072983
금리/NNG@$하락/NNG@$압력/NNG,0,0.38965962726168235,21,13,8,36,0.4349227248749295,0.1910774438072983
이자/NNG@$부담/NNG@$증가/NNG,1,0.3896008094339771,40,24,16,41,0.5839332977508749,0.2565788036388157
외국인/NNG@$증권/NNG@$자금/NNG,0,0.38775734894752967,11,7,4,16,0.3461474722936675,0.15275809338398044
가격/NNG@$변수/NNG@$변동성/NNG@$확대/NNG,0,0.38775734894752967,11,7,4,13,0.3461474722936675,0.15275809338398044
상승/NNG@$기조/NNG@$유지/NNG,1,0.38681586586058136,61,36,25,66,0.7059410720778675,0.3122290153856554
수출/NNG@$호조/NNG@$지속/NNG,1,0.38681586586058136,61,36,25,39,0.7059410720778675,0.3122290153856554
대출/NNG@$금리/NNG@$상승/NNG,1,0.386794282206284,99,58,41,46,0.8230023948626157,0.3640222643710489
경제/NNG@$비추/VV@$성장/NNG@$경로/NNG@$불확실성/NNG,0,0.38208735904939695,16,10,6,49,0.390251693205639,0.17452895922731856
회복/NNG@$조짐/NNG@$나타나/VV,0,0.38208735904939695,16,10,6,32,0.390251693205639,0.17452895922731856
지속/NNG@$성장잠재력/NNG@$훼손/NNG@$않/VX,0,0.38208735904939695,16,10,6,39,0.390251693205639,0.17452895922731856
물가/NNG@$상승/NNG@$요인/NNG,1,0.38115249069799195,118,69,49,97,0.8444424618677173,0.37847995778975174
정책/NNG@$기조/NNG@$유지/NNG,1,0.38008383178626004,191,112,79,145,0.8627281912043118,0.3876429927279554
채권/NNG@$기준금리/NNG@$동결/NNG,0,0.37778991431471787,28,17,11,26,0.490895759846502,0.2217547962045769
상승/NNG@$기대/NNG@$심리/NNG,0,0.37778991431471787,28,17,11,28,0.490895759846502,0.2217547962045769
변동성/NNG@$확대/NNG@$경제/NNG,0,0.37778991431471787,28,17,11,40,0.490895759846502,0.2217547962045769
고용/NNG@$지표/NNG@$좋/VA,0,0.37778991431471787,28,17,11,26,0.490895759846502,0.2217547962045769
가계/NNG@$소비/NNG@$위축/NNG,0,0.37778991431471787,28,17,11,26,0.490895759846502,0.2217547962045769
유통/NNG@$구조/NNG@$개선/NNG,0,0.37778991431471787,28,17,11,29,0.490895759846502,0.2217547962045769
고용/NNG@$시장/NNG@$부진/NNG,0,0.37778991431471787,28,17,11,29,0.490895759846502,0.2217547962045769
고려/NNG@$금리/NNG@$동결/NNG,0,0.37778991431471787,28,17,11,32,0.490895759846502,0.2217547962045769
가능성/NNG@$높/VA@$시장/NNG,0,0.37778991431471787,28,17,11,18,0.490895759846502,0.2217547962045769
콜금리/NNG@$인상/NNG@$가능성/NNG,1,0.3773502151897008,181,106,75,74,0.8613720787484361,0.38951106760301835
경기/NNG@$부양적/NNG@$통화정책/NNG,1,0.37677049039807753,56,33,23,59,0.6773338041172106,0.30670338659351576
자산/NNG@$가격/NNG@$거품/NNG,1,0.37677049039807753,56,33,23,32,0.6773338041172106,0.30670338659351576
가능성/NNG@$크/VA@$보/VX,1,0.3762430024385588,49,29,20,55,0.6379701506167892,0.2892343398907817
지수/NNG@$하락/NNG@$기록/NNG,1,0.37543667625820887,42,25,17,58,0.5934442163142155,0.2695533305639594
인상/NNG@$가능성/NNG@$없/VA,1,0.37543667625820887,42,25,17,47,0.5934442163142155,0.2695533305639594
우려/NNG@$금리/NNG@$인상/NNG@$가능성/NNG,1,0.37543667625820887,42,25,17,16,0.5934442163142155,0.2695533305639594
지금/NNG@$금리/NNG@$인상/NNG,1,0.37543667625820887,42,25,17,30,0.5934442163142155,0.2695533305639594
수출/NNG@$부정적/NNG@$영향/NNG,1,0.37534663992814776,96,56,40,91,0.8129904772993883,0.3693526869289828
금리/NNG@$정상화/NNG@$기조/NNG,1,0.37520286612384934,35,21,14,94,0.5441536781916425,0.2472991800324279
금리/NNG@$정상화/NNG@$의지/NNG,1,0.37520286612384934,35,21,14,75,0.5441536781916425,0.2472991800324279
의심/NNG@$여지/NNG@$없/VA,1,0.37520286612384934,35,21,14,35,0.5441536781916425,0.2472991800324279
가격/NNG@$상승세/NNG@$둔화/NNG,1,0.37520286612384934,35,21,14,28,0.5441536781916425,0.2472991800324279
수출/NNG@$부진/NNG@$지속/NNG,1,0.3746967526320526,77,45,32,54,0.7647962554913836,0.347983147869054
물가/NNG@$상승/NNG@$압력/NNG@$높/VA,1,0.3730119856067189,132,77,55,114,0.850456475269051,0.38847684350151795
민간/NNG@$소비/NNG@$회복/NNG,1,0.3728497577178269,84,49,35,63,0.7847558749275434,0.3586007880349163
경기/NNG@$회복/NNG@$뒷받침/NNG,1,0.369303367601699,139,81,58,115,0.8519343911764732,0.3925128878304542
양적완화/NNG@$규모/NNG@$축소/NNG,1,0.3683323210593472,122,71,51,346,0.8425471961502132,0.38906120775980385
경제/NNG@$경기/NNG@$회복/NNG,1,0.367097032213626,65,38,27,66,0.7166279320188605,0.33186217136400614
하방/NNG@$위험/NNG@$요인/NNG,1,0.367097032213626,65,38,27,79,0.7166279320188605,0.33186217136400614
인상/NNG@$하지/NNG@$않/VX,1,0.3662645365231494,79,46,33,56,0.7676951214760879,0.35619511320996783
이유/NNG@$금리/NNG@$인상/NNG,1,0.36488954941104357,86,50,36,56,0.7867090290049806,0.3661772916557492
금리/NNG@$인상/NNG@$가능성/NNG@$배제/NNG@$없/VA,1,0.3624360212016047,44,26,18,39,0.6025561601819984,0.2820524854259986
경제/NNG@$침체/NNG@$가능성/NNG,1,0.3624360212016047,44,26,18,34,0.6025561601819984,0.2820524854259986
가능성/NNG@$높/VA@$덧붙였/VV,0,0.3615230468366737,23,14,9,33,0.4469520351742688,0.2096551836086096
가격/NNG@$소비자/NNG@$물가/NNG,0,0.3615230468366737,23,14,9,30,0.4469520351742688,0.2096551836086096
대출/NNG@$주택/NNG@$담보대출/NNG@$크/VA,0,0.3615230468366737,23,14,9,22,0.4469520351742688,0.2096551836086096
기대/NNG@$심리/NNG@$높/VA,1,0.3598473063892649,37,22,15,40,0.5544845494314979,0.2610999635076197
금리/NNG@$인상/NNG@$강력/XR,1,0.3598473063892649,37,22,15,15,0.5544845494314979,0.2610999635076197
인상/NNG@$가능성/NNG@$배제/NNG@$없/VA,1,0.35843111702496055,74,43,31,72,0.7481580413543747,0.3534455394735942
금융시장/NNG@$기준금리/NNG@$인상/NNG,1,0.35829952027577283,30,18,12,27,0.5022374807752673,0.23733914952264967
경제/NNG@$전망/NNG@$불확실/NNG,1,0.35829952027577283,30,18,12,27,0.5022374807752673,0.23733914952264967
경제/NNG@$하방/NNG@$위험/NNG,1,0.3557436020035454,95,55,40,119,0.8029633676805249,0.38168013557206976
실제/NNG@$금리/NNG@$인상/NNG,1,0.3539798378012513,53,31,22,58,0.6531657871969708,0.3117305785121813
인상/NNG@$서두르/VV@$않/VX,1,0.3539798378012513,53,31,22,45,0.6531657871969708,0.3117305785121813
산업/NNG@$생산/NNG@$증가세/NNG,1,0.3539798378012513,53,31,22,23,0.6531657871969708,0.3117305785121813
금리/NNG@$인상/NNG@$예상/NNG,1,0.3512985416626264,543,315,228,430,0.8523536706530865,0.40929333969245996
부진/NNG@$경기/NNG@$둔화/NNG,1,0.35042564966701084,46,27,19,36,0.6112755371636667,0.29411434905932365
동향/NNG@$소비자/NNG@$물가/NNG,1,0.35042564966701084,46,27,19,39,0.6112755371636667,0.29411434905932365
물가/NNG@$상승/NNG@$속도/NNG,1,0.35042564966701084,46,27,19,48,0.6112755371636667,0.29411434905932365
고용/NNG@$지표/NNG@$경제/NNG,1,0.35042564966701084,46,27,19,22,0.6112755371636667,0.29411434905932365
경기/NNG@$부양/NNG@$조치/NNG,1,0.3497804678911136,90,52,38,135,0.7899729137440051,0.38065354848231076
확대/NNG@$금리/NNG@$인상/NNG,1,0.3491417985232794,69,40,29,41,0.7259761977809518,0.3503255245502595
고공/NNG@$행진/NNG@$지속/NNG,1,0.3491417985232794,69,40,29,65,0.7259761977809518,0.3503255245502595
채권/NNG@$시장/NNG@$강세/NNG,1,0.3486868150781952,97,56,41,97,0.8037552124262767,0.3882603453047715
통화/NNG@$완화/NNG@$정책/NNG@$종료/NNG,1,0.3471806582589432,104,60,44,126,0.8145637198432255,0.3948319187658654
금리/NNG@$인상/NNG@$강하/VA,1,0.3459870528321469,39,23,16,28,0.5644383058448617,0.2743352394015142
해외/NNG@$위험/NNG@$요인/NNG@$영향/NNG,1,0.3459870528321469,39,23,16,46,0.5644383058448617,0.2743352394015142
회복/NNG@$속도/NNG@$예상/NNG,1,0.3459870528321469,39,23,16,34,0.5644383058448617,0.2743352394015142
경제/NNG@$전망/NNG@$금융시장/NNG,1,0.3459870528321469,39,23,16,20,0.5644383058448617,0.2743352394015142
금리/NNG@$올릴/VV@$없/VA,1,0.3459870528321469,39,23,16,30,0.5644383058448617,0.2743352394015142
경제/NNG@$민간/NNG@$소비/NNG,0,0.3443189532516575,18,11,7,24,0.40231948161765974,0.19628202122529875
기준금리/NNG@$인하/NNG@$동결/NNG,0,0.3443189532516575,18,11,7,38,0.40231948161765974,0.19628202122529875
양적완화/NNG@$종료/NNG@$금리/NNG,0,0.3443189532516575,18,11,7,33,0.40231948161765974,0.19628202122529875
유로지역/NNG@$재정/NNG@$문제/NNG,0,0.3443189532516575,18,11,7,26,0.40231948161765974,0.19628202122529875
금리/NNG@$인상/NNG@$기대/NNG,1,0.3435981975626221,268,155,113,213,0.8493328558869065,0.41504693387273367
경기/NNG@$회복/NNG@$국면/NNG,1,0.3426046163797858,92,53,39,73,0.7913069912795384,0.3875628584394952
수출/NNG@$호조/NNG@$소비/NNG,1,0.3413532751377122,32,19,13,13,0.5132411625845887,0.2520862168551173
인상/NNG@$전망/NNG@$금리/NNG,1,0.3413532751377122,32,19,13,27,0.5132411625845887,0.2520862168551173
강세/NNG@$보일/VV@$전망/NNG,1,0.3413532751377122,32,19,13,23,0.5132411625845887,0.2520862168551173
성장/NNG@$둔화/NNG@$인플레/NNG,1,0.3413532751377122,32,19,13,20,0.5132411625845887,0.2520862168551173
통화/NNG@$달러/NNG@$지수/NNG,1,0.3413532751377122,32,19,13,36,0.5132411625845887,0.2520862168551173
유지/NNG@$금리/NNG@$인상/NNG,1,0.3412253262537479,225,130,95,137,0.8483181636309903,0.4167850520174532
투자/NNG@$활성화/NNG@$대책/NNG,1,0.33926712644012724,48,28,20,30,0.619609147549653,0.3057694986877804
전망/NNG@$기준금리/NNG@$인상/NNG,1,0.33926712644012724,48,28,20,44,0.619609147549653,0.3057694986877804
물가/NNG@$상승/NNG@$압력/NNG@$커지/VV,1,0.33926712644012724,48,28,20,35,0.619609147549653,0.3057694986877804
예정/NNG@$금리/NNG@$인상/NNG,1,0.33926712644012724,48,28,20,51,0.619609147549653,0.3057694986877804
물가/NNG@$상승/NNG@$주도/NNG,0,0.3385911398771515,25,15,10,21,0.45870093959190855,0.22670918981939367
시장/NNG@$교란/NNG@$요인/NNG,0,0.3385911398771515,25,15,10,26,0.45870093959190855,0.22670918981939367
인하/NNG@$전망/NNG@$유지/NNG,0,0.3385911398771515,25,15,10,29,0.45870093959190855,0.22670918981939367
인상/NNG@$속도/NNG@$시장/NNG,0,0.3385911398771515,25,15,10,14,0.45870093959190855,0.22670918981939367
하방/NNG@$위험/NNG@$남/VV,0,0.3385911398771515,25,15,10,27,0.45870093959190855,0.22670918981939367
위안화/NNG@$절상/NNG@$문제/NNG,0,0.3385911398771515,25,15,10,24,0.45870093959190855,0.22670918981939367
경제/NNG@$전망/NNG@$기준금리/NNG,0,0.3385911398771515,25,15,10,42,0.45870093959190855,0.22670918981939367
가능성/NNG@$높/VA@$기준금리/NNG,0,0.3385911398771515,25,15,10,28,0.45870093959190855,0.22670918981939367
물가/NNG@$상승/NNG@$전망/NNG,1,0.33815387024390775,64,37,27,67,0.7010094583875647,0.34681043769677894
가격/NNG@$상승/NNG@$경제/NNG,1,0.33815387024390775,64,37,27,36,0.7010094583875647,0.34681043769677894
시장/NNG@$금리/NNG@$동결/NNG,1,0.33566512685453964,94,54,40,73,0.7924573562350488,0.3942592847222692
원리금/NNG@$상환/NNG@$부담/NNG,1,0.3345683577772416,80,46,34,64,0.7575385364894401,0.3778188278690583
경제/NNG@$수출/NNG@$호조/NNG,1,0.3333646564773949,41,24,17,27,0.5740177727466301,0.2870652492579915
시장/NNG@$예상/NNG@$깨/VV,1,0.3333646564773949,41,24,17,50,0.5740177727466301,0.2870652492579915
위험/NNG@$요인/NNG@$영향/NNG,1,0.3333646564773949,41,24,17,53,0.5740177727466301,0.2870652492579915
금리/NNG@$인상/NNG@$서두르/VV@$않/VX,1,0.3333646564773949,41,24,17,36,0.5740177727466301,0.2870652492579915
조짐/NNG@$보이/VV@$않/VX,1,0.33268374039022097,73,42,31,54,0.7340899545044872,0.3676796346934518
금리/NNG@$인상/NNG@$반영/NNG,1,0.3296327540914945,66,38,28,31,0.7060738160286014,0.35607868906363943
금리/NNG@$인상/NNG@$아니/VCN,1,0.32895114546682014,96,55,41,52,0.7934346400713074,0.4007475505653611
물가/NNG@$상승/NNG@$가능성/NNG,1,0.32884866635728005,50,29,21,26,0.6275642209594416,0.31704263881326017
전망/NNG@$크/VA@$벗어나/VV@$않/VX,0,0.3286002327130768,13,8,5,25,0.35784009157647023,0.18087991794691533
기준금리/NNG@$결정/NNG@$금융/NNG,0,0.3286002327130768,13,8,5,41,0.35784009157647023,0.18087991794691533
에너지/NNG@$상품/NNG@$가격/NNG,1,0.3272009660063544,82,47,35,22,0.7601562558520727,0.38544785376395146
국내총생산/NNG@$증가율/NNG@$전망/NNG,1,0.326402142704884,34,20,14,20,0.5239065074867344,0.2661295696008649
지속/NNG@$경기/NNG@$둔화/NNG,1,0.326402142704884,34,20,14,25,0.5239065074867344,0.2661295696008649
경제/NNG@$위협/NNG@$요인/NNG,1,0.326402142704884,34,20,14,34,0.5239065074867344,0.2661295696008649
확산/NNG@$금리/NNG@$인상/NNG,1,0.326402142704884,34,20,14,18,0.5239065074867344,0.2661295696008649
인상/NNG@$금융/NNG@$위기/NNG,1,0.326402142704884,34,20,14,17,0.5239065074867344,0.2661295696008649
시장/NNG@$영향/NNG@$크/VA@$않/VX,1,0.326402142704884,34,20,14,19,0.5239065074867344,0.2661295696008649
하락/NNG@$경기/NNG@$둔화/NNG,1,0.3249501322307722,75,43,32,37,0.7377155663021017,0.37595746140127356
금리/NNG@$인상/NNG@$시장/NNG,1,0.32456337183938433,223,128,95,184,0.8416082891029625,0.4292746047307602
가격/NNG@$상승/NNG@$물가/NNG,1,0.32261060027491517,105,60,45,92,0.8054298217104923,0.41261676291462684
기준금리/NNG@$동결/NNG@$인상/NNG,1,0.321780786656509,43,25,18,46,0.583226092086244,0.29933681008864466
기준금리/NNG@$사상/NNG@$최저치/NNG,1,0.321780786656509,43,25,18,58,0.583226092086244,0.29933681008864466
갭/NNG@$마이너스/NNG@$상태/NNG,1,0.321780786656509,43,25,18,27,0.583226092086244,0.29933681008864466
최대/NNG@$채권/NNG@$펀드/NNG,1,0.3214897491587816,68,39,29,67,0.7108205558556137,0.36506066201516735
금리/NNG@$인상/NNG@$요구/NNG,0,0.31941558363694966,27,16,11,26,0.47017200309563123,0.24258782948035088
경기/NNG@$전망/NNG@$하락/NNG,0,0.31941558363694966,27,16,11,25,0.47017200309563123,0.24258782948035088
경제/NNG@$성장/NNG@$목표/NNG,0,0.31941558363694966,27,16,11,21,0.47017200309563123,0.24258782948035088
성장/NNG@$물가/NNG@$상승/NNG,0,0.31941558363694966,27,16,11,31,0.47017200309563123,0.24258782948035088
조정/NNG@$금리/NNG@$인상/NNG,1,0.31907910673097706,52,30,22,41,0.635148422335156,0.3279538993321643
금리/NNG@$인상/NNG@$동결/NNG,1,0.31907910673097706,52,30,22,41,0.635148422335156,0.3279538993321643
국채/NNG@$금리/NNG@$서비스/NNG,1,0.3179400938681569,147,84,63,203,0.83359787029772,0.4315139899358193
금리/NNG@$인상/NNG@$적절/XR,1,0.31616041308665244,100,57,43,87,0.7949104740945558,0.41311842318924336
가계부채/NNG@$증가세/NNG@$통화정책/NNG,0,0.3157722391463571,20,12,8,29,0.414179512611496,0.21543655911498077
외국인/NNG@$채권/NNG@$투자/NNG@$자금/NNG,0,0.3157722391463571,20,12,8,37,0.414179512611496,0.21543655911498077
경제/NNG@$수출/NNG@$내수/NNG,0,0.3157722391463571,20,12,8,22,0.414179512611496,0.21543655911498077
기준금리/NNG@$인상/NNG@$나서/VV,0,0.3157722391463571,20,12,8,31,0.414179512611496,0.21543655911498077
물가/NNG@$경기/NNG@$회복/NNG,0,0.3157722391463571,20,12,8,30,0.414179512611496,0.21543655911498077
압력/NNG@$금리/NNG@$인상/NNG,1,0.31510804973353723,93,53,40,52,0.7814588671689822,0.4070777653738462
경제/NNG@$전망/NNG@$경제성장률/NNG,1,0.31510804973353723,93,53,40,94,0.7814588671689822,0.4070777653738462
인상/NNG@$여부/NNG@$결정/NNG,1,0.31414377776273783,142,81,61,58,0.8304869742048534,0.43354420567521773
평균/NNG@$지수/NNG@$하락/NNG@$거래/NNG@$마쳤/VV,1,0.3136957716477442,70,40,30,66,0.7152616605483075,0.3737636433099009
산업/NNG@$평균/NNG@$지수/NNG@$하락/NNG@$거래/NNG,1,0.3136957716477442,70,40,30,66,0.7152616605483075,0.3737636433099009
확장적/NNG@$거시/NNG@$정책/NNG,1,0.3132469934085804,86,49,37,71,0.7647000263620717,0.39999574244071984
경기/NNG@$위축/NNG@$우려/NNG,1,0.31304543027414833,36,21,15,38,0.5342325238058467,0.27956876064376507
인상/NNG@$가능성/NNG@$낮/VA,1,0.3127506662784172,156,89,67,148,0.8333711591079859,0.4363957543788681
금리/NNG@$동결/NNG@$반대/NNG,1,0.31107908803376083,45,26,19,22,0.5920668789808149,0.31118649907441426
하강/NNG@$국면/NNG@$진입/NNG,1,0.31107908803376083,45,26,19,16,0.5920668789808149,0.31118649907441426
인플레이션/NNG@$상승/NNG@$위험/NNG,1,0.31107908803376083,45,26,19,15,0.5920668789808149,0.31118649907441426
공격적/NNG@$금리/NNG@$인상/NNG,1,0.3109794045627894,184,105,79,76,0.8352874556526989,0.4391185345957941
개선/NNG@$조짐/NNG@$보이/VV,1,0.3098833904119189,54,31,23,60,0.6423698359965071,0.33851986058642936
채권/NNG@$투자/NNG@$자금/NNG,1,0.3098833904119189,54,31,23,54,0.6423698359965071,0.33851986058642936
금리/NNG@$인상/NNG@$어려울/VA,1,0.30875629106373115,95,54,41,64,0.7826314101828248,0.4134647970527254
시장/NNG@$기준금리/NNG@$동결/NNG,1,0.30875629106373115,95,54,41,93,0.7826314101828248,0.4134647970527254
금리/NNG@$인상/NNG@$문제/NNG,1,0.30836100598135174,63,36,27,50,0.6847387198546131,0.36206413819848776
경기/NNG@$전망/NNG@$지수/NNG,1,0.3062253153047756,72,41,31,77,0.7194089908176712,0.382194442863223
둔화/NNG@$인플레이션/NNG@$압력/NNG,1,0.3062253153047756,72,41,31,27,0.7194089908176712,0.382194442863223
기준금리/NNG@$동결/NNG@$경제/NNG,1,0.3062253153047756,72,41,31,79,0.7194089908176712,0.382194442863223
민간/NNG@$소비/NNG@$설비투자/NNG,1,0.30416085003482185,104,59,45,93,0.7958115929589021,0.4247129937043417
국채/NNG@$수익률/NNG@$상승/NNG,1,0.303481774486309,81,46,35,68,0.7470135883868088,0.39926700559104444
우려/NNG@$가시/VV@$않/VX,0,0.3030308539425095,29,17,12,24,0.4813631097347761,0.2575365853074271
전격적/NNG@$금리/NNG@$인상/NNG,0,0.3030308539425095,29,17,12,38,0.4813631097347761,0.2575365853074271
증가/NNG@$물가/NNG@$상승/NNG,0,0.3030308539425095,29,17,12,35,0.4813631097347761,0.2575365853074271
시장/NNG@$충격/NNG@$최소화/NNG,0,0.3030308539425095,29,17,12,30,0.4813631097347761,0.2575365853074271
전망/NNG@$소비자/NNG@$물가/NNG@$상승률/NNG,0,0.3030308539425095,29,17,12,36,0.4813631097347761,0.2575365853074271
정책/NNG@$방향/NNG@$제시/NNG,0,0.3030308539425095,29,17,12,17,0.4813631097347761,0.2575365853074271
수요/NNG@$물가/NNG@$압력/NNG,1,0.3011991517427861,56,32,24,30,0.6492369346424737,0.34875435908560126
가능성/NNG@$열/VV@$둔/VX,1,0.300985281916351,38,22,16,41,0.5442181335724932,0.29247830746746933
경제/NNG@$전망/NNG@$불확실성/NNG,1,0.300985281916351,38,22,16,48,0.5442181335724932,0.29247830746746933
주택/NNG@$담보대출/NNG@$급증/NNG,1,0.300985281916351,38,22,16,15,0.5442181335724932,0.29247830746746933
동향/NNG@$산업/NNG@$생산/NNG,1,0.300985281916351,38,22,16,19,0.5442181335724932,0.29247830746746933
모습/NNG@$보일/VV@$예상/NNG,1,0.300985281916351,38,22,16,30,0.5442181335724932,0.29247830746746933
시장/NNG@$불안/NNG@$심리/NNG,1,0.3005383464483371,65,37,28,33,0.6900382055350401,0.37121069397296474
금리/NNG@$인하/NNG@$중단/NNG,1,0.3005383464483371,65,37,28,10,0.6900382055350401,0.37121069397296474
완화/NNG@$정책/NNG@$종료/NNG,1,0.2984380791247283,106,60,46,128,0.7960690576566452,0.430230832333885
전망/NNG@$금리/NNG@$인상/NNG,1,0.2982868811962771,206,117,89,179,0.8304693280659055,0.4489712227363255
대외/NNG@$불안/NNG@$요인/NNG,1,0.2968462599244255,83,47,36,83,0.749625699442902,0.4065480242667319
경제/NNG@$위험/NNG@$요인/NNG,1,0.29640026296590705,150,85,65,126,0.8251093864542193,0.44792319840947853
증권/NNG@$금리/NNG@$인상/NNG,1,0.29425494652632245,115,65,50,66,0.8048370037712061,0.43897606005752815
거시/NNG@$건전성/NNG@$규제/NNG,0,0.2932775668614216,22,13,9,40,0.42584335316844946,0.23276176094007783
경제/NNG@$회복/NNG@$전망/NNG,0,0.2932775668614216,22,13,9,25,0.42584335316844946,0.23276176094007783
부정적/NNG@$영향/NNG@$크/VA@$않/VX,0,0.2932775668614216,22,13,9,22,0.42584335316844946,0.23276176094007783
개선/NNG@$추세/NNG@$보이/VV,0,0.2932775668614216,22,13,9,26,0.42584335316844946,0.23276176094007783
거시/NNG@$경제/NNG@$영향/NNG,0,0.2932775668614216,22,13,9,20,0.42584335316844946,0.23276176094007783
경제/NNG@$성장/NNG@$기여/NNG,0,0.2932775668614216,22,13,9,28,0.42584335316844946,0.23276176094007783
부담/NNG@$금리/NNG@$인상/NNG,1,0.2929741137134467,58,33,25,36,0.6557585385683348,0.358669119031833
경제/NNG@$성장/NNG@$전망치/NNG,1,0.29184987209115243,49,28,21,41,0.6086631618404452,0.333729466976226
금리/NNG@$인상/NNG@$나설/VV@$전망/NNG,1,0.29184987209115243,49,28,21,30,0.6086631618404452,0.333729466976226
자산/NNG@$매입/NNG@$규모/NNG@$축소/NNG,1,0.2899964026960524,40,23,17,79,0.5538625721472982,0.30491431827435794
금리/NNG@$인상/NNG@$의견/NNG,1,0.2899964026960524,40,23,17,36,0.5538625721472982,0.30491431827435794
경기/NNG@$부양/NNG@$기조/NNG,1,0.2899964026960524,40,23,17,42,0.5538625721472982,0.30491431827435794
경제/NNG@$더딘/VA@$회복세/NNG,0,0.2895440924686088,15,9,6,26,0.3694067219253287,0.20356792850864394
물가/NNG@$상승/NNG@$유발/NNG,0,0.28877506938302755,31,18,13,28,0.4922696423692513,0.271729209077095
금리/NNG@$동결/NNG@$기조/NNG@$유지/NNG,0,0.28877506938302755,31,18,13,32,0.4922696423692513,0.271729209077095
인플레이션/NNG@$압력/NNG@$대응/NNG,0,0.28877506938302755,31,18,13,28,0.4922696423692513,0.271729209077095
완화적/NNG@$통화정책/NNG@$유지/NNG,0,0.28877506938302755,31,18,13,30,0.4922696423692513,0.271729209077095
경제/NNG@$성장/NNG@$지지/NNG,0,0.28877506938302755,31,18,13,24,0.4922696423692513,0.271729209077095
인플레이션/NNG@$우려/NNG@$높/VA,0,0.28877506938302755,31,18,13,29,0.4922696423692513,0.271729209077095
위험/NNG@$크/VA@$않/VX,0,0.28877506938302755,31,18,13,27,0.4922696423692513,0.271729209077095
금리/NNG@$인상/NNG@$배제/NNG,0,0.28877506938302755,31,18,13,25,0.4922696423692513,0.271729209077095
금리/NNG@$올릴/VV@$가능성/NNG,1,0.2877075682266488,147,83,64,109,0.8205059735527319,0.45396876287246646
은행/NNG@$기준금리/NNG@$인상/NNG,1,0.28554246811277917,78,44,34,63,0.7302045332898971,0.4059168539294292
경제/NNG@$전망/NNG@$금리/NNG,1,0.283141461246621,51,29,22,41,0.6164288154942348,0.34446396154553666
우려/NNG@$적/VA@$않/VX,1,0.283141461246621,51,29,22,29,0.6164288154942348,0.34446396154553666
기준금리/NNG@$인상/NNG@$기조/NNG,1,0.283141461246621,51,29,22,36,0.6164288154942348,0.34446396154553666
지속/NNG@$금리/NNG@$인상/NNG,1,0.28136319123364073,165,93,72,129,0.8210781821550331,0.46059921665871795
유지/NNG@$기준금리/NNG@$인상/NNG,1,0.27990559187803843,42,24,18,42,0.563165641245471,0.3169193381924017
전망/NNG@$기준금리/NNG@$인하/NNG,1,0.27990559187803843,42,24,18,40,0.563165641245471,0.3169193381924017
금리/NNG@$인상/NNG@$부담/NNG,1,0.2791899033079306,121,68,53,102,0.8034210684253632,0.4528245412009817
소비자/NNG@$물가/NNG@$높/VA,1,0.27916477372385007,80,45,35,43,0.7332919993139926,0.4133208861964613
등락/NNG@$장기금리/NNG@$국채/NNG,1,0.27863523851839345,144,81,63,197,0.8155426952387044,0.4602096412251849
은행/NNG@$가계/NNG@$대출/NNG@$주택/NNG@$담보대출/NNG,1,0.27618228805525913,33,19,14,33,0.5028858882305441,0.2852896796829908
금리/NNG@$인상/NNG@$국제금융시장/NNG,1,0.27618228805525913,33,19,14,25,0.5028858882305441,0.2852896796829908
경기/NNG@$부진/NNG@$우려/NNG,1,0.27618228805525913,33,19,14,26,0.5028858882305441,0.2852896796829908
금리/NNG@$인상/NNG@$결정/NNG,1,0.2752295074553788,398,224,174,268,0.8206124042008274,0.46649833750079034
금리/NNG@$인하/NNG@$가능성/NNG@$배제/NNG@$없/VA,0,0.27493938495076886,24,14,10,31,0.4373098992620939,0.2487561827124946
시장/NNG@$금리/NNG@$인상/NNG@$예상/NNG,0,0.27493938495076886,24,14,10,24,0.4373098992620939,0.2487561827124946
예상/NNG@$깨/VV@$기준금리/NNG,0,0.27493938495076886,24,14,10,39,0.4373098992620939,0.2487561827124946
금리/NNG@$주가/NNG@$환율/NNG,0,0.27493938495076886,24,14,10,21,0.4373098992620939,0.2487561827124946
금리/NNG@$인상/NNG@$부동산가격/NNG,0,0.27493938495076886,24,14,10,47,0.4373098992620939,0.2487561827124946
전통적/NNG@$통화정책/NNG@$수단/NNG,0,0.27493938495076886,24,14,10,25,0.4373098992620939,0.2487561827124946
경기/NNG@$개선/NNG@$추세/NNG,0,0.27493938495076886,24,14,10,25,0.4373098992620939,0.2487561827124946
기조/NNG@$유지/NNG@$가능성/NNG,0,0.27493938495076886,24,14,10,24,0.4373098992620939,0.2487561827124946
서비스수지/NNG@$적자/NNG@$확대/NNG,0,0.27493938495076886,24,14,10,26,0.4373098992620939,0.2487561827124946
금리/NNG@$인상/NNG@$가능성/NNG@$시사/NNG,1,0.274366006146912,169,95,74,125,0.8183846479406093,0.46610156932836944
금리/NNG@$인상/NNG@$영향/NNG,1,0.273268377774754,139,78,61,89,0.8113025165899631,0.4631655978567981
지수/NNG@$하락/NNG@$거래/NNG@$마쳤/VV,1,0.27248379183185967,73,41,32,74,0.7082154923508149,0.4049999795225888
구조/NNG@$개혁/NNG@$추진/NNG,1,0.27248379183185967,73,41,32,46,0.7082154923508149,0.4049999795225888
경기/NNG@$회복/NNG@$조짐/NNG,1,0.2713229054708326,100,56,44,77,0.7744820161396095,0.44400662479450215
금리/NNG@$인상/NNG@$지속/NNG,1,0.2710020851622956,171,96,75,103,0.8170568053471577,0.4687389669253371
가계부채/NNG@$증가/NNG@$속도/NNG,1,0.26720086772158713,55,31,24,56,0.6309249301424982,0.36493455324013596
통화/NNG@$가치/NNG@$급락/NNG,1,0.26720086772158713,55,31,24,51,0.6309249301424982,0.36493455324013596
예상/NNG@$금리/NNG@$인상/NNG@$가능성/NNG,1,0.2649163801800034,35,20,15,22,0.5132059407907946,0.2983072691421525
경제/NNG@$성장/NNG@$달성/NNG,1,0.2649163801800034,35,20,15,37,0.5132059407907946,0.2983072691421525
금융정책/NNG@$열/VV@$기준금리/NNG,1,0.2649163801800034,35,20,15,30,0.5132059407907946,0.2983072691421525
금리/NNG@$인상/NNG@$자금/NNG,1,0.2649163801800034,35,20,15,34,0.5132059407907946,0.2983072691421525
소비/NNG@$설비투자/NNG@$내수/NNG,1,0.2649163801800034,35,20,15,18,0.5132059407907946,0.2983072691421525
주택/NNG@$담보대출/NNG@$크/VA,1,0.2649163801800034,35,20,15,23,0.5132059407907946,0.2983072691421525
결정/NNG@$금리/NNG@$인상/NNG,1,0.2632782977761694,136,76,60,75,0.8053959895147497,0.4697975082265971
사상/NNG@$최대/NNG@$규모/NNG,1,0.2619056520275629,46,26,20,46,0.5807505346076228,0.33975908969046276
가격/NNG@$하락/NNG@$축소/NNG,0,0.26168380131845104,17,10,7,11,0.38089197563368066,0.22294108438593901
고려/NNG@$금리/NNG@$인상/NNG,1,0.26075821600191684,202,113,89,142,0.813775864192341,0.4772607151313839
금리/NNG@$역전/NNG@$자본/NNG,0,0.25957227562481244,26,15,11,25,0.44857135182193497,0.26374667815463004
성장/NNG@$둔화/NNG@$위험/NNG,0,0.25957227562481244,26,15,11,27,0.44857135182193497,0.26374667815463004
물가/NNG@$하방/NNG@$압력/NNG,0,0.25957227562481244,26,15,11,36,0.44857135182193497,0.26374667815463004
매출액/NNG@$기준/NNG@$기업/NNG,0,0.25957227562481244,26,15,11,26,0.44857135182193497,0.26374667815463004
예상/NNG@$물가/NNG@$상승/NNG,0,0.25957227562481244,26,15,11,31,0.44857135182193497,0.26374667815463004
정책금리/NNG@$인상/NNG@$시장/NNG,0,0.25957227562481244,26,15,11,16,0.44857135182193497,0.26374667815463004
동일/NNG@$점포/NNG@$매출/NNG,0,0.25957227562481244,26,15,11,60,0.44857135182193497,0.26374667815463004
경제/NNG@$기준금리/NNG@$인상/NNG,1,0.25739532041389745,68,38,30,65,0.6835111504762109,0.4037632491673042
인상/NNG@$예상/NNG@$금리/NNG,1,0.25739532041389745,68,38,30,41,0.6835111504762109,0.4037632491673042
국채/NNG@$금리/NNG@$상승/NNG,1,0.2559324812533743,156,87,69,211,0.8081265256287632,0.47887304523088303
금리/NNG@$인상/NNG@$가능성/NNG@$높/VA,1,0.2551734526362679,249,139,110,162,0.8114780410077629,0.48164045905885206
가능/NNG@$속도/NNG@$금리/NNG@$인상/NNG,1,0.25472940924841314,37,21,16,16,0.5232242715710133,0.31084684608481117
인상/NNG@$가능성/NNG@$커졌/VV,1,0.25472940924841314,37,21,16,40,0.5232242715710133,0.31084684608481117
하락/NNG@$금리/NNG@$인하/NNG,1,0.25472940924841314,37,21,16,31,0.5232242715710133,0.31084684608481117
소비자들/NNG@$경제/NNG@$심리/NNG@$나타내/VV@$소비자심리지수/NNG,1,0.25472940924841314,37,21,16,36,0.5232242715710133,0.31084684608481117
예측/NNG@$가능/NNG@$속도/NNG@$금리/NNG@$인상/NNG,1,0.25472940924841314,37,21,16,16,0.5232242715710133,0.31084684608481117
상향/NNG@$조정/NNG@$경제/NNG,1,0.25472940924841314,37,21,16,41,0.5232242715710133,0.31084684608481117
경제/NNG@$회복/NNG@$기조/NNG,1,0.25472940924841314,37,21,16,16,0.5232242715710133,0.31084684608481117
원자재/NNG@$가격/NNG@$상승/NNG@$인플레이션/NNG,1,0.25472940924841314,37,21,16,31,0.5232242715710133,0.31084684608481117
호조/NNG@$금리/NNG@$인상/NNG,1,0.25472940924841314,37,21,16,41,0.5232242715710133,0.31084684608481117
속도/NNG@$빠르/VA@$않/VX,1,0.2538037394884074,48,27,21,55,0.5890357982344627,0.3506385358061018
부동산/NNG@$종합/NNG@$대책/NNG,1,0.2538037394884074,48,27,21,56,0.5890357982344627,0.3506385358061018
둔화/NNG@$인플레/NNG@$압력/NNG,1,0.2538037394884074,48,27,21,28,0.5890357982344627,0.3506385358061018
금리/NNG@$동결/NNG@$이유/NNG,1,0.2538037394884074,48,27,21,38,0.5890357982344627,0.3506385358061018
수출/NNG@$호조/NNG@$내수/NNG,1,0.2538037394884074,48,27,21,26,0.5890357982344627,0.3506385358061018
기조/NNG@$유지/NNG@$경제/NNG,1,0.2529033446807518,59,33,26,47,0.644086620507703,0.38414724708101244
금리/NNG@$단기금리/NNG@$국채/NNG,1,0.25148304565221213,142,79,63,201,0.8022929829527446,0.47995833494286955
경기/NNG@$둔화/NNG@$인플레이션/NNG,1,0.2513295962294395,99,55,44,43,0.7632989966052625,0.45678041522854335
우려/NNG@$크/VA@$않/VX,1,0.25118881432479534,70,39,31,74,0.6881584219237844,0.41193785156025553
둔화/NNG@$금리/NNG@$인상/NNG,1,0.2486421027864616,203,113,90,123,0.8081818768478269,0.4864197064587641
물가/NNG@$상승/NNG@$목표/NNG,0,0.24640357777771738,28,16,12,40,0.4596166812940026,0.2779511966813071
모니터링/NNG@$필요/NNG@$있/VA,0,0.24640357777771738,28,16,12,14,0.4596166812940026,0.2779511966813071
경상수지/NNG@$흑자/NNG@$축소/NNG,0,0.24640357777771738,28,16,12,27,0.4596166812940026,0.2779511966813071
변화/NNG@$없/VA@$예상/NNG,0,0.24640357777771738,28,16,12,26,0.4596166812940026,0.2779511966813071
경제/NNG@$불확실성/NNG@$확대/NNG,0,0.24640357777771738,28,16,12,26,0.4596166812940026,0.2779511966813071
변화/NNG@$없/VA@$전망/NNG,0,0.24640357777771738,28,16,12,30,0.4596166812940026,0.2779511966813071
규모/NNG@$자산/NNG@$매입/NNG@$프로그램/NNG,0,0.24640357777771738,28,16,12,42,0.4596166812940026,0.2779511966813071
성장률/NNG@$예상/NNG@$높/VA,0,0.24640357777771738,28,16,12,24,0.4596166812940026,0.2779511966813071
지표/NNG@$개인/NNG@$소비/NNG@$지출/NNG@$물가지수/NNG,0,0.24640357777771738,28,16,12,36,0.4596166812940026,0.2779511966813071
인상/NNG@$가능성/NNG@$전망/NNG,1,0.24620230008623545,50,28,22,23,0.5969865868566397,0.36117976273235236
통화정책/NNG@$방향/NNG@$전환/NNG,1,0.24543477154171578,39,22,17,9,0.5329360832881397,0.32295596874386356
경제/NNG@$심리/NNG@$나타내/VV@$소비자심리지수/NNG,1,0.24543477154171578,39,22,17,42,0.5329360832881397,0.32295596874386356
금리/NNG@$인상/NNG@$시기/NNG@$전망/NNG,1,0.24543477154171578,39,22,17,37,0.5329360832881397,0.32295596874386356
비둘기파/NNG@$통화/NNG@$완화/NNG@$선호/NNG,1,0.24543477154171578,39,22,17,35,0.5329360832881397,0.32295596874386356
기술/NNG@$지수/NNG@$높/VA,1,0.24543477154171578,39,22,17,17,0.5329360832881397,0.32295596874386356
지속/NNG@$기준금리/NNG@$인상/NNG,1,0.24543477154171578,39,22,17,40,0.5329360832881397,0.32295596874386356
자산/NNG@$가격/NNG@$버블/NNG,1,0.24537770799235292,92,51,41,89,0.7471991900655399,0.45285306258673286
금리/NNG@$인상/NNG@$재개/NNG,1,0.24523484463768974,72,40,32,62,0.6925276407713857,0.41984600842787595
부동산/NNG@$자산/NNG@$가격/NNG,1,0.24319009472989062,83,46,37,39,0.7249476009965427,0.4414156478047147
금융/NNG@$통화정책/NNG@$기준금리/NNG@$동결/NNG,0,0.24059273467724696,19,11,8,38,0.39230122364340897,0.24019081076842022
채권/NNG@$자금/NNG@$유입/NNG,0,0.24059273467724696,19,11,8,22,0.39230122364340897,0.24019081076842022
하락/NNG@$크/VA@$않/VX,0,0.24059273467724696,19,11,8,34,0.39230122364340897,0.24019081076842022
기조/NNG@$변화/NNG@$가능성/NNG,0,0.24059273467724696,19,11,8,22,0.39230122364340897,0.24019081076842022
통화정책/NNG@$방향/NNG@$금리/NNG,0,0.24059273467724696,19,11,8,31,0.39230122364340897,0.24019081076842022
금리/NNG@$인상/NNG@$가능성/NNG@$낮/VA,1,0.24039620490875624,94,52,42,100,0.748840621515597,0.4586773087291663
시중/NNG@$유동성/NNG@$풍부/XR,1,0.23995679536113346,63,35,28,49,0.6559749197869165,0.4021703228807234
금리/NNG@$인상/NNG@$의지/NNG,1,0.23951670827636162,74,41,33,39,0.6966287085920909,0.4274935933492122
성장률/NNG@$하향/NNG@$조정/NNG,1,0.2380701014476747,123,68,55,140,0.7854789336531389,0.48349826944297625
가능성/NNG@$높/VA@$예상/NNG,1,0.23795447645602863,85,47,38,69,0.7275994186426228,0.4479805506843234
사상/NNG@$최고치/NNG@$기록/NNG,1,0.23761299652795542,141,78,63,119,0.7952782584763615,0.490004676206443
통화정책/NNG@$방향/NNG@$물가/NNG,1,0.23688943749823,41,23,18,29,0.5423375165116582,0.3346698199024353
고용/NNG@$시장/NNG@$악화/NNG,1,0.23688943749823,41,23,18,44,0.5423375165116582,0.3346698199024353
구조적/NNG@$문제/NNG@$해결/NNG,1,0.23688943749823,41,23,18,48,0.5423375165116582,0.3346698199024353
지속/NNG@$물가/NNG@$상승/NNG@$압력/NNG,0,0.2349108014684016,30,17,13,25,0.47043365729178965,0.2915175534334321
달러/NNG@$원/NNG@$환율/NNG@$원대/NNG,0,0.2349108014684016,30,17,13,23,0.47043365729178965,0.2915175534334321
물가/NNG@$목표제/NNG@$채택/NNG,0,0.2349108014684016,30,17,13,22,0.47043365729178965,0.2915175534334321
지수/NNG@$내린/VV@$기술/NNG,0,0.2349108014684016,30,17,13,21,0.47043365729178965,0.2915175534334321
증가/NNG@$민간/NNG@$소비/NNG,0,0.2349108014684016,30,17,13,17,0.47043365729178965,0.2915175534334321
금리/NNG@$인상/NNG@$금융/NNG,1,0.2340195059767045,76,42,34,44,0.7004714784023695,0.4348863456988625
정책/NNG@$기조/NNG@$변화/NNG,1,0.2340195059767045,76,42,34,95,0.7004714784023695,0.4348863456988625
시장/NNG@$금리/NNG@$인하/NNG@$기대/NNG,1,0.2339206900745816,65,36,29,67,0.6614621063935008,0.4107533012676674
콜금리/NNG@$동결/NNG@$전망/NNG,1,0.23228192429987216,54,30,24,13,0.6119003103715299,0.3812954093276363
가능성/NNG@$크/VA@$않/VX@$전망/NNG,1,0.22898194297343832,43,24,19,35,0.5514257572760128,0.3460146813374635
경기/NNG@$조절적/NNG@$통화정책/NNG,1,0.22898194297343832,43,24,19,44,0.5514257572760128,0.3460146813374635
흑자/NNG@$기조/NNG@$유지/NNG,1,0.22898194297343832,43,24,19,31,0.5514257572760128,0.3460146813374635
기준금리/NNG@$인상/NNG@$가능/NNG,1,0.22898194297343832,43,24,19,42,0.5514257572760128,0.3460146813374635
침체/NNG@$빠지/VV@$않/VX,1,0.22898194297343832,43,24,19,32,0.5514257572760128,0.3460146813374635
주택/NNG@$담보대출/NNG@$증가/NNG,1,0.22872987920722543,78,43,35,58,0.7040657251734387,0.442029914749099
경제/NNG@$전망/NNG@$성장/NNG,0,0.22472905102462715,32,18,14,30,0.4810100457056267,0.30454751753635906
금리/NNG@$인상/NNG@$시기/NNG@$예상/NNG,0,0.22472905102462715,32,18,14,32,0.4810100457056267,0.30454751753635906
기업/NNG@$가격/NNG@$경쟁력/NNG,0,0.22472905102462715,32,18,14,25,0.4810100457056267,0.30454751753635906
저금리/NNG@$정책/NNG@$유지/NNG,0,0.22472905102462715,32,18,14,19,0.4810100457056267,0.30454751753635906
물가/NNG@$불안/NNG@$심리/NNG,0,0.22472905102462715,32,18,14,22,0.4810100457056267,0.30454751753635906
투자/NNG@$심리/NNG@$긍정적/NNG,0,0.22472905102462715,32,18,14,24,0.4810100457056267,0.30454751753635906
발생/NNG@$가능성/NNG@$높/VA,0,0.22388454160005145,21,12,9,25,0.403622238449584,0.2560048533783785
정책/NNG@$수단/NNG@$개발/NNG,0,0.22388454160005145,21,12,9,21,0.403622238449584,0.2560048533783785
기조/NNG@$유지/NNG@$통화정책/NNG,0,0.22388454160005145,21,12,9,33,0.403622238449584,0.2560048533783785
하방/NNG@$위험/NNG@$상존/NNG,0,0.22388454160005145,21,12,9,27,0.403622238449584,0.2560048533783785
자본/NNG@$유출/NNG@$발생/NNG,0,0.22388454160005145,21,12,9,33,0.403622238449584,0.2560048533783785
자산/NNG@$축소/NNG@$계획/NNG,0,0.22388454160005145,21,12,9,35,0.403622238449584,0.2560048533783785
국채/NNG@$금리/NNG@$하락/NNG,1,0.22363579324927652,80,44,36,126,0.7074211199152556,0.44892989140569084
경기/NNG@$둔화/NNG@$물가/NNG,1,0.22330491012082954,91,50,41,44,0.7343419459007483,0.46633849690711926
인상/NNG@$필요/NNG@$있/VA,1,0.22261435732375134,69,38,31,45,0.6715657593933662,0.427093044719127
인플레/NNG@$압력/NNG@$높/VA,1,0.22261435732375134,69,38,31,53,0.6715657593933662,0.427093044719127
국고채/NNG@$금리/NNG@$하락/NNG,1,0.22162409787473658,45,25,20,41,0.5601990773729043,0.3570104086763397
경상수지/NNG@$흑자/NNG@$지속/NNG,1,0.22162409787473658,45,25,20,71,0.5601990773729043,0.3570104086763397
금리/NNG@$인하/NNG@$부정적/NNG,1,0.22162409787473658,45,25,20,56,0.5601990773729043,0.3570104086763397
전세/NNG@$가격/NNG@$상승/NNG,1,0.22162409787473658,45,25,20,36,0.5601990773729043,0.3570104086763397
경기/NNG@$회복세/NNG@$뚜렷/XR,1,0.22162409787473658,45,25,20,57,0.5601990773729043,0.3570104086763397
종합/NNG@$지수/NNG@$하락/NNG,1,0.22162409787473658,45,25,20,56,0.5601990773729043,0.3570104086763397
동결/NNG@$가능성/NNG@$크/VA,1,0.22162409787473658,45,25,20,49,0.5601990773729043,0.3570104086763397
콜금리/NNG@$인상/NNG@$전망/NNG,1,0.21979224875053305,58,32,26,15,0.6255297232176417,0.4001829784184401
통화정책/NNG@$파급/NNG@$경로/NNG,1,0.21979224875053305,58,32,26,40,0.6255297232176417,0.4001829784184401
기준금리/NNG@$인상/NNG@$시기/NNG,0,0.21916464916227296,260,143,117,245,0.7942892536056346,0.5088173549659493
인플레이션/NNG@$상승/NNG@$압력/NNG,1,0.21874632148467676,93,51,42,86,0.7362159379721108,0.4720304319002103
성장률/NNG@$전망치/NNG@$상향/NNG@$조정/NNG,1,0.2173084627981181,71,39,32,65,0.6761999756169363,0.4348613796528243
가능성/NNG@$높/VA@$보/VX,1,0.2173084627981181,71,39,32,52,0.6761999756169363,0.4348613796528243
금리/NNG@$인상/NNG@$사이클/NNG,0,0.21589258221358665,164,90,74,124,0.7901398457356511,0.5096472439142281
내수/NNG@$경기/NNG@$회복/NNG,0,0.21584373401339674,135,74,61,82,0.78192725075335,0.504401717936763
통화/NNG@$부양/NNG@$기조/NNG,0,0.21559619766901883,34,19,15,39,0.4913343122647799,0.31711205058213204
모습/NNG@$보이/VV@$경기/NNG,0,0.21559619766901883,34,19,15,30,0.4913343122647799,0.31711205058213204
수출/NNG@$경제/NNG@$성장/NNG,0,0.21559619766901883,34,19,15,32,0.4913343122647799,0.31711205058213204
금리/NNG@$인하/NNG@$어려울/VA,0,0.21559619766901883,34,19,15,23,0.4913343122647799,0.31711205058213204
환율/NNG@$금리/NNG@$인상/NNG,0,0.21559619766901883,34,19,15,34,0.4913343122647799,0.31711205058213204
성장률/NNG@$전망/NNG@$제시/NNG,1,0.21474515105104675,47,26,21,39,0.5686568289113391,0.36767221311861153
전망/NNG@$좋/VA@$않/VX,1,0.21474515105104675,47,26,21,35,0.5686568289113391,0.36767221311861153
위험/NNG@$요인/NNG@$상존/NNG,1,0.2139916743280892,84,46,38,72,0.7134533855679958,0.46202126471690663
물가/NNG@$금리/NNG@$인상/NNG,1,0.2139916743280892,84,46,38,89,0.7134533855679958,0.46202126471690663
완화/NNG@$정책/NNG@$필요/NNG,0,0.21017641433485323,23,13,10,31,0.4148353873839043,0.27079538303433454
인상/NNG@$지연/NNG@$가능성/NNG,0,0.21017641433485323,23,13,10,28,0.4148353873839043,0.27079538303433454
부채/NNG@$상환/NNG@$능력/NNG,0,0.21017641433485323,23,13,10,29,0.4148353873839043,0.27079538303433454
외국인/NNG@$채권/NNG@$자금/NNG,0,0.21017641433485323,23,13,10,23,0.4148353873839043,0.27079538303433454
투자/NNG@$심리/NNG@$부정적/NNG,0,0.21017641433485323,23,13,10,27,0.4148353873839043,0.27079538303433454
인플레율/NNG@$상승/NNG@$압력/NNG,0,0.21017641433485323,23,13,10,46,0.4148353873839043,0.27079538303433454
상승/NNG@$압력/NNG@$높/VA@$않/VX,0,0.21017641433485323,23,13,10,25,0.4148353873839043,0.27079538303433454
영향/NNG@$크/VA@$않/VX@$전망/NNG,0,0.21017641433485323,23,13,10,29,0.4148353873839043,0.27079538303433454
가격/NNG@$변동성/NNG@$확대/NNG,0,0.21017641433485323,23,13,10,18,0.4148353873839043,0.27079538303433454
경기/NNG@$회복/NNG@$추세/NNG,1,0.21007257034775395,97,53,44,61,0.7394565630515416,0.48280578707075544
기조/NNG@$유지/NNG@$전망/NNG,1,0.20848198536518603,62,34,28,52,0.6379223969675506,0.4178997674973215
소비/NNG@$지출/NNG@$둔화/NNG,1,0.20848198536518603,62,34,28,44,0.6379223969675506,0.4178997674973215
경기/NNG@$하강/NNG@$우려/NNG,1,0.20848198536518603,62,34,28,26,0.6379223969675506,0.4178997674973215
시장/NNG@$예상치/NNG@$웃돌/VV,1,0.20828761140961438,49,27,22,54,0.5767994080886698,0.3780119559601824
양적완화/NNG@$축소/NNG@$가능성/NNG,1,0.20828761140961438,49,27,22,83,0.5767994080886698,0.3780119559601824
기조/NNG@$이어질/VV@$전망/NNG,1,0.20828761140961438,49,27,22,37,0.5767994080886698,0.3780119559601824
원자재/NNG@$가격/NNG@$상승/NNG@$물가/NNG,1,0.20828761140961438,49,27,22,34,0.5767994080886698,0.3780119559601824
매입/NNG@$규모/NNG@$늘리/VV,1,0.20731921173147394,36,20,16,27,0.5013960267124169,0.3292611568793617
상승률/NNG@$최고치/NNG@$기록/NNG,1,0.20731921173147394,36,20,16,52,0.5013960267124169,0.3292611568793617
투자/NNG@$증권/NNG@$경기/NNG,1,0.20731921173147394,36,20,16,44,0.5013960267124169,0.3292611568793617
기금/NNG@$금리선물/NNG@$시장/NNG@$금리/NNG@$인상/NNG,1,0.20731921173147394,36,20,16,28,0.5013960267124169,0.3292611568793617
끝/NNG@$나지/NNG@$않/VX,1,0.20731921173147394,36,20,16,14,0.5013960267124169,0.3292611568793617
금리/NNG@$경기/NNG@$회복/NNG,1,0.20731921173147394,36,20,16,39,0.5013960267124169,0.3292611568793617
경제/NNG@$성장/NNG@$기대/NNG,1,0.20731921173147394,36,20,16,20,0.5013960267124169,0.3292611568793617
결정/NNG@$쉽/VA@$않/VX,1,0.20731921173147394,36,20,16,22,0.5013960267124169,0.3292611568793617
금리/NNG@$인상/NNG@$속도/NNG@$완만/XR,1,0.20731921173147394,36,20,16,16,0.5013960267124169,0.3292611568793617
은행/NNG@$지급준비율/NNG@$인상/NNG,1,0.2032092328185331,64,35,29,53,0.6436719062305515,0.42633417406600793
성장/NNG@$모멘텀/NNG@$약화/NNG,1,0.20220420697652108,51,28,23,43,0.5846281986787389,0.3880390960990674
소득/NNG@$주도/NNG@$성장/NNG,1,0.20220420697652108,51,28,23,37,0.5846281986787389,0.3880390960990674
인상/NNG@$행진/NNG@$중단/NNG,1,0.20220420697652108,51,28,23,26,0.5846281986787389,0.3880390960990674
인상/NNG@$가능성/NNG@$있/VA,1,0.20220420697652108,51,28,23,52,0.5846281986787389,0.3880390960990674
인상/NNG@$가능성/NNG@$높/VA,0,0.20131110862976453,403,220,183,290,0.785369540296322,0.5222497360322161
성장/NNG@$발목/NNG@$잡/VV,1,0.1997528011367551,38,21,17,38,0.5111860813169309,0.34103039075449865
가격/NNG@$상승/NNG@$인플레이션/NNG@$압력/NNG,1,0.1997528011367551,38,21,17,32,0.5111860813169309,0.34103039075449865
더블딥/NNG@$경기/NNG@$상승/NNG@$하강/NNG,1,0.1997528011367551,38,21,17,45,0.5111860813169309,0.34103039075449865
통화정책/NNG@$기준금리/NNG@$유지/NNG,0,0.19861701385669894,25,14,11,42,0.42591854836922793,0.28481814242281056
외환/NNG@$위기/NNG@$가능성/NNG,0,0.19861701385669894,25,14,11,27,0.42591854836922793,0.28481814242281056
인상/NNG@$시기/NNG@$늦추/VV,0,0.19861701385669894,25,14,11,26,0.42591854836922793,0.28481814242281056
물가/NNG@$목표치/NNG@$달성/NNG,0,0.19861701385669894,25,14,11,23,0.42591854836922793,0.28481814242281056
국내총생산/NNG@$증가율/NNG@$전망치/NNG,0,0.19861701385669894,25,14,11,27,0.42591854836922793,0.28481814242281056
석유/NNG@$제품/NNG@$가격/NNG,0,0.19861701385669894,25,14,11,22,0.42591854836922793,0.28481814242281056
금리/NNG@$인상/NNG@$기업/NNG,0,0.19861701385669894,25,14,11,24,0.42591854836922793,0.28481814242281056
축소/NNG@$기준금리/NNG@$인상/NNG,0,0.19861701385669894,25,14,11,25,0.42591854836922793,0.28481814242281056
무역수지/NNG@$흑자/NNG@$규모/NNG,0,0.19861701385669894,25,14,11,20,0.42591854836922793,0.28481814242281056
채권/NNG@$시장/NNG@$주식시장/NNG,0,0.19861701385669894,25,14,11,27,0.42591854836922793,0.28481814242281056
금리/NNG@$인상/NNG@$카드/NNG,0,0.19851591124032875,114,62,52,82,0.7573525164714553,0.5065596198695109
소비자/NNG@$물가/NNG@$상승률/NNG@$농산물/NNG@$가격/NNG,0,0.19690923990973497,14,8,6,28,0.3467979872019778,0.2327346301329494
개선/NNG@$모습/NNG@$보였/VV,0,0.19690923990973497,14,8,6,25,0.3467979872019778,0.2327346301329494
경기/NNG@$회복/NNG@$강도/NNG,1,0.1964556394683885,53,29,24,45,0.5921455027214736,0.39776138726379606
금리/NNG@$동결/NNG@$경기/NNG,1,0.1964556394683885,53,29,24,41,0.5921455027214736,0.39776138726379606
기준금리/NNG@$인상/NNG@$나설/VV,1,0.1933346423998923,68,37,31,55,0.6543143051792305,0.442382363326742
통화정책/NNG@$경기/NNG@$부양/NNG,1,0.19278545479445053,40,22,18,38,0.5206967919828319,0.3524452441042338
경제/NNG@$침체/NNG@$빠질/VV,1,0.19278545479445053,40,22,18,36,0.5206967919828319,0.3524452441042338
민간/NNG@$소비/NNG@$증가/NNG,1,0.19278545479445053,40,22,18,63,0.5206967919828319,0.3524452441042338
인하/NNG@$가능성/NNG@$배제/NNG@$없/VA,1,0.19278545479445053,40,22,18,50,0.5206967919828319,0.3524452441042338
금리/NNG@$상승/NNG@$주택/NNG,1,0.19278545479445053,40,22,18,28,0.5206967919828319,0.3524452441042338
기술/NNG@$지수/NNG@$내린/VV@$마감/NNG,1,0.19278545479445053,40,22,18,24,0.5206967919828319,0.3524452441042338
실질/NNG@$국내총생산/NNG@$증가율/NNG,1,0.19278545479445053,40,22,18,40,0.5206967919828319,0.3524452441042338
금리/NNG@$인상/NNG@$충격/NNG,1,0.19264839296683034,94,51,43,70,0.7250025336654643,0.4908738408476958
경기/NNG@$금리/NNG@$인상/NNG,1,0.19100890393735215,55,30,25,30,0.5993544637984758,0.40718539266890436
자금/NNG@$단기/NNG@$부동화/NNG,1,0.19100890393735215,55,30,25,41,0.5993544637984758,0.40718539266890436
예상/NNG@$기준금리/NNG@$인상/NNG,1,0.18879638338860016,96,52,44,76,0.7267767068777651,0.49602392340646356
금리/NNG@$인상/NNG@$여부/NNG@$결정/NNG,1,0.18870185605146683,70,38,32,30,0.6592227952474449,0.4500066767024195
억제/NNG@$기준금리/NNG@$인상/NNG,0,0.18865515664644472,27,15,12,43,0.43684952783542125,0.29823640881215113
하지/NNG@$않/VX@$생각/NNG,0,0.18865515664644472,27,15,12,31,0.43684952783542125,0.29823640881215113
달러화/NNG@$약세/NNG@$보이/VV,0,0.18865515664644472,27,15,12,35,0.43684952783542125,0.29823640881215113
인플레/NNG@$압력/NNG@$가중/NNG,0,0.18865515664644472,27,15,12,24,0.43684952783542125,0.29823640881215113
사상/NNG@$최저/NNG@$유지/NNG,0,0.18865515664644472,27,15,12,31,0.43684952783542125,0.29823640881215113
확대/NNG@$필요/NNG@$있/VA,0,0.18865515664644472,27,15,12,30,0.43684952783542125,0.29823640881215113
경제/NNG@$회복/NNG@$기대감/NNG,0,0.18865515664644472,27,15,12,25,0.43684952783542125,0.29823640881215113
경제/NNG@$혁신/NNG@$계획/NNG,1,0.18633008171893772,42,23,19,73,0.5299219239986995,0.3635241595090844
기업/NNG@$투자/NNG@$확대/NNG,1,0.18633008171893772,42,23,19,19,0.5299219239986995,0.3635241595090844
금리/NNG@$인하/NNG@$어렵/VA,1,0.18633008171893772,42,23,19,36,0.5299219239986995,0.3635241595090844
마련/NNG@$필요/NNG@$있/VA,1,0.18633008171893772,42,23,19,28,0.5299219239986995,0.3635241595090844
인상/NNG@$가능성/NNG@$크/VA@$않/VX,1,0.1858360157467629,57,31,26,33,0.6062589867905179,0.4163168651383627
물가/NNG@$상승/NNG@$압력/NNG@$완화/NNG,1,0.1858360157467629,57,31,26,48,0.6062589867905179,0.4163168651383627
지속적/NNG@$경제/NNG@$성장/NNG,1,0.1858360157467629,57,31,26,38,0.6062589867905179,0.4163168651383627
성장/NNG@$둔화/NNG@$우려/NNG,0,0.18509235593521578,122,66,56,109,0.7577609251698461,0.5211548720120389
모기지/NNG@$금리/NNG@$상승/NNG,1,0.18425430411633203,72,39,33,93,0.6638668563798331,0.45737141888885624
억제/NNG@$금리/NNG@$인상/NNG,0,0.18146158738323215,100,54,46,100,0.72985504570925,0.5057474192950464
경제/NNG@$성장세/NNG@$지속/NNG,1,0.18091303517085056,59,32,27,56,0.6128636569371723,0.4251610272408946
금융시장/NNG@$금리/NNG@$인상/NNG,0,0.18046093342014036,113,61,52,106,0.7468219851129246,0.5185761252500413
반대/NNG@$금리/NNG@$인상/NNG,1,0.1803175834647064,44,24,20,18,0.5388566689954247,0.3742806326719729
경기/NNG@$회복/NNG@$않/VX,1,0.1803175834647064,44,24,20,21,0.5388566689954247,0.3742806326719729
지수/NNG@$오른/VV@$기록/NNG,1,0.1803175834647064,44,24,20,75,0.5388566689954247,0.3742806326719729
기준금리/NNG@$올릴/VV@$예상/NNG,1,0.1803175834647064,44,24,20,23,0.5388566689954247,0.3742806326719729
사드/NNG@$고고/NNG@$미사일/NNG@$방어/NNG@$체계/NNG,1,0.1803175834647064,44,24,20,46,0.5388566689954247,0.3742806326719729
경제/NNG@$물가/NNG@$상승/NNG,1,0.1803175834647064,44,24,20,32,0.5388566689954247,0.3742806326719729
경기/NNG@$확장/NNG@$국면/NNG,1,0.1799804174542543,74,40,34,85,0.6682546820909605,0.46448181019626467
금리/NNG@$인상/NNG@$크/VA,0,0.1799186925174936,29,16,13,26,0.4476072565612034,0.31115674068442767
기업/NNG@$많/VA@$의미/NNG,0,0.1799186925174936,29,16,13,22,0.4476072565612034,0.31115674068442767
경제/NNG@$성장/NNG@$부정적/NNG,0,0.1799186925174936,29,16,13,27,0.4476072565612034,0.31115674068442767
시장/NNG@$금리/NNG@$상승세/NNG,0,0.1799186925174936,29,16,13,29,0.4476072565612034,0.31115674068442767
상회/NNG@$증가세/NNG@$갔/VV,0,0.1799186925174936,29,16,13,31,0.4476072565612034,0.31115674068442767
영향력/NNG@$크/VA@$않/VX,0,0.1799186925174936,29,16,13,30,0.4476072565612034,0.31115674068442767
전망/NNG@$채권/NNG@$시장/NNG,0,0.1799186925174936,29,16,13,31,0.4476072565612034,0.31115674068442767
가격/NNG@$상승/NNG@$우려/NNG,0,0.1799186925174936,29,16,13,25,0.4476072565612034,0.31115674068442767
금리/NNG@$인상/NNG@$진행/NNG,0,0.1799186925174936,29,16,13,24,0.4476072565612034,0.31115674068442767
경제/NNG@$성장세/NNG@$예상/NNG,0,0.1799186925174936,29,16,13,20,0.4476072565612034,0.31115674068442767
기준금리/NNG@$인상/NNG@$없/VA,0,0.1799186925174936,29,16,13,48,0.4476072565612034,0.31115674068442767
회복/NNG@$속도/NNG@$완만/XR,0,0.1799186925174936,29,16,13,37,0.4476072565612034,0.31115674068442767
정책/NNG@$방향/NNG@$결정/NNG,0,0.17882508101625905,16,9,7,24,0.35779301386032414,0.24928445045906056
자금/NNG@$유입/NNG@$확대/NNG,0,0.17882508101625905,16,9,7,35,0.35779301386032414,0.24928445045906056
금융시장/NNG@$불안/NNG@$가능성/NNG,0,0.17882508101625905,16,9,7,23,0.35779301386032414,0.24928445045906056
금리/NNG@$인상/NNG@$시작/NNG,0,0.1779930166563528,259,140,119,201,0.7733065787547089,0.5397110855529936
조정/NNG@$필요/NNG@$있/VA,1,0.17621931218722708,61,33,28,45,0.6191736602278594,0.4337227765900452
국내총생산/NNG@$성장률/NNG@$전망치/NNG,1,0.1758697909495428,76,41,35,75,0.6723945427696497,0.47134310686968633
금리/NNG@$인상/NNG@$부정적/NNG,1,0.1758697909495428,76,41,35,56,0.6723945427696497,0.47134310686968633
민간/NNG@$소비/NNG@$위축/NNG,1,0.17469234684126111,46,25,21,33,0.5474975903587692,0.38472469902596207
시장/NNG@$관심/NNG@$금리/NNG,1,0.17469234684126111,46,25,21,24,0.5474975903587692,0.38472469902596207
경제/NNG@$성장/NNG@$엔진/NNG,1,0.17469234684126111,46,25,21,36,0.5474975903587692,0.38472469902596207
가능성/NNG@$높/VA@$금리/NNG@$인상/NNG,1,0.17469234684126111,46,25,21,38,0.5474975903587692,0.38472469902596207
성장률/NNG@$전망/NNG@$상향/NNG@$조정/NNG,1,0.17469234684126111,46,25,21,45,0.5474975903587692,0.38472469902596207
경기/NNG@$회복/NNG@$기대/NNG,0,0.17314449711549296,241,130,111,227,0.7707286515821021,0.5433196405649299
회복세/NNG@$보이/VV@$경제/NNG,0,0.1721473137649301,31,17,14,31,0.45817236792368804,0.32364979084309203
국채/NNG@$매입/NNG@$확대/NNG,0,0.1721473137649301,31,17,14,34,0.45817236792368804,0.32364979084309203
이중/NNG@$침체/NNG@$우려/NNG,0,0.1721473137649301,31,17,14,23,0.45817236792368804,0.32364979084309203
대외/NNG@$불확실성/NNG@$높/VA,0,0.1721473137649301,31,17,14,46,0.45817236792368804,0.32364979084309203
규모/NNG@$인프라/NNG@$투자/NNG,0,0.1721473137649301,31,17,14,18,0.45817236792368804,0.32364979084309203
인상/NNG@$나서/VV@$않/VX,0,0.1721473137649301,31,17,14,52,0.45817236792368804,0.32364979084309203
변화/NNG@$금리/NNG@$인상/NNG,0,0.1721473137649301,31,17,14,26,0.45817236792368804,0.32364979084309203
달러화/NNG@$강세/NNG@$보이/VV,0,0.1721473137649301,31,17,14,42,0.45817236792368804,0.32364979084309203
수출/NNG@$호조세/NNG@$지속/NNG,0,0.1721473137649301,31,17,14,21,0.45817236792368804,0.32364979084309203
상승/NNG@$인플레이션/NNG@$압력/NNG,1,0.1719130222194667,78,42,36,70,0.6762947478467706,0.4779606139205354
개선/NNG@$금리/NNG@$인상/NNG,1,0.17173689605878595,63,34,29,51,0.625194706563233,0.44200683483854614
물가/NNG@$불안/NNG@$우려/NNG,1,0.17173689605878595,63,34,29,37,0.625194706563233,0.44200683483854614
성장/NNG@$둔화/NNG@$인플레이션/NNG,1,0.17173689605878595,63,34,29,21,0.625194706563233,0.44200683483854614
구조/NNG@$개혁/NNG@$경제/NNG,1,0.17173689605878595,63,34,29,34,0.625194706563233,0.44200683483854614
채권/NNG@$시장/NNG@$콜금리/NNG,1,0.17173689605878595,63,34,29,22,0.625194706563233,0.44200683483854614
기준금리/NNG@$인상/NNG@$단행/NNG,0,0.17044043621814464,132,71,61,123,0.7567279466923277,0.5364302158261985
경기/NNG@$회복/NNG@$도움/NNG,1,0.16940902286424642,48,26,22,38,0.5558425485761754,0.3948639959660212
외환시장/NNG@$변동성/NNG@$확대/NNG,1,0.16940902286424642,48,26,22,26,0.5558425485761754,0.3948639959660212
금리/NNG@$인상/NNG@$행진/NNG@$중단/NNG,1,0.16940902286424642,48,26,22,24,0.5558425485761754,0.3948639959660212
경제/NNG@$성장/NNG@$둔화/NNG@$우려/NNG,1,0.16745006955628572,65,35,30,36,0.6309329566798794,0.45001785416284296
억제/NNG@$기준치/NNG@$허용/NNG@$한도/NNG,0,0.16515338326734597,33,18,15,68,0.46852745460815026,0.3357628944187064
통화정책/NNG@$열/VV@$기준금리/NNG@$동결/NNG,0,0.16515338326734597,33,18,15,40,0.46852745460815026,0.3357628944187064
통화/NNG@$가치/NNG@$절상/NNG,0,0.16515338326734597,33,18,15,29,0.46852745460815026,0.3357628944187064
회복/NNG@$모습/NNG@$보이/VV,0,0.16493313419533506,18,10,8,24,0.36885257859621495,0.26445214560222435
경제/NNG@$전망/NNG@$반영/NNG,0,0.16493313419533506,18,10,8,17,0.36885257859621495,0.26445214560222435
경제/NNG@$전망/NNG@$낙관적/NNG,0,0.16493313419533506,18,10,8,32,0.36885257859621495,0.26445214560222435
불안/NNG@$요인/NNG@$가능성/NNG,0,0.16493313419533506,18,10,8,14,0.36885257859621495,0.26445214560222435
인위적/NNG@$경기/NNG@$부양/NNG,1,0.16443018531427,50,27,23,36,0.56389061434532,0.4047045275832219
부정적/NNG@$영향/NNG@$예상/NNG,1,0.16443018531427,50,27,23,33,0.56389061434532,0.4047045275832219
인상/NNG@$단행/NNG@$않/VX,1,0.16443018531427,50,27,23,55,0.56389061434532,0.4047045275832219
경제/NNG@$성장/NNG@$동력/NNG,1,0.1633449783824541,67,36,31,67,0.6363949534915776,0.4577604916065314
자산/NNG@$매입/NNG@$축소/NNG,0,0.16261373777486532,125,67,58,129,0.7480219176408557,0.5388628274598597
금리/NNG@$인상/NNG@$무게/NNG,1,0.15972460225719454,52,28,24,31,0.5716419748945812,0.41425121763346123
경기/NNG@$둔화/NNG@$예상/NNG,1,0.15972460225719454,52,28,24,43,0.5716419748945812,0.41425121763346123
경기/NNG@$회복/NNG@$예상/NNG,1,0.15972460225719454,52,28,24,43,0.5716419748945812,0.41425121763346123
매입/NNG@$규모/NNG@$축소/NNG,1,0.15972460225719454,52,28,24,86,0.5716419748945812,0.41425121763346123
소폭/NNG@$상향/NNG@$조정/NNG,0,0.158798098819678,35,19,16,41,0.4786571533764858,0.34752794565443307
투자/NNG@$증권/NNG@$금리/NNG@$인상/NNG,0,0.158798098819678,35,19,16,25,0.4786571533764858,0.34752794565443307
금리/NNG@$인상/NNG@$실시/NNG,0,0.158798098819678,35,19,16,20,0.4786571533764858,0.34752794565443307
인플레이션/NNG@$압력/NNG@$크/VA,0,0.158798098819678,35,19,16,32,0.4786571533764858,0.34752794565443307
금리/NNG@$인상/NNG@$점치/VV,0,0.158798098819678,35,19,16,25,0.4786571533764858,0.34752794565443307
중기/NNG@$물가/NNG@$목표치/NNG,0,0.158798098819678,35,19,16,31,0.4786571533764858,0.34752794565443307
인도/NNG@$금리/NNG@$인상/NNG,0,0.158798098819678,35,19,16,26,0.4786571533764858,0.34752794565443307
경제/NNG@$성장세/NNG@$둔화/NNG,0,0.1564819820017198,211,113,98,234,0.7616341987693286,0.5556152351937265
수출/NNG@$증가세/NNG@$지속/NNG,0,0.15378212953650428,20,11,9,18,0.3799295925030158,0.2786975505098676
가격/NNG@$동향/NNG@$기준금리/NNG@$인상/NNG@$확률/NNG,0,0.15378212953650428,20,11,9,48,0.3799295925030158,0.2786975505098676
기준금리/NNG@$동결/NNG@$열/VV,0,0.15378212953650428,20,11,9,30,0.3799295925030158,0.2786975505098676
금융/NNG@$위기/NNG@$통화정책/NNG,0,0.15378212953650428,20,11,9,29,0.3799295925030158,0.2786975505098676
미국채/NNG@$금리/NNG@$상승/NNG,0,0.15378212953650428,20,11,9,30,0.3799295925030158,0.2786975505098676
금리/NNG@$정상화/NNG@$추진/NNG,0,0.15378212953650428,20,11,9,27,0.3799295925030158,0.2786975505098676
국채/NNG@$가격/NNG@$동향/NNG@$기준금리/NNG@$인상/NNG,0,0.15378212953650428,20,11,9,48,0.3799295925030158,0.2786975505098676
동향/NNG@$기준금리/NNG@$인상/NNG@$확률/NNG,0,0.15378212953650428,20,11,9,48,0.3799295925030158,0.2786975505098676
경제지표/NNG@$호조/NNG@$보이/VV,0,0.15297644230588148,37,20,17,39,0.4885481357330629,0.35896647566256384
은행/NNG@$금리/NNG@$인상/NNG@$가능성/NNG,0,0.15297644230588148,37,20,17,27,0.4885481357330629,0.35896647566256384
과거/NNG@$금리/NNG@$인상/NNG,0,0.15297644230588148,37,20,17,30,0.4885481357330629,0.35896647566256384
금리/NNG@$기준금리/NNG@$인상/NNG,0,0.15297644230588148,37,20,17,23,0.4885481357330629,0.35896647566256384
시장/NNG@$충격/NNG@$않/VX,0,0.15297644230588148,37,20,17,37,0.4885481357330629,0.35896647566256384
엔/NNG@$원/NNG@$환율/NNG,1,0.15200366355552686,73,39,34,58,0.6511932801363113,0.47942568389504214
임금/NNG@$상승/NNG@$압력/NNG,1,0.15103179240189757,56,30,26,44,0.5862603320770503,0.432479656172454
국채/NNG@$가격/NNG@$하락/NNG,1,0.15103179240189757,56,30,26,50,0.5862603320770503,0.432479656172454
경제/NNG@$긍정적/NNG@$영향/NNG,1,0.15103179240189757,56,30,26,38,0.5862603320770503,0.432479656172454
금리/NNG@$인상/NNG@$단행/NNG@$않/VX,0,0.14760736493151638,39,21,18,45,0.4981890461570211,0.37009301060543254
둔화/NNG@$경기/NNG@$회복/NNG,0,0.14760736493151638,39,21,18,17,0.4981890461570211,0.37009301060543254
실시/NNG@$금리/NNG@$동결/NNG,0,0.14760736493151638,39,21,18,18,0.4981890461570211,0.37009301060543254
기준금리/NNG@$동결/NNG@$가능성/NNG@$높/VA,0,0.14760736493151638,39,21,18,23,0.4981890461570211,0.37009301060543254
경제/NNG@$영향/NNG@$않/VX,0,0.14760736493151638,39,21,18,20,0.4981890461570211,0.37009301060543254
물가/NNG@$관리/NNG@$목표치/NNG,0,0.14760736493151638,39,21,18,43,0.4981890461570211,0.37009301060543254
의미/NNG@$금리/NNG@$인상/NNG,0,0.14760736493151638,39,21,18,19,0.4981890461570211,0.37009301060543254
유지/NNG@$경기/NNG@$회복/NNG,1,0.14700290743156774,58,31,27,46,0.5931324174787682,0.4411689245121083
축소/NNG@$금리/NNG@$인상/NNG,1,0.14700290743156774,58,31,27,52,0.5931324174787682,0.4411689245121083
금리/NNG@$올리/VV@$않/VX,0,0.146813729628974,225,120,105,195,0.7564193599802165,0.5628384924624336
국채/NNG@$금리/NNG@$낮/VA,0,0.14453132785580713,22,12,10,26,0.3909810478947766,0.29228184212406116
민간/NNG@$소비/NNG@$개선/NNG,0,0.14453132785580713,22,12,10,28,0.3909810478947766,0.29228184212406116
안정적/NNG@$모습/NNG@$보이/VV,0,0.14453132785580713,22,12,10,27,0.3909810478947766,0.29228184212406116
인상/NNG@$긴축/NNG@$기조/NNG,0,0.14453132785580713,22,12,10,28,0.3909810478947766,0.29228184212406116
외환/NNG@$위기/NNG@$금융/NNG,1,0.14316262442728944,60,32,28,39,0.5997177885010434,0.44957974357239083
잠정/NNG@$주택/NNG@$판매/NNG,1,0.14316262442728944,60,32,28,70,0.5997177885010434,0.44957974357239083
경상수지/NNG@$적자/NNG@$확대/NNG,1,0.1426272040643457,41,22,19,43,0.5075704108753878,0.3809173408535114
둔화/NNG@$우려/NNG@$커지/VV,1,0.1426272040643457,41,22,19,55,0.5075704108753878,0.3809173408535114
결정/NNG@$시장/NNG@$예상/NNG,1,0.1426272040643457,41,22,19,35,0.5075704108753878,0.3809173408535114
소비자/NNG@$동향/NNG@$소비자심리지수/NNG,1,0.1426272040643457,41,22,19,29,0.5075704108753878,0.3809173408535114
금리/NNG@$인상/NNG@$효과/NNG,0,0.1412485215261079,128,68,60,129,0.7383050862924158,0.5556382707356659
물가/NNG@$상승세/NNG@$둔화/NNG,1,0.13949640668529972,62,33,29,58,0.6060207890014532,0.4577158039641159
우려/NNG@$기준금리/NNG@$인상/NNG,1,0.13949640668529972,62,33,29,53,0.6060207890014532,0.4577158039641159
금리/NNG@$인상/NNG@$지연/NNG,0,0.13922618324025282,160,85,75,142,0.7489955467466961,0.5660136788303622
금리/NNG@$인상/NNG@$환율/NNG,0,0.13881079522536122,81,43,38,42,0.6674965109602276,0.5048525067641605
시장/NNG@$관심/NNG@$쏠리/VV,1,0.1379851568571855,43,23,20,20,0.5166845302664186,0.3914460812504941
경기/NNG@$둔화/NNG@$우려/NNG@$금리/NNG,1,0.1379851568571855,43,23,20,33,0.5166845302664186,0.3914460812504941
채권/NNG@$금리/NNG@$급등/NNG,1,0.1379851568571855,43,23,20,38,0.5166845302664186,0.3914460812504941
정책/NNG@$경기/NNG@$부양/NNG,1,0.1379851568571855,43,23,20,43,0.5166845302664186,0.3914460812504941
경기/NNG@$회복/NNG@$여부/NNG,1,0.1379851568571855,43,23,20,37,0.5166845302664186,0.3914460812504941
인플레이션/NNG@$압력/NNG@$높/VA,0,0.13717888046007376,147,78,69,128,0.7447959883596005,0.5651939284602868
금리/NNG@$상승/NNG@$속도/NNG,0,0.13665976948353475,24,13,11,28,0.40196874329429566,0.3053597872202541
채권/NNG@$시장/NNG@$자금/NNG,0,0.13665976948353475,24,13,11,38,0.40196874329429566,0.3053597872202541
유지/NNG@$기준금리/NNG@$인하/NNG,0,0.13665976948353475,24,13,11,24,0.40196874329429566,0.3053597872202541
금융/NNG@$시스템/NNG@$불안/NNG,0,0.13665976948353475,24,13,11,24,0.40196874329429566,0.3053597872202541
대출/NNG@$증가세/NNG@$둔화/NNG,0,0.13665976948353475,24,13,11,12,0.40196874329429566,0.3053597872202541
시중/NNG@$자금/NNG@$단기화/NNG,0,0.13665976948353475,24,13,11,24,0.40196874329429566,0.3053597872202541
외환시장/NNG@$원달러/NNG@$환율/NNG,0,0.13665976948353475,24,13,11,16,0.40196874329429566,0.3053597872202541
물가/NNG@$목표/NNG@$소비자/NNG,0,0.13665976948353475,24,13,11,23,0.40196874329429566,0.3053597872202541
금리/NNG@$인하/NNG@$사이클/NNG,1,0.13599148234675562,64,34,30,28,0.6120463291523629,0.4655809248926469
시장/NNG@$신뢰/NNG@$회복/NNG,1,0.1336400990960831,45,24,21,37,0.5255253626399405,0.4016837583982211
물가/NNG@$상승/NNG@$압박/NNG,1,0.1336400990960831,45,24,21,38,0.5255253626399405,0.4016837583982211
금융/NNG@$위기/NNG@$발생/NNG,0,0.13355428256323365,119,63,56,108,0.7271215020703685,0.5558702804058381
금리/NNG@$인상/NNG@$단행/NNG@$전망/NNG,1,0.13263655644729555,66,35,31,39,0.6177998081318936,0.47317909576217343
인상/NNG@$가능성/NNG@$열/VV,0,0.13075267276429225,170,90,80,112,0.7455923119332973,0.5732499385059946
인상/NNG@$단행/NNG@$전망/NNG,0,0.13011492040187767,87,46,41,57,0.6774207446188548,0.5215122195103741
가격/NNG@$상승/NNG@$소비자/NNG,0,0.1298269974513564,26,14,12,22,0.41285908413382716,0.31802566294051604
완화/NNG@$조정/NNG@$필요/NNG,0,0.1298269974513564,26,14,12,56,0.41285908413382716,0.31802566294051604
소비자/NNG@$물가/NNG@$기준/NNG,0,0.1298269974513564,26,14,12,28,0.41285908413382716,0.31802566294051604
농산물/NNG@$가격/NNG@$하락/NNG,0,0.1298269974513564,26,14,12,46,0.41285908413382716,0.31802566294051604
긍정적/NNG@$영향/NNG@$전망/NNG,0,0.1298269974513564,26,14,12,28,0.41285908413382716,0.31802566294051604
가격/NNG@$상승세/NNG@$지속/NNG,0,0.1298269974513564,26,14,12,22,0.41285908413382716,0.31802566294051604
시장/NNG@$예상/NNG@$일치/NNG,0,0.1298269974513564,26,14,12,29,0.41285908413382716,0.31802566294051604
소비/NNG@$내수/NNG@$회복세/NNG,0,0.1298269974513564,26,14,12,33,0.41285908413382716,0.31802566294051604
국고채/NNG@$금리/NNG@$내린/VV,0,0.1298269974513564,26,14,12,24,0.41285908413382716,0.31802566294051604
소비/NNG@$투자/NNG@$내수/NNG,0,0.12977781225434026,155,82,73,87,0.7426969880097151,0.5721572800553324
기조/NNG@$지속/NNG@$전망/NNG,1,0.12955830549872704,47,25,22,38,0.5340884041851404,0.4116335753471728
전망/NNG@$힘/NNG@$실/VV,1,0.12955830549872704,47,25,22,42,0.5340884041851404,0.4116335753471728
부정적/NNG@$영향/NNG@$가능성/NNG,1,0.12942157948570698,68,36,32,40,0.6232870423537424,0.4805144990821317
환율/NNG@$변동성/NNG@$확대/NNG,0,0.12658321580026466,108,57,51,86,0.7115102525048264,0.5517030955647685
통화/NNG@$가치/NNG@$하락/NNG,0,0.12658321580026466,108,57,51,139,0.7115102525048264,0.5517030955647685
수출/NNG@$호조/NNG@$보이/VV,1,0.12633755997904772,70,37,33,60,0.6285141993119714,0.48759151960537933
가계/NNG@$이자/NNG@$부담/NNG,1,0.12633755997904772,70,37,33,72,0.6285141993119714,0.48759151960537933
소비자/NNG@$물가/NNG@$상승세/NNG,1,0.12633755997904772,70,37,33,49,0.6285141993119714,0.48759151960537933
고용/NNG@$시장/NNG@$개선/NNG,0,0.1261854560300968,176,93,83,229,0.7435454281247805,0.5770092596395349
수요/NNG@$인플레이션/NNG@$압력/NNG,1,0.12571178733725685,49,26,23,31,0.5423705681930889,0.4212979519646985
주택/NNG@$판매/NNG@$감소/NNG,1,0.12571178733725685,49,26,23,39,0.5423705681930889,0.4212979519646985
물가/NNG@$상승률/NNG@$달성/NNG,1,0.12571178733725685,49,26,23,28,0.5423705681930889,0.4212979519646985
기준금리/NNG@$인상/NNG@$동결/NNG,1,0.12571178733725685,49,26,23,47,0.5423705681930889,0.4212979519646985
산업/NNG@$생산/NNG@$증가율/NNG,0,0.12428481293182414,110,58,52,77,0.7126456036761177,0.5551696050060146
지속적/NNG@$금리/NNG@$인상/NNG,0,0.12428481293182414,110,58,52,76,0.7126456036761177,0.5551696050060146
부동산/NNG@$경기/NNG@$둔화/NNG,0,0.12380073299008565,28,15,13,29,0.423622644950916,0.33033772743759776
원자재/NNG@$가격/NNG@$약세/NNG,0,0.12380073299008565,28,15,13,26,0.423622644950916,0.33033772743759776
금융/NNG@$위기/NNG@$이전/NNG@$회복/NNG,0,0.12380073299008565,28,15,13,38,0.423622644950916,0.33033772743759776
경제/NNG@$회복/NNG@$기대/NNG,0,0.12380073299008565,28,15,13,23,0.423622644950916,0.33033772743759776
물가/NNG@$상승률/NNG@$지속/NNG,0,0.12380073299008565,28,15,13,36,0.423622644950916,0.33033772743759776
산업/NNG@$생산/NNG@$부진/NNG,0,0.12380073299008565,28,15,13,21,0.423622644950916,0.33033772743759776
정책/NNG@$경기/NNG@$회복/NNG,0,0.12380073299008565,28,15,13,21,0.423622644950916,0.33033772743759776
경제/NNG@$회복/NNG@$신호/NNG,0,0.12380073299008565,28,15,13,24,0.423622644950916,0.33033772743759776
경제/NNG@$수출/NNG@$부진/NNG,0,0.12380073299008565,28,15,13,15,0.423622644950916,0.33033772743759776
지수/NNG@$오른/VV@$종합/NNG,0,0.12380073299008565,28,15,13,54,0.423622644950916,0.33033772743759776
시장/NNG@$금리/NNG@$낮/VA,0,0.12380073299008565,28,15,13,35,0.423622644950916,0.33033772743759776
부채/NNG@$상환/NNG@$부담/NNG,0,0.12380073299008565,28,15,13,26,0.423622644950916,0.33033772743759776
시장/NNG@$금리/NNG@$경기/NNG,0,0.12380073299008565,28,15,13,23,0.423622644950916,0.33033772743759776
경기/NNG@$회복/NNG@$걸림돌/NNG,1,0.12207706112864591,51,27,24,25,0.5503700656663586,0.4306789066924382
중기/NNG@$물가/NNG@$목표/NNG,0,0.12135182620736673,148,78,70,137,0.7361017362828701,0.5768672655034307
수출/NNG@$비중/NNG@$높/VA,0,0.11984956725240226,95,50,45,88,0.6879733114852851,0.540795967018149
금리/NNG@$인상/NNG@$움직임/NNG,1,0.11863422366091969,53,28,25,38,0.5580862888099192,0.43977832457865595
불확실성/NNG@$금리/NNG@$인상/NNG,1,0.11863422366091969,53,28,25,37,0.5580862888099192,0.43977832457865595
수출/NNG@$호조/NNG@$힘입/VV,0,0.11841677567372022,30,16,14,32,0.434233717884606,0.3423320263122203
해외/NNG@$자본/NNG@$유출/NNG,0,0.11841677567372022,30,16,14,26,0.434233717884606,0.3423320263122203
물가/NNG@$상승/NNG@$경제/NNG,0,0.11841677567372022,30,16,14,20,0.434233717884606,0.3423320263122203
증가/NNG@$소매/NNG@$판매/NNG,0,0.11841677567372022,30,16,14,19,0.434233717884606,0.3423320263122203
증가/NNG@$시장/NNG@$예상치/NNG,0,0.11841677567372022,30,16,14,37,0.434233717884606,0.3423320263122203
소비/NNG@$기업/NNG@$투자/NNG,0,0.11841677567372022,30,16,14,30,0.434233717884606,0.3423320263122203
결정적/NNG@$역할/NNG@$할/VV,0,0.1175676294114365,11,6,5,39,0.31070503486482226,0.24536921842064358
방안/NNG@$검토/NNG@$필요/NNG@$있/VA,0,0.1175676294114365,11,6,5,22,0.31070503486482226,0.24536921842064358
금리/NNG@$낮/VA@$유지/NNG,0,0.11521308823914889,99,52,47,99,0.692233728523146,0.5492844247931318
가계/NNG@$대출/NNG@$증가/NNG,0,0.11521308823914889,99,52,47,59,0.692233728523146,0.5492844247931318
전망치/NNG@$상향/NNG@$조정/NNG,0,0.1146434389249329,251,132,119,239,0.738242525263983,0.5864687642245806
기준금리/NNG@$인상/NNG@$가능성/NNG@$반영/NNG,0,0.11394314578220044,272,143,129,165,0.7378416689420058,0.586982539331102
통화정책/NNG@$금리/NNG@$인상/NNG,0,0.11381009418831955,120,63,57,103,0.7167446419823844,0.5703527219755923
금리/NNG@$인상/NNG@$기정사실/NNG,0,0.11355553665901641,32,17,15,24,0.44466991191576016,0.35403056442755737
기준금리/NNG@$추이/NNG@$열/VV,0,0.11355553665901641,32,17,15,52,0.44466991191576016,0.35403056442755737
유럽연합/NNG@$탈퇴/NNG@$결정/NNG,0,0.11355553665901641,32,17,15,31,0.44466991191576016,0.35403056442755737
출구전략/NNG@$시행/NNG@$시기/NNG,0,0.11355553665901641,32,17,15,43,0.44466991191576016,0.35403056442755737
자본/NNG@$유출/NNG@$위험/NNG,0,0.11355553665901641,32,17,15,30,0.44466991191576016,0.35403056442755737
외국인투자/NNG@$자금/NNG@$유입/NNG,0,0.11355553665901641,32,17,15,45,0.44466991191576016,0.35403056442755737
달러/NNG@$환율/NNG@$하락/NNG,0,0.11355553665901641,32,17,15,25,0.44466991191576016,0.35403056442755737
기준금리/NNG@$인상/NNG@$속도/NNG,0,0.11087148252527501,103,54,49,79,0.6958919593255255,0.5570643475589342
금리/NNG@$인상/NNG@$불가피/XR,0,0.11017990692679991,82,43,39,45,0.6547909845889719,0.5248971590261174
증가/NNG@$금리/NNG@$인상/NNG,1,0.1092980280883733,59,31,28,47,0.5795446228704143,0.46540769793537606
가능성/NNG@$낮/VA@$전망/NNG,0,0.10912767164968895,34,18,16,26,0.45491181240993694,0.36544634063965903
선행지수/NNG@$순환/NNG@$변동/NNG,0,0.10912767164968895,34,18,16,27,0.45491181240993694,0.36544634063965903
인상/NNG@$사이클/NNG@$종료/NNG,0,0.10912767164968895,34,18,16,16,0.45491181240993694,0.36544634063965903
기록/NNG@$금리/NNG@$인상/NNG,0,0.10912767164968895,34,18,16,33,0.45491181240993694,0.36544634063965903
인상/NNG@$시장/NNG@$예상/NNG,0,0.10912767164968895,34,18,16,37,0.45491181240993694,0.36544634063965903
반응/NNG@$보이/VV@$않/VX,0,0.10912767164968895,34,18,16,40,0.45491181240993694,0.36544634063965903
환율/NNG@$하락/NNG@$수출/NNG,0,0.10912767164968895,34,18,16,18,0.45491181240993694,0.36544634063965903
휘발유/NNG@$가격/NNG@$상승/NNG,0,0.10912767164968895,34,18,16,36,0.45491181240993694,0.36544634063965903
금리/NNG@$인상/NNG@$없/VA,0,0.10901713240421107,244,128,116,171,0.7349625217078256,0.5905528149364525
가능/NNG@$경제/NNG@$성장/NNG,0,0.10880398160618254,105,55,50,37,0.6975120531468962,0.5607026225367198
원자재/NNG@$가격/NNG@$하락/NNG,0,0.10831600742937053,307,161,146,222,0.7345637647004883,0.5910703551585618
소매/NNG@$판매/NNG@$증가/NNG,0,0.10782342298717595,84,44,40,126,0.6583883833210662,0.5303036878566687
금리/NNG@$인상/NNG@$정책/NNG,0,0.10726475394330937,147,77,70,115,0.7276306554863797,0.5867381076003046
경기/NNG@$둔화/NNG@$가능성/NNG,0,0.10696218243314304,311,163,148,218,0.7337710492706516,0.5920517660058082
유로존/NNG@$산업/NNG@$생산/NNG,0,0.10516532534743828,13,7,6,38,0.3212985780601689,0.2601872681015985
인상/NNG@$전망/NNG@$우세/NNG,0,0.10506494251148601,36,19,17,18,0.46494269351328427,0.37658655481533554
엔화/NNG@$약세/NNG@$수출/NNG,0,0.10506494251148601,36,19,17,43,0.46494269351328427,0.37658655481533554
요인/NNG@$물가/NNG@$상승/NNG,0,0.10506494251148601,36,19,17,24,0.46494269351328427,0.37658655481533554
금융/NNG@$중개/NNG@$기능/NNG,0,0.10506494251148601,36,19,17,21,0.46494269351328427,0.37658655481533554
회복/NNG@$조짐/NNG@$보이/VV,0,0.1048624773285225,109,57,52,86,0.7003664507575919,0.567503435713347
인상/NNG@$시기/NNG@$예상/NNG,1,0.10377590206428922,63,33,30,54,0.5924659398284234,0.4811278582172484
경제성장률/NNG@$전망치/NNG@$상향/NNG@$조정/NNG,1,0.10377590206428922,63,33,30,57,0.5924659398284234,0.4811278582172484
금리/NNG@$인상/NNG@$우려/NNG,0,0.10306326994837889,237,124,113,222,0.7314602296568898,0.5948580847172191
엔화/NNG@$달러당/NNG@$거래/NNG@$가격/NNG,0,0.10131421161920051,38,20,18,13,0.4747482724229252,0.3874547067989376
경기/NNG@$회복/NNG@$저해/NNG,0,0.10131421161920051,38,20,18,24,0.4747482724229252,0.3874547067989376
부정적/NNG@$영향/NNG@$미쳤/VV,0,0.10131421161920051,38,20,18,29,0.4747482724229252,0.3874547067989376
달러당/NNG@$거래/NNG@$가격/NNG,0,0.10131421161920051,38,20,18,13,0.4747482724229252,0.3874547067989376
우려/NNG@$경기/NNG@$둔화/NNG,0,0.10131421161920051,38,20,18,19,0.4747482724229252,0.3874547067989376
달러화/NNG@$엔화/NNG@$달러당/NNG@$거래/NNG@$가격/NNG,0,0.10131421161920051,38,20,18,13,0.4747482724229252,0.3874547067989376
속도/NNG@$금리/NNG@$인상/NNG,0,0.10005226025331826,136,71,65,68,0.7191271785252006,0.5883968551499428
시장/NNG@$기준금리/NNG@$인상/NNG@$가능성/NNG@$반영/NNG,0,0.09979235391973562,245,128,117,149,0.7295378605309008,0.597228401161959
필요/NNG@$있/VA@$덧붙였/VV,0,0.0993987886559835,115,60,55,114,0.7037755161440797,0.5765964503520735
기대/NNG@$금리/NNG@$인상/NNG,1,0.09872490014077595,67,35,32,33,0.6043155358702007,0.49578407124477125
채권/NNG@$시장/NNG@$경기/NNG,1,0.09872490014077595,67,35,32,71,0.6043155358702007,0.49578407124477125
시장/NNG@$금리/NNG@$인상/NNG@$가능성/NNG@$반영/NNG,0,0.097833382073363,40,21,19,23,0.48431649549612366,0.3980519996570326
영향/NNG@$않/VX@$전망/NNG,0,0.097833382073363,40,21,19,18,0.48431649549612366,0.3980519996570326
고용/NNG@$지표/NNG@$호조/NNG,0,0.09768862208479923,117,61,56,126,0.7047025623208136,0.5793530812976593
금리/NNG@$동결/NNG@$결정/NNG,0,0.09614994320046288,324,169,155,248,0.7273865085709259,0.5998622896865313
성장/NNG@$전망/NNG@$경로/NNG,0,0.09592120220724665,15,8,7,20,0.3321481950495349,0.27404299312496283
성장/NNG@$동력/NNG@$약화/NNG,0,0.09458858505370649,42,22,20,14,0.4936373482610854,0.4083782923537398
외국인투자/NNG@$자금/NNG@$유출/NNG,0,0.09458858505370649,42,22,20,34,0.4936373482610854,0.4083782923537398
가격/NNG@$상승/NNG@$인플레/NNG,0,0.09458858505370649,42,22,20,33,0.4936373482610854,0.4083782923537398
구조/NNG@$개혁/NNG@$정책/NNG,0,0.09458858505370649,42,22,20,39,0.4936373482610854,0.4083782923537398
회복세/NNG@$보일/VV@$전망/NNG,0,0.09458858505370649,42,22,20,37,0.4936373482610854,0.4083782923537398
고려/NNG@$기준금리/NNG@$동결/NNG,0,0.09458858505370649,42,22,20,39,0.4936373482610854,0.4083782923537398
신용등급/NNG@$하향/NNG@$조정/NNG,0,0.09458858505370649,42,22,20,32,0.4936373482610854,0.4083782923537398
금리/NNG@$인상/NNG@$시사/NNG,0,0.09236473832439285,386,201,185,286,0.7251290259951364,0.6025847360535334
상승/NNG@$가능성/NNG@$높/VA,1,0.09155218872748261,44,23,21,26,0.5027026834817757,0.41843275256183216
인상/NNG@$가능성/NNG@$금리/NNG,1,0.09155218872748261,44,23,21,52,0.5027026834817757,0.41843275256183216
금리/NNG@$인상/NNG@$필요/NNG@$있/VA,1,0.09155218872748261,44,23,21,25,0.5027026834817757,0.41843275256183216
금리/NNG@$인상/NNG@$채권/NNG,1,0.09155218872748261,44,23,21,29,0.5027026834817757,0.41843275256183216
개선/NNG@$경기/NNG@$회복/NNG,1,0.09155218872748261,44,23,21,48,0.5027026834817757,0.41843275256183216
가격/NNG@$상승/NNG@$영향/NNG,1,0.08870136162182174,46,24,22,37,0.5115060631595918,0.42821430511789665
경제/NNG@$구조적/NNG@$문제/NNG,1,0.08870136162182174,46,24,22,23,0.5115060631595918,0.42821430511789665
가능성/NNG@$높/VA@$경제/NNG,1,0.08870136162182174,46,24,22,23,0.5115060631595918,0.42821430511789665
공개/NNG@$시장/NNG@$금리/NNG@$인상/NNG,1,0.08870136162182174,46,24,22,24,0.5115060631595918,0.42821430511789665
경기/NNG@$부양/NNG@$나설/VV,1,0.08870136162182174,46,24,22,59,0.5115060631595918,0.42821430511789665
금융/NNG@$위기/NNG@$가능성/NNG,1,0.08870136162182174,46,24,22,40,0.5115060631595918,0.42821430511789665
추이/NNG@$열/VV@$기준금리/NNG,0,0.08865314924948953,17,9,8,34,0.34314951058413123,0.2873002265432287
물가/NNG@$오름세/NNG@$지속/NNG,0,0.08865314924948953,17,9,8,33,0.34314951058413123,0.2873002265432287
가능성/NNG@$높/VA@$진/VX,0,0.08826563863325854,104,54,50,64,0.6842940433456158,0.5733693984302554
원화/NNG@$강세/NNG@$수출/NNG,0,0.08779367608654409,77,40,37,85,0.6295278641702,0.5279827806434476
금리/NNG@$기조/NNG@$유지/NNG,0,0.08664557018800445,106,55,51,133,0.6860285686013022,0.5767022619057794
국채/NNG@$가격/NNG@$상승/NNG,1,0.08601701832554087,48,25,23,23,0.5200426116756064,0.43772193836817447
회복/NNG@$속도/NNG@$둔화/NNG,1,0.08601701832554087,48,25,23,38,0.5200426116756064,0.43772193836817447
인하/NNG@$가능성/NNG@$제기/NNG,1,0.08601701832554087,48,25,23,39,0.5200426116756064,0.43772193836817447
경기/NNG@$하강/NNG@$리스크/NNG,0,0.08574483974038594,133,69,64,74,0.7091079387419202,0.5971863127188042
금리/NNG@$인상/NNG@$포함/NNG,1,0.08348303392315048,50,26,24,28,0.5283088782374655,0.4469549100368581
인상/NNG@$가능성/NNG@$반영/NNG,0,0.08287236935995379,432,224,208,284,0.719417284383453,0.6093834623295026
성장/NNG@$경로/NNG@$하방/NNG@$리스크/NNG,0,0.08271433048513499,19,10,9,25,0.35422577864679566,0.3001429503996556
주택/NNG@$가격/NNG@$상승/NNG@$기대/NNG,0,0.08271433048513499,19,10,9,20,0.35422577864679566,0.3001429503996556
경기/NNG@$회복/NNG@$경제/NNG,0,0.08271433048513499,19,10,9,29,0.35422577864679566,0.3001429503996556
성장/NNG@$전망치/NNG@$하향/NNG,0,0.08271433048513499,19,10,9,30,0.35422577864679566,0.3001429503996556
엔화/NNG@$가치/NNG@$하락/NNG,1,0.07881302369100895,54,28,26,65,0.5440231174235877,0.46459599786438477
채권/NNG@$시장/NNG@$관심/NNG,1,0.07881302369100895,54,28,26,47,0.5440231174235877,0.46459599786438477
콜금리/NNG@$목표/NNG@$동결/NNG,1,0.07881302369100895,54,28,26,30,0.5440231174235877,0.46459599786438477
금리/NNG@$인상/NNG@$기대감/NNG,0,0.07878610765894045,87,45,42,55,0.6490618505400484,0.5543291449404998
기금/NNG@$금리선물/NNG@$시장/NNG@$기준금리/NNG@$인상/NNG,0,0.07795642897898447,259,134,125,168,0.7164282842835789,0.6128854271316592
상승/NNG@$압력/NNG@$전망/NNG,0,0.07771961651437853,21,11,10,27,0.3653179161165849,0.3126687259457332
생각/NNG@$볼/VX@$필요/NNG,0,0.07771961651437853,21,11,10,19,0.3653179161165849,0.3126687259457332
시장/NNG@$예상치/NNG@$밑돌/VV,0,0.07771961651437853,21,11,10,31,0.3653179161165849,0.3126687259457332
경상수지/NNG@$흑자/NNG@$규모/NNG,0,0.07717396046112479,89,46,43,115,0.6523607592879525,0.5589564947938966
콜금리/NNG@$동결/NNG@$예상/NNG,0,0.07717396046112479,89,46,43,24,0.6523607592879525,0.5589564947938966
소비자/NNG@$물가/NNG@$상승률/NNG@$전망/NNG,1,0.076654870712628,56,29,27,58,0.5514701846342792,0.47300493580251307
산업/NNG@$생산/NNG@$지표/NNG,1,0.076654870712628,56,29,27,72,0.5514701846342792,0.47300493580251307
주택/NNG@$가격/NNG@$급등/NNG,1,0.07460219670640877,58,30,28,32,0.5586449359141337,0.4811409166742279
금융시장/NNG@$불안/NNG@$요인/NNG,1,0.07460219670640877,58,30,28,39,0.5586449359141337,0.4811409166742279
물가/NNG@$상승률/NNG@$예상/NNG,0,0.07411573518573555,93,48,45,94,0.6584050642986236,0.5676156721542768
상승/NNG@$환율/NNG@$하락/NNG,0,0.07342465260831688,23,12,11,26,0.37637866906965206,0.32492986879634994
내수/NNG@$경기/NNG@$부진/NNG,0,0.07342465260831688,23,12,11,26,0.37637866906965206,0.32492986879634994
경기/NNG@$개선/NNG@$기대/NNG,0,0.07342465260831688,23,12,11,37,0.37637866906965206,0.32492986879634994
엠파이어/NNG@$스테이트/NNG@$지수/NNG,0,0.07342465260831688,23,12,11,62,0.37637866906965206,0.32492986879634994
디플레이션/NNG@$우려/NNG@$제기/NNG,0,0.07342465260831688,23,12,11,15,0.37637866906965206,0.32492986879634994
경기/NNG@$회복/NNG@$지원/NNG,1,0.07264707761715727,60,31,29,58,0.5655492468141631,0.48900570539790233
지속/NNG@$가능/NNG@$경제/NNG@$성장/NNG,0,0.0712626939250065,97,50,47,31,0.6637560689714518,0.5755200449778819
금리/NNG@$인하/NNG@$가능성/NNG@$높/VA,0,0.0712626939250065,97,50,47,61,0.6637560689714518,0.5755200449778819
청/NNG@$원유/NNG@$재고/NNG,1,0.0707824876408385,62,32,30,70,0.572185746611101,0.4966015930740465
에너지/NNG@$청/NNG@$원유/NNG@$재고/NNG,1,0.0707824876408385,62,32,30,70,0.572185746611101,0.4966015930740465
인상/NNG@$시장/NNG@$기대/NNG,0,0.06966649386235924,25,13,12,23,0.3873691186337069,0.3369535199889485
흑자/NNG@$규모/NNG@$축소/NNG,0,0.06966649386235924,25,13,12,24,0.3873691186337069,0.3369535199889485
인상/NNG@$시기/NNG@$가능성/NNG,0,0.06966649386235924,25,13,12,24,0.3873691186337069,0.3369535199889485
경기/NNG@$개선/NNG@$지속/NNG,0,0.06966649386235924,25,13,12,20,0.3873691186337069,0.3369535199889485
결제/NNG@$선물환/NNG@$시장/NNG,0,0.06966649386235924,25,13,12,29,0.3873691186337069,0.3369535199889485
차액/NNG@$결제/NNG@$선물환/NNG@$시장/NNG,0,0.06966649386235924,25,13,12,29,0.3873691186337069,0.3369535199889485
상승/NNG@$압력/NNG@$기준금리/NNG,0,0.06966649386235924,25,13,12,39,0.3873691186337069,0.3369535199889485
경제성장률/NNG@$전망/NNG@$상향/NNG@$조정/NNG,0,0.06966649386235924,25,13,12,36,0.3873691186337069,0.3369535199889485
은행/NNG@$통화/NNG@$완화/NNG@$정책/NNG@$종료/NNG,0,0.06966649386235924,25,13,12,28,0.3873691186337069,0.3369535199889485
금리/NNG@$인상/NNG@$나서/VV@$않/VX,0,0.06966649386235924,25,13,12,32,0.3873691186337069,0.3369535199889485
요인/NNG@$경기/NNG@$회복/NNG,0,0.06966649386235924,25,13,12,23,0.3873691186337069,0.3369535199889485
우려/NNG@$커지/VV@$금리/NNG,0,0.06966649386235924,25,13,12,32,0.3873691186337069,0.3369535199889485
하방/NNG@$리스크/NNG@$요인/NNG,0,0.06966649386235924,25,13,12,21,0.3873691186337069,0.3369535199889485
자산/NNG@$가격/NNG@$급등/NNG,0,0.06900216050429697,64,33,31,56,0.578557729742371,0.5039313702175668
경기/NNG@$둔화/NNG@$위험/NNG,0,0.06900216050429697,64,33,31,38,0.578557729742371,0.5039313702175668
경기/NNG@$회복/NNG@$신호/NNG,0,0.06900216050429697,64,33,31,52,0.578557729742371,0.5039313702175668
원화/NNG@$가치/NNG@$상승/NNG,0,0.0688847815553324,165,85,80,139,0.7084022204363848,0.6171731534423798
경제/NNG@$회복/NNG@$속도/NNG,0,0.06733039516127315,103,53,50,114,0.6705973468059245,0.5860640195245003
재정/NNG@$확대/NNG@$정책/NNG,0,0.06730047708432685,66,34,32,59,0.5846690735789731,0.5109982934820292
통화정책/NNG@$결정/NNG@$영향/NNG,0,0.06633202633148816,27,14,13,21,0.3982565245358806,0.3487522345102126
필요/NNG@$있/VA@$물가/NNG,0,0.06633202633148816,27,14,13,17,0.3982565245358806,0.3487522345102126
채권/NNG@$시장/NNG@$변동성/NNG,0,0.06633202633148816,27,14,13,22,0.3982565245358806,0.3487522345102126
양적/NNG@$통화/NNG@$완화/NNG,0,0.06633202633148816,27,14,13,27,0.3982565245358806,0.3487522345102126
상승/NNG@$공공요금/NNG@$인상/NNG,0,0.06633202633148816,27,14,13,16,0.3982565245358806,0.3487522345102126
시장/NNG@$기대/NNG@$금리/NNG,0,0.06633202633148816,27,14,13,23,0.3982565245358806,0.3487522345102126
통화정책/NNG@$완화적/NNG@$기조/NNG,0,0.06633202633148816,27,14,13,20,0.3982565245358806,0.3487522345102126
인상/NNG@$시기/NNG@$가늠/NNG,0,0.06633202633148816,27,14,13,23,0.3982565245358806,0.3487522345102126
금리/NNG@$인상/NNG@$늦출/VV,0,0.06633202633148816,27,14,13,28,0.3982565245358806,0.3487522345102126
금리/NNG@$결정/NNG@$시장/NNG,0,0.06633202633148816,27,14,13,27,0.3982565245358806,0.3487522345102126
금리/NNG@$상승/NNG@$기조/NNG,0,0.06633202633148816,27,14,13,18,0.3982565245358806,0.3487522345102126
정책/NNG@$여력/NNG@$확보/NNG,0,0.06633202633148816,27,14,13,59,0.3982565245358806,0.3487522345102126
하방/NNG@$리스크/NNG@$우세/NNG,0,0.06633202633148816,27,14,13,21,0.3982565245358806,0.3487522345102126
물가/NNG@$상승률/NNG@$상승/NNG,0,0.06567237365139977,68,35,33,48,0.5905241624006317,0.517806048343142
금리/NNG@$인상/NNG@$확률/NNG,0,0.06491864470975361,107,55,52,76,0.6744419508026294,0.5922858561925626
경제/NNG@$불안/NNG@$요인/NNG,0,0.06411326638807036,70,36,34,76,0.5961278174044842,0.5243587096120766
외환시장/NNG@$달러/NNG@$환율/NNG,0,0.06334006696234629,29,15,14,25,0.40901295064646254,0.3603299324104994
경제/NNG@$둘러싼/VV@$불확실성/NNG,0,0.06334006696234629,29,15,14,28,0.40901295064646254,0.3603299324104994
상승/NNG@$지수/NNG@$오른/VV,0,0.06334006696234629,29,15,14,21,0.40901295064646254,0.3603299324104994
수출/NNG@$부진/NNG@$경기/NNG,0,0.06334006696234629,29,15,14,18,0.40901295064646254,0.3603299324104994
상승/NNG@$압력/NNG@$우려/NNG,0,0.06334006696234629,29,15,14,24,0.40901295064646254,0.3603299324104994
부동산/NNG@$자산/NNG@$시장/NNG,0,0.06334006696234629,29,15,14,15,0.40901295064646254,0.3603299324104994
금리/NNG@$인상/NNG@$금융시장/NNG,0,0.06265947952523887,111,57,54,79,0.6777702598191347,0.5979146095253174
가격/NNG@$반대/NNG@$움직이/VV@$수익률/NNG,0,0.061185739734898936,74,38,36,43,0.6066019159708996,0.5367167561094289
경기/NNG@$하강/NNG@$국면/NNG,0,0.061185739734898936,74,38,36,44,0.6066019159708996,0.5367167561094289
반대/NNG@$움직이/VV@$수익률/NNG,0,0.061185739734898936,74,38,36,43,0.6066019159708996,0.5367167561094289
기업/NNG@$투자/NNG@$위축/NNG,0,0.06063068071941968,31,16,15,29,0.4196143586003282,0.37168541892999707
환율/NNG@$상승/NNG@$압력/NNG,0,0.06063068071941968,31,16,15,38,0.4196143586003282,0.37168541892999707
성장/NNG@$물가/NNG@$전망/NNG,0,0.06063068071941968,31,16,15,15,0.4196143586003282,0.37168541892999707
소비자/NNG@$물가/NNG@$오르/VV,0,0.06063068071941968,31,16,15,33,0.4196143586003282,0.37168541892999707
규모/NNG@$개방/NNG@$경제/NNG,0,0.06063068071941968,31,16,15,16,0.4196143586003282,0.37168541892999707
예상치/NNG@$크/VA@$웃돌/VV,0,0.06063068071941968,31,16,15,36,0.4196143586003282,0.37168541892999707
개인/NNG@$소비/NNG@$지출/NNG@$물가지수/NNG@$상승률/NNG,0,0.06063068071941968,31,16,15,24,0.4196143586003282,0.37168541892999707
경상수지/NNG@$적자/NNG@$기록/NNG,0,0.06063068071941968,31,16,15,23,0.4196143586003282,0.37168541892999707
소비자/NNG@$물가/NNG@$예상/NNG,0,0.06063068071941968,31,16,15,29,0.4196143586003282,0.37168541892999707
소비/NNG@$지출/NNG@$물가지수/NNG@$상승률/NNG,0,0.06063068071941968,31,16,15,24,0.4196143586003282,0.37168541892999707
물가/NNG@$지표/NNG@$개인/NNG@$소비/NNG@$지출/NNG,0,0.06063068071941968,31,16,15,45,0.4196143586003282,0.37168541892999707
전망/NNG@$경제성장률/NNG@$전망치/NNG,0,0.06063068071941968,31,16,15,24,0.4196143586003282,0.37168541892999707
관리/NNG@$필요/NNG@$있/VA,0,0.06063068071941968,31,16,15,28,0.4196143586003282,0.37168541892999707
인상/NNG@$나설/VV@$전망/NNG,0,0.05981003909904947,76,39,37,53,0.6114836368000732,0.5425318776536711
단행/NNG@$금리/NNG@$인상/NNG,0,0.05981003909904947,76,39,37,41,0.6114836368000732,0.5425318776536711
서브프라임모기지/NNG@$부실/NNG@$사태/NNG,0,0.05981003909904947,76,39,37,37,0.6114836368000732,0.5425318776536711
금리/NNG@$인하/NNG@$가능/NNG,0,0.05848869118643263,78,40,38,55,0.6161363769471989,0.5481113020719683
경상수지/NNG@$흑자/NNG@$기록/NNG,0,0.058158527360733236,33,17,16,23,0.4300399877246808,0.38281455357762184
목표/NNG@$소비자/NNG@$물가/NNG,0,0.058158527360733236,33,17,16,32,0.4300399877246808,0.38281455357762184
통화정책/NNG@$정상화/NNG@$속도/NNG,0,0.058158527360733236,33,17,16,28,0.4300399877246808,0.38281455357762184
우려/NNG@$있/VA@$금리/NNG,0,0.058158527360733236,33,17,16,17,0.4300399877246808,0.38281455357762184
전망/NNG@$경기/NNG@$회복/NNG,0,0.058158527360733236,33,17,16,27,0.4300399877246808,0.38281455357762184
인플레이션/NNG@$우려/NNG@$커지/VV,0,0.058158527360733236,33,17,16,22,0.4300399877246808,0.38281455357762184
주택/NNG@$가격/NNG@$하락세/NNG,0,0.058158527360733236,33,17,16,29,0.4300399877246808,0.38281455357762184
발생/NNG@$가능성/NNG@$크/VA,0,0.058158527360733236,33,17,16,27,0.4300399877246808,0.38281455357762184
경제/NNG@$성장/NNG@$회복/NNG,0,0.058158527360733236,33,17,16,18,0.4300399877246808,0.38281455357762184
차원/NNG@$금리/NNG@$인하/NNG,0,0.055888566652604554,35,18,17,52,0.44027191339681226,0.3937116296518766
경제/NNG@$불확실성/NNG@$높/VA,0,0.055888566652604554,35,18,17,38,0.44027191339681226,0.3937116296518766
제품/NNG@$가격/NNG@$경쟁력/NNG,0,0.055888566652604554,35,18,17,28,0.44027191339681226,0.3937116296518766
제품/NNG@$가격/NNG@$상승/NNG,0,0.055888566652604554,35,18,17,45,0.44027191339681226,0.3937116296518766
매파적/NNG@$통화/NNG@$긴축/NNG@$선호/NNG,0,0.055888566652604554,35,18,17,24,0.44027191339681226,0.3937116296518766
산업/NNG@$생산/NNG@$수출/NNG,0,0.055888566652604554,35,18,17,43,0.44027191339681226,0.3937116296518766
기준금리/NNG@$인하/NNG@$기조/NNG,0,0.055888566652604554,35,18,17,26,0.44027191339681226,0.3937116296518766
인상/NNG@$금리/NNG@$동결/NNG,0,0.05482243708856149,84,43,41,28,0.6287828434749502,0.5634905243983737
소비자/NNG@$물가/NNG@$상승률/NNG@$석유류/NNG@$가격/NNG,0,0.053793199997962615,37,19,18,12,0.45029471839251295,0.4043702716477424
상승률/NNG@$석유류/NNG@$가격/NNG,0,0.053793199997962615,37,19,18,12,0.45029471839251295,0.4043702716477424
물가/NNG@$상승세/NNG@$확대/NNG,0,0.053793199997962615,37,19,18,24,0.45029471839251295,0.4043702716477424
물가/NNG@$상승률/NNG@$석유류/NNG@$가격/NNG,0,0.053793199997962615,37,19,18,12,0.45029471839251295,0.4043702716477424
금리/NNG@$인상/NNG@$통한/VV,0,0.053793199997962615,37,19,18,35,0.45029471839251295,0.4043702716477424
투자/NNG@$심리/NNG@$악화/NNG,0,0.053793199997962615,37,19,18,38,0.45029471839251295,0.4043702716477424
금리선물/NNG@$시장/NNG@$기준금리/NNG@$인상/NNG@$가능성/NNG,0,0.05327499152252857,258,132,126,169,0.701150244959964,0.6302963064118755
필요/NNG@$있/VA@$경제/NNG,0,0.05185031727420952,39,20,19,25,0.46009523680917697,0.41478402671208375
단기/NNG@$시장/NNG@$금리/NNG,0,0.05185031727420952,39,20,19,25,0.46009523680917697,0.41478402671208375
사상/NNG@$최고/NNG@$기록/NNG,0,0.05185031727420952,39,20,19,33,0.46009523680917697,0.41478402671208375
위안화/NNG@$절상/NNG@$가능성/NNG,0,0.05185031727420952,39,20,19,48,0.46009523680917697,0.41478402671208375
투자/NNG@$증권/NNG@$기준금리/NNG,0,0.05185031727420952,39,20,19,43,0.46009523680917697,0.41478402671208375
금리/NNG@$인상/NNG@$주택/NNG,0,0.05185031727420952,39,20,19,21,0.46009523680917697,0.41478402671208375
상승/NNG@$크/VA@$않/VX,0,0.05185031727420952,39,20,19,34,0.46009523680917697,0.41478402671208375
예상/NNG@$경기/NNG@$둔화/NNG,0,0.05185031727420952,39,20,19,26,0.46009523680917697,0.41478402671208375
금리/NNG@$인상/NNG@$어렵/VA,0,0.051551761627186554,90,46,44,59,0.6395959783208451,0.5769523823519227
달러/NNG@$원/NNG@$환율/NNG@$하락/NNG,0,0.05004193122011347,41,21,20,63,0.46966234526744466,0.42494675528449916
상승/NNG@$지수/NNG@$높/VA,0,0.04835320315213698,43,22,21,39,0.4789867854284825,0.4348528860556735
효과/NNG@$지켜볼/VV@$필요/NNG@$있/VA,0,0.04835320315213698,43,22,21,63,0.4789867854284825,0.4348528860556735
생산/NNG@$소비/NNG@$투자/NNG,0,0.04835320315213698,43,22,21,46,0.4789867854284825,0.4348528860556735
가격/NNG@$금리/NNG@$인상/NNG,0,0.04677173530653844,45,23,22,21,0.48806100772816313,0.444497577015192
사상/NNG@$최대치/NNG@$기록/NNG,0,0.04677173530653844,45,23,22,45,0.48806100772816313,0.444497577015192
금리/NNG@$인하/NNG@$인상/NNG,0,0.04677173530653844,45,23,22,16,0.48806100772816313,0.444497577015192
공개/NNG@$시장/NNG@$열/VV,1,0.0438901911775893,49,25,24,17,0.5054363067648967,0.46298743947107707
경제/NNG@$전망/NNG@$정책/NNG,1,0.0438901911775893,49,25,24,56,0.5054363067648967,0.46298743947107707
금융정책/NNG@$결정/NNG@$열/VV,1,0.0438901911775893,49,25,24,43,0.5054363067648967,0.46298743947107707
경제성장률/NNG@$전망치/NNG@$하향/NNG@$조정/NNG,0,0.042872409218927876,110,56,54,111,0.6646202287588284,0.6100449529375238
심리/NNG@$나타내/VV@$소비자심리지수/NNG,1,0.04257344229956139,51,26,25,48,0.5137296075303776,0.47182720328664685
신중/NNG@$금리/NNG@$인상/NNG,1,0.04257344229956139,51,26,25,34,0.5137296075303776,0.47182720328664685
경기/NNG@$부양/NNG@$의지/NNG,0,0.041464491095526856,114,58,56,109,0.6679592498493219,0.6148413484766071
증권사/NNG@$채권/NNG@$딜러/NNG,0,0.041360385336194794,226,115,111,165,0.6935690866341225,0.638547761392752
테이퍼링/NNG@$양적완화/NNG@$축소/NNG,1,0.04133008375113545,53,27,26,79,0.5217569013896617,0.48039471418035545
인상/NNG@$채권/NNG@$시장/NNG,1,0.04015422313789019,55,28,27,33,0.5295172483884542,0.48868942980292585
경제/NNG@$성장/NNG@$예상/NNG,1,0.039040654860780455,57,29,28,63,0.537010696470451,0.49671161207713854
불확실성/NNG@$높/VA@$진/VX,1,0.039040654860780455,57,29,28,39,0.537010696470451,0.49671161207713854
자본/NNG@$유출/NNG@$압력/NNG,1,0.039040654860780455,57,29,28,25,0.537010696470451,0.49671161207713854
채권/NNG@$금리/NNG@$상승/NNG,0,0.03890978258507061,122,62,60,129,0.6733336798162122,0.6229677111296533
자본/NNG@$유출/NNG@$우려/NNG,0,0.038622727288773584,183,93,90,149,0.6910110096384127,0.6396903812224503
물가/NNG@$상승률/NNG@$낮/VA,0,0.03809775580716934,309,157,152,256,0.6915279718062325,0.6408422888949196
기준금리/NNG@$인상/NNG@$통화정책/NNG,0,0.03698236792327925,61,31,30,25,0.5512014481610157,0.5119431453218996
금융/NNG@$위기/NNG@$여파/NNG,0,0.03698236792327925,61,31,30,56,0.5512014481610157,0.5119431453218996
경제/NNG@$좋/VA@$않/VX,0,0.03512363884298986,65,33,32,74,0.5643457339503718,0.5261055133964386
기준금리/NNG@$인상/NNG@$경기/NNG,0,0.03512363884298986,65,33,32,50,0.5643457339503718,0.5261055133964386
산업/NNG@$생산/NNG@$감소/NNG,0,0.03426087545676304,67,34,33,79,0.5705334723786826,0.532793433278172
상승/NNG@$금리/NNG@$인상/NNG,0,0.03421108669567441,140,71,69,136,0.68049218628629,0.6355418659499417
시장/NNG@$변동성/NNG@$확대/NNG,0,0.03343871511793006,69,35,34,81,0.5764702752725682,0.5392242778642546
원/NNG@$환율/NNG@$하락/NNG,0,0.03343871511793006,69,35,34,83,0.5764702752725682,0.5392242778642546
가능성/NNG@$크/VA@$진단/NNG,0,0.03343871511793006,69,35,34,44,0.5764702752725682,0.5392242778642546
에너지/NNG@$가격/NNG@$상승/NNG,0,0.03305157085415966,217,110,107,139,0.6882060479874565,0.6442398316499366
영향/NNG@$주지/NNG@$않/VX,0,0.03190625038526118,73,37,36,37,0.5876096077566959,0.5513325387140231
금리/NNG@$인상/NNG@$자본/NNG@$유출/NNG,0,0.030508314039153106,77,39,38,54,0.5978040886117996,0.5624692331113695
소비자/NNG@$물가/NNG@$상승률/NNG@$기록/NNG,0,0.02985494586819759,79,40,39,79,0.602560794912038,0.5676866293844379
억제/NNG@$목표치/NNG@$허용/NNG@$한도/NNG,0,0.02922968127251857,81,41,40,57,0.6070982219523698,0.5726776188761046
목표치/NNG@$허용/NNG@$한도/NNG,0,0.028057309090787186,85,43,42,58,0.6155392752202786,0.582003967330521
매입/NNG@$규모/NNG@$확대/NNG,0,0.028057309090787186,85,43,42,60,0.6155392752202786,0.582003967330521
금리/NNG@$인상/NNG@$압력/NNG,0,0.026979939171697165,89,45,44,64,0.6231761547138281,0.5904964662788591
대응/NNG@$필요/NNG@$있/VA,0,0.026979939171697165,89,45,44,64,0.6231761547138281,0.5904964662788591
경제성장률/NNG@$하향/NNG@$조정/NNG,0,0.026473772599509227,91,46,45,72,0.6267085351549744,0.5944453795955589
서비스/NNG@$금리/NNG@$비교/NNG@$보/VV@$장기금리/NNG,0,0.025520958530268922,95,48,47,105,0.6332322713941044,0.601779476002005
부정적/NNG@$영향/NNG@$우려/NNG,0,0.023442194498944913,105,53,52,93,0.6466720936401904,0.617113062653223
통화/NNG@$긴축/NNG@$선호/NNG,0,0.02307187480255224,107,54,53,85,0.6489161513552583,0.619713509840692
투자/NNG@$자금/NNG@$유입/NNG,0,0.02271502867476305,109,55,54,96,0.6510258186997038,0.6221722561780184
가능성/NNG@$배제/NNG@$없/VA,0,0.015351812683223942,718,361,357,621,0.6767878713834591,0.6563894350014656
최고/NNG@$투자/NNG@$책임자/NNG,0,0.01532214652041497,179,90,89,147,0.6756994437936238,0.6553726971764094
금리/NNG@$인하/NNG@$기대/NNG,0,0.013066021957732321,444,223,221,383,0.6752863520831147,0.6579340729339495
경제/NNG@$검토/NNG@$기준금리/NNG@$유지/NNG,0,0.011534160327112186,12,6,6,46,0.29081939837683835,0.2842158235238241
농산물/NNG@$석유류/NNG@$가격/NNG,0,0.011534160327112186,12,6,6,30,0.29081939837683835,0.2842158235238241
금융/NNG@$경제/NNG@$검토/NNG@$기준금리/NNG@$유지/NNG,0,0.011534160327112186,12,6,6,45,0.29081939837683835,0.2842158235238241
경기/NNG@$하향/NNG@$리스크/NNG,0,0.010754932171272547,14,7,7,13,0.3024669755045637,0.29605991775002677
확대/NNG@$경기/NNG@$부양/NNG,0,0.009329318158360245,18,9,9,31,0.3256932684981294,0.3197043658785369
환율/NNG@$경상수지/NNG@$흑자/NNG,0,0.009329318158360245,18,9,9,28,0.3256932684981294,0.3197043658785369
하방/NNG@$리스크/NNG@$커지/VV,0,0.008680504270151213,20,10,10,41,0.33722349929717826,0.33145234310069605
가계부채/NNG@$구조/NNG@$개선/NNG,0,0.008680504270151213,20,10,10,36,0.33722349929717826,0.33145234310069605
선제/NNG@$안내/NNG@$포워드가이던스/NNG,0,0.008680504270151213,20,10,10,33,0.33722349929717826,0.33145234310069605
정상화/NNG@$기조/NNG@$유지/NNG,0,0.008680504270151213,20,10,10,32,0.33722349929717826,0.33145234310069605
영향/NNG@$경기/NNG@$회복/NNG,0,0.008680504270151213,20,10,10,20,0.33722349929717826,0.33145234310069605
감소세/NNG@$지속/NNG@$소비/NNG,0,0.008680504270151213,20,10,10,31,0.33722349929717826,0.33145234310069605
금리/NNG@$동결/NNG@$시장/NNG@$예상/NNG,0,0.008680504270151213,20,10,10,48,0.33722349929717826,0.33145234310069605
지속/NNG@$필요/NNG@$있/VA,0,0.008072600330111257,22,11,11,25,0.3486677922767867,0.34311763361185305
유로/NNG@$유로존/NNG@$재무/NNG,0,0.008072600330111257,22,11,11,30,0.3486677922767867,0.34311763361185305
위축/NNG@$우려/NNG@$있/VA,0,0.008072600330111257,22,11,11,23,0.3486677922767867,0.34311763361185305
경제정책/NNG@$방향/NNG@$성장률/NNG,0,0.008072600330111257,22,11,11,28,0.3486677922767867,0.34311763361185305
원화/NNG@$강세/NNG@$보이/VV,0,0.008072600330111257,22,11,11,32,0.3486677922767867,0.34311763361185305
수출/NNG@$증가세/NNG@$유지/NNG,0,0.008072600330111257,22,11,11,25,0.3486677922767867,0.34311763361185305
경기/NNG@$회복/NNG@$수요/NNG@$압력/NNG,0,0.008072600330111257,22,11,11,27,0.3486677922767867,0.34311763361185305
물가/NNG@$상승/NNG@$경기/NNG,0,0.007504209763768088,24,12,12,29,0.36000460166151654,0.3546768812314428
호흡기/NNG@$증후군/NNG@$메르스/NNG@$여파/NNG,0,0.007504209763768088,24,12,12,26,0.36000460166151654,0.3546768812314428
인하/NNG@$금리/NNG@$인상/NNG,0,0.007504209763768088,24,12,12,40,0.36000460166151654,0.3546768812314428
주식/NNG@$부동산/NNG@$자산/NNG,0,0.007504209763768088,24,12,12,35,0.36000460166151654,0.3546768812314428
증후군/NNG@$메르스/NNG@$여파/NNG,0,0.007504209763768088,24,12,12,26,0.36000460166151654,0.3546768812314428
경제/NNG@$성장/NNG@$금리/NNG,0,0.007504209763768088,24,12,12,28,0.36000460166151654,0.3546768812314428
시장/NNG@$금리/NNG@$오르/VV,0,0.007504209763768088,24,12,12,25,0.36000460166151654,0.3546768812314428
양적완화/NNG@$축소/NNG@$금리/NNG,0,0.007504209763768088,24,12,12,27,0.36000460166151654,0.3546768812314428
회복/NNG@$수요/NNG@$압력/NNG,0,0.007504209763768088,24,12,12,33,0.36000460166151654,0.3546768812314428
시장/NNG@$인상/NNG@$가능성/NNG,0,0.00697388430607826,26,13,13,24,0.3712136724110507,0.36610811344628336
금리/NNG@$상승/NNG@$경기/NNG,0,0.00697388430607826,26,13,13,31,0.3712136724110507,0.36610811344628336
성장률/NNG@$전망/NNG@$유지/NNG,0,0.00697388430607826,26,13,13,31,0.3712136724110507,0.36610811344628336
인상/NNG@$어려울/VA@$전망/NNG,0,0.00697388430607826,26,13,13,24,0.3712136724110507,0.36610811344628336
금리/NNG@$상승/NNG@$영향/NNG,0,0.00697388430607826,26,13,13,19,0.3712136724110507,0.36610811344628336
양적완화/NNG@$축소/NNG@$경제/NNG,0,0.00697388430607826,26,13,13,34,0.3712136724110507,0.36610811344628336
경기/NNG@$부진/NNG@$지속/NNG,0,0.00697388430607826,26,13,13,39,0.3712136724110507,0.36610811344628336
소비자/NNG@$물가/NNG@$상승/NNG@$압력/NNG,0,0.006480135794548092,28,14,14,26,0.38227612317321735,0.3773908407368988
인하/NNG@$가능성/NNG@$전망/NNG,0,0.006480135794548092,28,14,14,28,0.38227612317321735,0.3773908407368988
외환/NNG@$위기/NNG@$이전/NNG,0,0.006480135794548092,28,14,14,35,0.38227612317321735,0.3773908407368988
금리/NNG@$인상/NNG@$마지막/NNG,0,0.006480135794548092,28,14,14,30,0.38227612317321735,0.3773908407368988
무담보/NNG@$콜론/NNG@$금리/NNG@$동결/NNG,0,0.006480135794548092,28,14,14,35,0.38227612317321735,0.3773908407368988
경제/NNG@$성장/NNG@$부진/NNG,0,0.006021447644208866,30,15,15,31,0.3931745073409763,0.3885061305547111
경기/NNG@$부양/NNG@$대책/NNG,0,0.006021447644208866,30,15,15,26,0.3931745073409763,0.3885061305547111
통화/NNG@$증가율/NNG@$높/VA,0,0.006021447644208866,30,15,15,7,0.3931745073409763,0.3885061305547111
지수/NNG@$상승/NNG@$기록/NNG,0,0.006021447644208866,30,15,15,61,0.3931745073409763,0.3885061305547111
경기/NNG@$둔화/NNG@$우려/NNG@$커지/VV,0,0.006021447644208866,30,15,15,39,0.3931745073409763,0.3885061305547111
상환/NNG@$부담/NNG@$증가/NNG,0,0.006021447644208866,30,15,15,31,0.3931745073409763,0.3885061305547111
모기지/NNG@$주택/NNG@$담보대출/NNG,0,0.006021447644208866,30,15,15,30,0.3931745073409763,0.3885061305547111
지출/NNG@$물가지수/NNG@$상승률/NNG,0,0.005596285840874682,32,16,16,24,0.4038928531650854,0.39943665696116903
인플레이션/NNG@$압력/NNG@$금리/NNG,0,0.005596285840874682,32,16,16,28,0.4038928531650854,0.39943665696116903
기준금리/NNG@$조정/NNG@$여부/NNG,0,0.005596285840874682,32,16,16,24,0.4038928531650854,0.39943665696116903
예상/NNG@$기업/NNG@$많/VA,0,0.005596285840874682,32,16,16,32,0.4038928531650854,0.39943665696116903
금리/NNG@$인상/NNG@$마무리/NNG,0,0.005596285840874682,32,16,16,30,0.4038928531650854,0.39943665696116903
확대/NNG@$경기/NNG@$회복/NNG,0,0.005596285840874682,32,16,16,22,0.4038928531650854,0.39943665696116903
곡물/NNG@$가격/NNG@$급등/NNG,0,0.005596285840874682,32,16,16,36,0.4038928531650854,0.39943665696116903
산업/NNG@$생산/NNG@$예상/NNG,0,0.005596285840874682,32,16,16,44,0.4038928531650854,0.39943665696116903
국채/NNG@$매입/NNG@$계획/NNG,0,0.005596285840874682,32,16,16,66,0.4038928531650854,0.39943665696116903
약세/NNG@$보일/VV@$전망/NNG,0,0.005596285840874682,32,16,16,19,0.4038928531650854,0.39943665696116903
인하/NNG@$금리/NNG@$동결/NNG,0,0.005596285840874682,32,16,16,25,0.4038928531650854,0.39943665696116903
금리/NNG@$결정/NNG@$앞두/VV,0,0.005596285840874682,32,16,16,26,0.4038928531650854,0.39943665696116903
정상화/NNG@$금리/NNG@$인상/NNG,0,0.005203109316136878,34,17,17,31,0.41441668422481726,0.4101667273831082
원화/NNG@$강세/NNG@$지속/NNG,0,0.005203109316136878,34,17,17,49,0.41441668422481726,0.4101667273831082
금리/NNG@$인상/NNG@$속도/NNG@$예상/NNG,0,0.005203109316136878,34,17,17,20,0.41441668422481726,0.4101667273831082
금융/NNG@$위기/NNG@$최저/NNG,0,0.005203109316136878,34,17,17,18,0.41441668422481726,0.4101667273831082
의견/NNG@$적/VA@$않/VX,0,0.005203109316136878,34,17,17,26,0.41441668422481726,0.4101667273831082
금리/NNG@$인하/NNG@$동결/NNG,0,0.005203109316136878,34,17,17,30,0.41441668422481726,0.4101667273831082
물가/NNG@$상승률/NNG@$억제/NNG,0,0.005203109316136878,34,17,17,25,0.41441668422481726,0.4101667273831082
금리/NNG@$인하/NNG@$가능성/NNG@$제기/NNG,0,0.005203109316136878,34,17,17,20,0.41441668422481726,0.4101667273831082
가격/NNG@$상승/NNG@$경기/NNG,0,0.004840379595207667,36,18,18,16,0.42473302183323397,0.4206822882875972
압력/NNG@$기준금리/NNG@$인상/NNG,0,0.004840379595207667,36,18,18,36,0.42473302183323397,0.4206822882875972
금융/NNG@$투자/NNG@$채권/NNG@$시장/NNG,0,0.004506569635970958,38,19,19,29,0.43483037115212264,0.43097091183462266
환시/NNG@$달러화/NNG@$엔화/NNG@$달러당/NNG@$거래/NNG,0,0.004506569635970958,38,19,19,12,0.43483037115212264,0.43097091183462266
급등/NNG@$금리/NNG@$인상/NNG,0,0.004506569635970958,38,19,19,21,0.43483037115212264,0.43097091183462266
은행/NNG@$자본/NNG@$확충/NNG,0,0.004506569635970958,38,19,19,22,0.43483037115212264,0.43097091183462266
주택/NNG@$가격/NNG@$전망/NNG,0,0.004506569635970958,38,19,19,39,0.43483037115212264,0.43097091183462266
가격/NNG@$고공/NNG@$행진/NNG,0,0.004506569635970958,38,19,19,42,0.43483037115212264,0.43097091183462266
경제/NNG@$성장/NNG@$둔화/NNG@$인플레이션/NNG,0,0.004200171803615982,40,20,20,11,0.44469869291861736,0.4410217657315026
시장/NNG@$금리/NNG@$영향/NNG,0,0.004200171803615982,40,20,20,29,0.44469869291861736,0.4410217657315026
인상/NNG@$확률/NNG@$높/VA,0,0.004200171803615982,40,20,20,27,0.44469869291861736,0.4410217657315026
투자/NNG@$채권/NNG@$시장/NNG,0,0.004200171803615982,40,20,20,32,0.44469869291861736,0.4410217657315026
실시/NNG@$기준금리/NNG@$동결/NNG,0,0.004200171803615982,40,20,20,26,0.44469869291861736,0.4410217657315026
금리/NNG@$인상/NNG@$인내심/NNG,0,0.004200171803615982,40,20,20,57,0.44469869291861736,0.4410217657315026
수출/NNG@$경기/NNG@$회복/NNG,0,0.003919704949288061,42,21,21,43,0.45432936274683117,0.45082556859619904
금리/NNG@$유지/NNG@$결정/NNG,0,0.00366372058284381,44,22,22,30,0.4637151199711768,0.46037453314721494
직접적/NNG@$영향/NNG@$않/VX,0,0.00366372058284381,44,22,22,16,0.4637151199711768,0.46037453314721494
긴축/NNG@$기조/NNG@$유지/NNG,0,0.00366372058284381,44,22,22,38,0.4637151199711768,0.46037453314721494
기준금리/NNG@$동결/NNG@$전망/NNG,0,0.0034077354256600856,236,118,118,218,0.6688836123733413,0.664404999860402
물가/NNG@$상승률/NNG@$전망치/NNG,0,0.003253182363957219,176,88,88,139,0.6675353705257449,0.6632707335008594
외국인/NNG@$자금/NNG@$유입/NNG,0,0.0032195994298880315,48,24,24,49,0.48172930767814287,0.478683860638273
경기/NNG@$하강/NNG@$속도/NNG,0,0.0030287721181334604,50,25,25,30,0.49034946638209864,0.48743548237060896
기준금리/NNG@$인상/NNG@$시사/NNG,0,0.0030287721181334604,50,25,25,49,0.49034946638209864,0.48743548237060896
채권/NNG@$시장/NNG@$국고채/NNG@$금리/NNG,0,0.0030287721181334604,50,25,25,21,0.49034946638209864,0.48743548237060896
만장일치/NNG@$기준금리/NNG@$동결/NNG,0,0.0028570525988143025,52,26,26,59,0.49870802274513226,0.4959146191465122
공개/NNG@$시장/NNG@$기준금리/NNG,0,0.002703218006292918,54,27,27,31,0.5068035301109913,0.5041198278759131
기준금리/NNG@$인상/NNG@$가능성/NNG@$높/VA,0,0.002703218006292918,54,27,27,48,0.5068035301109913,0.5041198278759131
통화/NNG@$완화/NNG@$선호/NNG,0,0.0024445736027807197,58,29,29,49,0.5222042197695554,0.5197076796955301
압력/NNG@$높/VA@$않/VX,0,0.0024445736027807197,58,29,29,68,0.5222042197695554,0.5197076796955301
삭제/NNG@$금리/NNG@$인상/NNG,0,0.0024445736027807197,58,29,29,44,0.5222042197695554,0.5197076796955301
금리/NNG@$인상/NNG@$기정사실화/NNG,0,0.0024445736027807197,58,29,29,30,0.5222042197695554,0.5197076796955301
고용/NNG@$지표/NNG@$시장/NNG,0,0.0023375813345944962,60,30,30,51,0.5295108870776127,0.5270921697075123
이전/NNG@$금리/NNG@$인상/NNG,0,0.0023375813345944962,60,30,30,45,0.5295108870776127,0.5270921697075123
하락/NNG@$거래/NNG@$마쳤/VV,0,0.002336844675668859,116,58,58,108,0.6452043124956245,0.642258072918528
개인/NNG@$소비/NNG@$지출/NNG@$가격지수/NNG,0,0.002244109093678004,62,31,31,47,0.5365573257004549,0.5342062582918164
가능성/NNG@$가격/NNG@$반영/NNG,0,0.002163197461361843,64,32,32,56,0.5433460195429933,0.5410527353706884
매파/NNG@$통화/NNG@$긴축/NNG@$선호/NNG,0,0.002163197461361843,64,32,32,57,0.5433460195429933,0.5410527353706884
자국/NNG@$통화/NNG@$가치/NNG,0,0.002067077796355843,102,51,51,121,0.6294285419442187,0.6268924086339821
자금/NNG@$유출/NNG@$우려/NNG,0,0.0020354735885377284,68,34,34,50,0.5561628994397708,0.5539569790483538
기준치/NNG@$허용/NNG@$한도/NNG,0,0.0020354735885377284,68,34,34,85,0.5561628994397708,0.5539569790483538
금리/NNG@$단기금리/NNG@$없/VA,0,0.002002493682472295,98,49,49,126,0.623642053234252,0.621209453864472
국채/NNG@$금리/NNG@$단기금리/NNG@$없/VA,0,0.002002493682472295,98,49,49,126,0.623642053234252,0.621209453864472
주택/NNG@$담보대출/NNG@$증가세/NNG,0,0.0019477357572101894,72,36,36,23,0.5679916853459268,0.5658381096368491
경기/NNG@$둔화/NNG@$조짐/NNG,0,0.001868543884521845,84,42,42,43,0.5979354031322188,0.5957626259337422
금리/NNG@$인상/NNG@$않/VX,0,-0.005874373306683611,231,115,116,175,0.6626797208387334,0.6705740086240191
물가/NNG@$목표/NNG@$달성/NNG,0,-0.009259075633184288,173,86,87,152,0.6589473819069812,0.6713256446325161
가능성/NNG@$높/VA@$않/VX,0,-0.01057786764873303,159,79,80,134,0.6563372342666595,0.6704322585797263
금리/NNG@$상승/NNG@$압력/NNG,0,-0.011010059531086025,155,77,78,137,0.6553082524493778,0.6699599767602372
보유/NNG@$자산/NNG@$축소/NNG,0,-0.013316567253592426,137,68,69,170,0.648339561363204,0.6659000178471112
가능성/NNG@$배제/NNG@$않/VX,0,-0.013613058586398274,135,67,68,98,0.6472645431186793,0.6651902001654134
금리/NNG@$인상/NNG@$가능성/NNG@$반영/NNG,0,-0.015580441890821639,123,61,62,80,0.639125785943202,0.6594155999319739
금리/NNG@$인상/NNG@$반대/NNG,0,-0.016312052325863413,119,59,60,99,0.635664957091678,0.6568052934061489
경기/NNG@$회복/NNG@$가시화/NNG,0,-0.016692829818462318,117,58,59,72,0.6337733684990537,0.6553497218869064
인상/NNG@$나설/VV@$가능성/NNG,0,-0.019654315997172378,103,51,52,58,0.6170488997483694,0.6418467411246577
전망/NNG@$금리/NNG@$인하/NNG,0,-0.023183987609821544,89,44,45,65,0.592890979713578,0.6210880896264257
물가/NNG@$상승률/NNG@$전망/NNG,0,-0.02444802725072792,158,78,80,167,0.6468167152534987,0.6792942150730016
금리/NNG@$올릴/VV@$예상/NNG,0,-0.02610339620835256,79,39,40,75,0.5699964632945346,0.6006027209668341
주택/NNG@$경기/NNG@$둔화/NNG,0,-0.02610339620835256,79,39,40,70,0.5699964632945346,0.6006027209668341
채권/NNG@$시장/NNG@$금리/NNG@$인하/NNG,0,-0.02673188636914292,77,38,39,69,0.5647791953920724,0.5958541810508963
금리/NNG@$인상/NNG@$나설/VV@$가능성/NNG,0,-0.02673188636914292,77,38,39,43,0.5647791953920724,0.5958541810508963
시장/NNG@$금리/NNG@$하락/NNG,0,-0.02708207583522937,146,72,74,113,0.6422954536840247,0.6781105106984583
동결/NNG@$금리/NNG@$인하/NNG,0,-0.028586332950394477,140,69,71,100,0.6393065483679049,0.6769897624213811
기준금리/NNG@$동결/NNG@$경기/NNG,0,-0.03012769833689799,67,33,34,71,0.5352107136639366,0.5685091174796877
채권/NNG@$시장/NNG@$국채/NNG@$가격/NNG,0,-0.03012769833689799,67,33,34,37,0.5352107136639366,0.5685091174796877
동결/NNG@$가능성/NNG@$높/VA,0,-0.030810586701981668,132,65,67,85,0.6343581869015409,0.6747466872360744
소비/NNG@$지출/NNG@$가격지수/NNG,0,-0.031619100595219995,63,31,32,48,0.5216733495452287,0.5557860815256052
불안/NNG@$경기/NNG@$둔화/NNG,0,-0.031619100595219995,63,31,32,50,0.5216733495452287,0.5557860815256052
지속/NNG@$금리/NNG@$인하/NNG,0,-0.032397582073808384,61,30,31,38,0.5145230650202234,0.5490230728942811
투자/NNG@$심리/NNG@$회복/NNG,-1,-0.034027688842785175,57,28,29,64,0.49944580735862876,0.5346767258784624
금리/NNG@$인하/NNG@$통한/VV,-1,-0.0348831586756696,55,27,28,37,0.4915150860692651,0.5270884985112367
시장/NNG@$국고채/NNG@$금리/NNG,-1,-0.036687343259281247,51,25,26,24,0.4748647899731851,0.5110759363863305
생활/NNG@$형편/NNG@$전망/NNG,0,-0.0368619272433417,114,56,58,109,0.6179227435754221,0.6652753923888741
결정/NNG@$금리/NNG@$동결/NNG,-1,-0.03764252119803779,49,24,25,21,0.4661454149591825,0.5026521122732205
성장세/NNG@$회복/NNG@$이어지/VV@$중기적/NNG@$물가/NNG,0,-0.03863851705317345,47,23,24,51,0.4571645875273361,0.49395213576248986
美/NNG@$국채/NNG@$수익률/NNG,0,-0.03863851705317345,47,23,24,36,0.4571645875273361,0.49395213576248986
금융/NNG@$외환시장/NNG@$영향/NNG,0,-0.03863851705317345,47,23,24,8,0.4571645875273361,0.49395213576248986
기조/NNG@$변화/NNG@$없/VA,0,-0.03863851705317345,47,23,24,48,0.4571645875273361,0.49395213576248986
경기/NNG@$좋/VA@$않/VX,0,-0.03924637591915858,108,53,55,82,0.6103687142656608,0.6602877214485927
완화/NNG@$정책/NNG@$유지/NNG,0,-0.03968049329303591,45,22,23,35,0.4479242889718155,0.4849792396515302
상승/NNG@$수입/NNG@$물가/NNG,0,-0.03968049329303591,45,22,23,28,0.4479242889718155,0.4849792396515302
우려/NNG@$고개/NNG@$들/VV,0,-0.03968049329303591,45,22,23,38,0.4479242889718155,0.4849792396515302
상승/NNG@$경제/NNG@$성장/NNG,0,-0.03968049329303591,45,22,23,29,0.4479242889718155,0.4849792396515302
기준금리/NNG@$인하/NNG@$필요/NNG,0,-0.04077475670000219,43,21,22,50,0.4384272695218795,0.47573806430355964
기금/NNG@$금리/NNG@$동결/NNG,0,-0.04077475670000219,43,21,22,32,0.4384272695218795,0.47573806430355964
인상/NNG@$속도/NNG@$점진적/NNG,0,-0.04077475670000219,43,21,22,19,0.4384272695218795,0.47573806430355964
소비/NNG@$심리/NNG@$개선/NNG,0,-0.04183916556078282,102,50,52,109,0.6015473032512864,0.6541329822038484
금리/NNG@$인상/NNG@$경제/NNG@$성장/NNG,0,-0.04192906377771355,41,20,21,27,0.4286770230586841,0.4662347875660819
경제/NNG@$성장률/NNG@$기록/NNG,0,-0.04315302293642709,39,19,20,38,0.4186777272120684,0.45647726204192607
진행/NNG@$금리/NNG@$인상/NNG,0,-0.04315302293642709,39,19,20,42,0.4186777272120684,0.45647726204192607
가격/NNG@$하락/NNG@$영향/NNG,0,-0.04315302293642709,39,19,20,25,0.4186777272120684,0.45647726204192607
채권/NNG@$시장/NNG@$부담/NNG,0,-0.04315302293642709,39,19,20,15,0.4186777272120684,0.45647726204192607
경제지표/NNG@$금리/NNG@$인상/NNG,0,-0.04315302293642709,39,19,20,37,0.4186777272120684,0.45647726204192607
디플레이션/NNG@$물가/NNG@$하락/NNG,0,-0.04315302293642709,39,19,20,45,0.4186777272120684,0.45647726204192607
소비/NNG@$위축/NNG@$우려/NNG,0,-0.04315302293642709,39,19,20,23,0.4186777272120684,0.45647726204192607
금리/NNG@$인상/NNG@$소비/NNG,0,-0.04315302293642709,39,19,20,29,0.4186777272120684,0.45647726204192607
가격/NNG@$상승/NNG@$소비/NNG,0,-0.04315302293642709,39,19,20,22,0.4186777272120684,0.45647726204192607
기준금리/NNG@$동결/NNG@$예상/NNG,0,-0.04425733498016138,225,110,115,224,0.6364676599980587,0.6954668941836871
채권/NNG@$시장/NNG@$전망/NNG,0,-0.04445863073515044,37,18,19,28,0.4084341353569067,0.4464751616068284
실질/NNG@$국내총생산/NNG@$성장률/NNG,0,-0.04445863073515044,37,18,19,44,0.4084341353569067,0.4464751616068284
통화정책/NNG@$기조/NNG@$변경/NNG,0,-0.04445863073515044,37,18,19,16,0.4084341353569067,0.4464751616068284
지수/NNG@$높/VA@$마감/NNG,0,-0.04445863073515044,37,18,19,13,0.4084341353569067,0.4464751616068284
인상/NNG@$가능성/NNG@$희박/XR,0,-0.04445863073515044,37,18,19,27,0.4084341353569067,0.4464751616068284
소비/NNG@$투자/NNG@$수출/NNG,0,-0.04445863073515044,37,18,19,29,0.4084341353569067,0.4464751616068284
콜금리/NNG@$인상/NNG@$효과/NNG,0,-0.04445863073515044,37,18,19,11,0.4084341353569067,0.4464751616068284
동결/NNG@$예상/NNG@$금리/NNG,0,-0.04445863073515044,37,18,19,34,0.4084341353569067,0.4464751616068284
경제/NNG@$환경/NNG@$변화/NNG,0,-0.04445863073515044,37,18,19,37,0.4084341353569067,0.4464751616068284
상승/NNG@$가능성/NNG@$크/VA,0,-0.045860996957975075,35,17,18,25,0.3979514011804573,0.43624014048274645
금융/NNG@$시스템/NNG@$안정성/NNG,0,-0.045860996957975075,35,17,18,34,0.3979514011804573,0.43624014048274645
금리/NNG@$인하/NNG@$명분/NNG,0,-0.045860996957975075,35,17,18,32,0.3979514011804573,0.43624014048274645
대책/NNG@$금리/NNG@$인상/NNG,0,-0.045860996957975075,35,17,18,19,0.3979514011804573,0.43624014048274645
인상/NNG@$압력/NNG@$높/VA,0,-0.045860996957975075,35,17,18,19,0.3979514011804573,0.43624014048274645
자산/NNG@$시장/NNG@$버블/NNG,0,-0.045860996957975075,35,17,18,23,0.3979514011804573,0.43624014048274645
기준금리/NNG@$만장일치/NNG@$동결/NNG,0,-0.045860996957975075,35,17,18,37,0.3979514011804573,0.43624014048274645
반영/NNG@$기준금리/NNG@$인상/NNG,0,-0.045860996957975075,35,17,18,27,0.3979514011804573,0.43624014048274645
악화/NNG@$금리/NNG@$인상/NNG,0,-0.045860996957975075,35,17,18,16,0.3979514011804573,0.43624014048274645
경기/NNG@$하방/NNG@$압력/NNG,0,-0.045860996957975075,35,17,18,58,0.3979514011804573,0.43624014048274645
전망/NNG@$고개/NNG@$들/VV,0,-0.04737934068386129,33,16,17,20,0.387234807352349,0.4257860104036418
금리/NNG@$인상/NNG@$전제/NNG,0,-0.04737934068386129,33,16,17,35,0.387234807352349,0.4257860104036418
가격/NNG@$급등/NNG@$물가/NNG,0,-0.04737934068386129,33,16,17,31,0.387234807352349,0.4257860104036418
경기/NNG@$둔화/NNG@$기준금리/NNG,0,-0.04737934068386129,33,16,17,24,0.387234807352349,0.4257860104036418
인하/NNG@$단행/NNG@$가능성/NNG,0,-0.0477249585426206,90,44,46,67,0.579507960665859,0.637642453443872
성장/NNG@$모멘텀/NNG@$둔화/NNG,0,-0.049038383415803355,31,15,16,16,0.3762893551286014,0.41512894490727287
수출/NNG@$산업/NNG@$생산/NNG,0,-0.049038383415803355,31,15,16,22,0.3762893551286014,0.41512894490727287
경기/NNG@$회복/NNG@$발목/NNG@$잡/VV,0,-0.049038383415803355,31,15,16,18,0.3762893551286014,0.41512894490727287
소비자/NNG@$물가/NNG@$올랐/VV,0,-0.049038383415803355,31,15,16,26,0.3762893551286014,0.41512894490727287
경제/NNG@$성장/NNG@$견인/NNG,0,-0.049038383415803355,31,15,16,32,0.3762893551286014,0.41512894490727287
주택/NNG@$경기/NNG@$부진/NNG,0,-0.049038383415803355,31,15,16,36,0.3762893551286014,0.41512894490727287
양적/NNG@$질적/NNG@$금융완화/NNG,0,-0.049038383415803355,31,15,16,22,0.3762893551286014,0.41512894490727287
소비/NNG@$지출/NNG@$위축/NNG,0,-0.049038383415803355,31,15,16,19,0.3762893551286014,0.41512894490727287
시장/NNG@$영향/NNG@$제한적/NNG,0,-0.049038383415803355,31,15,16,32,0.3762893551286014,0.41512894490727287
물가/NNG@$오름세/NNG@$둔화/NNG,0,-0.049038383415803355,31,15,16,6,0.3762893551286014,0.41512894490727287
국내총생산/NNG@$기준/NNG@$경제성장률/NNG,0,-0.049038383415803355,31,15,16,23,0.3762893551286014,0.41512894490727287
통화/NNG@$달러화/NNG@$가치/NNG,0,-0.049038383415803355,31,15,16,35,0.3762893551286014,0.41512894490727287
인하/NNG@$시장/NNG@$기대/NNG,0,-0.049038383415803355,31,15,16,27,0.3762893551286014,0.41512894490727287
경기/NNG@$호전/NNG@$예상/NNG,0,-0.05087033768809279,29,14,15,35,0.36511914735149426,0.40428772530263174
문제/NNG@$해결/NNG@$없/VA,0,-0.05087033768809279,29,14,15,29,0.36511914735149426,0.40428772530263174
기준금리/NNG@$인하/NNG@$정책/NNG,0,-0.05087033768809279,29,14,15,37,0.36511914735149426,0.40428772530263174
금융/NNG@$균형/NNG@$누적/NNG,0,-0.05087033768809279,29,14,15,13,0.36511914735149426,0.40428772530263174
외환시장/NNG@$달러/NNG@$원/NNG,0,-0.05087033768809279,29,14,15,23,0.36511914735149426,0.40428772530263174
콜론/NNG@$금리/NNG@$동결/NNG,0,-0.05087033768809279,29,14,15,35,0.36511914735149426,0.40428772530263174
기업/NNG@$구조조정/NNG@$진행/NNG,0,-0.05087033768809279,29,14,15,39,0.36511914735149426,0.40428772530263174
상승/NNG@$인플레이션/NNG@$우려/NNG,0,-0.05087033768809279,29,14,15,25,0.36511914735149426,0.40428772530263174
달러/NNG@$환율/NNG@$기록/NNG,0,-0.05087033768809279,29,14,15,23,0.36511914735149426,0.40428772530263174
외국/NNG@$자본/NNG@$유출/NNG,0,-0.05087033768809279,29,14,15,22,0.36511914735149426,0.40428772530263174
가능성/NNG@$금리/NNG@$인상/NNG,0,-0.05170646016047553,123,60,63,125,0.6150832586217908,0.682209659642065
국채/NNG@$매입/NNG@$재개/NNG,0,-0.05291781252055916,27,13,14,90,0.3537264555718463,0.39328405166029934
가격/NNG@$하락/NNG@$기록/NNG,0,-0.05291781252055916,27,13,14,41,0.3537264555718463,0.39328405166029934
전망/NNG@$국내총생산/NNG@$성장률/NNG,0,-0.05291781252055916,27,13,14,46,0.3537264555718463,0.39328405166029934
비철/NNG@$금속/NNG@$가격/NNG,0,-0.05291781252055916,27,13,14,36,0.3537264555718463,0.39328405166029934
경제/NNG@$동향/NNG@$인플레율/NNG,0,-0.05291781252055916,27,13,14,25,0.3537264555718463,0.39328405166029934
기준금리/NNG@$인상/NNG@$금융시장/NNG,0,-0.05291781252055916,27,13,14,24,0.3537264555718463,0.39328405166029934
경제/NNG@$외환/NNG@$위기/NNG,0,-0.05291781252055916,27,13,14,21,0.3537264555718463,0.39328405166029934
가계/NNG@$소비/NNG@$여력/NNG,0,-0.05291781252055916,27,13,14,22,0.3537264555718463,0.39328405166029934
과거/NNG@$금융/NNG@$위기/NNG,0,-0.055238173440127936,25,12,13,28,0.34211028794161,0.3821429564324361
축소/NNG@$자본/NNG@$유출/NNG,0,-0.055238173440127936,25,12,13,28,0.34211028794161,0.3821429564324361
경제/NNG@$더블딥/NNG@$이중/NNG@$침체/NNG,0,-0.055238173440127936,25,12,13,28,0.34211028794161,0.3821429564324361
경기/NNG@$회복/NNG@$촉진/NNG,0,-0.055238173440127936,25,12,13,23,0.34211028794161,0.3821429564324361
인하/NNG@$기대/NNG@$높/VA,0,-0.055238173440127936,25,12,13,22,0.34211028794161,0.3821429564324361
주식/NNG@$채권/NNG@$시장/NNG,0,-0.057327935648883166,74,36,38,79,0.5392160661435018,0.6048435909957832
유로존/NNG@$국채/NNG@$매입/NNG,0,-0.05791029103382994,23,11,12,49,0.33026413765601037,0.37089338189738014
가계부채/NNG@$상환/NNG@$부담/NNG,0,-0.05791029103382994,23,11,12,20,0.33026413765601037,0.37089338189738014
내수/NNG@$수출/NNG@$균형/NNG,0,-0.05791029103382994,23,11,12,21,0.33026413765601037,0.37089338189738014
기준금리/NNG@$인상/NNG@$할/VX,0,-0.05791029103382994,23,11,12,29,0.33026413765601037,0.37089338189738014
소비/NNG@$지출/NNG@$물가/NNG,0,-0.05791029103382994,23,11,12,39,0.33026413765601037,0.37089338189738014
저금리/NNG@$기조/NNG@$장기화/NNG,0,-0.05791029103382994,23,11,12,39,0.33026413765601037,0.37089338189738014
잠재적/NNG@$위험/NNG@$요인/NNG,0,-0.05791029103382994,23,11,12,28,0.33026413765601037,0.37089338189738014
방향/NNG@$금리/NNG@$인상/NNG,0,-0.05791029103382994,23,11,12,25,0.33026413765601037,0.37089338189738014
시장/NNG@$금리/NNG@$인상/NNG@$시기/NNG,0,-0.05791029103382994,23,11,12,27,0.33026413765601037,0.37089338189738014
상승세/NNG@$보일/VV@$전망/NNG,0,-0.05791029103382994,23,11,12,28,0.33026413765601037,0.37089338189738014
물가/NNG@$상승률/NNG@$기록/NNG,0,-0.05802862236911821,144,70,74,150,0.6205362161761634,0.6970403289871593
금리/NNG@$인상/NNG@$있/VA,0,-0.05869915656064806,72,35,37,66,0.5331801424065701,0.599720683148461
시장/NNG@$금리/NNG@$급등/NNG,0,-0.05869915656064806,72,35,37,64,0.5331801424065701,0.599720683148461
둔화/NNG@$우려/NNG@$금리/NNG,0,-0.05869915656064806,72,35,37,44,0.5331801424065701,0.599720683148461
경기/NNG@$하방/NNG@$위험/NNG,0,-0.06003971156207766,171,83,88,144,0.6239245099862001,0.7036802706489139
회복세/NNG@$지속/NNG@$전망/NNG,0,-0.06011447549029192,70,34,36,69,0.5269054389547395,0.5943484993501988
시장/NNG@$국채/NNG@$가격/NNG,0,-0.06011447549029192,70,34,36,41,0.5269054389547395,0.5943484993501988
금리/NNG@$인하/NNG@$단행/NNG@$가능성/NNG,0,-0.06011447549029192,70,34,36,50,0.5269054389547395,0.5943484993501988
금융/NNG@$경제/NNG@$부장/NNG,0,-0.061045372132745856,21,10,11,33,0.3181723269956759,0.35956902258350437
금리/NNG@$동결/NNG@$물가/NNG,0,-0.061045372132745856,21,10,11,36,0.3181723269956759,0.35956902258350437
정책금리/NNG@$인상/NNG@$예상/NNG,0,-0.061045372132745856,21,10,11,20,0.3181723269956759,0.35956902258350437
주택/NNG@$착공/NNG@$증가/NNG,0,-0.061045372132745856,21,10,11,30,0.3181723269956759,0.35956902258350437
성장세/NNG@$둔화/NNG@$예상/NNG,0,-0.061045372132745856,21,10,11,24,0.3181723269956759,0.35956902258350437
물가/NNG@$상승률/NNG@$최고치/NNG,0,-0.061045372132745856,21,10,11,30,0.3181723269956759,0.35956902258350437
경기/NNG@$둔화/NNG@$추세/NNG,0,-0.061045372132745856,21,10,11,28,0.3181723269956759,0.35956902258350437
인플레/NNG@$압력/NNG@$완화/NNG,0,-0.06157627803202137,68,33,35,34,0.5203875246948171,0.5887209961974724
통화정책/NNG@$방향/NNG@$기준금리/NNG@$유지/NNG,0,-0.06308722884194018,66,32,34,102,0.5136222545732436,0.5828324475038241
전망/NNG@$힘/NNG@$얻/VV,0,-0.06313030232497152,103,50,53,97,0.5889813209454706,0.6684038852333687
금리/NNG@$동결/NNG@$배경/NNG,0,-0.0644644006307018,101,49,52,82,0.5855923342879757,0.6663403372286936
광공업/NNG@$생산/NNG@$감소/NNG,0,-0.06465032080562394,64,31,33,32,0.5066058038036795,0.5766775074020013
경제/NNG@$성장/NNG@$모멘텀/NNG,0,-0.06465032080562394,64,31,33,52,0.5066058038036795,0.5766775074020013
경기/NNG@$회복/NNG@$지속/NNG,0,-0.06465032080562394,64,31,33,65,0.5066058038036795,0.5766775074020013
통화정책/NNG@$완화/NNG@$조정/NNG@$필요/NNG,0,-0.06480510739701184,19,9,10,53,0.3058038220484646,0.34820960330609013
성장률/NNG@$소비자/NNG@$물가/NNG,0,-0.06480510739701184,19,9,10,31,0.3058038220484646,0.34820960330609013
수입/NNG@$물가/NNG@$하락/NNG,-1,-0.06626893498425734,62,30,32,53,0.49933470172312894,0.5702512796771502
가능성/NNG@$배제/NNG@$어렵/VA,0,-0.06725154335730243,97,47,50,57,0.5783200283402429,0.6617590339314976
동결/NNG@$전망/NNG@$우세/NNG,-1,-0.06794691404596342,60,29,31,34,0.4918058641936221,0.5635493935840112
투자/NNG@$증권/NNG@$채권/NNG,-1,-0.06794691404596342,60,29,31,62,0.4918058641936221,0.5635493935840112
위험/NNG@$요인/NNG@$가능성/NNG,-1,-0.06794691404596342,60,29,31,44,0.4918058641936221,0.5635493935840112
채권/NNG@$시장/NNG@$영향/NNG,-1,-0.06794691404596342,60,29,31,58,0.4918058641936221,0.5635493935840112
채권/NNG@$시장/NNG@$경제/NNG,0,-0.06943369619963757,17,8,9,33,0.29310122062463917,0.3368628874762126
양적완화/NNG@$축소/NNG@$시기/NNG,0,-0.06943369619963757,17,8,9,27,0.29310122062463917,0.3368628874762126
개인/NNG@$서비스/NNG@$요금/NNG,0,-0.06943369619963757,17,8,9,21,0.29310122062463917,0.3368628874762126
요인/NNG@$가능성/NNG@$있/VA,0,-0.06943369619963757,17,8,9,31,0.29310122062463917,0.3368628874762126
차원/NNG@$금리/NNG@$인상/NNG,-1,-0.06968865266365076,58,28,30,47,0.4840166231117718,0.5565680863551595
브렉시트/NNG@$유럽연합/NNG@$탈퇴/NNG,0,-0.07041252159661804,149,72,77,159,0.6132713234990468,0.7062238736179065
소비/NNG@$투자/NNG@$심리/NNG@$위축/NNG,-1,-0.07149920939372412,56,27,29,35,0.4759647511309135,0.5493042925547803
비교/NNG@$보/VV@$장기금리/NNG@$국고채/NNG,0,-0.07175023081428356,91,44,47,87,0.5660925644986257,0.653649247705082
금리/NNG@$비교/NNG@$보/VV@$장기금리/NNG@$국고채/NNG,0,-0.07175023081428356,91,44,47,87,0.5660925644986257,0.653649247705082
인상/NNG@$자본/NNG@$유출/NNG,0,-0.07334072811196579,89,43,46,60,0.5616427065789746,0.6505878503939025
경기/NNG@$둔화/NNG@$리스크/NNG,-1,-0.07338444594175364,54,26,28,46,0.4676484791041811,0.541755740375708
주식/NNG@$투자/NNG@$자금/NNG,-1,-0.07338444594175364,54,26,28,41,0.4676484791041811,0.541755740375708
금리/NNG@$인상/NNG@$대응/NNG,-1,-0.07338444594175364,54,26,28,47,0.4676484791041811,0.541755740375708
금리/NNG@$인상/NNG@$가능/NNG,0,-0.07469952887538878,193,93,100,188,0.6147237790423623,0.7140232178943144
상승/NNG@$압력/NNG@$완화/NNG,0,-0.07497956939974149,87,42,45,70,0.5569965448105193,0.6473354360644766
물가/NNG@$목표/NNG@$크/VA,0,-0.07531808592249056,15,7,8,35,0.2799598710308668,0.3255879367411936
물가/NNG@$상승/NNG@$영향/NNG,-1,-0.07535120161706454,52,25,27,47,0.4590665029701123,0.5339210549205032
경기/NNG@$하강/NNG@$위험/NNG,0,-0.07611660159112976,216,104,112,94,0.614040819891385,0.7152653726269822
금리/NNG@$인상/NNG@$가능성/NNG@$열/VV,0,-0.07753100656046974,112,54,58,71,0.5890192408583421,0.6880737880927162
경기/NNG@$둔화/NNG@$수출/NNG,0,-0.07841011125491781,83,40,43,63,0.5470932247589413,0.6402284378633152
시장/NNG@$예상/NNG@$부합/NNG,0,-0.07841011125491781,83,40,43,78,0.5470932247589413,0.6402284378633152
기준금리/NNG@$인상/NNG@$확률/NNG,-1,-0.07956289562694907,48,23,25,73,0.44110247889069915,0.517392937598112
채권/NNG@$시장/NNG@$기준금리/NNG@$동결/NNG,-1,-0.07956289562694907,48,23,25,50,0.44110247889069915,0.517392937598112
회복/NNG@$발목/NNG@$잡/VV,-1,-0.07956289562694907,48,23,25,28,0.44110247889069915,0.517392937598112
악화/NNG@$금리/NNG@$인하/NNG,-1,-0.07956289562694907,48,23,25,30,0.44110247889069915,0.517392937598112
생산/NNG@$소매/NNG@$판매/NNG,-1,-0.07956289562694907,48,23,25,43,0.44110247889069915,0.517392937598112
이상/NNG@$금리/NNG@$인상/NNG,0,-0.08175859418885179,131,63,68,79,0.599071132356364,0.7057951067871041
국채/NNG@$수익률/NNG@$하락/NNG,-1,-0.08182869869807441,46,22,24,23,0.4317199652185175,0.5087022673649269
경기/NNG@$상승/NNG@$하강/NNG,-1,-0.08182869869807441,46,22,24,47,0.4317199652185175,0.5087022673649269
유지/NNG@$가능성/NNG@$크/VA,-1,-0.08182869869807441,46,22,24,42,0.4317199652185175,0.5087022673649269
경제/NNG@$회복/NNG@$수출/NNG,0,-0.08421857316034742,44,21,23,30,0.4220706629491758,0.4997312420967407
금리/NNG@$인상/NNG@$종료/NNG,0,-0.08421857316034742,44,21,23,47,0.4220706629491758,0.4997312420967407
양적완화/NNG@$정책/NNG@$종료/NNG,0,-0.08421857316034742,44,21,23,48,0.4220706629491758,0.4997312420967407
사상/NNG@$최저/NNG@$금리/NNG,0,-0.08421857316034742,44,21,23,38,0.4220706629491758,0.4997312420967407
기업/NNG@$수익성/NNG@$악화/NNG,0,-0.08421857316034742,44,21,23,25,0.4220706629491758,0.4997312420967407
상승/NNG@$거래/NNG@$마쳤/VV,0,-0.08625982233958518,125,60,65,84,0.5927531505687221,0.704710626121788
위기/NNG@$발생/NNG@$가능성/NNG,0,-0.08674907693693212,42,20,22,35,0.41215492621278393,0.49048476332329344
시작/NNG@$금리/NNG@$인상/NNG,0,-0.08798788728517881,73,35,38,57,0.5185205978681285,0.6186073965670212
금리/NNG@$인상/NNG@$불확실성/NNG,0,-0.08798788728517881,73,35,38,65,0.5185205978681285,0.6186073965670212
시장/NNG@$예상치/NNG@$크/VA,0,-0.0894404790898734,40,19,21,40,0.40197301162306076,0.4809693948935127
수출/NNG@$차지/NNG@$비중/NNG,0,-0.0894404790898734,40,19,21,28,0.40197301162306076,0.4809693948935127
경기/NNG@$부양/NNG@$필요/NNG,0,-0.0894404790898734,40,19,21,34,0.40197301162306076,0.4809693948935127
달러화/NNG@$가치/NNG@$상승/NNG,0,-0.0894404790898734,40,19,21,42,0.40197301162306076,0.4809693948935127
가능성/NNG@$크/VA@$내/VX,0,-0.0894404790898734,40,19,21,34,0.40197301162306076,0.4809693948935127
금리/NNG@$인상/NNG@$이뤄질/VV,0,-0.08948883942421026,121,58,63,122,0.58800284271989,0.703626694659398
경제/NNG@$금리/NNG@$인상/NNG,0,-0.09216030843956191,247,118,129,200,0.6026541725531388,0.7250538727699088
성장세/NNG@$갈/VX@$전망/NNG,0,-0.09231783809482497,38,18,20,35,0.3915247515726514,0.47119351603144316
경제/NNG@$지속/NNG@$가능/NNG,0,-0.09231783809482497,38,18,20,43,0.3915247515726514,0.47119351603144316
경기/NNG@$둔화/NNG@$속도/NNG,0,-0.09231783809482497,38,18,20,33,0.3915247515726514,0.47119351603144316
부진/NNG@$모습/NNG@$보였/VV,0,-0.09231783809482497,38,18,20,48,0.3915247515726514,0.47119351603144316
금리/NNG@$인상/NNG@$리스크/NNG,0,-0.09231783809482497,38,18,20,28,0.3915247515726514,0.47119351603144316
산업/NNG@$평균/NNG@$지수/NNG@$상승/NNG@$거래/NNG,0,-0.09325330935453069,94,45,49,59,0.5570726474232208,0.6716938076570064
예상/NNG@$경기/NNG@$회복/NNG,-1,-0.09454182678267886,67,32,35,42,0.4985603747193307,0.602706925768794
사상/NNG@$최저/NNG@$기준금리/NNG,-1,-0.09454182678267886,67,32,35,69,0.4985603747193307,0.602706925768794
평균/NNG@$지수/NNG@$상승/NNG@$거래/NNG@$마쳤/VV,0,-0.09527412225171827,92,44,48,58,0.5526700029330351,0.6691077031222781
지수/NNG@$떨어진/VV@$기록/NNG,0,-0.0954124701946083,36,17,19,37,0.3808090813263252,0.4611674835450279
금리/NNG@$인상/NNG@$이어질/VV,0,-0.0954124701946083,36,17,19,27,0.3808090813263252,0.4611674835450279
부동산/NNG@$담보대출/NNG@$모기지/NNG,0,-0.0954124701946083,36,17,19,26,0.3808090813263252,0.4611674835450279
예상/NNG@$크/VA@$않/VX,0,-0.0954124701946083,36,17,19,26,0.3808090813263252,0.4611674835450279
장기/NNG@$채권/NNG@$금리/NNG,0,-0.0954124701946083,36,17,19,36,0.3808090813263252,0.4611674835450279
소수/NNG@$의견/NNG@$나올/VV,0,-0.0954124701946083,36,17,19,30,0.3808090813263252,0.4611674835450279
인상/NNG@$없/VA@$전망/NNG,0,-0.0954124701946083,36,17,19,30,0.3808090813263252,0.4611674835450279
단기/NNG@$경제/NNG@$관측/NNG,-1,-0.0968846674667494,65,31,34,54,0.4914102472617647,0.5968785739548563
출구전략/NNG@$금리/NNG@$인상/NNG,0,-0.09876398298108557,34,16,18,37,0.36982335558197366,0.4509038052377371
경기/NNG@$신뢰/NNG@$지수/NNG,0,-0.09876398298108557,34,16,18,65,0.36982335558197366,0.4509038052377371
경제/NNG@$회복/NNG@$조짐/NNG,0,-0.09876398298108557,34,16,18,34,0.36982335558197366,0.4509038052377371
필요/NNG@$있/VA@$진단/NNG,-1,-0.09931516921399008,63,30,33,51,0.4840051314800727,0.5907761151362454
자금/NNG@$이탈/NNG@$우려/NNG,0,-0.10242314604861225,32,15,17,31,0.3585623556280248,0.44041732772483694
담보대출/NNG@$모기지/NNG@$금리/NNG,0,-0.10242314604861225,32,15,17,30,0.3585623556280248,0.44041732772483694
하향/NNG@$조정/NNG@$기준금리/NNG,0,-0.10242314604861225,32,15,17,24,0.3585623556280248,0.44041732772483694
하향/NNG@$조정/NNG@$예상/NNG,0,-0.10242314604861225,32,15,17,30,0.3585623556280248,0.44041732772483694
경제/NNG@$성장/NNG@$전망/NNG,0,-0.10268807560404902,263,125,138,258,0.5950734876580955,0.7313122016416859
투자자들/NNG@$금리/NNG@$인상/NNG,0,-0.10400536673877592,84,40,44,63,0.5330983866335759,0.6568948914686197
금리/NNG@$인상/NNG@$관측/NNG,0,-0.1063639984999859,82,39,43,61,0.5276880001825875,0.6533364812049918
지수/NNG@$내린/VV@$종합/NNG,0,-0.1064560320473027,30,14,16,52,0.3470168309096908,0.42972544337317037
기준금리/NNG@$동결/NNG@$했/VV,0,-0.1064560320473027,30,14,16,42,0.3470168309096908,0.42972544337317037
결정/NNG@$기준금리/NNG@$인상/NNG,0,-0.1064560320473027,30,14,16,18,0.3470168309096908,0.42972544337317037
견조/NNG@$성장세/NNG@$지속/NNG,0,-0.1064560320473027,30,14,16,32,0.3470168309096908,0.42972544337317037
상승/NNG@$소비/NNG@$지출/NNG,0,-0.1064560320473027,30,14,16,28,0.3470168309096908,0.42972544337317037
경제/NNG@$차지/NNG@$비중/NNG,0,-0.1064560320473027,30,14,16,32,0.3470168309096908,0.42972544337317037
회복/NNG@$지연/NNG@$가능성/NNG,0,-0.1064560320473027,30,14,16,25,0.3470168309096908,0.42972544337317037
내수/NNG@$회복/NNG@$지연/NNG,0,-0.1064560320473027,30,14,16,18,0.3470168309096908,0.42972544337317037
경기/NNG@$부양책/NNG@$필요/NNG,0,-0.1064560320473027,30,14,16,26,0.3470168309096908,0.42972544337317037
물가/NNG@$상승률/NNG@$기준금리/NNG,0,-0.1064560320473027,30,14,16,26,0.3470168309096908,0.42972544337317037
채권/NNG@$가격/NNG@$상승/NNG,0,-0.1064560320473027,30,14,16,24,0.3470168309096908,0.42972544337317037
모습/NNG@$보이/VV@$경제/NNG,0,-0.1064560320473027,30,14,16,28,0.3470168309096908,0.42972544337317037
시중/NNG@$유동성/NNG@$확대/NNG,0,-0.1064560320473027,30,14,16,36,0.3470168309096908,0.42972544337317037
경제/NNG@$성장/NNG@$완만/XR,0,-0.1064560320473027,30,14,16,28,0.3470168309096908,0.42972544337317037
단행/NNG@$가능성/NNG@$크/VA,0,-0.1064560320473027,30,14,16,36,0.3470168309096908,0.42972544337317037
시장/NNG@$예상/NNG@$크/VA,-1,-0.10719855154126834,57,27,30,58,0.46022548082923576,0.5707730300709977
인상/NNG@$경제/NNG@$성장/NNG,-1,-0.10719855154126834,57,27,30,48,0.46022548082923576,0.5707730300709977
금리/NNG@$인상/NNG@$늦추/VV,-1,-0.10719855154126834,57,27,30,28,0.46022548082923576,0.5707730300709977
둔화/NNG@$물가/NNG@$상승/NNG,-1,-0.11005059876313283,55,26,29,36,0.4517674059114732,0.5635260511956454
콜금리/NNG@$동결/NNG@$결정/NNG,-1,-0.11005059876313283,55,26,29,31,0.4517674059114732,0.5635260511956454
인플레율/NNG@$억제/NNG@$목표치/NNG@$허용/NNG@$한도/NNG,-1,-0.11005059876313283,55,26,29,48,0.4517674059114732,0.5635260511956454
조업/NNG@$일수/NNG@$감소/NNG,-1,-0.11005059876313283,55,26,29,30,0.4517674059114732,0.5635260511956454
달러/NNG@$원/NNG@$환율하락/NNG,-1,-0.11005059876313283,55,26,29,51,0.4517674059114732,0.5635260511956454
중개인/NNG@$주택/NNG@$판매/NNG,0,-0.11095013993672542,28,13,15,44,0.3351713207718829,0.4188483229001059
상승/NNG@$속도/NNG@$둔화/NNG,0,-0.11095013993672542,28,13,15,25,0.3351713207718829,0.4188483229001059
인상/NNG@$가능성/NNG@$가격/NNG@$반영/NNG,0,-0.11095013993672542,28,13,15,31,0.3351713207718829,0.4188483229001059
금리/NNG@$인상/NNG@$가시화/NNG,0,-0.11095013993672542,28,13,15,18,0.3351713207718829,0.4188483229001059
마이너스금리/NNG@$정책/NNG@$도입/NNG,0,-0.11095013993672542,28,13,15,26,0.3351713207718829,0.4188483229001059
경기/NNG@$회복/NNG@$속도/NNG@$둔화/NNG,0,-0.11095013993672542,28,13,15,21,0.3351713207718829,0.4188483229001059
소비자/NNG@$물가/NNG@$전망/NNG,0,-0.11095013993672542,28,13,15,30,0.3351713207718829,0.4188483229001059
내수/NNG@$수출/NNG@$부진/NNG,0,-0.11095013993672542,28,13,15,13,0.3351713207718829,0.4188483229001059
기준금리/NNG@$인상/NNG@$신중/NNG,0,-0.11095013993672542,28,13,15,33,0.3351713207718829,0.4188483229001059
금리/NNG@$인상/NNG@$부동산시장/NNG,0,-0.11095013993672542,28,13,15,24,0.3351713207718829,0.4188483229001059
가격/NNG@$상승/NNG@$가능성/NNG,0,-0.11095013993672542,28,13,15,11,0.3351713207718829,0.4188483229001059
정책/NNG@$금리/NNG@$인하/NNG,0,-0.11131490782163722,78,37,41,35,0.5162088318561716,0.645559222430822
민간/NNG@$소비/NNG@$증가율/NNG,0,-0.11131490782163722,78,37,41,113,0.5162088318561716,0.645559222430822
시기/NNG@$금리/NNG@$인상/NNG,-1,-0.11303150364007064,53,25,28,50,0.44303914307471354,0.5559842162749172
국내총생산/NNG@$성장률/NNG@$전망/NNG,-1,-0.11303150364007064,53,25,28,69,0.44303914307471354,0.5559842162749172
금융시장/NNG@$변동성/NNG@$확대/NNG,0,-0.11304367678670701,116,55,61,155,0.5681758149413427,0.7130398725721737
경제/NNG@$성장/NNG@$인플레이션/NNG,0,-0.11341998246028939,97,46,51,72,0.548173712123072,0.6884625309651944
금리/NNG@$인상/NNG@$전망/NNG,0,-0.11370553983552123,715,338,377,517,0.5870864163300146,0.737760428015095
금리/NNG@$동결/NNG@$예상/NNG,0,-0.11424282581868717,292,138,154,183,0.5866953614324393,0.7380719567004839
하향/NNG@$조정/NNG@$가능성/NNG,0,-0.11556733616887882,131,62,69,125,0.5753813222617435,0.7257840457637685
기업/NNG@$투자/NNG@$부진/NNG,0,-0.11602371017034296,26,12,14,25,0.32300082868337776,0.40780918191947974
예상/NNG@$좋/VA@$않/VX,0,-0.11602371017034296,26,12,14,33,0.32300082868337776,0.40780918191947974
대내외/NNG@$경제/NNG@$환경/NNG,0,-0.11602371017034296,26,12,14,27,0.32300082868337776,0.40780918191947974
영향/NNG@$소비자/NNG@$물가/NNG,0,-0.11602371017034296,26,12,14,25,0.32300082868337776,0.40780918191947974
과거/NNG@$외환/NNG@$위기/NNG,0,-0.11602371017034296,26,12,14,30,0.32300082868337776,0.40780918191947974
경기/NNG@$회복세/NNG@$약화/NNG,0,-0.11602371017034296,26,12,14,40,0.32300082868337776,0.40780918191947974
소비자/NNG@$물가/NNG@$상승률/NNG@$중기/NNG,0,-0.11602371017034296,26,12,14,37,0.32300082868337776,0.40780918191947974
가능성/NNG@$있/VA@$덧붙였/VV,0,-0.11602371017034296,26,12,14,27,0.32300082868337776,0.40780918191947974
유지/NNG@$물가/NNG@$상승/NNG,0,-0.11602371017034296,26,12,14,22,0.32300082868337776,0.40780918191947974
인하/NNG@$정책/NNG@$효과/NNG,0,-0.11602371017034296,26,12,14,44,0.32300082868337776,0.40780918191947974
물가/NNG@$상승/NNG@$금리/NNG@$인상/NNG,0,-0.11602371017034296,26,12,14,31,0.32300082868337776,0.40780918191947974
둔화/NNG@$우려/NNG@$있/VA,0,-0.11602371017034296,26,12,14,23,0.32300082868337776,0.40780918191947974
완화/NNG@$금리/NNG@$인상/NNG,-1,-0.11615386948770956,51,24,27,46,0.43403831486777933,0.5481456950152981
기술/NNG@$지수/NNG@$오른/VV@$마감/NNG,0,-0.11660346550402612,74,35,39,44,0.503817375239122,0.6368495908189099
금리/NNG@$인하/NNG@$시기/NNG,0,-0.11660346550402612,74,35,39,72,0.503817375239122,0.6368495908189099
기준금리/NNG@$인상/NNG@$가능성/NNG@$크/VA,-1,-0.11943256972473648,49,23,26,38,0.42476261222524603,0.5400096761557482
달러화/NNG@$강세/NNG@$지속/NNG,0,-0.1218403694019855,24,11,13,18,0.31046560253976746,0.39663459024669795
가계부채/NNG@$증가세/NNG@$둔화/NNG,0,-0.1218403694019855,24,11,13,22,0.31046560253976746,0.39663459024669795
양적완화/NNG@$축소/NNG@$결정/NNG,0,-0.1218403694019855,24,11,13,33,0.31046560253976746,0.39663459024669795
금융/NNG@$불안/NNG@$확산/NNG,0,-0.1218403694019855,24,11,13,21,0.31046560253976746,0.39663459024669795
소매/NNG@$판매/NNG@$부진/NNG,0,-0.1218403694019855,24,11,13,28,0.31046560253976746,0.39663459024669795
기준금리/NNG@$인상/NNG@$논의/NNG,0,-0.1218403694019855,24,11,13,38,0.31046560253976746,0.39663459024669795
부진/NNG@$경제/NNG@$성장/NNG,0,-0.1218403694019855,24,11,13,28,0.31046560253976746,0.39663459024669795
금리/NNG@$인상/NNG@$추세/NNG,0,-0.1218403694019855,24,11,13,46,0.31046560253976746,0.39663459024669795
확대/NNG@$가능성/NNG@$있/VA,0,-0.1218403694019855,24,11,13,22,0.31046560253976746,0.39663459024669795
갭/NNG@$플러스/NNG@$전환/NNG,0,-0.1218403694019855,24,11,13,46,0.31046560253976746,0.39663459024669795
재정/NNG@$건전성/NNG@$유지/NNG,0,-0.1218403694019855,24,11,13,32,0.31046560253976746,0.39663459024669795
개선/NNG@$금리/NNG@$인하/NNG,0,-0.1218403694019855,24,11,13,30,0.31046560253976746,0.39663459024669795
물가/NNG@$불안/NNG@$요인/NNG,-1,-0.1222666727495686,70,33,37,66,0.4904739243376135,0.6271462408843388
금리/NNG@$인상/NNG@$검토/NNG,-1,-0.1222666727495686,70,33,37,54,0.4904739243376135,0.6271462408843388
기준금리/NNG@$인상/NNG@$필요성/NNG,-1,-0.12288530156077282,47,22,25,51,0.41520965425226936,0.5315764849713213
금리/NNG@$인하/NNG@$있/VA,-1,-0.12288530156077282,47,22,25,31,0.41520965425226936,0.5315764849713213
예상/NNG@$기준금리/NNG@$인하/NNG,-1,-0.12288530156077282,47,22,25,38,0.41520965425226936,0.5315764849713213
전망치/NNG@$하향/NNG@$조정/NNG,0,-0.12353129110600936,423,199,224,455,0.5799211643800992,0.7434245652521725
지속/NNG@$가능/NNG@$성장/NNG,0,-0.1249357329161952,138,65,73,111,0.5714713225439992,0.7346849445641208
금리/NNG@$인상/NNG@$성장/NNG,-1,-0.12653330593885448,45,21,24,28,0.40537678577982744,0.5228477057136329
상승/NNG@$최고치/NNG@$기록/NNG,-1,-0.12653330593885448,45,21,24,45,0.40537678577982744,0.5228477057136329
경제/NNG@$성장/NNG@$이끌/VV,-1,-0.12653330593885448,45,21,24,41,0.40537678577982744,0.5228477057136329
심리/NNG@$부정적/NNG@$영향/NNG,-1,-0.12653330593885448,45,21,24,31,0.40537678577982744,0.5228477057136329
은행/NNG@$채권/NNG@$딜러/NNG,0,-0.12708101394793048,104,49,55,94,0.5475558355179566,0.7070142248020063
장기/NNG@$시장/NNG@$금리/NNG@$상승/NNG,0,-0.12863305530744018,22,10,12,23,0.2975026635206791,0.3853548288213895
소수/NNG@$의견/NNG@$나오/VV,0,-0.12863305530744018,22,10,12,34,0.2975026635206791,0.3853548288213895
확장/NNG@$국면/NNG@$지속/NNG,0,-0.12863305530744018,22,10,12,17,0.2975026635206791,0.3853548288213895
경기/NNG@$하강/NNG@$가능성/NNG,0,-0.12863305530744018,22,10,12,25,0.2975026635206791,0.3853548288213895
외국인투자/NNG@$자금/NNG@$이탈/NNG,0,-0.12863305530744018,22,10,12,26,0.2975026635206791,0.3853548288213895
하방/NNG@$위험/NNG@$확대/NNG,0,-0.12863305530744018,22,10,12,19,0.2975026635206791,0.3853548288213895
심리/NNG@$크/VA@$위축/NNG,0,-0.12863305530744018,22,10,12,22,0.2975026635206791,0.3853548288213895
원화/NNG@$가치/NNG@$하락/NNG,0,-0.12904467488191307,85,40,45,55,0.519114493294411,0.6729713713739202
외국인/NNG@$자금/NNG@$이탈/NNG,0,-0.12904467488191307,85,40,45,70,0.519114493294411,0.6729713713739202
거시/NNG@$경제/NNG@$금융/NNG,-1,-0.13040231418949977,43,20,23,33,0.395260789925282,0.5138263079486245
부담/NNG@$크/VA@$않/VX,-1,-0.13452380837316158,41,19,22,39,0.38485748349640736,0.5045167754039435
금리/NNG@$인상/NNG@$달러화/NNG@$강세/NNG,-1,-0.13452380837316158,41,19,22,23,0.38485748349640736,0.5045167754039435
이자/NNG@$상환/NNG@$부담/NNG,-1,-0.13452380837316158,41,19,22,37,0.38485748349640736,0.5045167754039435
원자재/NNG@$가격/NNG@$상승세/NNG,-1,-0.13491011515494455,62,29,33,31,0.4607836081425076,0.604525145252254
기준금리/NNG@$인상/NNG@$예상/NNG,0,-0.13595230420111215,186,87,99,160,0.5702300901210801,0.7497033243870882
하락/NNG@$종합/NNG@$지수/NNG,0,-0.13674491499870067,20,9,11,31,0.2840114956397903,0.37400428194296353
물가/NNG@$상승률/NNG@$농산물/NNG@$가격/NNG,0,-0.13674491499870067,20,9,11,40,0.2840114956397903,0.37400428194296353
정책적/NNG@$노력/NNG@$필요/NNG,0,-0.13674491499870067,20,9,11,20,0.2840114956397903,0.37400428194296353
주택/NNG@$판매/NNG@$지수/NNG,0,-0.13674491499870067,20,9,11,31,0.2840114956397903,0.37400428194296353
상승률/NNG@$농산물/NNG@$가격/NNG,0,-0.13674491499870067,20,9,11,41,0.2840114956397903,0.37400428194296353
경기/NNG@$부양/NNG@$양적완화/NNG,0,-0.13674491499870067,20,9,11,45,0.2840114956397903,0.37400428194296353
수출/NNG@$견조/NNG@$증가세/NNG,0,-0.13674491499870067,20,9,11,12,0.2840114956397903,0.37400428194296353
물가/NNG@$상승률/NNG@$목표치/NNG,0,-0.1375298566741704,244,114,130,263,0.5696411033617365,0.7513403115551167
물가/NNG@$상승/NNG@$우려/NNG,0,-0.13756951230981473,141,66,75,119,0.5633404211002906,0.7430899491072022
지수/NNG@$오른/VV@$마감/NNG,0,-0.1379414263455867,96,45,51,67,0.5305912235908371,0.7004219640293894
금리/NNG@$인상/NNG@$압박/NNG,-1,-0.1383910299576837,60,28,32,39,0.45271046220382966,0.5981612345630274
금리/NNG@$인상/NNG@$할/VX,-1,-0.1383910299576837,60,28,32,43,0.45271046220382966,0.5981612345630274
회복/NNG@$쉽/VA@$않/VX,0,-0.13893672268832935,39,18,21,27,0.3741611489870956,0.4949252354679619
인상/NNG@$가능성/NNG@$높이/VV,0,-0.13893672268832935,39,18,21,24,0.3741611489870956,0.4949252354679619
종합/NNG@$지수/NNG@$오른/VV,0,-0.13893672268832935,39,18,21,93,0.3741611489870956,0.4949252354679619
기업/NNG@$투자/NNG@$활성화/NNG,0,-0.13893672268832935,39,18,21,33,0.3741611489870956,0.4949252354679619
인하/NNG@$나설/VV@$전망/NNG,0,-0.13893672268832935,39,18,21,23,0.3741611489870956,0.4949252354679619
광공업/NNG@$생산/NNG@$증가/NNG,-1,-0.1420200890467329,58,27,31,46,0.44436911119713807,0.591502114950664
인상/NNG@$기조/NNG@$지속/NNG,-1,-0.1420200890467329,58,27,31,26,0.44436911119713807,0.591502114950664
사상/NNG@$최고치/NNG@$경신/NNG,0,-0.1425902513149575,221,103,118,169,0.5658626258316404,0.7540997866066207
통화/NNG@$달러/NNG@$가치/NNG,0,-0.14368977616577927,37,17,20,27,0.3631637353507378,0.4850595868031179
소비/NNG@$투자/NNG@$부진/NNG,0,-0.14368977616577927,37,17,20,36,0.3631637353507378,0.4850595868031179
회복/NNG@$기대/NNG@$어렵/VA,0,-0.14368977616577927,37,17,20,30,0.3631637353507378,0.4850595868031179
투자/NNG@$내수/NNG@$부진/NNG,0,-0.14368977616577927,37,17,20,4,0.3631637353507378,0.4850595868031179
금리/NNG@$인상/NNG@$정당화/NNG,0,-0.14368977616577927,37,17,20,26,0.3631637353507378,0.4850595868031179
환율/NNG@$상승/NNG@$요인/NNG,0,-0.14368977616577927,37,17,20,14,0.3631637353507378,0.4850595868031179
전망/NNG@$힘/NNG@$실리/VV,0,-0.14368977616577927,37,17,20,23,0.3631637353507378,0.4850595868031179
우려/NNG@$기준금리/NNG@$인하/NNG,0,-0.14368977616577927,37,17,20,36,0.3631637353507378,0.4850595868031179
물가/NNG@$상승/NNG@$압력/NNG@$가중/NNG,0,-0.14368977616577927,37,17,20,17,0.3631637353507378,0.4850595868031179
동결/NNG@$시장/NNG@$예상/NNG,0,-0.14368977616577927,37,17,20,69,0.3631637353507378,0.4850595868031179
금리/NNG@$인상/NNG@$긴축/NNG,-1,-0.1445636977209186,75,35,40,79,0.48911113390699823,0.654448064864537
국채/NNG@$금리/NNG@$급등/NNG,-1,-0.14581003706754414,56,26,30,83,0.43575570282305354,0.5845428560942758
경제/NNG@$완만/XR@$성장세/NNG,-1,-0.14581003706754414,56,26,30,41,0.43575570282305354,0.5845428560942758
실시/NNG@$금리/NNG@$인상/NNG,-1,-0.14581003706754414,56,26,30,23,0.43575570282305354,0.5845428560942758
완화적/NNG@$통화정책/NNG@$지속/NNG,0,-0.1467031122066309,18,8,10,21,0.26982868867028204,0.36262179866829897
위축/NNG@$소비/NNG@$심리/NNG,0,-0.1467031122066309,18,8,10,29,0.26982868867028204,0.36262179866829897
주가/NNG@$상승/NNG@$환율/NNG,0,-0.1467031122066309,18,8,10,28,0.26982868867028204,0.36262179866829897
훼손/NNG@$않/VX@$중기적/NNG@$소비자/NNG@$물가/NNG,0,-0.1467031122066309,18,8,10,45,0.26982868867028204,0.36262179866829897
경제/NNG@$전망/NNG@$국내총생산/NNG@$성장률/NNG,0,-0.1467031122066309,18,8,10,37,0.26982868867028204,0.36262179866829897
주택/NNG@$착공/NNG@$감소/NNG,0,-0.1467031122066309,18,8,10,38,0.26982868867028204,0.36262179866829897
성장잠재력/NNG@$훼손/NNG@$않/VX@$중기적/NNG@$소비자/NNG,0,-0.1467031122066309,18,8,10,45,0.26982868867028204,0.36262179866829897
에너지/NNG@$원자재/NNG@$가격/NNG,-1,-0.14799588427093124,73,34,39,34,0.4824158962897375,0.6500323435230624
은행권/NNG@$채권/NNG@$딜러/NNG,-1,-0.14799588427093124,73,34,39,34,0.4824158962897375,0.6500323435230624
인플레이션/NNG@$억제/NNG@$금리/NNG@$인상/NNG,0,-0.14884472688403405,35,16,19,30,0.3518537260184587,0.47492962148697404
물가/NNG@$상승/NNG@$인플레이션/NNG,0,-0.14884472688403405,35,16,19,22,0.3518537260184587,0.47492962148697404
전망/NNG@$금리/NNG@$동결/NNG,0,-0.14884472688403405,35,16,19,36,0.3518537260184587,0.47492962148697404
확인/NNG@$금리/NNG@$인하/NNG,0,-0.14884472688403405,35,16,19,32,0.3518537260184587,0.47492962148697404
금리/NNG@$동결/NNG@$인하/NNG,0,-0.14884472688403405,35,16,19,27,0.3518537260184587,0.47492962148697404
기준금리/NNG@$내릴/VV@$전망/NNG,0,-0.14884472688403405,35,16,19,33,0.3518537260184587,0.47492962148697404
침체/NNG@$빠질/VV@$가능성/NNG,0,-0.14884472688403405,35,16,19,29,0.3518537260184587,0.47492962148697404
경기/NNG@$회복/NNG@$지연/NNG,0,-0.14992788182056294,170,79,91,134,0.5590972379173287,0.7563390816678028
금리/NNG@$인하/NNG@$반대/NNG,-1,-0.15393437018666678,52,24,28,43,0.4176970523529863,0.5697077034728815
인상/NNG@$가능성/NNG@$무게/NNG,-1,-0.15393437018666678,52,24,28,47,0.4176970523529863,0.5697077034728815
전망/NNG@$성장률/NNG@$전망치/NNG,-1,-0.15393437018666678,52,24,28,79,0.4176970523529863,0.5697077034728815
성장률/NNG@$전망/NNG@$낮췄/VV,0,-0.15448100117481356,33,15,18,25,0.34021451866701996,0.46454713637577644
달러/NNG@$강세/NNG@$지속/NNG,0,-0.15448100117481356,33,15,18,26,0.34021451866701996,0.46454713637577644
구매/NNG@$관리/NNG@$지수/NNG,0,-0.15448100117481356,33,15,18,36,0.34021451866701996,0.46454713637577644
기대/NNG@$쉽/VA@$않/VX,0,-0.15448100117481356,33,15,18,18,0.34021451866701996,0.46454713637577644
엔화/NNG@$강세/NNG@$보이/VV,0,-0.15448100117481356,33,15,18,18,0.34021451866701996,0.46454713637577644
기준금리/NNG@$인상/NNG@$기대/NNG,-1,-0.15696987391647543,84,39,45,56,0.49947072439934126,0.685491476812938
경제/NNG@$회복/NNG@$지연/NNG,-1,-0.15830656541753707,50,23,27,61,0.40824346510536524,0.5618257479091571
금리/NNG@$인상/NNG@$예측/NNG,-1,-0.15830656541753707,50,23,27,31,0.40824346510536524,0.5618257479091571
인상/NNG@$달러화/NNG@$강세/NNG,-1,-0.15830656541753707,50,23,27,29,0.40824346510536524,0.5618257479091571
기준금리/NNG@$인상/NNG@$시작/NNG,-1,-0.15906734927700472,67,31,36,69,0.46085066348900067,0.6352144253927035
달러/NNG@$원/NNG@$환율/NNG@$상승/NNG,-1,-0.15906734927700472,67,31,36,65,0.46085066348900067,0.6352144253927035
경기/NNG@$둔화/NNG@$신호/NNG,0,-0.160702425231815,31,14,17,23,0.3282220727070843,0.4539260254356478
금리/NNG@$인상/NNG@$미루/VV,0,-0.160702425231815,31,14,17,21,0.3282220727070843,0.4539260254356478
성장률/NNG@$전망치/NNG@$낮/VA,0,-0.160702425231815,31,14,17,34,0.3282220727070843,0.4539260254356478
예상/NNG@$크/VA@$벗어나/VV@$않/VX,0,-0.160702425231815,31,14,17,31,0.3282220727070843,0.4539260254356478
인상/NNG@$예상/NNG@$시장/NNG,0,-0.160702425231815,31,14,17,20,0.3282220727070843,0.4539260254356478
경제/NNG@$금융시장/NNG@$불안/NNG,0,-0.160702425231815,31,14,17,25,0.3282220727070843,0.4539260254356478
금리/NNG@$인상/NNG@$시기상조/NNG,0,-0.160702425231815,31,14,17,38,0.3282220727070843,0.4539260254356478
물가/NNG@$경제/NNG@$성장/NNG,-1,-0.16291663655482835,48,22,26,37,0.3985007458706133,0.5536317365249144
증권/NNG@$투자/NNG@$자금/NNG@$유입/NNG,-1,-0.16291663655482835,48,22,26,27,0.3985007458706133,0.5536317365249144
소비/NNG@$심리/NNG@$악화/NNG,-1,-0.16291663655482835,48,22,26,33,0.3985007458706133,0.5536317365249144
선제적/NNG@$금리/NNG@$인하/NNG,-1,-0.16304461794404335,65,30,35,61,0.4531529743831299,0.6297248722981882
인하/NNG@$가능성/NNG@$높/VA,0,-0.16308427359565114,182,84,98,121,0.5500482592480659,0.7644378540882854
경기/NNG@$회복세/NNG@$둔화/NNG,-1,-0.1641747059433255,80,37,43,119,0.4874124928608847,0.6789081763118259
인상/NNG@$단행/NNG@$금리/NNG,-1,-0.1641747059433255,80,37,43,45,0.4874124928608847,0.6789081763118259
금리/NNG@$내릴/VV@$가능성/NNG,-1,-0.16718229518047,63,29,34,51,0.445192723955159,0.6239473944686004
유지/NNG@$가능성/NNG@$높/VA,-1,-0.16718229518047,63,29,34,39,0.445192723955159,0.6239473944686004
금리/NNG@$인상/NNG@$많/VA,0,-0.1676472607466939,29,13,16,24,0.31584143124623015,0.44308233953850745
인플레이션/NNG@$압력/NNG@$억제/NNG,0,-0.1676472607466939,29,13,16,23,0.31584143124623015,0.44308233953850745
위기/NNG@$금리/NNG@$인하/NNG,0,-0.1676472607466939,29,13,16,27,0.31584143124623015,0.44308233953850745
수출/NNG@$타격/NNG@$입/VV,0,-0.1676472607466939,29,13,16,25,0.31584143124623015,0.44308233953850745
경제/NNG@$성장/NNG@$하방/NNG@$위험/NNG,0,-0.1676472607466939,29,13,16,37,0.31584143124623015,0.44308233953850745
확대/NNG@$가능성/NNG@$크/VA,0,-0.1676472607466939,29,13,16,34,0.31584143124623015,0.44308233953850745
경기/NNG@$회복/NNG@$정책/NNG,0,-0.1676472607466939,29,13,16,23,0.31584143124623015,0.44308233953850745
기업/NNG@$체감/NNG@$경기/NNG,0,-0.1676472607466939,29,13,16,31,0.31584143124623015,0.44308233953850745
저금리/NNG@$정책/NNG@$기조/NNG,0,-0.1676472607466939,29,13,16,26,0.31584143124623015,0.44308233953850745
인하/NNG@$단행/NNG@$예상/NNG,0,-0.1676472607466939,29,13,16,26,0.31584143124623015,0.44308233953850745
성장/NNG@$전망/NNG@$하향/NNG@$조정/NNG,0,-0.1676472607466939,29,13,16,33,0.31584143124623015,0.44308233953850745
금리/NNG@$인상/NNG@$은행/NNG,-1,-0.1677938536285607,46,21,25,43,0.388463211130044,0.5451251563049964
외국인/NNG@$증권/NNG@$투자/NNG@$자금/NNG@$유입/NNG,-1,-0.1677938536285607,46,21,25,26,0.388463211130044,0.5451251563049964
증시/NNG@$금리/NNG@$인상/NNG,-1,-0.1677938536285607,46,21,25,43,0.388463211130044,0.5451251563049964
만장일치/NNG@$금리/NNG@$동결/NNG,-1,-0.1677938536285607,46,21,25,59,0.388463211130044,0.5451251563049964
금리선물/NNG@$시장/NNG@$금리/NNG@$인상/NNG@$가능성/NNG,-1,-0.1677938536285607,46,21,25,32,0.388463211130044,0.5451251563049964
원/NNG@$환율/NNG@$원대/NNG,-1,-0.1677938536285607,46,21,25,37,0.388463211130044,0.5451251563049964
금리/NNG@$동결/NNG@$경제/NNG,-1,-0.1677938536285607,46,21,25,26,0.388463211130044,0.5451251563049964
기준금리/NNG@$사상/NNG@$최저/NNG,0,-0.16889437261584217,141,65,76,143,0.5406046052147495,0.7603431607116258
에너지/NNG@$가격/NNG@$하락/NNG,0,-0.1700054945344769,91,42,49,70,0.5023493679745125,0.7081564181365926
금리/NNG@$인하/NNG@$가능성/NNG@$반영/NNG,-1,-0.17149270817371343,61,28,33,36,0.43696517124827156,0.6178747561999407
소비자/NNG@$물가/NNG@$상승률/NNG@$전망치/NNG,-1,-0.17149270817371343,61,28,33,56,0.43696517124827156,0.6178747561999407
관측/NNG@$힘/NNG@$얻/VV,-1,-0.17297371537213935,44,20,24,24,0.3781239200238132,0.5363066952524672
시장/NNG@$불안/NNG@$요인/NNG,-1,-0.17297371537213935,44,20,24,18,0.3781239200238132,0.5363066952524672
국고채/NNG@$금리/NNG@$상승/NNG,-1,-0.17297371537213935,44,20,24,38,0.3781239200238132,0.5363066952524672
인상/NNG@$기조/NNG@$유지/NNG,0,-0.1736194835192887,102,47,55,63,0.5137525072169287,0.7296442677096838
은행/NNG@$금융정책/NNG@$결정/NNG@$열/VV,0,-0.17550359596983434,27,12,15,26,0.3030214653362371,0.43203429060970083
경제/NNG@$구조/NNG@$개혁/NNG,0,-0.17550359596983434,27,12,15,18,0.3030214653362371,0.43203429060970083
금리/NNG@$통화정책/NNG@$결정/NNG,0,-0.17550359596983434,27,12,15,36,0.3030214653362371,0.43203429060970083
경기/NNG@$둔화/NNG@$대응/NNG,0,-0.17550359596983434,27,12,15,31,0.3030214653362371,0.43203429060970083
예상/NNG@$성장/NNG@$경로/NNG,0,-0.17550359596983434,27,12,15,28,0.3030214653362371,0.43203429060970083
경기/NNG@$모멘텀/NNG@$둔화/NNG,0,-0.17550359596983434,27,12,15,24,0.3030214653362371,0.43203429060970083
결정/NNG@$중요/NNG@$변수/NNG,0,-0.17550359596983434,27,12,15,22,0.3030214653362371,0.43203429060970083
동결/NNG@$자산/NNG@$매입/NNG,0,-0.17550359596983434,27,12,15,57,0.3030214653362371,0.43203429060970083
금리/NNG@$인하/NNG@$가능성/NNG@$낮/VA,-1,-0.17598999077830213,59,27,32,35,0.4284655084134554,0.6115001140987119
검토/NNG@$기준금리/NNG@$유지/NNG,0,-0.1761956918194273,14,6,8,52,0.2380867936574335,0.3399384820659259
금리/NNG@$올릴/VV@$전망/NNG,0,-0.1771694439238124,100,46,54,43,0.5091438364785779,0.728414156288509
소비/NNG@$지출/NNG@$증가/NNG,-1,-0.177506762108951,87,40,47,89,0.4912942159072241,0.7033669847445224
금융/NNG@$위기/NNG@$대응/NNG,-1,-0.177506762108951,87,40,47,82,0.4912942159072241,0.7033669847445224
경기/NNG@$회복세/NNG@$예상/NNG,-1,-0.17849972057884922,42,19,23,39,0.36747409363265243,0.5271783477565964
금융/NNG@$규제/NNG@$완화/NNG,-1,-0.17849972057884922,42,19,23,25,0.36747409363265243,0.5271783477565964
경제/NNG@$완만/XR@$속도/NNG,-1,-0.17849972057884922,42,19,23,34,0.36747409363265243,0.5271783477565964
경기/NNG@$회복/NNG@$기대감/NNG,0,-0.17908549049225064,236,108,128,203,0.5388033910070249,0.7739032010306526
공급/NNG@$과잉/NNG@$우려/NNG,-1,-0.18069046092855834,57,26,31,52,0.41968877530052184,0.6048170930821954
위안화/NNG@$절상/NNG@$속도/NNG,-1,-0.18069046092855834,57,26,31,49,0.41968877530052184,0.6048170930821954
금리/NNG@$인하/NNG@$효과/NNG,0,-0.18113175309134733,420,192,228,320,0.5372977114798193,0.7750110268387296
경기/NNG@$둔화/NNG@$경제/NNG,-1,-0.18144309382714752,85,39,46,68,0.48545056294589456,0.7006763491973459
금리/NNG@$인하/NNG@$필요/NNG,0,-0.18313000560823878,142,65,77,119,0.5304516330801682,0.768304750364437
종사자/NNG@$기준금리/NNG@$동결/NNG,-1,-0.18442576775082897,40,18,22,26,0.3565023159675095,0.5177435131867802
기준금리/NNG@$인하/NNG@$않/VX,-1,-0.18442576775082897,40,18,22,37,0.3565023159675095,0.5177435131867802
통화/NNG@$완화/NNG@$기조/NNG@$유지/NNG,-1,-0.18442576775082897,40,18,22,17,0.3565023159675095,0.5177435131867802
소비자/NNG@$물가/NNG@$상승률/NNG@$상승/NNG,-1,-0.18442576775082897,40,18,22,28,0.3565023159675095,0.5177435131867802
경기/NNG@$저점/NNG@$통과/NNG,-1,-0.18442576775082897,40,18,22,25,0.3565023159675095,0.5177435131867802
초저/NNG@$금리/NNG@$기조/NNG@$유지/NNG,-1,-0.18451846448742626,70,32,38,94,0.45317895967630917,0.6582720012597925
전세/NNG@$가격/NNG@$수도권/NNG,0,-0.1845337266005117,25,11,14,34,0.2896867244822391,0.42080215896571727
완화/NNG@$정책/NNG@$지속/NNG,0,-0.1845337266005117,25,11,14,27,0.2896867244822391,0.42080215896571727
경제/NNG@$성장/NNG@$주도/NNG,0,-0.1845337266005117,25,11,14,23,0.2896867244822391,0.42080215896571727
유로존/NNG@$경기/NNG@$회복/NNG,0,-0.1845337266005117,25,11,14,45,0.2896867244822391,0.42080215896571727
경로/NNG@$하방/NNG@$리스크/NNG,0,-0.1845337266005117,25,11,14,28,0.2896867244822391,0.42080215896571727
금리/NNG@$역전/NNG@$현상/NNG,-1,-0.18551106617425683,83,38,45,49,0.4793890370062302,0.6977764024289318
고고/NNG@$미사일/NNG@$방어/NNG@$체계/NNG,-1,-0.18905239871661372,68,31,37,70,0.4455896840036431,0.653356804056112
주택/NNG@$담보대출/NNG@$부실/NNG,-1,-0.19078013722278686,53,24,29,38,0.40128273818450466,0.5905032485466732
통화정책/NNG@$금리/NNG@$인하/NNG,-1,-0.19078013722278686,53,24,29,49,0.40128273818450466,0.5905032485466732
경제/NNG@$경착륙/NNG@$우려/NNG,-1,-0.19081945615686724,38,17,21,31,0.34519342820804144,0.5080070820389577
가격/NNG@$하락/NNG@$경기/NNG,-1,-0.19081945615686724,38,17,21,23,0.34519342820804144,0.5080070820389577
경제/NNG@$성장률/NNG@$전망/NNG,-1,-0.19081945615686724,38,17,21,40,0.34519342820804144,0.5080070820389577
경제/NNG@$견조/NNG@$성장세/NNG,-1,-0.19081945615686724,38,17,21,34,0.34519342820804144,0.5080070820389577
물가/NNG@$상승률/NNG@$넘/VV,-1,-0.19081945615686724,38,17,21,35,0.34519342820804144,0.5080070820389577
확인/NNG@$필요/NNG@$있/VA,-1,-0.19376574861235552,66,30,36,44,0.4377407185146506,0.6481581978823857
하락/NNG@$경기/NNG@$회복/NNG,0,-0.19511424144139644,23,10,13,22,0.2757244177134156,0.40940802793302866
유지/NNG@$물가/NNG@$상승률/NNG,0,-0.19511424144139644,23,10,13,26,0.2757244177134156,0.40940802793302866
지수/NNG@$내린/VV@$마감/NNG,-1,-0.1962178618178101,51,23,28,36,0.39164144666454725,0.5828627715734527
위험/NNG@$요인/NNG@$경제/NNG,-1,-0.1962178618178101,51,23,28,26,0.39164144666454725,0.5828627715734527
신중/NNG@$필요/NNG@$있/VA,-1,-0.1962178618178101,51,23,28,56,0.39164144666454725,0.5828627715734527
금융시장/NNG@$금리/NNG@$인하/NNG,-1,-0.1962178618178101,51,23,28,38,0.39164144666454725,0.5828627715734527
경제/NNG@$전망/NNG@$성장률/NNG@$전망치/NNG,0,-0.1977667049473626,36,16,20,55,0.33352698518949425,0.4979755016009704
금리/NNG@$인하/NNG@$아니/VCN,0,-0.1977667049473626,36,16,20,16,0.33352698518949425,0.4979755016009704
성장/NNG@$경로/NNG@$크/VA,0,-0.1977667049473626,36,16,20,20,0.33352698518949425,0.4979755016009704
가계부채/NNG@$종합/NNG@$대책/NNG,0,-0.1977667049473626,36,16,20,21,0.33352698518949425,0.4979755016009704
영향/NNG@$제한적/NNG@$전망/NNG,0,-0.1977667049473626,36,16,20,29,0.33352698518949425,0.4979755016009704
금리/NNG@$인상/NNG@$근거/NNG,-1,-0.19857359327720958,77,35,42,44,0.45984353379083337,0.68772756847137
지수/NNG@$상승/NNG@$거래/NNG@$마쳤/VV,-1,-0.20162391147378134,99,45,54,61,0.4913771168494316,0.7395723785326952
인상/NNG@$속도/NNG@$예상/NNG,-1,-0.20195758399854968,49,22,27,31,0.381698589516977,0.5748947908482669
모기지/NNG@$담보/NNG@$증권/NNG@$매입/NNG,-1,-0.20378526336185065,62,28,34,79,0.42124233058983884,0.6368763493997815
소비자/NNG@$물가/NNG@$상승률/NNG@$둔화/NNG,0,-0.2053783403124897,34,15,19,28,0.32147507638740525,0.4876568095218518
소비자/NNG@$물가/NNG@$상승률/NNG@$목표/NNG,0,-0.2053783403124897,34,15,19,44,0.32147507638740525,0.4876568095218518
양적완화/NNG@$축소/NNG@$테이퍼링/NNG,0,-0.2053783403124897,34,15,19,48,0.32147507638740525,0.4876568095218518
기준금리/NNG@$인상/NNG@$우려/NNG,0,-0.2053783403124897,34,15,19,55,0.32147507638740525,0.4876568095218518
인상/NNG@$가능성/NNG@$시장/NNG,0,-0.2053783403124897,34,15,19,23,0.32147507638740525,0.4876568095218518
지표/NNG@$호조/NNG@$보이/VV,0,-0.2053783403124897,34,15,19,24,0.32147507638740525,0.4876568095218518
모습/NNG@$보이/VV@$금리/NNG,0,-0.2053783403124897,34,15,19,25,0.32147507638740525,0.4876568095218518
노력/NNG@$필요/NNG@$있/VA,0,-0.2053783403124897,34,15,19,35,0.32147507638740525,0.4876568095218518
가계/NNG@$수입/NNG@$전망/NNG@$소비/NNG@$지출/NNG,0,-0.2053783403124897,34,15,19,30,0.32147507638740525,0.4876568095218518
달러/NNG@$원/NNG@$상승/NNG,0,-0.207804825106914,21,9,12,31,0.2609628977527651,0.3978752011593104
주택/NNG@$판매/NNG@$증가/NNG,0,-0.207804825106914,21,9,12,49,0.2609628977527651,0.3978752011593104
경제/NNG@$전망/NNG@$하향/NNG@$조정/NNG,0,-0.207804825106914,21,9,12,32,0.2609628977527651,0.3978752011593104
해소/NNG@$금리/NNG@$인상/NNG,0,-0.207804825106914,21,9,12,30,0.2609628977527651,0.3978752011593104
이례적/NNG@$낮/VA@$금리/NNG,0,-0.207804825106914,21,9,12,42,0.2609628977527651,0.3978752011593104
강세/NNG@$엔화/NNG@$약세/NNG,0,-0.207804825106914,21,9,12,31,0.2609628977527651,0.3978752011593104
담보인정비율/NNG@$부채/NNG@$상환/NNG,-1,-0.20803696004538752,47,21,26,48,0.37144553354036675,0.5665965706916763
가격/NNG@$하락/NNG@$물가/NNG,-1,-0.20803696004538752,47,21,26,31,0.37144553354036675,0.5665965706916763
고용/NNG@$지표/NNG@$개선/NNG,-1,-0.2080789517651641,73,33,40,73,0.4456252827836288,0.6798087336186504
상승/NNG@$경기/NNG@$회복/NNG,-1,-0.20912370064515884,60,27,33,59,0.4125817816055909,0.6307765010873952
경기/NNG@$회복세/NNG@$보이/VV,-1,-0.20912370064515884,60,27,33,73,0.4125817816055909,0.6307765010873952
검토/NNG@$필요/NNG@$있/VA,-1,-0.20912370064515884,60,27,33,81,0.4125817816055909,0.6307765010873952
통화정책/NNG@$기조/NNG@$변화/NNG,-1,-0.2113307465492743,115,52,63,70,0.49848650429577424,0.7656390918487854
경기/NNG@$회복/NNG@$가능성/NNG,-1,-0.21309999727515405,71,32,39,39,0.4381435162596967,0.6754542971459386
시장/NNG@$금리/NNG@$상승/NNG@$압력/NNG,0,-0.21379968983031283,32,14,18,30,0.30899920682463394,0.47706061807238254
필요/NNG@$있/VA@$생각/NNG,0,-0.21379968983031283,32,14,18,31,0.30899920682463394,0.47706061807238254
성장/NNG@$지속/NNG@$물가/NNG@$유지/NNG,0,-0.21379968983031283,32,14,18,24,0.30899920682463394,0.47706061807238254
고려/NNG@$않/VX@$없/VA,0,-0.21379968983031283,32,14,18,38,0.30899920682463394,0.47706061807238254
지속/NNG@$물가/NNG@$유지/NNG,0,-0.21379968983031283,32,14,18,24,0.30899920682463394,0.47706061807238254
차지/NNG@$비중/NNG@$높/VA,0,-0.21379968983031283,32,14,18,24,0.30899920682463394,0.47706061807238254
소비자/NNG@$물가/NNG@$상승률/NNG@$예상/NNG,0,-0.21379968983031283,32,14,18,31,0.30899920682463394,0.47706061807238254
금리/NNG@$오른/VV@$마감/NNG,0,-0.21379968983031283,32,14,18,44,0.30899920682463394,0.47706061807238254
원화/NNG@$강세/NNG@$기조/NNG,0,-0.21379968983031283,32,14,18,31,0.30899920682463394,0.47706061807238254
금융기관/NNG@$경제/NNG@$실시/NNG,-1,-0.2145017126130767,45,20,25,13,0.3608717479163029,0.5579663755128544
금리/NNG@$인상/NNG@$필요성/NNG@$제기/NNG,-1,-0.2145017126130767,45,20,25,21,0.3608717479163029,0.5579663755128544
회복/NNG@$기미/NNG@$보이/VV,-1,-0.21468194817417086,82,37,45,44,0.4588979666451155,0.709798948020713
경제/NNG@$경기/NNG@$둔화/NNG,-1,-0.21831568251542577,69,31,38,50,0.43040596310793827,0.6708234528597543
인상/NNG@$필요성/NNG@$제기/NNG,-1,-0.22055815715136884,56,25,31,36,0.39440775443196796,0.6176199220323224
고용/NNG@$시장/NNG@$회복/NNG,-1,-0.22140793534681114,43,19,24,46,0.3499640751046302,0.5490035529755033
금리/NNG@$인상/NNG@$확실/XR,-1,-0.22140793534681114,43,19,24,53,0.3499640751046302,0.5490035529755033
경기/NNG@$부양/NNG@$기준금리/NNG@$인하/NNG,-1,-0.22140793534681114,43,19,24,43,0.3499640751046302,0.5490035529755033
인상/NNG@$경제/NNG@$영향/NNG,-1,-0.22140793534681114,43,19,24,27,0.3499640751046302,0.5490035529755033
금리/NNG@$인상/NNG@$지급준비율/NNG,-1,-0.22140793534681114,43,19,24,29,0.3499640751046302,0.5490035529755033
종료/NNG@$금리/NNG@$인상/NNG,-1,-0.22140793534681114,43,19,24,62,0.3499640751046302,0.5490035529755033
목표/NNG@$물가/NNG@$상승률/NNG,-1,-0.22140793534681114,43,19,24,26,0.3499640751046302,0.5490035529755033
물가/NNG@$관리/NNG@$목표/NNG,-1,-0.22140793534681114,43,19,24,35,0.3499640751046302,0.5490035529755033
채권/NNG@$금리/NNG@$인상/NNG,-1,-0.22140793534681114,43,19,24,27,0.3499640751046302,0.5490035529755033
결정/NNG@$기준금리/NNG@$동결/NNG,0,-0.22322489055035355,30,13,17,22,0.296045758890978,0.46619802288988443
인상/NNG@$전제/NNG@$조건/NNG,0,-0.22322489055035355,30,13,17,43,0.296045758890978,0.46619802288988443
하방/NNG@$리스크/NNG@$있/VA,0,-0.22322489055035355,30,13,17,21,0.296045758890978,0.46619802288988443
국고채/NNG@$금리/NNG@$오른/VV,0,-0.22322489055035355,30,13,17,20,0.296045758890978,0.46619802288988443
가능성/NNG@$낮/VA@$진/VX,0,-0.22347239757136483,19,8,11,29,0.24513473067879024,0.3862270182836841
소비자/NNG@$물가/NNG@$상승률/NNG@$하락/NNG,0,-0.22347239757136483,19,8,11,36,0.24513473067879024,0.3862270182836841
동결/NNG@$경제/NNG@$동향/NNG,0,-0.22347239757136483,19,8,11,32,0.24513473067879024,0.3862270182836841
개인/NNG@$소비/NNG@$지출/NNG@$물가/NNG,0,-0.22347239757136483,19,8,11,35,0.24513473067879024,0.3862270182836841
해외/NNG@$투자/NNG@$활성화/NNG,-1,-0.22373967752997215,67,30,37,45,0.42240696534220173,0.6659064157880485
금리/NNG@$인하/NNG@$여력/NNG,-1,-0.22373967752997215,67,30,37,48,0.42240696534220173,0.6659064157880485
소비자/NNG@$물가/NNG@$하락/NNG,-1,-0.22655791772727962,98,44,54,71,0.47327198925626085,0.7505350741319132
둔화/NNG@$조짐/NNG@$보이/VV,-1,-0.22670457428556934,54,24,30,65,0.3848805710047979,0.610548870465245
투자/NNG@$심리/NNG@$위축/NNG,-1,-0.22813985060052266,143,64,79,154,0.4975018579483845,0.7915958941122578
정책/NNG@$금리/NNG@$인상/NNG,-1,-0.2287809474159831,87,39,48,51,0.45772534426812145,0.7292915401513559
금리/NNG@$내릴/VV@$전망/NNG,-1,-0.2288252145582954,41,18,23,23,0.33870574365567513,0.5397086050905537
불안/NNG@$심리/NNG@$확산/NNG,-1,-0.2288252145582954,41,18,23,24,0.33870574365567513,0.5397086050905537
딜러/NNG@$금리/NNG@$인하/NNG,-1,-0.2288252145582954,41,18,23,14,0.33870574365567513,0.5397086050905537
국내총생산/NNG@$증가율/NNG@$기록/NNG,-1,-0.2288252145582954,41,18,23,20,0.33870574365567513,0.5397086050905537
경기/NNG@$회복/NNG@$둔화/NNG,-1,-0.2288252145582954,41,18,23,52,0.33870574365567513,0.5397086050905537
개선/NNG@$기미/NNG@$보이/VV,-1,-0.2288252145582954,41,18,23,26,0.33870574365567513,0.5397086050905537
주택/NNG@$담보대출/NNG@$규제/NNG,-1,-0.2288252145582954,41,18,23,33,0.33870574365567513,0.5397086050905537
초저/NNG@$금리/NNG@$유지/NNG,-1,-0.23017639539210188,168,75,93,189,0.49916733932843654,0.7976668669935828
금리/NNG@$인하/NNG@$경제/NNG,-1,-0.2312643105628327,96,43,53,66,0.4678347735416921,0.7493172999491532
전망/NNG@$경제/NNG@$성장/NNG,-1,-0.23317834784612723,52,23,29,74,0.37504937332332017,0.6031406607336766
점진적/NNG@$금리/NNG@$인상/NNG@$기조/NNG,-1,-0.23317834784612723,52,23,29,17,0.37504937332332017,0.6031406607336766
양적완화/NNG@$축소/NNG@$우려/NNG,0,-0.2339187972078216,28,12,16,76,0.2825392655324523,0.4550813951697723
환율/NNG@$변동/NNG@$확대/NNG,0,-0.2339187972078216,28,12,16,45,0.2825392655324523,0.4550813951697723
확대/NNG@$가능성/NNG@$높/VA,0,-0.2339187972078216,28,12,16,22,0.2825392655324523,0.4550813951697723
회복/NNG@$국면/NNG@$접어들/VV,0,-0.2339187972078216,28,12,16,25,0.2825392655324523,0.4550813951697723
불안/NNG@$심리/NNG@$진정/NNG,0,-0.2339187972078216,28,12,16,9,0.2825392655324523,0.4550813951697723
긍정적/NNG@$영향/NNG@$기대/NNG,0,-0.2339187972078216,28,12,16,29,0.2825392655324523,0.4550813951697723
제품/NNG@$가격/NNG@$하락/NNG,0,-0.2339187972078216,28,12,16,19,0.2825392655324523,0.4550813951697723
경기/NNG@$부양/NNG@$정책/NNG,-1,-0.23451945769653337,209,93,116,160,0.49703936120915815,0.8015912050761674
담보/NNG@$증권/NNG@$매입/NNG,-1,-0.23527679039830063,63,28,35,85,0.40560104145066483,0.6551749752943228
금리/NNG@$인상/NNG@$점진적/NNG,-1,-0.23527679039830063,63,28,35,56,0.40560104145066483,0.6551749752943228
금리/NNG@$인하/NNG@$않/VX,-1,-0.2361211290145021,94,42,52,62,0.4622012240771672,0.7479381532120135
금리/NNG@$인상/NNG@$단행/NNG@$가능성/NNG,-1,-0.2361211290145021,94,42,52,88,0.4622012240771672,0.7479381532120135
금리/NNG@$인하/NNG@$금융시장/NNG,-1,-0.23684091976294208,39,17,22,30,0.32707502311695963,0.5300832396955063
증가/NNG@$경제/NNG@$성장/NNG,-1,-0.23684091976294208,39,17,22,32,0.32707502311695963,0.5300832396955063
금리/NNG@$상승/NNG@$예상/NNG,-1,-0.23684091976294208,39,17,22,20,0.32707502311695963,0.5300832396955063
기금/NNG@$금리선물/NNG@$기준금리/NNG,-1,-0.23684091976294208,39,17,22,24,0.32707502311695963,0.5300832396955063
물가/NNG@$상승률/NNG@$유지/NNG,-1,-0.23684091976294208,39,17,22,28,0.32707502311695963,0.5300832396955063
인상/NNG@$이뤄질/VV@$전망/NNG,-1,-0.23684091976294208,39,17,22,27,0.32707502311695963,0.5300832396955063
경제/NNG@$성장/NNG@$물가/NNG,-1,-0.23713751083017431,155,69,86,105,0.49276498004420016,0.7991152432608465
확인/NNG@$금리/NNG@$인상/NNG,-1,-0.2390769752762859,83,37,46,63,0.444822636063524,0.7243390926530523
가격/NNG@$상승/NNG@$압력/NNG,-1,-0.24001782669421778,50,22,28,42,0.3649046687557565,0.5953895973099351
서브프라임모기지/NNG@$우량/NNG@$주택/NNG@$담보대출/NNG@$부실/NNG,-1,-0.24001782669421778,50,22,28,35,0.3649046687557565,0.5953895973099351
우량/NNG@$주택/NNG@$담보대출/NNG@$부실/NNG,-1,-0.24001782669421778,50,22,28,36,0.3649046687557565,0.5953895973099351
경제/NNG@$기초/NNG@$체력/NNG,-1,-0.24001782669421778,50,22,28,55,0.3649046687557565,0.5953895973099351
통화정책/NNG@$방향/NNG@$경제/NNG,-1,-0.24001782669421778,50,22,28,34,0.3649046687557565,0.5953895973099351
필요/NNG@$있/VA@$조언/NNG,-1,-0.24099175468815304,72,32,40,58,0.42322635798737723,0.6919778876266371
지수/NNG@$뛴/VV@$기록/NNG,0,-0.24352848745305766,17,7,10,34,0.2278106737800673,0.37448449107431114
규모/NNG@$유동성/NNG@$공급/NNG,-1,-0.2455661958807206,37,16,21,27,0.3150433763229089,0.5201303918182449
금융/NNG@$위기/NNG@$직전/NNG,-1,-0.2455661958807206,37,16,21,29,0.3150433763229089,0.5201303918182449
필요/NNG@$있/VA@$기준금리/NNG,-1,-0.2455661958807206,37,16,21,35,0.3150433763229089,0.5201303918182449
인상/NNG@$통화/NNG@$긴축/NNG,-1,-0.2455661958807206,37,16,21,24,0.3150433763229089,0.5201303918182449
물가/NNG@$원자재/NNG@$가격/NNG,-1,-0.2455661958807206,37,16,21,30,0.3150433763229089,0.5201303918182449
국내총생산/NNG@$갭/NNG@$마이너스/NNG,0,-0.24625153242613196,26,11,15,36,0.2683722325421948,0.4437239912120842
인하/NNG@$기조/NNG@$유지/NNG,0,-0.24625153242613196,26,11,15,27,0.2683722325421948,0.4437239912120842
가능성/NNG@$무게/NNG@$실리/VV,0,-0.24625153242613196,26,11,15,24,0.2683722325421948,0.4437239912120842
금리/NNG@$인하/NNG@$대응/NNG,0,-0.24625153242613196,26,11,15,41,0.2683722325421948,0.4437239912120842
가능성/NNG@$크/VA@$덧붙였/VV,0,-0.24625153242613196,26,11,15,26,0.2683722325421948,0.4437239912120842
통화정책/NNG@$기조/NNG@$완화/NNG,0,-0.24625153242613196,26,11,15,25,0.2683722325421948,0.4437239912120842
금융/NNG@$불안/NNG@$경제/NNG,0,-0.24625153242613196,26,11,15,22,0.2683722325421948,0.4437239912120842
상승/NNG@$경기/NNG@$둔화/NNG,0,-0.24625153242613196,26,11,15,26,0.2683722325421948,0.4437239912120842
수출/NNG@$부진/NNG@$경제/NNG,0,-0.24625153242613196,26,11,15,20,0.2683722325421948,0.4437239912120842
금융/NNG@$위기/NNG@$발발/NNG,0,-0.24625153242613196,26,11,15,35,0.2683722325421948,0.4437239912120842
식료품/NNG@$에너지/NNG@$지수/NNG,0,-0.24625153242613196,26,11,15,16,0.2683722325421948,0.4437239912120842
원유/NNG@$도입/NNG@$단가/NNG,0,-0.24625153242613196,26,11,15,20,0.2683722325421948,0.4437239912120842
사태/NNG@$금융/NNG@$위기/NNG,0,-0.24625153242613196,26,11,15,18,0.2683722325421948,0.4437239912120842
움직임/NNG@$보이/VV@$않/VX,0,-0.24625153242613196,26,11,15,15,0.2683722325421948,0.4437239912120842
규모/NNG@$국채/NNG@$매입/NNG,-1,-0.24726914609524642,48,21,27,64,0.3544351662315234,0.5872907131801662
서두/NNG@$필요/NNG@$없/VA,-1,-0.24786431475095638,59,26,33,25,0.38767535283377536,0.6431838199562828
원/NNG@$환율/NNG@$상승/NNG,-1,-0.2501022055680162,79,35,44,75,0.4310053380024528,0.7184911091928091
인상/NNG@$중단/NNG@$가능성/NNG,-1,-0.2501022055680162,79,35,44,62,0.4310053380024528,0.7184911091928091
총액/NNG@$대출한도/NNG@$축소/NNG,-1,-0.2529717971364971,68,30,38,24,0.40719987077207837,0.6829779169515792
조치/NNG@$금리/NNG@$인상/NNG,-1,-0.25461335618485326,57,25,32,30,0.37827474971135405,0.6366929740693353
달러/NNG@$가치/NNG@$상승/NNG,-1,-0.25461335618485326,57,25,32,31,0.37827474971135405,0.6366929740693353
기금/NNG@$금리/NNG@$인하/NNG,-1,-0.25498833658501885,46,20,26,28,0.3436271502106376,0.5788398444292508
채권/NNG@$시장/NNG@$불안/NNG,-1,-0.25498833658501885,46,20,26,26,0.3436271502106376,0.5788398444292508
기대/NNG@$금리/NNG@$인하/NNG,-1,-0.25498833658501885,46,20,26,34,0.3436271502106376,0.5788398444292508
인상/NNG@$가능성/NNG@$커지/VV,-1,-0.25498833658501885,46,20,26,36,0.3436271502106376,0.5788398444292508
최대/NNG@$낙폭/NNG@$기록/NNG,-1,-0.2551444802068704,35,15,20,17,0.3025728964174334,0.5098542001125892
채권/NNG@$시장/NNG@$외국인/NNG,-1,-0.2551444802068704,35,15,20,44,0.3025728964174334,0.5098542001125892
회복/NNG@$이어지/VV@$중기적/NNG@$물가/NNG@$상승률/NNG,-1,-0.2551444802068704,35,15,20,24,0.3025728964174334,0.5098542001125892
수입/NNG@$전망/NNG@$소비/NNG@$지출/NNG,-1,-0.2551444802068704,35,15,20,30,0.3025728964174334,0.5098542001125892
시장/NNG@$관심/NNG@$집중/NNG,-1,-0.2572258420005701,95,42,53,87,0.44909368008912637,0.7601290648409209
식료품/NNG@$가격/NNG@$급등/NNG,0,-0.26075479926780254,24,10,14,24,0.25338940095036905,0.4321392699239351
부정적/NNG@$영향/NNG@$않/VX,0,-0.26075479926780254,24,10,14,28,0.25338940095036905,0.4321392699239351
체감/NNG@$경기/NNG@$수치화/NNG,0,-0.26075479926780254,24,10,14,26,0.25338940095036905,0.4321392699239351
경기/NNG@$부양/NNG@$목적/NNG,0,-0.26075479926780254,24,10,14,27,0.25338940095036905,0.4321392699239351
실제/NNG@$소비자/NNG@$물가/NNG,0,-0.26075479926780254,24,10,14,25,0.25338940095036905,0.4321392699239351
대출/NNG@$높/VA@$증가세/NNG,0,-0.26075479926780254,24,10,14,10,0.25338940095036905,0.4321392699239351
경제/NNG@$회복세/NNG@$둔화/NNG,0,-0.26075479926780254,24,10,14,24,0.25338940095036905,0.4321392699239351
기업/NNG@$구조조정/NNG@$추진/NNG,0,-0.26075479926780254,24,10,14,29,0.25338940095036905,0.4321392699239351
예상/NNG@$좋/VA@$실적/NNG,0,-0.26075479926780254,24,10,14,35,0.25338940095036905,0.4321392699239351
주택/NNG@$담보대출/NNG@$금리/NNG,-1,-0.26150388788573264,102,45,57,73,0.4532195986864875,0.7741802427490513
전망/NNG@$하향/NNG@$조정/NNG,-1,-0.2616431630339865,367,161,206,379,0.47668874967020214,0.8145132132627356
신경/NNG@$쓰/VV@$않/VX,-1,-0.26170710330422065,55,24,31,31,0.36857124188640206,0.6298603715227237
결정/NNG@$금리/NNG@$인하/NNG,-1,-0.26170710330422065,55,24,31,28,0.36857124188640206,0.6298603715227237
금융시장/NNG@$불안/NNG@$경기/NNG,-1,-0.26170710330422065,55,24,31,24,0.36857124188640206,0.6298603715227237
경기/NNG@$회복/NNG@$수출/NNG,-1,-0.26324413489581844,44,19,25,46,0.33246365049269044,0.5700336961378255
식품/NNG@$가격/NNG@$상승/NNG,-1,-0.26324413489581844,44,19,25,52,0.33246365049269044,0.5700336961378255
채권/NNG@$시장/NNG@$투자/NNG,0,-0.26576384296604527,33,14,19,27,0.28961271215184586,0.49925991714523976
부정적/NNG@$영향/NNG@$최소화/NNG,0,-0.26576384296604527,33,14,19,30,0.28961271215184586,0.49925991714523976
선행/NNG@$지표/NNG@$역할/NNG,0,-0.26576384296604527,33,14,19,26,0.28961271215184586,0.49925991714523976
주택담보대출비율/NNG@$부채/NNG@$상환/NNG,0,-0.26576384296604527,33,14,19,33,0.28961271215184586,0.49925991714523976
경제/NNG@$회복/NNG@$국면/NNG,0,-0.26576384296604527,33,14,19,27,0.28961271215184586,0.49925991714523976
통화/NNG@$완화/NNG@$정책/NNG@$유지/NNG,0,-0.26576384296604527,33,14,19,23,0.28961271215184586,0.49925991714523976
기준금리/NNG@$인상/NNG@$고려/NNG,0,-0.26576384296604527,33,14,19,23,0.28961271215184586,0.49925991714523976
금리/NNG@$인하/NNG@$행진/NNG,-1,-0.265969387189085,64,28,36,16,0.39009669052530616,0.672780533351057
가능성/NNG@$크/VA@$전망/NNG,-1,-0.2673802813136742,139,61,78,118,0.467590096361633,0.8088825746270778
금융/NNG@$유의/NNG@$통화정책/NNG,-1,-0.26819834728884173,73,32,41,67,0.4084667514191472,0.7078515307386818
금리/NNG@$인하/NNG@$소수/NNG@$의견/NNG,-1,-0.26918347313614754,53,23,30,57,0.3585550901699057,0.6226778360355408
금융/NNG@$위기/NNG@$대처/NNG,-1,-0.26918347313614754,53,23,30,14,0.3585550901699057,0.6226778360355408
통화/NNG@$가치/NNG@$상승/NNG,-1,-0.26918347313614754,53,23,30,56,0.3585550901699057,0.6226778360355408
불안/NNG@$요인/NNG@$잠재/NNG,-1,-0.26918347313614754,53,23,30,44,0.3585550901699057,0.6226778360355408
장단기/NNG@$시장/NNG@$금리/NNG,0,-0.27041455700118533,15,6,9,19,0.20827684446757225,0.3626615445429037
인하/NNG@$쉽/VA@$않/VX,-1,-0.27212177697174555,42,18,24,50,0.32092333697705144,0.5608698935908828
부진/NNG@$경기/NNG@$회복/NNG,-1,-0.27212177697174555,42,18,24,45,0.32092333697705144,0.5608698935908828
여부/NNG@$결정/NNG@$예정/NNG,-1,-0.27212177697174555,42,18,24,13,0.32092333697705144,0.5608698935908828
금융시장/NNG@$가격/NNG@$변수/NNG,-1,-0.27212177697174555,42,18,24,35,0.32092333697705144,0.5608698935908828
경제/NNG@$동향/NNG@$성장률/NNG,-1,-0.27212177697174555,42,18,24,26,0.32092333697705144,0.5608698935908828
활동/NNG@$동향/NNG@$보/VV,-1,-0.27212177697174555,42,18,24,31,0.32092333697705144,0.5608698935908828
달러/NNG@$환율/NNG@$상승/NNG,-1,-0.27212177697174555,42,18,24,40,0.32092333697705144,0.5608698935908828
산업/NNG@$활동/NNG@$동향/NNG@$보/VV,-1,-0.27212177697174555,42,18,24,30,0.32092333697705144,0.5608698935908828
긴급/NNG@$금리/NNG@$인하/NNG,-1,-0.27224673619005924,98,43,55,45,0.44203635850289164,0.7727446709570465
인하/NNG@$소수/NNG@$의견/NNG,-1,-0.27224673619005924,98,43,55,109,0.44203635850289164,0.7727446709570465
경기/NNG@$부양/NNG@$나서/VV,-1,-0.2729024203264412,62,27,35,72,0.3811244724426262,0.6672060230771117
한계/NNG@$대출/NNG@$금리/NNG,-1,-0.2746999783014913,71,31,40,38,0.40044723701326884,0.7037621897807972
미사일/NNG@$방어/NNG@$체계/NNG,-1,-0.2746999783014913,71,31,40,72,0.40044723701326884,0.7037621897807972
정책금리/NNG@$인상/NNG@$가능성/NNG,-1,-0.2749529859910672,80,35,45,73,0.41682735771759966,0.7329502654622558
안전자산/NNG@$선호/NNG@$현상/NNG,-1,-0.2749529859910672,80,35,45,104,0.41682735771759966,0.7329502654622558
시사/NNG@$금리/NNG@$인상/NNG,-1,-0.27708766070448465,51,22,29,66,0.34821494673111886,0.6151376805187113
가계/NNG@$기업/NNG@$부채/NNG,-1,-0.27708766070448465,51,22,29,26,0.34821494673111886,0.6151376805187113
성장률/NNG@$전망/NNG@$하향/NNG@$조정/NNG,-1,-0.2773231784010851,112,49,63,117,0.4496750646282834,0.7947769722676045
성장률/NNG@$전망/NNG@$낮추/VV,0,-0.2776752473700651,31,13,18,24,0.2760938855548097,0.4883537225962288
견조/NNG@$성장/NNG@$지속/NNG@$물가/NNG@$유지/NNG,0,-0.2776752473700651,31,13,18,24,0.2760938855548097,0.4883537225962288
외국/NNG@$자본/NNG@$유입/NNG,0,-0.2776752473700651,31,13,18,51,0.2760938855548097,0.4883537225962288
부정적/NNG@$영향/NNG@$전망/NNG,0,-0.2776752473700651,31,13,18,24,0.2760938855548097,0.4883537225962288
물가/NNG@$압력/NNG@$높/VA,0,-0.2776752473700651,31,13,18,22,0.2760938855548097,0.4883537225962288
회복/NNG@$금리/NNG@$인하/NNG,0,-0.2776752473700651,31,13,18,30,0.2760938855548097,0.4883537225962288
지속/NNG@$가능성/NNG@$높/VA,-1,-0.277875142506284,96,42,54,56,0.436154495160305,0.771802479124699
인하/NNG@$경기/NNG@$부양/NNG@$효과/NNG,0,-0.2782170797027502,22,9,13,37,0.23736288364486266,0.42033973241467576
기준금리/NNG@$인상/NNG@$검토/NNG,0,-0.2782170797027502,22,9,13,34,0.23736288364486266,0.42033973241467576
실물/NNG@$경기/NNG@$회복/NNG,-1,-0.2801595604683629,60,26,34,55,0.3718617845953175,0.6613001641829139
가능성/NNG@$높/VA@$전망/NNG,-1,-0.28025150448255565,184,80,104,115,0.46215102652208545,0.8220299680981739
물가/NNG@$안정세/NNG@$유지/NNG,-1,-0.2814638954154953,69,30,39,21,0.3921641480080257,0.6993822663504725
물가/NNG@$상승률/NNG@$중기/NNG,-1,-0.2817281845929307,40,17,23,50,0.30897904089142103,0.5513470106302177
경기/NNG@$부양책/NNG@$시행/NNG,-1,-0.2817281845929307,40,17,23,31,0.30897904089142103,0.5513470106302177
가능성/NNG@$있/VA@$전망/NNG,-1,-0.2817281845929307,40,17,23,27,0.30897904089142103,0.5513470106302177
가능성/NNG@$적/VA@$않/VX,-1,-0.2817281845929307,40,17,23,15,0.30897904089142103,0.5513470106302177
성장/NNG@$둔화/NNG@$금리/NNG,-1,-0.2817281845929307,40,17,23,32,0.30897904089142103,0.5513470106302177
금리/NNG@$동결/NNG@$전망/NNG,-1,-0.2835394165673969,182,79,103,173,0.45962060619543116,0.823388729957398
통화정책/NNG@$경기/NNG@$회복/NNG,-1,-0.2854740011499941,49,21,28,46,0.3375373410400912,0.6072327753506511
투자/NNG@$자금/NNG@$유출/NNG,-1,-0.2854740011499941,49,21,28,62,0.3375373410400912,0.6072327753506511
전망/NNG@$상향/NNG@$조정/NNG,-1,-0.2872476122839376,187,81,106,181,0.4569469364294535,0.8252336582501452
지수/NNG@$높/VA@$기술/NNG,-1,-0.2885099046737982,67,29,38,38,0.38361090614095145,0.6947000563845294
물가/NNG@$상승률/NNG@$하락/NNG,-1,-0.2885099046737982,67,29,38,89,0.38361090614095145,0.6947000563845294
기준금리/NNG@$인하/NNG@$경기/NNG@$부양/NNG,0,-0.29122019125370857,29,12,17,35,0.26192208196664474,0.47714239342967013
안정적/NNG@$경제/NNG@$성장/NNG,0,-0.29122019125370857,29,12,17,21,0.26192208196664474,0.47714239342967013
기업들/NNG@$체감/NNG@$경기/NNG,0,-0.29122019125370857,29,12,17,24,0.26192208196664474,0.47714239342967013
예정/NNG@$기준금리/NNG@$인상/NNG,0,-0.29122019125370857,29,12,17,26,0.26192208196664474,0.47714239342967013
금융시장/NNG@$혼란/NNG@$경제/NNG,0,-0.29122019125370857,29,12,17,31,0.26192208196664474,0.47714239342967013
구조/NNG@$개혁/NNG@$노력/NNG,0,-0.29122019125370857,29,12,17,26,0.26192208196664474,0.47714239342967013
금리/NNG@$상승/NNG@$채권/NNG,0,-0.29122019125370857,29,12,17,34,0.26192208196664474,0.47714239342967013
불안/NNG@$요인/NNG@$상존/NNG,-1,-0.29219915978404365,38,16,22,43,0.2965957648156602,0.5414645639973363
전망/NNG@$하방/NNG@$리스크/NNG,-1,-0.29219915978404365,38,16,22,38,0.2965957648156602,0.5414645639973363
시장/NNG@$체감/NNG@$지표/NNG,-1,-0.29219915978404365,38,16,22,38,0.2965957648156602,0.5414645639973363
기준금리/NNG@$인상/NNG@$영향/NNG,-1,-0.29219915978404365,38,16,22,30,0.2965957648156602,0.5414645639973363
경기/NNG@$둔화/NNG@$영향/NNG,-1,-0.29219915978404365,38,16,22,40,0.2965957648156602,0.5414645639973363
금리/NNG@$인하/NNG@$물가/NNG,-1,-0.29219915978404365,38,16,22,34,0.2965957648156602,0.5414645639973363
정책/NNG@$일관성/NNG@$유지/NNG,-1,-0.29219915978404365,38,16,22,23,0.2965957648156602,0.5414645639973363
인플레이션/NNG@$압력/NNG@$가중/NNG,-1,-0.29219915978404365,38,16,22,32,0.2965957648156602,0.5414645639973363
채권/NNG@$시장/NNG@$체감/NNG@$지표/NNG,-1,-0.29219915978404365,38,16,22,38,0.2965957648156602,0.5414645639973363
기준금리/NNG@$인하/NNG@$기대감/NNG,-1,-0.29257880728073893,83,36,47,127,0.4101257471469081,0.7493464146034283
변동성/NNG@$확대/NNG@$가능성/NNG,-1,-0.29453206234903284,113,49,64,71,0.4380506594672442,0.8037964667852705
금리/NNG@$인상/NNG@$중단/NNG@$가능성/NNG,-1,-0.29472215627634424,74,32,42,60,0.3939008801596362,0.723085202719981
국제금융시장/NNG@$변동성/NNG@$확대/NNG,-1,-0.29472215627634424,74,32,42,55,0.3939008801596362,0.723085202719981
필요/NNG@$조치/NNG@$취할/VV,-1,-0.2957766407626502,56,24,32,64,0.3524299379099299,0.6484529566598138
금리/NNG@$인하/NNG@$불가피/XR,-1,-0.2957766407626502,56,24,32,17,0.3524299379099299,0.6484529566598138
주택/NNG@$가격/NNG@$하락/NNG,-1,-0.2961919221449907,253,109,144,226,0.45059510050788804,0.8298266966619938
회복/NNG@$금리/NNG@$인상/NNG,-1,-0.29920066069092066,81,35,46,74,0.40284797306384484,0.7468080137696438
경기/NNG@$확장/NNG@$위축/NNG,0,-0.2998511067247176,20,8,12,35,0.2199521760809604,0.4083349603644478
양적완화/NNG@$축소/NNG@$시작/NNG,0,-0.2998511067247176,20,8,12,50,0.2199521760809604,0.4083349603644478
대응/NNG@$방안/NNG@$마련/NNG,0,-0.2998511067247176,20,8,12,23,0.2199521760809604,0.4083349603644478
경기/NNG@$하방/NNG@$리스크/NNG,-1,-0.30166063768410945,165,71,94,164,0.44529416193734495,0.8299710932993947
유동성/NNG@$공급/NNG@$확대/NNG,-1,-0.30228343097977006,88,38,50,48,0.4105751944919928,0.7663087223053774
가능성/NNG@$높/VA@$경기/NNG,-1,-0.3037095182825945,36,15,21,22,0.28372798846725683,0.5312229583437589
상승/NNG@$원자재/NNG@$가격/NNG,-1,-0.3037095182825945,36,15,21,25,0.28372798846725683,0.5312229583437589
인상/NNG@$나설/VV@$예상/NNG,-1,-0.3037095182825945,36,15,21,27,0.28372798846725683,0.5312229583437589
감소/NNG@$금리/NNG@$인상/NNG,-1,-0.3037095182825945,36,15,21,17,0.28372798846725683,0.5312229583437589
성장률/NNG@$전망치/NNG@$낮췄/VV,-1,-0.3037095182825945,36,15,21,21,0.28372798846725683,0.5312229583437589
시장/NNG@$금리/NNG@$크/VA,-1,-0.3037095182825945,36,15,21,14,0.28372798846725683,0.5312229583437589
경제/NNG@$성장/NNG@$저해/NNG,-1,-0.3037095182825945,36,15,21,42,0.28372798846725683,0.5312229583437589
경기/NNG@$회복/NNG@$금리/NNG@$인상/NNG,-1,-0.3039716288635065,45,19,26,39,0.3151010355555045,0.5903033577079306
부양/NNG@$기준금리/NNG@$인하/NNG,-1,-0.3039716288635065,45,19,26,46,0.3151010355555045,0.5903033577079306
공급/NNG@$제조업/NNG@$지수/NNG,-1,-0.3039716288635065,45,19,26,27,0.3151010355555045,0.5903033577079306
경기/NNG@$둔화/NNG@$지속/NNG,-1,-0.3039716288635065,45,19,26,34,0.3151010355555045,0.5903033577079306
금융/NNG@$위기/NNG@$경제/NNG,-1,-0.3041394893245605,137,59,78,104,0.4400197438727297,0.8246282436066175
금리/NNG@$올리/VV@$시작/NNG,-1,-0.3042165402950181,54,23,31,54,0.34224028396040707,0.6414914934983371
기업/NNG@$채산성/NNG@$악화/NNG,-1,-0.3042165402950181,54,23,31,46,0.34224028396040707,0.6414914934983371
시장/NNG@$예상/NNG@$기준금리/NNG,-1,-0.3042165402950181,54,23,31,47,0.34224028396040707,0.6414914934983371
경기/NNG@$부양/NNG@$효과/NNG,-1,-0.3063126535450347,224,96,128,197,0.4429228009357566,0.8340558280560768
수출/NNG@$경기/NNG@$둔화/NNG,0,-0.30687358491497363,27,11,16,32,0.24696692653653288,0.46563276157380534
농산물/NNG@$가격/NNG@$급등/NNG,0,-0.30687358491497363,27,11,16,32,0.24696692653653288,0.46563276157380534
가격/NNG@$하락/NNG@$압력/NNG,0,-0.30687358491497363,27,11,16,37,0.24696692653653288,0.46563276157380534
국내총생산/NNG@$성장률/NNG@$기록/NNG,0,-0.30687358491497363,27,11,16,43,0.24696692653653288,0.46563276157380534
경기/NNG@$부양/NNG@$재정/NNG,0,-0.30687358491497363,27,11,16,25,0.24696692653653288,0.46563276157380534
실업/NNG@$수당/NNG@$청구/NNG@$예상/NNG,0,-0.30687358491497363,27,11,16,51,0.24696692653653288,0.46563276157380534
수당/NNG@$청구/NNG@$예상/NNG,0,-0.30687358491497363,27,11,16,51,0.24696692653653288,0.46563276157380534
경기/NNG@$회복/NNG@$부진/NNG,0,-0.30687358491497363,27,11,16,31,0.24696692653653288,0.46563276157380534
통화/NNG@$가치/NNG@$절하/NNG,-1,-0.3092150863585187,70,30,40,62,0.3773408208832661,0.7151300811510839
단행/NNG@$가능성/NNG@$높/VA,-1,-0.3092150863585187,70,30,40,42,0.3773408208832661,0.7151300811510839
효과/NNG@$나타나/VV@$않/VX,-1,-0.3092150863585187,70,30,40,65,0.3773408208832661,0.7151300811510839
채권/NNG@$딜러/NNG@$금리/NNG,-1,-0.31158386107596237,61,26,35,29,0.35625754778349283,0.6787216214775696
금리/NNG@$인상/NNG@$여지/NNG,-1,-0.3131433155142991,52,22,30,29,0.33171844384168353,0.6341585754806989
주택/NNG@$가격/NNG@$급락/NNG,-1,-0.31426353958828324,43,18,25,15,0.3032976941939544,0.5812678952656667
메르스/NNG@$호흡기/NNG@$증후군/NNG,-1,-0.31426353958828324,43,18,25,39,0.3032976941939544,0.5812678952656667
경기/NNG@$둔화/NNG@$막/VV,-1,-0.31426353958828324,43,18,25,21,0.3032976941939544,0.5812678952656667
금리/NNG@$인하/NNG@$가능성/NNG@$크/VA,-1,-0.31648759667758575,34,14,20,46,0.270316000385437,0.5206233606893395
경제/NNG@$성장률/NNG@$전망치/NNG,-1,-0.31648759667758575,34,14,20,49,0.270316000385437,0.5206233606893395
민간/NNG@$소비/NNG@$증가세/NNG,-1,-0.31648759667758575,34,14,20,23,0.270316000385437,0.5206233606893395
물가/NNG@$금리/NNG@$인하/NNG,-1,-0.31648759667758575,34,14,20,17,0.270316000385437,0.5206233606893395
실업/NNG@$수당/NNG@$신청/NNG,-1,-0.31648759667758575,34,14,20,32,0.270316000385437,0.5206233606893395
경제/NNG@$경착륙/NNG@$가능성/NNG,-1,-0.31648759667758575,34,14,20,33,0.270316000385437,0.5206233606893395
자산/NNG@$매입/NNG@$확대/NNG,-1,-0.31648759667758575,34,14,20,31,0.270316000385437,0.5206233606893395
둔화/NNG@$가능성/NNG@$높/VA,-1,-0.31648759667758575,34,14,20,39,0.270316000385437,0.5206233606893395
지식/NNG@$경제/NNG@$부/NNG,-1,-0.32002121649324156,59,25,34,41,0.34654764547907313,0.6727121278268118
수출/NNG@$가격/NNG@$경쟁력/NNG,-1,-0.32002121649324156,59,25,34,35,0.34654764547907313,0.6727121278268118
안전자산/NNG@$선호/NNG@$심리/NNG,-1,-0.32002121649324156,59,25,34,46,0.34654764547907313,0.6727121278268118
경제/NNG@$회복세/NNG@$보이/VV,-1,-0.3205639410356448,75,32,43,73,0.37956171129686617,0.7376899638937051
경제/NNG@$하방/NNG@$리스크/NNG,-1,-0.3205639410356448,75,32,43,79,0.37956171129686617,0.7376899638937051
소비/NNG@$심리/NNG@$위축/NNG,-1,-0.32184480708576424,207,88,119,150,0.4311574562782017,0.8403643769185761
금리/NNG@$인하/NNG@$기조/NNG,-1,-0.32207476691300774,117,50,67,63,0.4204775507679954,0.819968816440529
기준금리/NNG@$올릴/VV@$전망/NNG,-1,-0.32261880678991806,50,21,29,47,0.3208493932928366,0.62644502887136
금리/NNG@$인상/NNG@$기조/NNG@$지속/NNG,-1,-0.32261880678991806,50,21,29,16,0.3208493932928366,0.62644502887136
원달러/NNG@$환율/NNG@$상승/NNG,-1,-0.32284832608502034,82,35,47,61,0.38909240258953925,0.7600759341688499
단기/NNG@$외화/NNG@$차입/NNG,-1,-0.32284832608502034,82,35,47,27,0.38909240258953925,0.7600759341688499
불안/NNG@$금리/NNG@$인상/NNG,-1,-0.3232188546411269,110,47,63,39,0.4159876597442527,0.8132871881543204
인플레이션/NNG@$경제/NNG@$성장/NNG,-1,-0.32436419741939293,96,41,55,34,0.4045453058600101,0.792942588748193
수출/NNG@$내수/NNG@$부진/NNG,0,-0.3253119856008274,25,10,15,32,0.23104644666710492,0.45383085242903753
경기/NNG@$활성화/NNG@$정책/NNG,0,-0.3253119856008274,25,10,15,28,0.23104644666710492,0.45383085242903753
시장/NNG@$예상치/NNG@$상회/NNG,0,-0.3253119856008274,25,10,15,38,0.23104644666710492,0.45383085242903753
영향/NNG@$금리/NNG@$인하/NNG,0,-0.3253119856008274,25,10,15,26,0.23104644666710492,0.45383085242903753
소매/NNG@$판매/NNG@$지표/NNG,0,-0.3253119856008274,25,10,15,42,0.23104644666710492,0.45383085242903753
서부텍사스산원유/NNG@$가격/NNG@$하락/NNG,0,-0.3253119856008274,25,10,15,27,0.23104644666710492,0.45383085242903753
상승/NNG@$종합/NNG@$지수/NNG@$오른/VV,0,-0.3253119856008274,25,10,15,45,0.23104644666710492,0.45383085242903753
지수/NNG@$오른/VV@$거래/NNG,0,-0.3253119856008274,25,10,15,27,0.23104644666710492,0.45383085242903753
회복세/NNG@$보일/VV@$예상/NNG,0,-0.3253119856008274,25,10,15,41,0.23104644666710492,0.45383085242903753
금융/NNG@$통화정책/NNG@$금리/NNG,0,-0.3253119856008274,25,10,15,31,0.23104644666710492,0.45383085242903753
금리/NNG@$상승/NNG@$제한/NNG,0,-0.3253119856008274,25,10,15,29,0.23104644666710492,0.45383085242903753
브렉시트/NNG@$국민/NNG@$투표/NNG,0,-0.3253119856008274,25,10,15,38,0.23104644666710492,0.45383085242903753
경제/NNG@$전망/NNG@$밝/VA,-1,-0.32540905484739024,41,17,24,25,0.2910649891597737,0.5718458403100536
완화/NNG@$정책/NNG@$시행/NNG,0,-0.3276009370640033,18,7,11,33,0.20063944196774225,0.39612828019937385
유로존/NNG@$경제/NNG@$성장/NNG,-1,-0.32823871346004285,73,31,42,103,0.3712956060833086,0.7341079329177964
금리/NNG@$인하/NNG@$유동성/NNG@$공급/NNG,-1,-0.3288947767479379,57,24,33,34,0.3365255314587767,0.6663413949792192
금리/NNG@$인상/NNG@$조치/NNG,-1,-0.3301367520139703,127,54,73,101,0.4184391243994313,0.8308467978585701
가계/NNG@$대출/NNG@$금리/NNG,-1,-0.33083637658492204,32,13,19,13,0.2562808835344812,0.5096674746905645
둔화/NNG@$수출/NNG@$부진/NNG,-1,-0.33083637658492204,32,13,19,19,0.2562808835344812,0.5096674746905645
하향/NNG@$조정/NNG@$불가피/XR,-1,-0.33083637658492204,32,13,19,27,0.2562808835344812,0.5096674746905645
금리/NNG@$결정/NNG@$경제/NNG,-1,-0.33083637658492204,32,13,19,26,0.2562808835344812,0.5096674746905645
실적/NNG@$시장/NNG@$예상/NNG,-1,-0.33083637658492204,32,13,19,19,0.2562808835344812,0.5096674746905645
경제/NNG@$하강/NNG@$리스크/NNG,-1,-0.33083637658492204,32,13,19,25,0.2562808835344812,0.5096674746905645
성장/NNG@$목표/NNG@$달성/NNG,-1,-0.33083637658492204,32,13,19,35,0.2562808835344812,0.5096674746905645
국가신용등급/NNG@$상향/NNG@$조정/NNG,-1,-0.33083637658492204,32,13,19,54,0.2562808835344812,0.5096674746905645
경제/NNG@$동향/NNG@$경기/NNG,-1,-0.33110852805846636,94,40,54,61,0.3980440133869407,0.7920766493361213
하방/NNG@$리스크/NNG@$확대/NNG,-1,-0.33271784691556294,48,20,28,25,0.30961514221222974,0.6183421392945047
상승/NNG@$압력/NNG@$낮/VA,-1,-0.33271784691556294,48,20,28,38,0.30961514221222974,0.6183421392945047
도시/NNG@$주택/NNG@$가격/NNG,-1,-0.33333764120783016,64,27,37,57,0.3504546358170284,0.7008802520483903
금리/NNG@$인하/NNG@$필요성/NNG,-1,-0.3373003953053033,161,68,93,147,0.41842598290887134,0.8443214561978183
중기적/NNG@$물가/NNG@$기조/NNG@$유지/NNG@$금융/NNG,-1,-0.3375661560765607,39,16,23,43,0.2783637020926276,0.5620335255026657
경제/NNG@$성장/NNG@$우려/NNG,-1,-0.3375661560765607,39,16,23,23,0.2783637020926276,0.5620335255026657
수당/NNG@$청구/NNG@$감소/NNG,-1,-0.3375661560765607,39,16,23,51,0.2783637020926276,0.5620335255026657
실업/NNG@$수당/NNG@$청구/NNG@$감소/NNG,-1,-0.3375661560765607,39,16,23,51,0.2783637020926276,0.5620335255026657
은행/NNG@$기준금리/NNG@$인하/NNG,-1,-0.3375661560765607,39,16,23,40,0.2783637020926276,0.5620335255026657
금리/NNG@$인상/NNG@$점쳤/VV,-1,-0.3375661560765607,39,16,23,30,0.2783637020926276,0.5620335255026657
장기/NNG@$국채/NNG@$금리/NNG,-1,-0.3382526023142015,55,23,32,34,0.32617952194222904,0.6595978798799302
상향/NNG@$조정/NNG@$가능성/NNG,-1,-0.33836015848657375,85,36,49,70,0.38307567405108356,0.7748410225670846
투자/NNG@$심리/NNG@$개선/NNG,-1,-0.34212458556558456,62,26,36,71,0.3409162951647572,0.6954609724853498
전망/NNG@$밝/VA@$않/VX,-1,-0.34353179052200933,46,19,27,38,0.2979938922469025,0.6098417009838227
美/NNG@$금리/NNG@$인상/NNG,-1,-0.3440150737682579,97,41,56,43,0.3921065834580682,0.8033222785237867
필요/NNG@$금리/NNG@$인상/NNG,-1,-0.3440150737682579,97,41,56,72,0.3921065834580682,0.8033222785237867
유지/NNG@$금리/NNG@$인하/NNG,-1,-0.344539040045751,69,29,40,40,0.3539692866125884,0.7260515315748693
원유/NNG@$가격/NNG@$상승/NNG,-1,-0.344539040045751,69,29,40,40,0.3539692866125884,0.7260515315748693
금리/NNG@$올리/VV@$경기/NNG,0,-0.3471647785283817,30,12,18,30,0.24151766078498219,0.498357173009197
금리/NNG@$인상/NNG@$가능성/NNG@$무게/NNG,0,-0.3471647785283817,30,12,18,26,0.24151766078498219,0.498357173009197
준비/NNG@$금리/NNG@$인상/NNG,0,-0.3471647785283817,30,12,18,39,0.24151766078498219,0.498357173009197
경기/NNG@$둔화/NNG@$국면/NNG,0,-0.3471647785283817,30,12,18,24,0.24151766078498219,0.498357173009197
금융/NNG@$위기/NNG@$우려/NNG,0,-0.34752497712720376,23,9,14,37,0.21390440539587696,0.44174053859290546
국채/NNG@$금리/NNG@$오른/VV,0,-0.34752497712720376,23,9,14,35,0.21390440539587696,0.44174053859290546
부동산/NNG@$거품/NNG@$붕괴/NNG,0,-0.34752497712720376,23,9,14,29,0.21390440539587696,0.44174053859290546
물가/NNG@$목표/NNG@$상한선/NNG,0,-0.34752497712720376,23,9,14,27,0.21390440539587696,0.44174053859290546
경제/NNG@$경기/NNG@$회복세/NNG,0,-0.34752497712720376,23,9,14,28,0.21390440539587696,0.44174053859290546
경제/NNG@$전망/NNG@$예상/NNG,0,-0.34752497712720376,23,9,14,26,0.21390440539587696,0.44174053859290546
자산/NNG@$매입/NNG@$규모/NNG@$유지/NNG,0,-0.34752497712720376,23,9,14,53,0.21390440539587696,0.44174053859290546
채권/NNG@$시장/NNG@$약세/NNG,-1,-0.34815175103150076,53,22,31,55,0.31549609303027387,0.6524702483012891
정책/NNG@$효과/NNG@$극대화/NNG,-1,-0.35093706166197014,37,15,22,32,0.26514385720774813,0.5518279378569936
내수/NNG@$부진/NNG@$수출/NNG,-1,-0.35093706166197014,37,15,22,32,0.26514385720774813,0.5518279378569936
경기/NNG@$부양/NNG@$규모/NNG,-1,-0.35093706166197014,37,15,22,24,0.26514385720774813,0.5518279378569936
중기적/NNG@$물가/NNG@$상승률/NNG@$목표/NNG,-1,-0.35093706166197014,37,15,22,25,0.26514385720774813,0.5518279378569936
물가/NNG@$상승률/NNG@$둔화/NNG,-1,-0.3511033283985592,95,40,55,103,0.38551155269599496,0.802646258258093
개선/NNG@$추세/NNG@$지속/NNG,-1,-0.3513435039730054,60,25,35,43,0.33107491127060473,0.6896853061423491
이상/NNG@$금리/NNG@$인하/NNG,-1,-0.3513435039730054,60,25,35,36,0.33107491127060473,0.6896853061423491
통화정책/NNG@$기준금리/NNG@$동결/NNG,-1,-0.3513435039730054,60,25,35,106,0.33107491127060473,0.6896853061423491
금리/NNG@$인하/NNG@$기대감/NNG,-1,-0.3521485293569865,220,92,128,202,0.408521691676871,0.8525848322049779
소비/NNG@$지출/NNG@$전망/NNG,-1,-0.3533497394381926,107,45,62,108,0.3930560739866258,0.8225614454128802
시중/NNG@$유동성/NNG@$공급/NNG,-1,-0.3539385315959126,74,31,43,66,0.35710761299262866,0.7483371936284032
기준금리/NNG@$인하/NNG@$예상/NNG,-1,-0.3570011618238307,112,47,65,101,0.3932752240277289,0.829925329412068
금융/NNG@$위기/NNG@$기준금리/NNG,-1,-0.35866046778293403,51,21,30,52,0.3044593922310229,0.6449474314494176
경기/NNG@$회복/NNG@$모멘텀/NNG,-1,-0.3601812113676016,105,44,61,107,0.38705390385158456,0.8227784163546016
시장/NNG@$예상/NNG@$웃돌/VV,-1,-0.3624828877912014,72,30,42,40,0.34847602364415875,0.7447032108387408
하방/NNG@$리스크/NNG@$높/VA,0,-0.3647265618523865,16,6,10,25,0.17862767856549444,0.3837110310695556
규모/NNG@$경기/NNG@$부양책/NNG,-1,-0.36512991502378245,127,53,74,72,0.39312216231153824,0.8452538071544001
모습/NNG@$보일/VV@$전망/NNG,-1,-0.3657839062716275,35,14,21,29,0.2513414179135243,0.5412265907198456
경기/NNG@$둔화/NNG@$금리/NNG@$인하/NNG,-1,-0.3657839062716275,35,14,21,23,0.2513414179135243,0.5412265907198456
급등/NNG@$소비자/NNG@$물가/NNG,-1,-0.3657839062716275,35,14,21,20,0.2513414179135243,0.5412265907198456
경기/NNG@$회복세/NNG@$지원/NNG,-1,-0.3657839062716275,35,14,21,11,0.2513414179135243,0.5412265907198456
경기/NNG@$둔화/NNG@$심화/NNG,-1,-0.3657839062716275,35,14,21,23,0.2513414179135243,0.5412265907198456
하락/NNG@$환율/NNG@$상승/NNG,-1,-0.3657839062716275,35,14,21,30,0.2513414179135243,0.5412265907198456
채권/NNG@$금리/NNG@$하락/NNG,-1,-0.36597877719801175,91,38,53,66,0.3717043038728302,0.8007704384001497
금융시장/NNG@$불안/NNG@$해소/NNG,0,-0.36603479259741223,28,11,17,23,0.2258860022581064,0.4866939288578258
회복/NNG@$지연/NNG@$우려/NNG,0,-0.36603479259741223,28,11,17,24,0.2258860022581064,0.4866939288578258
가격/NNG@$낮/VA@$진/VX,0,-0.36603479259741223,28,11,17,24,0.2258860022581064,0.4866939288578258
상승/NNG@$물가/NNG@$불안/NNG,0,-0.36603479259741223,28,11,17,26,0.2258860022581064,0.4866939288578258
산업/NNG@$생산/NNG@$증가/NNG,-1,-0.3667181425426993,149,62,87,181,0.39571586943386855,0.8539559924429965
유로존/NNG@$소비자/NNG@$물가/NNG,-1,-0.36778202882855604,42,17,25,52,0.2734774595026029,0.5916180967077873
은행/NNG@$주택/NNG@$담보대출/NNG,-1,-0.36778202882855604,42,17,25,18,0.2734774595026029,0.5916180967077873
공격적/NNG@$통화/NNG@$완화/NNG,-1,-0.36778202882855604,42,17,25,26,0.2734774595026029,0.5916180967077873
통화정책/NNG@$금리/NNG@$동결/NNG,-1,-0.36778202882855604,42,17,25,38,0.2734774595026029,0.5916180967077873
종합/NNG@$지수/NNG@$상승/NNG,-1,-0.36778202882855604,42,17,25,47,0.2734774595026029,0.5916180967077873
예금금리/NNG@$한계/NNG@$대출/NNG,-1,-0.36778202882855604,42,17,25,29,0.2734774595026029,0.5916180967077873
변동성/NNG@$심한/VA@$에너지/NNG,-1,-0.36986100403655053,49,20,29,27,0.293050631936432,0.6370186803065034
물가/NNG@$상승률/NNG@$크/VA,-1,-0.36986100403655053,49,20,29,40,0.293050631936432,0.6370186803065034
기준금리/NNG@$하향/NNG@$조정/NNG,-1,-0.3706250386732497,96,40,56,54,0.3732220024145383,0.8127287353674078
인하/NNG@$가능성/NNG@$크/VA,-1,-0.3706250386732497,96,40,56,94,0.3732220024145383,0.8127287353674078
금리/NNG@$인하/NNG@$여지/NNG,-1,-0.371380953734184,70,29,41,39,0.3395775522566599,0.7407617460905158
인하/NNG@$가능성/NNG@$있/VA,-1,-0.37176701818634217,63,26,37,45,0.325885866203126,0.7115313692454045
채권/NNG@$시장/NNG@$우호적/NNG,-1,-0.37176701818634217,63,26,37,47,0.325885866203126,0.7115313692454045
취업/NNG@$기회/NNG@$전망/NNG,-1,-0.37176701818634217,63,26,37,54,0.325885866203126,0.7115313692454045
상품/NNG@$가격/NNG@$상승/NNG,-1,-0.3737881705552929,89,37,52,82,0.364483021896116,0.7995474148671037
불안/NNG@$심리/NNG@$완화/NNG,0,-0.3750010361879146,21,8,13,17,0.1951781514209626,0.4293614516380272
수요/NNG@$압력/NNG@$완화/NNG,0,-0.3750010361879146,21,8,13,26,0.1951781514209626,0.4293614516380272
순이익/NNG@$주당/NNG@$기록/NNG,0,-0.3750010361879146,21,8,13,63,0.1951781514209626,0.4293614516380272
시차/NNG@$소비자/NNG@$물가/NNG,0,-0.3750010361879146,21,8,13,25,0.1951781514209626,0.4293614516380272
물가/NNG@$기조/NNG@$유지/NNG@$금융/NNG@$유의/NNG,-1,-0.381534154026432,40,16,24,43,0.26050853271339036,0.5818812827814548
증시/NNG@$사상/NNG@$최고치/NNG,-1,-0.381534154026432,40,16,24,23,0.26050853271339036,0.5818812827814548
유지/NNG@$금융/NNG@$유의/NNG@$통화정책/NNG,-1,-0.381534154026432,40,16,24,40,0.26050853271339036,0.5818812827814548
경제/NNG@$나쁘/VA@$않/VX,-1,-0.381534154026432,40,16,24,13,0.26050853271339036,0.5818812827814548
금리/NNG@$인상/NNG@$생각/NNG,-1,-0.381534154026432,40,16,24,25,0.26050853271339036,0.5818812827814548
리스크/NNG@$금리/NNG@$인상/NNG,-1,-0.381534154026432,40,16,24,18,0.26050853271339036,0.5818812827814548
대응/NNG@$금리/NNG@$인하/NNG,-1,-0.381534154026432,40,16,24,26,0.26050853271339036,0.5818812827814548
기조/NNG@$유지/NNG@$금융/NNG@$유의/NNG@$통화정책/NNG,-1,-0.381534154026432,40,16,24,40,0.26050853271339036,0.5818812827814548
실업/NNG@$보험/NNG@$청구자/NNG,-1,-0.381534154026432,40,16,24,18,0.26050853271339036,0.5818812827814548
시장/NNG@$예상/NNG@$금리/NNG@$인상/NNG,-1,-0.381534154026432,40,16,24,29,0.26050853271339036,0.5818812827814548
기준금리/NNG@$올릴/VV@$가능성/NNG,-1,-0.38171961817846967,61,25,36,56,0.3159330178499253,0.7059857872686037
회복/NNG@$국면/NNG@$진입/NNG,-1,-0.38171961817846967,61,25,36,49,0.3159330178499253,0.7059857872686037
식료품/NNG@$가격/NNG@$상승/NNG,-1,-0.38185327167000527,47,19,28,27,0.2812473412058953,0.6286736145972687
금리/NNG@$인상/NNG@$여파/NNG,-1,-0.38185327167000527,47,19,28,32,0.2812473412058953,0.6286736145972687
경제/NNG@$둔화/NNG@$가능성/NNG,-1,-0.3820749015853182,54,22,32,55,0.299619899476701,0.6700894744074111
물가/NNG@$상승률/NNG@$기준치/NNG,-1,-0.3824510025170572,33,13,20,27,0.23687403488505207,0.5302273059754856
지수/NNG@$사상/NNG@$최고치/NNG,-1,-0.3824510025170572,33,13,20,35,0.23687403488505207,0.5302273059754856
인하/NNG@$가능성/NNG@$없/VA,-1,-0.3824510025170572,33,13,20,23,0.23687403488505207,0.5302273059754856
지수/NNG@$최고치/NNG@$기록/NNG,-1,-0.3824510025170572,33,13,20,28,0.23687403488505207,0.5302273059754856
금리/NNG@$인하/NNG@$추경/NNG,-1,-0.3824510025170572,33,13,20,33,0.23687403488505207,0.5302273059754856
종합/NNG@$지수/NNG@$내린/VV,-1,-0.3824510025170572,33,13,20,27,0.23687403488505207,0.5302273059754856
시장/NNG@$예상/NNG@$뛰어넘/VV,-1,-0.3824510025170572,33,13,20,49,0.23687403488505207,0.5302273059754856
인하/NNG@$효과/NNG@$지켜보/VV,-1,-0.3824510025170572,33,13,20,28,0.23687403488505207,0.5302273059754856
단기적/NNG@$경기/NNG@$부양/NNG,-1,-0.3824510025170572,33,13,20,30,0.23687403488505207,0.5302273059754856
인상/NNG@$성장/NNG@$둔화/NNG,-1,-0.3824510025170572,33,13,20,18,0.23687403488505207,0.5302273059754856
경제/NNG@$전망/NNG@$영향/NNG,-1,-0.3824510025170572,33,13,20,38,0.23687403488505207,0.5302273059754856
금리/NNG@$인상/NNG@$논의/NNG,-1,-0.38513391194388136,80,33,47,71,0.3464762429205773,0.7804594188666644
예상/NNG@$금리/NNG@$인하/NNG,-1,-0.3852975273615783,153,63,90,90,0.3824176911278091,0.8617507641007124
금리/NNG@$정상화/NNG@$속도/NNG,0,-0.38823344415730054,26,10,16,44,0.20919794999133096,0.4746779638541889
예상/NNG@$벗어나/VV@$않/VX,0,-0.38823344415730054,26,10,16,30,0.20919794999133096,0.4746779638541889
상승률/NNG@$높/VA@$예상/NNG,0,-0.38823344415730054,26,10,16,17,0.20919794999133096,0.4746779638541889
산업/NNG@$생산/NNG@$소매/NNG@$판매/NNG,0,-0.38823344415730054,26,10,16,29,0.20919794999133096,0.4746779638541889
사상/NNG@$최저/NNG@$동결/NNG,0,-0.38823344415730054,26,10,16,33,0.20919794999133096,0.4746779638541889
내수/NNG@$경기/NNG@$부양/NNG,0,-0.38823344415730054,26,10,16,32,0.20919794999133096,0.4746779638541889
시장/NNG@$금리/NNG@$정책금리/NNG,0,-0.38823344415730054,26,10,16,20,0.20919794999133096,0.4746779638541889
경제/NNG@$성장/NNG@$도움/NNG,0,-0.38823344415730054,26,10,16,27,0.20919794999133096,0.4746779638541889
채권/NNG@$딜러/NNG@$시장/NNG,0,-0.38823344415730054,26,10,16,30,0.20919794999133096,0.4746779638541889
금리/NNG@$상향/NNG@$조정/NNG,0,-0.38823344415730054,26,10,16,25,0.20919794999133096,0.4746779638541889
인상/NNG@$금리/NNG@$인하/NNG,-1,-0.39218334910020236,59,24,35,33,0.3056678773771827,0.7000636541224344
기준금리/NNG@$인하/NNG@$효과/NNG,-1,-0.3925023863923528,102,42,60,126,0.36285979794634754,0.8316757406315884
기준금리/NNG@$인상/NNG@$경제/NNG,-1,-0.39399173131227216,78,32,46,69,0.3381844702717265,0.7778551669767524
기준금리/NNG@$동결/NNG@$결정/NNG,-1,-0.39430751305611356,176,72,104,199,0.376798684342602,0.8673195015875714
시장/NNG@$금리/NNG@$기준금리/NNG,-1,-0.39475960627431617,45,18,27,35,0.26902245168514366,0.6199022623254246
제기/NNG@$금리/NNG@$인상/NNG,-1,-0.39475960627431617,45,18,27,36,0.26902245168514366,0.6199022623254246
문제/NNG@$금리/NNG@$인하/NNG,-1,-0.3966526731128158,38,15,23,21,0.24700131652110266,0.5717195616533297
가계/NNG@$소비/NNG@$심리/NNG,-1,-0.3966526731128158,38,15,23,50,0.24700131652110266,0.5717195616533297
제품/NNG@$가격/NNG@$인상/NNG,-1,-0.3966526731128158,38,15,23,24,0.24700131652110266,0.5717195616533297
인상/NNG@$가능/NNG@$전망/NNG,-1,-0.3966526731128158,38,15,23,29,0.24700131652110266,0.5717195616533297
경제/NNG@$발목/NNG@$잡/VV,-1,-0.3974329608137759,71,29,42,71,0.3255143145299024,0.7548458371326285
통화정책/NNG@$기준금리/NNG@$인하/NNG,-1,-0.3974329608137759,71,29,42,70,0.3255143145299024,0.7548458371326285
둔화/NNG@$금리/NNG@$인하/NNG,-1,-0.4002632901355695,100,41,59,67,0.3562319901625527,0.8316561982813605
경제/NNG@$성장/NNG@$제약/NNG,-1,-0.40139672870131315,31,12,19,24,0.22163571058202733,0.518827874441034
성장률/NNG@$전망/NNG@$낮/VA,-1,-0.40139672870131315,31,12,19,24,0.22163571058202733,0.518827874441034
기준금리/NNG@$상향/NNG@$조정/NNG@$가능성/NNG,-1,-0.40139672870131315,31,12,19,24,0.22163571058202733,0.518827874441034
고용/NNG@$지표/NNG@$악화/NNG,-1,-0.40139672870131315,31,12,19,34,0.22163571058202733,0.518827874441034
인상/NNG@$가능성/NNG@$강하/VA@$시사/NNG,-1,-0.40139672870131315,31,12,19,32,0.22163571058202733,0.518827874441034
경제/NNG@$침체/NNG@$빠지/VV,-1,-0.40139672870131315,31,12,19,32,0.22163571058202733,0.518827874441034
고려/NNG@$기준금리/NNG@$인하/NNG,-1,-0.40139672870131315,31,12,19,37,0.22163571058202733,0.518827874441034
부동산/NNG@$중개인/NNG@$주택/NNG,-1,-0.40139672870131315,31,12,19,35,0.22163571058202733,0.518827874441034
대출/NNG@$금리/NNG@$예금금리/NNG,-1,-0.40139672870131315,31,12,19,24,0.22163571058202733,0.518827874441034
해외/NNG@$경제/NNG@$포커스/NNG,-1,-0.4031877777303431,76,31,45,42,0.32964589758752355,0.7749734978289918
기준금리/NNG@$무담보/NNG@$콜론/NNG,-1,-0.4032130687328004,57,23,34,53,0.2950787651758464,0.6937505789045195
인상/NNG@$소수/NNG@$의견/NNG,-1,-0.4057771209246879,50,20,30,63,0.2768966856640906,0.6550060055722187
달러/NNG@$엔/NNG@$환율/NNG,-1,-0.4057771209246879,50,20,30,43,0.2768966856640906,0.6550060055722187
자산운용사/NNG@$채권/NNG@$딜러/NNG,-1,-0.4057771209246879,50,20,30,48,0.2768966856640906,0.6550060055722187
하락/NNG@$소비자/NNG@$물가/NNG,-1,-0.4057771209246879,50,20,30,43,0.2768966856640906,0.6550060055722187
위기/NNG@$이전/NNG@$회복/NNG,-1,-0.4057771209246879,50,20,30,61,0.2768966856640906,0.6550060055722187
민간/NNG@$소비/NNG@$부진/NNG,-1,-0.4057771209246879,50,20,30,40,0.2768966856640906,0.6550060055722187
금리/NNG@$인하/NNG@$시작/NNG,-1,-0.40727500728282107,69,28,41,24,0.31626188430119834,0.7508144518548512
결정/NNG@$열/VV@$기준금리/NNG,-1,-0.4087310087047691,43,17,26,22,0.2563431978940521,0.6106950847195849
금융/NNG@$규제/NNG@$개혁/NNG,0,-0.41004112359949396,19,7,12,35,0.17435696783843294,0.4166857616439296
소비자/NNG@$물가/NNG@$반영/NNG,0,-0.41004112359949396,19,7,12,25,0.17435696783843294,0.4166857616439296
가격/NNG@$상승/NNG@$주택/NNG,0,-0.41004112359949396,19,7,12,24,0.17435696783843294,0.4166857616439296
금리/NNG@$인하/NNG@$예상/NNG,-1,-0.41011680446015497,190,77,113,142,0.36541973976253894,0.873454651164108
외국인/NNG@$자금/NNG@$유출/NNG,-1,-0.4127450501991735,74,30,44,94,0.32085497309085315,0.7717994913396683
인상/NNG@$달러/NNG@$강세/NNG,-1,-0.4127450501991735,74,30,44,51,0.32085497309085315,0.7717994913396683
성장률/NNG@$전망치/NNG@$하향/NNG@$조정/NNG,-1,-0.41315430494201244,118,48,70,138,0.356219799777398,0.8577134391883104
가능성/NNG@$크/VA@$금리/NNG,-1,-0.41342355139637366,36,14,22,32,0.23289236657648535,0.5611272783713845
유로화/NNG@$사용/NNG@$경제/NNG,-1,-0.41342355139637366,36,14,22,42,0.23289236657648535,0.5611272783713845
금융/NNG@$위기/NNG@$극복/NNG,-1,-0.4141201692900325,148,60,88,121,0.3610253238797811,0.8713119646996242
소비자/NNG@$물가/NNG@$근원물가/NNG,0,-0.4148834298409646,24,9,15,21,0.19120276299379496,0.46230699821372284
양적완화/NNG@$정책/NNG@$유지/NNG,0,-0.4148834298409646,24,9,15,32,0.19120276299379496,0.46230699821372284
경기동행지수/NNG@$순환/NNG@$변동/NNG,0,-0.4148834298409646,24,9,15,26,0.19120276299379496,0.46230699821372284
양적완화/NNG@$규모/NNG@$줄이/VV,0,-0.41693537215727605,14,5,9,43,0.1527019932981986,0.37105266031255846
지속/NNG@$경기/NNG@$회복/NNG,-1,-0.4170988982301761,79,32,47,40,0.32501560836598975,0.7900725175800682
전격적/NNG@$금리/NNG@$인하/NNG,-1,-0.4175504449889924,67,27,40,55,0.3067325984591108,0.7464444129980924
경기/NNG@$살아나/VV@$않/VX,-1,-0.41885996056073693,48,19,29,31,0.26495259314384473,0.6468206751504674
금리/NNG@$인하/NNG@$부작용/NNG,-1,-0.41885996056073693,48,19,29,42,0.26495259314384473,0.6468206751504674
국채/NNG@$매입/NNG@$규모/NNG,-1,-0.42050352515581,84,34,50,83,0.32877296927612093,0.8058313624610967
통화정책/NNG@$기조/NNG@$경기/NNG,-1,-0.42323938843307507,29,11,18,24,0.20549046658920142,0.5070255534868304
외환/NNG@$위기/NNG@$겪/VV,-1,-0.42323938843307507,29,11,18,27,0.20549046658920142,0.5070255534868304
인하/NNG@$효과/NNG@$나타나/VV,-1,-0.42323938843307507,29,11,18,24,0.20549046658920142,0.5070255534868304
자본/NNG@$유출/NNG@$막/VV,-1,-0.42323938843307507,29,11,18,23,0.20549046658920142,0.5070255534868304
원달러/NNG@$환율/NNG@$하락/NNG,-1,-0.42323938843307507,29,11,18,42,0.20549046658920142,0.5070255534868304
인하/NNG@$단행/NNG@$않/VX,-1,-0.42323938843307507,29,11,18,23,0.20549046658920142,0.5070255534868304
적자/NNG@$국채/NNG@$발행/NNG,-1,-0.42323938843307507,29,11,18,33,0.20549046658920142,0.5070255534868304
금리/NNG@$변동성/NNG@$확대/NNG,-1,-0.42323938843307507,29,11,18,18,0.20549046658920142,0.5070255534868304
우려/NNG@$금리/NNG@$인하/NNG,-1,-0.4251649101565108,159,64,95,107,0.3537059826145567,0.8768383644158468
유럽연합/NNG@$탈퇴/NNG@$브렉시트/NNG,-1,-0.42673301876284153,77,31,46,106,0.31641679867443745,0.7874086444074129
정책금리/NNG@$인하/NNG@$가능성/NNG,-1,-0.42724058197601633,53,21,32,29,0.2728736323117431,0.6798940531070757
자본/NNG@$유출/NNG@$가능성/NNG,-1,-0.4272868351758481,104,42,62,86,0.34033994759267766,0.8480895903281086
경제/NNG@$부정적/NNG@$영향/NNG,-1,-0.428155395004708,212,85,127,194,0.3523953532015344,0.8799988080060807
금리/NNG@$인하/NNG@$압력/NNG,-1,-0.42984339744126454,82,33,49,72,0.32059635169546197,0.80390902527672
완화/NNG@$정책/NNG@$펴/VV,-1,-0.43221693348759826,34,13,21,16,0.2181027424318808,0.5500989978208819
지수/NNG@$상승/NNG@$마감/NNG,-1,-0.43221693348759826,34,13,21,19,0.2181027424318808,0.5500989978208819
증권/NNG@$금리/NNG@$인하/NNG,-1,-0.43221693348759826,34,13,21,27,0.2181027424318808,0.5500989978208819
인상/NNG@$단행/NNG@$가능성/NNG@$높/VA,-1,-0.43221693348759826,34,13,21,22,0.2181027424318808,0.5500989978208819
경제/NNG@$영향/NNG@$크/VA@$않/VX,-1,-0.43221693348759826,34,13,21,26,0.2181027424318808,0.5500989978208819
은행권/NNG@$가계/NNG@$대출/NNG,-1,-0.43221693348759826,34,13,21,28,0.2181027424318808,0.5500989978208819
경제/NNG@$전망/NNG@$내놓/VV,-1,-0.43221693348759826,34,13,21,35,0.2181027424318808,0.5500989978208819
의존도/NNG@$높/VA@$경제/NNG,-1,-0.4329277987794742,46,18,28,38,0.2525869860565471,0.6381901305612148
기준금리/NNG@$인하/NNG@$필요성/NNG,-1,-0.4329277987794742,46,18,28,63,0.2525869860565471,0.6381901305612148
외국인/NNG@$자본/NNG@$유출/NNG,-1,-0.4329277987794742,46,18,28,30,0.2525869860565471,0.6381901305612148
경제/NNG@$차지/NNG@$소비/NNG,-1,-0.4329277987794742,46,18,28,36,0.2525869860565471,0.6381901305612148
시장/NNG@$투자/NNG@$심리/NNG,-1,-0.4329277987794742,46,18,28,31,0.2525869860565471,0.6381901305612148
금융/NNG@$위기/NNG@$충격/NNG,-1,-0.4329277987794742,46,18,28,32,0.2525869860565471,0.6381901305612148
금리/NNG@$인하/NNG@$고려/NNG,-1,-0.4340753400767001,58,23,35,59,0.28014712951859994,0.7098267655250821
기업/NNG@$신뢰/NNG@$지수/NNG,-1,-0.4404057419568965,51,20,31,75,0.26122495076187036,0.6723220049520195
원유/NNG@$재고/NNG@$감소/NNG,-1,-0.4406681880331237,39,15,24,38,0.2294541550264253,0.5909372596366211
변동성/NNG@$음식/NNG@$에너지/NNG,-1,-0.4406681880331237,39,15,24,16,0.2294541550264253,0.5909372596366211
외국인/NNG@$주식/NNG@$투자/NNG@$자금/NNG,-1,-0.4406681880331237,39,15,24,26,0.2294541550264253,0.5909372596366211
전망/NNG@$소비/NNG@$지출/NNG,-1,-0.4406681880331237,39,15,24,34,0.2294541550264253,0.5909372596366211
장단기/NNG@$금리/NNG@$스프레드/NNG,-1,-0.4406681880331237,39,15,24,19,0.2294541550264253,0.5909372596366211
달성/NNG@$쉽/VA@$않/VX,-1,-0.4406681880331237,39,15,24,33,0.2294541550264253,0.5909372596366211
단행/NNG@$금리/NNG@$인하/NNG,-1,-0.44288542514759266,90,36,54,48,0.32017101344897475,0.8291244290418063
경제/NNG@$둔화/NNG@$우려/NNG,-1,-0.4465093466352611,56,22,34,54,0.2691464988898964,0.7033136216676068
금리/NNG@$인상/NNG@$준비/NNG,-1,-0.4465093466352611,56,22,34,53,0.2691464988898964,0.7033136216676068
상품/NNG@$수지/NNG@$흑자/NNG,-1,-0.4471456352045461,73,29,44,45,0.29847446182885484,0.7811920826325538
금리/NNG@$인상/NNG@$기조/NNG@$유지/NNG,-1,-0.4471456352045461,73,29,44,40,0.29847446182885484,0.7811920826325538
양적완화/NNG@$규모/NNG@$확대/NNG,0,-0.44761152378328817,22,8,14,49,0.1715715128544585,0.449574456269193
인상/NNG@$속도/NNG@$조절/NNG,0,-0.44761152378328817,22,8,14,34,0.1715715128544585,0.449574456269193
전미/NNG@$주택/NNG@$건설업/NNG,-1,-0.4481377466298887,44,17,27,46,0.23976924516549888,0.6291026779006299
영향/NNG@$가능성/NNG@$상존/NNG,-1,-0.4481377466298887,44,17,27,42,0.23976924516549888,0.6291026779006299
경기/NNG@$부양/NNG@$필요성/NNG,-1,-0.4481377466298887,44,17,27,59,0.23976924516549888,0.6291026779006299
공개/NNG@$기준금리/NNG@$인상/NNG,0,-0.44882276450063163,27,10,17,27,0.18826577562875946,0.49481635235540655
하방/NNG@$위험/NNG@$높/VA,0,-0.44882276450063163,27,10,17,26,0.18826577562875946,0.49481635235540655
인상/NNG@$물가/NNG@$상승률/NNG,0,-0.44882276450063163,27,10,17,28,0.18826577562875946,0.49481635235540655
금리/NNG@$인하/NNG@$신중/NNG,0,-0.44882276450063163,27,10,17,30,0.18826577562875946,0.49481635235540655
소비자/NNG@$물가/NNG@$오름세/NNG,0,-0.44882276450063163,27,10,17,27,0.18826577562875946,0.49481635235540655
경기/NNG@$부양책/NNG@$효과/NNG,-1,-0.45122200893137443,83,33,50,55,0.3081599477122956,0.8148193714317485
금리/NNG@$인상/NNG@$출구전략/NNG,-1,-0.45275905332108435,93,37,56,90,0.3161499306020627,0.8391809798418001
기준금리/NNG@$인하/NNG@$가능성/NNG@$높/VA,-1,-0.4535161813729782,32,12,20,20,0.20253498223913685,0.538629239560416
유동성/NNG@$공급/NNG@$정책/NNG,-1,-0.4535161813729782,32,12,20,42,0.20253498223913685,0.538629239560416
금리/NNG@$격차/NNG@$확대/NNG,-1,-0.4535161813729782,32,12,20,21,0.20253498223913685,0.538629239560416
금리/NNG@$인상/NNG@$멈출/VV,-1,-0.4535161813729782,32,12,20,18,0.20253498223913685,0.538629239560416
경제/NNG@$성장/NNG@$영향/NNG,-1,-0.45447763251898066,49,19,30,27,0.24918620758515764,0.6643019380918378
전망/NNG@$성장/NNG@$경로/NNG,-1,-0.45447763251898066,49,19,30,40,0.24918620758515764,0.6643019380918378
접근/NNG@$필요/NNG@$있/VA,0,-0.45627647030773133,17,6,11,26,0.15074374763953394,0.4036932794585307
순환/NNG@$변동/NNG@$하락/NNG,0,-0.45627647030773133,17,6,11,31,0.15074374763953394,0.4036932794585307
제조업/NNG@$지수/NNG@$예상/NNG,0,-0.45627647030773133,17,6,11,35,0.15074374763953394,0.4036932794585307
경제성장률/NNG@$물가/NNG@$상승률/NNG,-1,-0.45797913641189103,71,28,43,54,0.28912053879241306,0.777607166665245
둔화/NNG@$모습/NNG@$보이/VV,-1,-0.4591668995126872,37,14,23,22,0.21513807864896609,0.5803695844278193
국제금융시장/NNG@$불안/NNG@$경제/NNG,-1,-0.4591668995126872,37,14,23,12,0.21513807864896609,0.5803695844278193
외환/NNG@$위기/NNG@$발생/NNG,-1,-0.4591668995126872,37,14,23,31,0.21513807864896609,0.5803695844278193
물가/NNG@$상승/NNG@$부담/NNG,-1,-0.4591668995126872,37,14,23,27,0.21513807864896609,0.5803695844278193
구조/NNG@$개혁/NNG@$필요/NNG,-1,-0.4591668995126872,37,14,23,31,0.21513807864896609,0.5803695844278193
콜금리/NNG@$인하/NNG@$가능성/NNG,-1,-0.45968403527456025,54,21,33,24,0.2578007132656709,0.6963709927563145
변화/NNG@$해외/NNG@$위험/NNG@$요인/NNG,-1,-0.45968403527456025,54,21,33,37,0.2578007132656709,0.6963709927563145
금리/NNG@$상승/NNG@$가계/NNG,-1,-0.45968403527456025,54,21,33,39,0.2578007132656709,0.6963709927563145
금리/NNG@$인하/NNG@$카드/NNG,-1,-0.4613758153026899,129,51,78,112,0.32502011369033934,0.8817212342334388
예상/NNG@$금리/NNG@$동결/NNG,-1,-0.4638209960351063,59,23,36,55,0.26568605085787045,0.725255758726793
하향/NNG@$조정/NNG@$경기/NNG,-1,-0.46468289906206706,42,16,26,37,0.22646326051756904,0.6195469939191033
걱정/NNG@$필요/NNG@$없/VA,-1,-0.46468289906206706,42,16,26,25,0.22646326051756904,0.6195469939191033
상품/NNG@$가격/NNG@$하락/NNG,-1,-0.46623831752455935,114,45,69,57,0.31803214147694725,0.8735177212377206
부진/NNG@$모습/NNG@$보이/VV,-1,-0.46698252340955315,64,25,39,72,0.27290290191260247,0.7509913844214654
인프라/NNG@$투자/NNG@$확대/NNG,-1,-0.46958706230775127,47,18,29,23,0.23673415878330847,0.6558199989253963
자산/NNG@$시장/NNG@$거품/NNG,-1,-0.46958706230775127,47,18,29,30,0.23673415878330847,0.6558199989253963
금리/NNG@$인하/NNG@$전망/NNG,-1,-0.4698231224528223,230,90,140,169,0.3223706418538395,0.8935980683328523
금리/NNG@$인하/NNG@$시장/NNG,-1,-0.470771262852431,122,48,74,82,0.3170967678374564,0.881121275192624
은행/NNG@$금리/NNG@$인하/NNG,-1,-0.4707985745691834,74,29,45,31,0.2855378673492415,0.7934837793253039
재정/NNG@$건전성/NNG@$악화/NNG,-1,-0.47369113428189025,52,20,32,40,0.24609431261946726,0.6889831780121326
대외/NNG@$위험/NNG@$요인/NNG,-1,-0.47369113428189025,52,20,32,54,0.24609431261946726,0.6889831780121326
금리/NNG@$상승/NNG@$가능성/NNG,-1,-0.47369113428189025,52,20,32,32,0.24609431261946726,0.6889831780121326
가능성/NNG@$높/VA@$내/VX,-1,-0.4779567231274463,30,11,19,20,0.18607077099218966,0.5267121021410922
상승/NNG@$금리/NNG@$인하/NNG,-1,-0.4779567231274463,30,11,19,29,0.18607077099218966,0.5267121021410922
약세/NNG@$원화/NNG@$강세/NNG,-1,-0.4779567231274463,30,11,19,26,0.18607077099218966,0.5267121021410922
인하/NNG@$필요성/NNG@$제기/NNG,-1,-0.4779567231274463,30,11,19,20,0.18607077099218966,0.5267121021410922
은행/NNG@$금리/NNG@$인상/NNG@$단행/NNG,-1,-0.4779567231274463,30,11,19,24,0.18607077099218966,0.5267121021410922
유로화/NNG@$달러화/NNG@$유로당/NNG,-1,-0.4779567231274463,30,11,19,23,0.18607077099218966,0.5267121021410922
전미/NNG@$부동산/NNG@$중개인/NNG@$주택/NNG,0,-0.4793072345915659,25,9,16,28,0.169748328439512,0.4821940532604586
정책금리/NNG@$인상/NNG@$기대/NNG,0,-0.4793072345915659,25,9,16,15,0.169748328439512,0.4821940532604586
국면/NNG@$진입/NNG@$가능성/NNG,0,-0.4793072345915659,25,9,16,18,0.169748328439512,0.4821940532604586
거시/NNG@$금융/NNG@$경제/NNG,0,-0.4793072345915659,25,9,16,27,0.169748328439512,0.4821940532604586
기준금리/NNG@$인하/NNG@$통화/NNG@$완화/NNG,0,-0.4793072345915659,25,9,16,32,0.169748328439512,0.4821940532604586
소비자/NNG@$물가/NNG@$동향/NNG,-1,-0.47938726390673525,62,24,38,38,0.26246577110564273,0.7457259258504129
금리/NNG@$경기/NNG@$부양/NNG,-1,-0.47982903813847066,35,13,22,27,0.2001523546940314,0.5693318582082202
상승/NNG@$원화/NNG@$가치/NNG,-1,-0.47982903813847066,35,13,22,20,0.2001523546940314,0.5693318582082202
우려/NNG@$필요/NNG@$없/VA,-1,-0.47982903813847066,35,13,22,46,0.2001523546940314,0.5693318582082202
은행/NNG@$마이너스금리/NNG@$도입/NNG,-1,-0.47982903813847066,35,13,22,19,0.2001523546940314,0.5693318582082202
긍정적/NNG@$영향/NNG@$미쳤/VV,-1,-0.47982903813847066,35,13,22,29,0.2001523546940314,0.5693318582082202
수요/NNG@$상승/NNG@$압력/NNG,-1,-0.47982903813847066,35,13,22,29,0.2001523546940314,0.5693318582082202
물가/NNG@$상승/NNG@$압력/NNG@$낮/VA,-1,-0.4828016933785243,40,15,25,28,0.21262678739420723,0.609512137842751
금융시장/NNG@$영향/NNG@$제한적/NNG,-1,-0.4828016933785243,40,15,25,16,0.21262678739420723,0.609512137842751
문제/NNG@$해결/NNG@$않/VX,-1,-0.4828016933785243,40,15,25,41,0.21262678739420723,0.609512137842751
실물경제/NNG@$부정적/NNG@$영향/NNG,-1,-0.48863925825477206,50,19,31,24,0.23400994243785908,0.6811345751532868
금리/NNG@$인하/NNG@$양적완화/NNG,-1,-0.48863925825477206,50,19,31,32,0.23400994243785908,0.6811345751532868
관심/NNG@$가질/VV@$필요/NNG@$있/VA,0,-0.4887917897404185,20,7,13,16,0.14989210448878798,0.43646697067904394
주택/NNG@$경기/NNG@$회복/NNG,0,-0.4887917897404185,20,7,13,37,0.14989210448878798,0.43646697067904394
물가/NNG@$목표/NNG@$하한/NNG,0,-0.4887917897404185,20,7,13,20,0.14989210448878798,0.43646697067904394
효과/NNG@$크/VA@$않/VX,-1,-0.489766662216217,126,49,77,154,0.30474771805117384,0.8896640648944162
가능성/NNG@$금리/NNG@$인하/NNG,-1,-0.49069401095297316,90,35,55,53,0.28929748089327206,0.8466233469334408
지속/NNG@$가능성/NNG@$크/VA,-1,-0.49084091768635785,55,21,34,50,0.24327131080662787,0.7122041852679809
경제성장률/NNG@$전망/NNG@$하향/NNG@$조정/NNG,-1,-0.493785271946769,70,27,43,57,0.2665368078001141,0.7864035099763963
물가/NNG@$안정세/NNG@$지속/NNG,0,-0.4944251300607718,12,4,8,21,0.12116063028102378,0.35808394643555297
경제/NNG@$경제정책/NNG@$방향/NNG,0,-0.4944251300607718,12,4,8,42,0.12116063028102378,0.35808394643555297
주가/NNG@$하락/NNG@$환율/NNG,0,-0.4944251300607718,12,4,8,27,0.12116063028102378,0.35808394643555297
인하/NNG@$가능성/NNG@$낮/VA,-1,-0.49670494114952723,98,38,60,70,0.29062814120306235,0.8641419349000599
국채/NNG@$매입/NNG@$양적완화/NNG,-1,-0.5027894498226189,38,14,24,31,0.19821117458592472,0.5989875441329395
회복/NNG@$속도/NNG@$빠르/VA,-1,-0.5031353627022848,33,12,21,29,0.18441628856666642,0.5578160656579972
금리/NNG@$인하/NNG@$나설/VV@$가능성/NNG,-1,-0.5035833360174669,43,16,27,29,0.21047989309698326,0.6374165742844563
경제/NNG@$기준금리/NNG@$인하/NNG,-1,-0.5035833360174669,43,16,27,30,0.21047989309698326,0.6374165742844563
정책/NNG@$목표/NNG@$달성/NNG,-1,-0.5046573651421246,48,18,30,36,0.22152826912771623,0.6728097559020779
조치/NNG@$금리/NNG@$인하/NNG,-1,-0.5046573651421246,48,18,30,27,0.22152826912771623,0.6728097559020779
은행/NNG@$지준율/NNG@$인상/NNG,-1,-0.5046573651421246,48,18,30,34,0.22152826912771623,0.6728097559020779
자산/NNG@$가격/NNG@$하락/NNG,-1,-0.5055856862138272,53,20,33,50,0.23155110952674962,0.705005024955288
경제/NNG@$성장세/NNG@$회복/NNG,-1,-0.5055856862138272,53,20,33,56,0.23155110952674962,0.705005024955288
성장률/NNG@$물가/NNG@$상승률/NNG,-1,-0.5061658921779199,58,22,36,40,0.2406830009039909,0.7339523247525901
필요/NNG@$있/VA@$주문/NNG,-1,-0.506375710864441,28,10,18,25,0.1685712575337318,0.5143407624021255
국고채/NNG@$금리/NNG@$기준금리/NNG,-1,-0.506375710864441,28,10,18,28,0.1685712575337318,0.5143407624021255
긍정적/NNG@$효과/NNG@$있/VA,-1,-0.506375710864441,28,10,18,27,0.1685712575337318,0.5143407624021255
추진/NNG@$필요/NNG@$있/VA,-1,-0.506375710864441,28,10,18,20,0.1685712575337318,0.5143407624021255
인플레이션/NNG@$압력/NNG@$완화/NNG,-1,-0.507395302707831,130,50,80,77,0.2931994076383398,0.8970610136424146
기준금리/NNG@$인하/NNG@$기대/NNG,-1,-0.5127476215290239,112,43,69,163,0.2858529998738769,0.8873270016677033
금리/NNG@$인하/NNG@$요구/NNG,-1,-0.5133919813363466,99,38,61,74,0.28025443526775506,0.871470857342575
성장/NNG@$하방/NNG@$위험/NNG,-1,-0.5162487762992782,107,41,66,170,0.28185541485464394,0.8832872700788947
금융/NNG@$경제/NNG@$전망/NNG,0,-0.5162864117256589,23,8,15,26,0.14968924305472978,0.4691489367911016
기금/NNG@$금리/NNG@$인상/NNG,-1,-0.5164929914372035,94,36,58,57,0.2754580805357866,0.8638140555792783
위안화/NNG@$절상/NNG@$압력/NNG,-1,-0.5173931841407993,71,27,44,71,0.25402058441876685,0.7985468215939727
수입/NNG@$물가/NNG@$상승/NNG,-1,-0.5180417719739651,115,44,71,129,0.28313100353458437,0.8916374843697681
오름세/NNG@$지속/NNG@$예상/NNG,0,-0.5194195680444342,15,5,10,24,0.12348385063819356,0.3903443259915689
가능성/NNG@$높/VA@$관측/NNG,-1,-0.5198753076452305,61,23,38,41,0.2383001797851089,0.7542306896294205
확대/NNG@$금리/NNG@$인하/NNG,-1,-0.5206790600624766,56,21,35,57,0.22931978330080494,0.7274083976507162
인하/NNG@$단행/NNG@$전망/NNG,-1,-0.521288973141474,51,19,32,38,0.2194711230680138,0.6973343800168622
금리/NNG@$인상/NNG@$통화/NNG,-1,-0.521288973141474,51,19,32,37,0.2194711230680138,0.6973343800168622
성장/NNG@$둔화/NNG@$경제/NNG,-1,-0.521288973141474,51,19,32,41,0.2194711230680138,0.6973343800168622
위기/NNG@$경기/NNG@$둔화/NNG,-1,-0.5228929084985567,41,15,26,21,0.1966137920329861,0.6274690355086965
회복세/NNG@$지속/NNG@$유로지역/NNG,-1,-0.5250120215897216,36,13,23,39,0.18316196184776504,0.587962995479377
생산자/NNG@$물가/NNG@$상승률/NNG,-1,-0.5250120215897216,36,13,23,33,0.18316196184776504,0.587962995479377
국채/NNG@$매입/NNG@$결정/NNG,-1,-0.5250120215897216,36,13,23,16,0.18316196184776504,0.587962995479377
경제/NNG@$위기/NNG@$극복/NNG,-1,-0.5268336937298915,92,35,57,62,0.2676063317829508,0.8633714860532666
시장/NNG@$유동성/NNG@$공급/NNG,-1,-0.5296969899843235,31,11,20,38,0.16783971202306996,0.5458140581534199
금리/NNG@$상승/NNG@$우려/NNG,-1,-0.5296969899843235,31,11,20,22,0.16783971202306996,0.5458140581534199
조정/NNG@$여부/NNG@$결정/NNG,-1,-0.5296969899843235,31,11,20,27,0.16783971202306996,0.5458140581534199
통화정책/NNG@$변경/NNG@$가능성/NNG,-1,-0.5296969899843235,31,11,20,21,0.16783971202306996,0.5458140581534199
주택/NNG@$담보인정비율/NNG@$부채/NNG@$상환/NNG,-1,-0.5296969899843235,31,11,20,25,0.16783971202306996,0.5458140581534199
급등/NNG@$물가/NNG@$상승/NNG,-1,-0.5296969899843235,31,11,20,35,0.16783971202306996,0.5458140581534199
더블딥/NNG@$이중/NNG@$침체/NNG,-1,-0.5302894333135248,87,33,54,102,0.2619910175056273,0.853398291356329
자본/NNG@$유출입/NNG@$동향/NNG,-1,-0.5321524682850955,64,24,40,60,0.23609790675657652,0.7730564428169089
금리/NNG@$인하/NNG@$여부/NNG,-1,-0.5335397386062721,95,36,59,60,0.26510535094241783,0.8714044674928028
기준금리/NNG@$올리/VV@$않/VX,-1,-0.5341387546725862,59,22,37,58,0.22728436873725177,0.7483388748632822
동결/NNG@$소수/NNG@$의견/NNG,-1,-0.5360523200083309,54,20,34,28,0.2176296997647938,0.7204023524730139
수출/NNG@$증가율/NNG@$둔화/NNG,-1,-0.5360523200083309,54,20,34,51,0.2176296997647938,0.7204023524730139
경기/NNG@$부양/NNG@$노력/NNG,-1,-0.5380739452781755,49,18,31,53,0.20701693327065265,0.6891754788785822
기준금리/NNG@$인하/NNG@$압박/NNG,-1,-0.5398685491545459,26,9,17,39,0.14988447214896933,0.5015068570636126
금융/NNG@$불안/NNG@$가능성/NNG,-1,-0.5398685491545459,26,9,17,16,0.14988447214896933,0.5015068570636126
자산/NNG@$매입/NNG@$규모/NNG@$확대/NNG,-1,-0.5398685491545459,26,9,17,30,0.14988447214896933,0.5015068570636126
달러/NNG@$약세/NNG@$지속/NNG,-1,-0.5405457077620475,44,16,28,11,0.19528670054787461,0.6546711240839043
환율/NNG@$상승/NNG@$물가/NNG,-1,-0.5405457077620475,44,16,28,30,0.19528670054787461,0.6546711240839043
인하/NNG@$시장/NNG@$금리/NNG,-1,-0.5405457077620475,44,16,28,16,0.19528670054787461,0.6546711240839043
美/NNG@$실업/NNG@$수당/NNG,0,-0.5418361413970827,18,6,12,37,0.12570869622451825,0.42296113293242915
조정/NNG@$가능성/NNG@$크/VA,0,-0.5418361413970827,18,6,12,38,0.12570869622451825,0.42296113293242915
수요/NNG@$하방/NNG@$압력/NNG,0,-0.5418361413970827,18,6,12,19,0.12570869622451825,0.42296113293242915
기준금리/NNG@$결정/NNG@$앞두/VV,0,-0.5418361413970827,18,6,12,43,0.12570869622451825,0.42296113293242915
통화/NNG@$긴축/NNG@$기조/NNG,-1,-0.5461554581114276,62,23,39,36,0.22541843736231637,0.7678060621773142
가능성/NNG@$크/VA@$예상/NNG,-1,-0.5461554581114276,62,23,39,60,0.22541843736231637,0.7678060621773142
둔화/NNG@$원자재/NNG@$가격/NNG,-1,-0.5491757036502911,57,21,36,46,0.2159705729359618,0.741998130862548
돈/NNG@$돌/VV@$않/VX,-1,-0.5499205728224594,34,12,22,16,0.16742127878973598,0.5764285811897494
채무/NNG@$상환/NNG@$부담/NNG,-1,-0.5499205728224594,34,12,22,26,0.16742127878973598,0.5764285811897494
물가/NNG@$상승률/NNG@$머물/VV,-1,-0.5499205728224594,34,12,22,25,0.16742127878973598,0.5764285811897494
금융시장/NNG@$불안/NNG@$실물경제/NNG,-1,-0.5499205728224594,34,12,22,14,0.16742127878973598,0.5764285811897494
금리/NNG@$인상/NNG@$행보/NNG,-1,-0.5499205728224594,34,12,22,30,0.16742127878973598,0.5764285811897494
유로존/NNG@$유로화/NNG@$사용/NNG@$경제/NNG,-1,-0.5499205728224594,34,12,22,42,0.16742127878973598,0.5764285811897494
기미/NNG@$보이/VV@$않/VX,-1,-0.5518375992585736,150,56,94,124,0.2642409313946611,0.9147970335520653
대출/NNG@$금리/NNG@$인상/NNG,-1,-0.551873562893149,169,63,106,129,0.26463519735471297,0.9162567029568371
경제/NNG@$완만/XR@$회복/NNG,-1,-0.552384761044175,52,19,33,52,0.20560343687554877,0.7129161637019945
금리/NNG@$인상/NNG@$달러/NNG@$강세/NNG,-1,-0.5568952200504564,65,24,41,43,0.2236998072091981,0.7858330932722071
기준금리/NNG@$인하/NNG@$전망/NNG,-1,-0.5574452243381218,156,58,98,180,0.26060662425236747,0.9169438224323591
예상/NNG@$채권/NNG@$시장/NNG,-1,-0.5602826458398709,29,10,19,22,0.1503299954294462,0.5333173035085371
경상수지/NNG@$흑자/NNG@$감소/NNG,-1,-0.5602826458398709,29,10,19,21,0.1503299954294462,0.5333173035085371
상승/NNG@$압력/NNG@$확대/NNG,-1,-0.5602826458398709,29,10,19,26,0.1503299954294462,0.5333173035085371
금리/NNG@$인하/NNG@$논의/NNG,-1,-0.5608138819464563,42,15,27,34,0.18148105904696207,0.6448281041799565
지수/NNG@$상승/NNG@$종합/NNG,-1,-0.5608138819464563,42,15,27,57,0.18148105904696207,0.6448281041799565
사상/NNG@$최저치/NNG@$기록/NNG,-1,-0.5608138819464563,42,15,27,27,0.18148105904696207,0.6448281041799565
소매/NNG@$판매/NNG@$증가율/NNG,-1,-0.5608138819464563,42,15,27,32,0.18148105904696207,0.6448281041799565
경제/NNG@$성장/NNG@$하방/NNG@$리스크/NNG,0,-0.5619015477141454,21,7,14,26,0.12783661399164473,0.4556662683344483
국제금융시장/NNG@$불안/NNG@$요인/NNG,0,-0.5619015477141454,21,7,14,24,0.12783661399164473,0.4556662683344483
경기/NNG@$회복/NNG@$전망/NNG,-1,-0.5650659865068199,55,20,35,45,0.20435330419047665,0.7351895085025539
금리/NNG@$인상/NNG@$자산/NNG,-1,-0.567543398760955,37,13,24,45,0.16722567535341365,0.606020485906039
금리/NNG@$동결/NNG@$가능성/NNG@$높/VA,-1,-0.567543398760955,37,13,24,31,0.16722567535341365,0.606020485906039
주례/NNG@$경제/NNG@$동향/NNG,-1,-0.5697902191881286,50,18,32,44,0.19323220297530416,0.7049319342461436
고려/NNG@$금리/NNG@$인하/NNG,-1,-0.5716875966421665,92,34,58,77,0.23933620764557914,0.8780505124781546
금융/NNG@$위기/NNG@$경기/NNG,-1,-0.5768376542357495,95,35,60,55,0.23764570596606782,0.8853463482752401
인하/NNG@$가능성/NNG@$반영/NNG,-1,-0.5770239525492866,114,42,72,64,0.24380518346566887,0.9088006520131379
경제/NNG@$성장/NNG@$고용/NNG,-1,-0.5780643069618352,32,11,21,47,0.15093374766611015,0.5643746586131155
사회/NNG@$기반/NNG@$시설/NNG,-1,-0.5780643069618352,32,11,21,29,0.15093374766611015,0.5643746586131155
곡물/NNG@$가격/NNG@$상승/NNG,-1,-0.5780643069618352,32,11,21,50,0.15093374766611015,0.5643746586131155
금리/NNG@$인하/NNG@$이뤄질/VV,-1,-0.5780643069618352,32,11,21,22,0.15093374766611015,0.5643746586131155
국제금융시장/NNG@$불안/NNG@$완화/NNG,-1,-0.5780643069618352,32,11,21,11,0.15093374766611015,0.5643746586131155
개선/NNG@$기준금리/NNG@$인상/NNG,-1,-0.5780643069618352,32,11,21,23,0.15093374766611015,0.5643746586131155
매입/NNG@$규모/NNG@$유지/NNG,-1,-0.5780643069618352,32,11,21,62,0.15093374766611015,0.5643746586131155
기준금리/NNG@$금융/NNG@$위기/NNG,-1,-0.5780643069618352,32,11,21,26,0.15093374766611015,0.5643746586131155
기준금리/NNG@$인하/NNG@$요구/NNG,-1,-0.5780643069618352,32,11,21,31,0.15093374766611015,0.5643746586131155
가계/NNG@$기업/NNG@$대출/NNG,-1,-0.5780643069618352,32,11,21,23,0.15093374766611015,0.5643746586131155
동결/NNG@$결정/NNG@$내렸/VV,-1,-0.5780643069618352,32,11,21,18,0.15093374766611015,0.5643746586131155
내수/NNG@$부진/NNG@$지속/NNG,-1,-0.5780643069618352,32,11,21,23,0.15093374766611015,0.5643746586131155
근거/NNG@$금리/NNG@$인상/NNG,0,-0.5798325646433544,24,8,16,35,0.12986945277100478,0.48819981410115126
성장률/NNG@$전망치/NNG@$유지/NNG,0,-0.5798325646433544,24,8,16,34,0.12986945277100478,0.48819981410115126
인하/NNG@$나설/VV@$가능성/NNG,-1,-0.581899957652332,53,19,34,39,0.19242804876241087,0.7278940593304397
금리/NNG@$인하/NNG@$없/VA,-1,-0.5828138907852447,74,27,47,58,0.21925475804348568,0.8316672919714927
기준금리/NNG@$인하/NNG@$여부/NNG,-1,-0.5829566480196843,40,14,26,30,0.1671897033064805,0.634450672955727
가능성/NNG@$높/VA@$보/VV,-1,-0.5829566480196843,40,14,26,25,0.1671897033064805,0.634450672955727
원자재/NNG@$가격/NNG@$급등/NNG,-1,-0.5869716064127275,148,54,94,111,0.2405207216555823,0.9239328807785891
시작/NNG@$금리/NNG@$인하/NNG,-1,-0.5883986868189521,48,17,31,24,0.1805086225024256,0.6964320261651497
달러화/NNG@$가치/NNG@$하락/NNG,-1,-0.5888298212320222,69,25,44,53,0.210676196427623,0.8138962675054983
인하/NNG@$유동성/NNG@$공급/NNG,-1,-0.5897262056600494,77,28,49,48,0.2179648758181301,0.844369359783208
내수/NNG@$부진/NNG@$경기/NNG,-1,-0.5936192571160719,35,12,23,21,0.15163595133329189,0.5944963447062932
성장/NNG@$금리/NNG@$인상/NNG,-1,-0.5936192571160719,35,12,23,23,0.15163595133329189,0.5944963447062932
소비자물가지수/NNG@$상승률/NNG@$기록/NNG,-1,-0.5958331968904835,27,9,18,29,0.13180939644820347,0.5203166559516386
내수/NNG@$경기/NNG@$활성화/NNG,-1,-0.5958331968904835,27,9,18,20,0.13180939644820347,0.5203166559516386
금융/NNG@$위기/NNG@$영향/NNG,-1,-0.5958331968904835,27,9,18,21,0.13180939644820347,0.5203166559516386
증권/NNG@$기준금리/NNG@$인하/NNG,-1,-0.5958331968904835,27,9,18,27,0.13180939644820347,0.5203166559516386
농산물/NNG@$석유류/NNG@$근원인플레이션율/NNG,-1,-0.5964752048506401,43,15,28,66,0.1672681687597358,0.6616060176012023
석유류/NNG@$가격/NNG@$하락/NNG,-1,-0.5997791667889824,51,18,33,29,0.18019205266455648,0.7200929632422233
경제/NNG@$성장/NNG@$촉진/NNG,-1,-0.6002161444640557,102,37,65,49,0.2257119115833443,0.9032339436785302
경제/NNG@$금리/NNG@$인하/NNG,-1,-0.6002161444640557,102,37,65,67,0.2257119115833443,0.9032339436785302
하향/NNG@$조정/NNG@$경제/NNG,-1,-0.602104547521657,59,21,38,41,0.1911323056019634,0.7693915693590543
하락/NNG@$물가/NNG@$상승/NNG,-1,-0.602104547521657,59,21,38,33,0.1911323056019634,0.7693915693590543
은행/NNG@$대출/NNG@$금리/NNG,-1,-0.6028433858901806,75,27,48,58,0.20860052173385907,0.8416582055115392
자본/NNG@$확충/NNG@$펀드/NNG,-1,-0.6031090282655903,67,24,43,65,0.20050889410355577,0.8096856299394251
금리/NNG@$인하/NNG@$조치/NNG,-1,-0.6041805182761559,270,97,173,140,0.2296792147563751,0.9306110047127704
채권/NNG@$보유/NNG@$종사자/NNG,-1,-0.6072667820460204,38,13,25,26,0.1523965651152021,0.6235257303144293
하향/NNG@$조정/NNG@$전망/NNG,-1,-0.6072667820460204,38,13,25,38,0.1523965651152021,0.6235257303144293
자금/NNG@$유출/NNG@$가능성/NNG,-1,-0.6083570318333711,46,16,30,57,0.16742819261901581,0.6873992180274315
가능성/NNG@$강하/VA@$시사/NNG,-1,-0.6083570318333711,46,16,30,45,0.16742819261901581,0.6873992180274315
하락/NNG@$물가/NNG@$상승률/NNG,-1,-0.6100930290190576,30,10,20,27,0.1336589020370386,0.5517918602548312
지준율/NNG@$인상/NNG@$효과/NNG,-1,-0.6100930290190576,30,10,20,25,0.1336589020370386,0.5517918602548312
통화/NNG@$금융/NNG@$대책/NNG,-1,-0.6100930290190576,30,10,20,22,0.1336589020370386,0.5517918602548312
기준금리/NNG@$인하/NNG@$결정/NNG,-1,-0.6121520569586163,114,41,73,75,0.22108205758110222,0.9187225548321651
유동성/NNG@$공급/NNG@$조치/NNG,-1,-0.6140465856858319,81,29,52,60,0.20678626235544326,0.864546286392162
인하/NNG@$단행/NNG@$금리/NNG,-1,-0.6164187445851546,73,26,47,27,0.19905596525450495,0.8386019019492659
시장/NNG@$금리/NNG@$인하/NNG@$가능성/NNG,-1,-0.6188164258545437,49,17,32,38,0.16764552608165953,0.7117676833390147
회복세/NNG@$지속/NNG@$예상/NNG,0,-0.6188292662917041,19,6,13,17,0.10403692099295204,0.4417248744977831
소비/NNG@$부정적/NNG@$영향/NNG,0,-0.6188292662917041,19,6,13,26,0.10403692099295204,0.4417248744977831
금리/NNG@$인하/NNG@$단행/NNG@$전망/NNG,-1,-0.6192652825430802,41,14,27,29,0.15318814690244054,0.6513333574826039
인하/NNG@$여부/NNG@$결정/NNG,-1,-0.6192652825430802,41,14,27,18,0.15318814690244054,0.6513333574826039
하방/NNG@$리스크/NNG@$크/VA,-1,-0.6192652825430802,41,14,27,24,0.15318814690244054,0.6513333574826039
금리/NNG@$상승/NNG@$요인/NNG,-1,-0.6192652825430802,41,14,27,47,0.15318814690244054,0.6513333574826039
경제/NNG@$불확실성/NNG@$커지/VV,-1,-0.6227864959231895,33,11,22,19,0.1354206430546218,0.5824246685445923
완화/NNG@$기조/NNG@$지속/NNG,-1,-0.6227864959231895,33,11,22,31,0.1354206430546218,0.5824246685445923
조치/NNG@$취할/VV@$준비/NNG,-1,-0.6227864959231895,33,11,22,81,0.1354206430546218,0.5824246685445923
위기/NNG@$대응/NNG@$능력/NNG,-1,-0.6227864959231895,33,11,22,21,0.1354206430546218,0.5824246685445923
달러/NNG@$가치/NNG@$하락/NNG,-1,-0.6230178895051065,87,31,56,66,0.20517516161629984,0.8830960862505461
시장/NNG@$기준금리/NNG@$인하/NNG,-1,-0.6242312492690703,132,47,85,137,0.2153185867203824,0.9304406372045031
금리/NNG@$내리/VV@$않/VX,-1,-0.6265424525086537,60,21,39,41,0.17965042848211993,0.7822239272347844
금리/NNG@$인하/NNG@$경기/NNG@$부양/NNG,-1,-0.6268132512141735,90,32,58,82,0.20443204130279888,0.8909205557379806
경기/NNG@$부진/NNG@$심화/NNG,0,-0.6279340190671062,22,7,15,20,0.10845654187364756,0.4744063496110948
가계/NNG@$소비/NNG@$지출/NNG,0,-0.6279340190671062,22,7,15,31,0.10845654187364756,0.4744063496110948
실업/NNG@$수당/NNG@$청구/NNG@$예상치/NNG,-1,-0.6298282354518852,44,15,29,35,0.15399158843168703,0.6778168978364836
엔/NNG@$원/NNG@$재정환율/NNG,-1,-0.6298282354518852,44,15,29,18,0.15399158843168703,0.6778168978364836
수당/NNG@$청구/NNG@$예상치/NNG,-1,-0.6298282354518852,44,15,29,35,0.15399158843168703,0.6778168978364836
예금/NNG@$대출/NNG@$금리/NNG,-1,-0.6334793788361444,63,22,41,42,0.17955779309859354,0.8000078983380089
상승률/NNG@$낮/VA@$물가/NNG,-1,-0.6340728265161975,36,12,24,14,0.1370974583853237,0.6120410954306321
인상/NNG@$단행/NNG@$시사/NNG,-1,-0.6340728265161975,36,12,24,21,0.1370974583853237,0.6120410954306321
인상/NNG@$속도/NNG@$빨라/VA,-1,-0.6340728265161975,36,12,24,15,0.1370974583853237,0.6120410954306321
경제/NNG@$전망/NNG@$하방/NNG,-1,-0.6374296145378346,25,8,17,25,0.11225243293968572,0.5068022858056798
자금/NNG@$중개/NNG@$기능/NNG,-1,-0.6374296145378346,25,8,17,15,0.11225243293968572,0.5068022858056798
둔화/NNG@$수출/NNG@$감소/NNG,-1,-0.6374296145378346,25,8,17,19,0.11225243293968572,0.5068022858056798
금융/NNG@$외환시장/NNG@$변동성/NNG,-1,-0.6391347190789312,47,16,31,14,0.1547934572760526,0.7029001555149468
신용등급/NNG@$상향/NNG@$조정/NNG,-1,-0.6391347190789312,47,16,31,55,0.1547934572760526,0.7029001555149468
금리/NNG@$인하/NNG@$결정/NNG,-1,-0.640970323417974,240,84,156,154,0.2055449156252513,0.9391771590121695
이전/NNG@$금리/NNG@$인하/NNG,-1,-0.6440964610847657,39,13,26,19,0.13869230664717025,0.6404952164288048
경기/NNG@$회복/NNG@$시작/NNG,-1,-0.6440964610847657,39,13,26,7,0.13869230664717025,0.6404952164288048
정책/NNG@$대응/NNG@$필요/NNG,-1,-0.6440964610847657,39,13,26,40,0.13869230664717025,0.6404952164288048
경기/NNG@$둔화/NNG@$원자재/NNG@$가격/NNG,-1,-0.6467309578897831,28,9,19,26,0.11559519668720265,0.5386712376646179
하방/NNG@$위험/NNG@$커지/VV,-1,-0.6467309578897831,28,9,19,26,0.11559519668720265,0.5386712376646179
하방/NNG@$위험/NNG@$크/VA,-1,-0.6467309578897831,28,9,19,30,0.11559519668720265,0.5386712376646179
기준금리/NNG@$인상/NNG@$인하/NNG,-1,-0.6467309578897831,28,9,19,22,0.11559519668720265,0.5386712376646179
달러/NNG@$강세/NNG@$보이/VV,-1,-0.6467309578897831,28,9,19,22,0.11559519668720265,0.5386712376646179
변동성/NNG@$크/VA@$확대/NNG,-1,-0.6529877846100128,42,14,28,32,0.1402082259373765,0.6676693052380053
조정/NNG@$가능성/NNG@$높/VA,-1,-0.6529877846100128,42,14,28,43,0.1402082259373765,0.6676693052380053
금리/NNG@$인하/NNG@$통화정책/NNG,-1,-0.6552201652750761,64,22,42,48,0.16909428677028962,0.81152977809669
기준금리/NNG@$인하/NNG@$단행/NNG,-1,-0.6552201652750761,64,22,42,82,0.16909428677028962,0.81152977809669
소수/NNG@$의견/NNG@$냈/VV,-1,-0.6555428177642935,31,10,21,28,0.11859127637344762,0.5697959054906611
요인/NNG@$소비자/NNG@$물가/NNG,-1,-0.6555428177642935,31,10,21,17,0.11859127637344762,0.5697959054906611
가계/NNG@$저축/NNG@$전망/NNG,-1,-0.6555428177642935,31,10,21,46,0.11859127637344762,0.5697959054906611
경제/NNG@$소비자들/NNG@$심리/NNG,-1,-0.6555428177642935,31,10,21,23,0.11859127637344762,0.5697959054906611
수출/NNG@$증가세/NNG@$둔화/NNG,-1,-0.6609297466044529,56,19,37,75,0.15710820261368014,0.7693400385929461
성장률/NNG@$마이너스/NNG@$기록/NNG,-1,-0.6637237730718761,34,11,23,27,0.12131091462512926,0.599985806777682
원유/NNG@$가격/NNG@$하락/NNG,-1,-0.6637237730718761,34,11,23,19,0.12131091462512926,0.599985806777682
금리/NNG@$결정/NNG@$영향/NNG,-1,-0.6682265476343577,73,25,48,65,0.1699869571495834,0.8544408086501921
소수/NNG@$의견/NNG@$낸/VV,-1,-0.6712173546526324,37,12,25,27,0.12380270221482326,0.6290788560637128
지표/NNG@$좋/VA@$않/VX,-1,-0.6712173546526324,37,12,25,21,0.12380270221482326,0.6290788560637128
필요/NNG@$금리/NNG@$인하/NNG,-1,-0.6714512313268008,62,21,41,49,0.15853142158017336,0.8062318834971874
금리/NNG@$인하/NNG@$기준금리/NNG,-1,-0.6739810676402107,51,17,34,28,0.14431327960859364,0.7407351997751968
조치/NNG@$취하/VV@$않/VX,-1,-0.6757666634006613,65,22,43,59,0.15920060139509337,0.8225234259614889
엔화/NNG@$가치/NNG@$상승/NNG,-1,-0.6780149427044256,40,13,27,24,0.12610164494019604,0.6569418441026528
통화정책/NNG@$가늠/NNG@$볼/VX,-1,-0.6780149427044256,40,13,27,20,0.12610164494019604,0.6569418441026528
테이퍼링/NNG@$자산/NNG@$매입/NNG@$축소/NNG,-1,-0.6780149427044256,40,13,27,44,0.12610164494019604,0.6569418441026528
금리/NNG@$인상/NNG@$서두/NNG,-1,-0.6780149427044256,40,13,27,16,0.12610164494019604,0.6569418441026528
예금/NNG@$증서/NNG@$금리/NNG,-1,-0.6795422648065941,68,23,45,39,0.15984049228701813,0.8374366011621356
양도성/NNG@$예금/NNG@$증서/NNG@$금리/NNG,-1,-0.6795422648065941,68,23,45,39,0.15984049228701813,0.8374366011621356
전망/NNG@$지수/NNG@$하락/NNG,0,-0.6858251242118292,20,6,14,30,0.08577900313735569,0.4601106888505761
경제/NNG@$회복세/NNG@$예상/NNG,0,-0.6858251242118292,20,6,14,33,0.08577900313735569,0.4601106888505761
조치/NNG@$내놓/VV@$않/VX,0,-0.6858251242118292,20,6,14,42,0.08577900313735569,0.4601106888505761
활용/NNG@$필요/NNG@$있/VA,0,-0.6861347019395891,23,7,16,28,0.09175929218940972,0.49276407945833667
조정/NNG@$가능성/NNG@$있/VA,-1,-0.6886826466241656,26,8,18,29,0.09682342393826979,0.5250047241174007
금융/NNG@$위기/NNG@$금리/NNG@$인상/NNG,-1,-0.6886826466241656,26,8,18,30,0.09682342393826979,0.5250047241174007
목표/NNG@$유지/NNG@$통화정책/NNG,-1,-0.6886826466241656,26,8,18,46,0.09682342393826979,0.5250047241174007
금융시장/NNG@$불안/NNG@$경제/NNG,-1,-0.6886826466241656,26,8,18,24,0.09682342393826979,0.5250047241174007
경제/NNG@$보/VV@$경기/NNG,-1,-0.6886826466241656,26,8,18,25,0.09682342393826979,0.5250047241174007
검토/NNG@$볼/VX@$필요/NNG@$있/VA,0,-0.6897326160273813,17,5,12,12,0.07848932830768114,0.42729688249107534
부동산/NNG@$규제/NNG@$완화/NNG,-1,-0.6903142385470489,80,27,53,75,0.16210889570001702,0.8844837404482536
대외/NNG@$경제정책/NNG@$경제/NNG,-1,-0.6923668051221481,29,9,20,26,0.10121578593665297,0.5566019630586315
매입/NNG@$프로그램/NNG@$규모/NNG,-1,-0.6923668051221481,29,9,20,25,0.10121578593665297,0.5566019630586315
물가/NNG@$전망/NNG@$하향/NNG,-1,-0.6923668051221481,29,9,20,17,0.10121578593665297,0.5566019630586315
주택/NNG@$착공/NNG@$허가/NNG,-1,-0.6923668051221481,29,9,20,31,0.10121578593665297,0.5566019630586315
대외/NNG@$의존도/NNG@$높/VA@$경제/NNG,-1,-0.6965510513628878,32,10,22,32,0.10509554090693804,0.5873505890958798
경제/NNG@$성장/NNG@$속도/NNG@$둔화/NNG,-1,-0.6965510513628878,32,10,22,19,0.10509554090693804,0.5873505890958798
금리/NNG@$인하/NNG@$경기/NNG@$부양책/NNG,-1,-0.6987908857102689,52,17,35,16,0.13381185696893294,0.7543908316383631
해외/NNG@$투자/NNG@$확대/NNG,-1,-0.7008609267579279,35,11,24,29,0.10857073450386276,0.6170732361920713
위기/NNG@$경제/NNG@$성장/NNG,-1,-0.7008609267579279,35,11,24,17,0.10857073450386276,0.6170732361920713
시장/NNG@$금리/NNG@$결정/NNG,-1,-0.7008609267579279,35,11,24,34,0.10857073450386276,0.6170732361920713
가능성/NNG@$유의/NNG@$필요/NNG@$있/VA,0,-0.701599039429017,14,4,10,16,0.06922496660556068,0.3945912279236481
위기/NNG@$금리/NNG@$인상/NNG,-1,-0.7090654781045684,41,13,28,41,0.11459094567301928,0.6728759270287196
완화/NNG@$기준금리/NNG@$인하/NNG,-1,-0.7090654781045684,41,13,28,27,0.11459094567301928,0.6728759270287196
모습/NNG@$보이/VV@$않/VX,-1,-0.7127603745933021,44,14,30,20,0.1172326479422222,0.6987451105678864
상승/NNG@$압력/NNG@$예상/NNG,-1,-0.7161245762216785,47,15,32,38,0.11967430529591114,0.7231640290724473
인하/NNG@$경기/NNG@$부양책/NNG,-1,-0.716731969990501,73,24,49,30,0.14341158396240308,0.8687673472533846
경기/NNG@$회복세/NNG@$미약/XR,-1,-0.7179789556470044,76,25,51,44,0.1444919280006548,0.8798184690211261
금리/NNG@$인하/NNG@$나서/VV,-1,-0.721090447750493,91,30,61,72,0.14908125069837638,0.9195462194362161
둔화/NNG@$경제/NNG@$성장/NNG,-1,-0.7262021993458276,59,19,40,47,0.12787278797267113,0.8058331218440188
경제/NNG@$침체/NNG@$우려/NNG,-1,-0.7327894152012681,30,9,21,26,0.08857648599136071,0.574128606167367
추경/NNG@$금리/NNG@$인하/NNG,-1,-0.7327894152012681,30,9,21,59,0.08857648599136071,0.574128606167367
금리/NNG@$하향/NNG@$조정/NNG,-1,-0.733195253329705,33,10,23,24,0.09309414773902384,0.6044696630576826
인하/NNG@$가능성/NNG@$무게/NNG,-1,-0.7335849139321531,27,8,19,28,0.08346135627990806,0.5428371081310899
금리/NNG@$인하/NNG@$검토/NNG,-1,-0.7335849139321531,27,8,19,29,0.08346135627990806,0.5428371081310899
가능성/NNG@$없/VA@$않/VX,-1,-0.7342886683118285,36,11,25,19,0.09713451173830367,0.6336973961754419
경제/NNG@$성장세/NNG@$유지/NNG,-1,-0.7342886683118285,36,11,25,22,0.09713451173830367,0.6336973961754419
경제/NNG@$금융/NNG@$위기/NNG,-1,-0.7351092184085279,129,42,87,121,0.1458839697357058,0.9551327462719804
부양/NNG@$기조/NNG@$유지/NNG,-1,-0.7357412499369265,39,12,27,74,0.10078490889464327,0.6616779145719783
금융/NNG@$위기/NNG@$해소/NNG,-1,-0.7357412499369265,39,12,27,14,0.10078490889464327,0.6616779145719783
심리/NNG@$회복/NNG@$지연/NNG,-1,-0.7363967624195575,24,7,17,27,0.07757935281045077,0.5107862625113402
경기/NNG@$활성화/NNG@$대책/NNG,-1,-0.7363967624195575,24,7,17,26,0.07757935281045077,0.5107862625113402
매입/NNG@$프로그램/NNG@$종료/NNG,-1,-0.7363967624195575,24,7,17,31,0.07757935281045077,0.5107862625113402
금융/NNG@$위기/NNG@$겪/VV,-1,-0.7373416140405833,42,13,29,49,0.10411031316093111,0.6883059531229716
통상/NNG@$자원/NNG@$부/NNG,-1,-0.7385529582893826,117,38,79,57,0.14319038568455514,0.9517230148677662
산업/NNG@$통상/NNG@$자원/NNG@$부/NNG,-1,-0.7385529582893826,117,38,79,57,0.14319038568455514,0.9517230148677662
조건/NNG@$부채권/NNG@$금리/NNG,-1,-0.7389538667308597,45,14,31,26,0.10716014634383442,0.7135036209400544
환매/NNG@$조건/NNG@$부채권/NNG@$금리/NNG,-1,-0.7389538667308597,45,14,31,26,0.10716014634383442,0.7135036209400544
실물/NNG@$경기/NNG@$둔화/NNG,-1,-0.7389538667308597,45,14,31,29,0.10716014634383442,0.7135036209400544
소비/NNG@$지출/NNG@$감소/NNG,-1,-0.7404916475906267,48,15,33,35,0.10997278212431542,0.7372185069136253
장기/NNG@$대출/NNG@$프로그램/NNG,-1,-0.7419015190868685,51,16,35,64,0.11257858796817441,0.7594213619279474
기준금리/NNG@$결정/NNG@$통화정책/NNG,0,-0.7425441577849601,21,6,15,38,0.07068612341550232,0.47819315577702937
확대/NNG@$기준금리/NNG@$인하/NNG,0,-0.7425441577849601,21,6,15,30,0.07068612341550232,0.47819315577702937
성장/NNG@$지속/NNG@$중기적/NNG,0,-0.7425441577849601,21,6,15,34,0.07068612341550232,0.47819315577702937
회복세/NNG@$나타낼/VV@$전망/NNG,0,-0.7425441577849601,21,6,15,35,0.07068612341550232,0.47819315577702937
경제/NNG@$성장/NNG@$지속/NNG@$중기적/NNG,0,-0.7425441577849601,21,6,15,34,0.07068612341550232,0.47819315577702937
기준금리/NNG@$인하/NNG@$시장/NNG,-1,-0.7442269884542498,57,18,39,36,0.1172630940855888,0.7992743988435573
인상/NNG@$전망/NNG@$유지/NNG,-1,-0.7458305768454194,63,20,43,62,0.12136202950647754,0.8331938877016499
경기/NNG@$부양책/NNG@$내놓/VV,-1,-0.746707364909348,81,26,55,59,0.13106492361217928,0.903373857638955
대출/NNG@$금리/NNG@$인하/NNG,-1,-0.7469348025428246,72,23,49,54,0.126633653775538,0.8737286987235449
장기/NNG@$국채/NNG@$매입/NNG,-1,-0.7528456015226034,207,66,141,63,0.1357223789119893,0.9620619224319321
금리/NNG@$인하/NNG@$압박/NNG,-1,-0.7538826971150554,144,46,98,129,0.1349280425992115,0.9610270412169923
성장/NNG@$속도/NNG@$둔화/NNG,-1,-0.7625315787904907,64,20,44,41,0.11365608853961504,0.8431170807002285
서브프라임/NNG@$모기/NNG@$지발/NNG,-1,-0.7629755442891284,43,13,30,31,0.0945989587881643,0.7032391633270023
경영/NNG@$애로/NNG@$요인/NNG,-1,-0.7633659324235622,40,12,28,27,0.09093350528600433,0.6772549099141452
가능성/NNG@$낮/VA@$금리/NNG,-1,-0.7633659324235622,40,12,28,33,0.09093350528600433,0.6772549099141452
엔화/NNG@$약세/NNG@$지속/NNG,-1,-0.7656758005139007,34,10,24,33,0.08248040386800838,0.6211616068644888
금리/NNG@$사상/NNG@$최저치/NNG,-1,-0.7656758005139007,34,10,24,26,0.08248040386800838,0.6211616068644888
하방/NNG@$리스크/NNG@$커졌/VV,-1,-0.7682364024339339,31,9,22,25,0.07754054808472532,0.5912627564751932
금융/NNG@$위기/NNG@$촉발/NNG,-1,-0.7682364024339339,31,9,22,23,0.07754054808472532,0.5912627564751932
상승률/NNG@$기록/NNG@$물가/NNG,-1,-0.7682364024339339,31,9,22,28,0.07754054808472532,0.5912627564751932
가격/NNG@$하락/NNG@$경제/NNG,-1,-0.7682364024339339,31,9,22,33,0.07754054808472532,0.5912627564751932
인상/NNG@$출구전략/NNG@$시행/NNG,-1,-0.7724297335549208,28,8,20,21,0.07198289488045435,0.5603166913900625
경기/NNG@$둔화/NNG@$수요/NNG,-1,-0.7724297335549208,28,8,20,31,0.07198289488045435,0.5603166913900625
유로지역/NNG@$경제활동/NNG@$부진/NNG,-1,-0.7724297335549208,28,8,20,64,0.07198289488045435,0.5603166913900625
자산/NNG@$매입/NNG@$프로그램/NNG@$규모/NNG,-1,-0.7724297335549208,28,8,20,23,0.07198289488045435,0.5603166913900625
금융/NNG@$불안/NNG@$요인/NNG,0,-0.7751140808206778,15,4,11,19,0.052270507423955614,0.4123515520544689
소매/NNG@$판매/NNG@$감소/NNG,-1,-0.7780987326101846,65,20,45,51,0.1064612194984729,0.8525700533123212
공급/NNG@$관리/NNG@$제조업/NNG@$지수/NNG,-1,-0.7790711572453651,62,19,43,47,0.10409332334885024,0.8377315585351697
상승률/NNG@$물가/NNG@$목표/NNG@$유지/NNG@$통화정책/NNG,-1,-0.7791097754866474,25,7,18,44,0.06565644925985621,0.5284996262582361
물가/NNG@$목표/NNG@$유지/NNG@$통화정책/NNG,-1,-0.7791097754866474,25,7,18,46,0.06565644925985621,0.5284996262582361
인하/NNG@$경기/NNG@$회복/NNG,-1,-0.7820642232282723,53,16,37,35,0.09600285437707098,0.7845408022221068
금리/NNG@$사상/NNG@$최저/NNG,-1,-0.7845300236746009,47,14,33,57,0.08958656011693258,0.7415026363544086
최악/NNG@$금융/NNG@$위기/NNG,-1,-0.7845300236746009,47,14,33,17,0.08958656011693258,0.7415026363544086
달러/NNG@$엔/NNG@$상승/NNG,-1,-0.7881389864819807,41,12,29,20,0.0820830374975503,0.6923578701329357
전망/NNG@$경기/NNG@$둔화/NNG,-1,-0.7881389864819807,41,12,29,19,0.0820830374975503,0.6923578701329357
금리/NNG@$인하/NNG@$소비/NNG,-1,-0.7907636869763199,38,11,27,18,0.07781755728005287,0.6655818868202814
사용/NNG@$물가/NNG@$상승률/NNG,-1,-0.7907636869763199,38,11,27,17,0.07781755728005287,0.6655818868202814
공격적/NNG@$금리/NNG@$인하/NNG@$단행/NNG,-1,-0.7907636869763199,38,11,27,19,0.07781755728005287,0.6655818868202814
유로화/NNG@$사용/NNG@$물가/NNG@$상승률/NNG,-1,-0.7907636869763199,38,11,27,17,0.07781755728005287,0.6655818868202814
유로존/NNG@$유로화/NNG@$사용/NNG@$물가/NNG@$상승률/NNG,-1,-0.7907636869763199,38,11,27,17,0.07781755728005287,0.6655818868202814
인하/NNG@$가능성/NNG@$열/VV,-1,-0.792202660732135,173,53,120,126,0.1124205510358176,0.9689762187458274
금리/NNG@$인하/NNG@$부담/NNG,-1,-0.7959509040723171,60,18,42,37,0.09457405416911066,0.8318511875358771
상환/NNG@$비율/NNG@$규제/NNG@$완화/NNG,-1,-0.7990732026220881,32,9,23,32,0.06795033671594952,0.608010255493939
전망/NNG@$변화/NNG@$없/VA,-1,-0.7990732026220881,32,9,23,32,0.06795033671594952,0.608010255493939
환율/NNG@$급/NNG@$등락/NNG,-1,-0.7990732026220881,32,9,23,19,0.06795033671594952,0.608010255493939
부채/NNG@$상환/NNG@$비율/NNG@$규제/NNG@$완화/NNG,-1,-0.7990732026220881,32,9,23,32,0.06795033671594952,0.608010255493939
가계부채/NNG@$증가/NNG@$우려/NNG,-1,-0.7990732026220881,32,9,23,25,0.06795033671594952,0.608010255493939
금리/NNG@$인상/NNG@$고민/NNG,-1,-0.7990732026220881,32,9,23,18,0.06795033671594952,0.608010255493939
비율/NNG@$규제/NNG@$완화/NNG,-1,-0.7990732026220881,32,9,23,32,0.06795033671594952,0.608010255493939
수출/NNG@$기업/NNG@$채산성/NNG@$악화/NNG,-1,-0.7990732026220881,32,9,23,22,0.06795033671594952,0.608010255493939
소비자/NNG@$물가/NNG@$영향/NNG,-1,-0.8018011094593012,51,15,36,28,0.08545475151301016,0.7763278998676633
금리/NNG@$인상/NNG@$위안화/NNG@$절상/NNG,-1,-0.8041957155528026,48,14,34,47,0.08196861245272034,0.754758325702558
하향/NNG@$조정/NNG@$금리/NNG@$인하/NNG,-1,-0.8057075570570165,29,8,21,25,0.06217679359957671,0.5774519068777015
경기/NNG@$부양/NNG@$금리/NNG@$인하/NNG,-1,-0.8124506610148553,100,30,70,54,0.09893310854101695,0.9553772523942399
가계부채/NNG@$문제/NNG@$악화/NNG,-1,-0.8149743795060871,26,7,19,16,0.055694324971933336,0.5459173500835175
부양/NNG@$금리/NNG@$인하/NNG,-1,-0.8173862649901773,114,34,80,62,0.09721846476980123,0.966795722829186
경기/NNG@$하강/NNG@$막/VV,-1,-0.819335707314617,36,10,26,13,0.06492192520600634,0.6532806508548606
금리/NNG@$인하/NNG@$정책/NNG,-1,-0.8236691242684597,149,44,105,119,0.09424904122141964,0.9739859212131469
중기적/NNG@$소비자/NNG@$물가/NNG@$상승률/NNG,-1,-0.8241955991055305,62,18,44,100,0.08209826764888396,0.851201705471307
구매자/NNG@$관리/NNG@$지수/NNG,-1,-0.834012501057682,30,8,22,26,0.053827741055860696,0.5942451155191313
통화/NNG@$완화/NNG@$조치/NNG,-1,-0.8350829995778829,40,11,29,43,0.06257267174750851,0.6956723147262162
금융/NNG@$위기/NNG@$경기침체/NNG,-1,-0.8366877157747961,63,18,45,32,0.07655263117146119,0.8602051386757809
금리/NNG@$인하/NNG@$할/VV,-1,-0.8401953213727535,60,17,43,40,0.07347023043320353,0.8452819471248157
관리/NNG@$제조업/NNG@$지수/NNG,-1,-0.8445429306633679,67,19,48,53,0.07437481053285487,0.8816725588127194
금융시장/NNG@$불안/NNG@$지속/NNG,-1,-0.8448376928920327,27,7,20,21,0.04739883858662137,0.5630434567975868
경제/NNG@$회복세/NNG@$완만/XR,0,-0.8463068525083832,20,5,15,62,0.040051926718859106,0.4806961429813384
금리/NNG@$인하/NNG@$가계부채/NNG,-1,-0.8474383436525442,91,26,65,50,0.07865549816898557,0.9515859475438206
금리/NNG@$인하/NNG@$시사/NNG,-1,-0.8485097284282304,105,30,75,72,0.07938383287386903,0.9677431410974939
시장/NNG@$부정적/NNG@$영향/NNG,-1,-0.8486923593645772,34,9,25,27,0.05245938831256883,0.6403500941973894
통화정책/NNG@$변화/NNG@$해외/NNG@$위험/NNG@$요인/NNG,-1,-0.8533784584211244,41,11,30,19,0.056227318537090884,0.7100500858804525
물가/NNG@$목표/NNG@$통화정책/NNG,-1,-0.8533784584211244,41,11,30,56,0.056227318537090884,0.7100500858804525
물가/NNG@$상승률/NNG@$마이너스/NNG,-1,-0.8533784584211244,41,11,30,18,0.056227318537090884,0.7100500858804525
양적완화/NNG@$정책/NNG@$시행/NNG,-1,-0.8533784584211244,41,11,30,37,0.056227318537090884,0.7100500858804525
완화/NNG@$금리/NNG@$인하/NNG,-1,-0.8541666485176197,85,24,61,40,0.0741709632177432,0.9421031595210683
이유/NNG@$금리/NNG@$인하/NNG,-1,-0.8579698961111322,31,8,23,34,0.0467311374449209,0.6106945748908519
경제/NNG@$완만/XR@$회복세/NNG@$지속/NNG@$전망/NNG,-1,-0.8683976826966633,35,9,26,32,0.04625283414307301,0.6559391266325346
제조업/NNG@$지수/NNG@$예상치/NNG,-1,-0.8683976826966633,35,9,26,25,0.04625283414307301,0.6559391266325346
물가/NNG@$상승세/NNG@$지속/NNG,-1,-0.8695727722116378,28,7,21,27,0.04049919639238602,0.5798758366764332
일본식/NNG@$장기/NNG@$불황/NNG,-1,-0.8695727722116378,28,7,21,20,0.04049919639238602,0.5798758366764332
금리/NNG@$인하/NNG@$가능성/NNG@$열/VV,-1,-0.8742769625923708,95,26,69,75,0.06471428607062822,0.963635960522736
인하/NNG@$가능성/NNG@$시사/NNG,-1,-0.8749717380839531,139,38,101,63,0.0655605671718365,0.9820192444025069
기준금리/NNG@$인하/NNG@$경제/NNG,-1,-0.8767835941514786,39,10,29,35,0.045900756964409935,0.6983093356794161
최대/NNG@$경제/NNG@$국인/NNG,-1,-0.8767835941514786,39,10,29,57,0.045900756964409935,0.6983093356794161
국책은행/NNG@$자본/NNG@$확충/NNG,-1,-0.8769055768137746,46,12,34,73,0.04996266102301966,0.7609066339914006
금리/NNG@$인상/NNG@$종결/NNG,0,-0.8778376100275551,21,5,16,29,0.03244541811713444,0.4981397637016436
금리/NNG@$인하/NNG@$쉽/VA@$않/VX,0,-0.8778376100275551,21,5,16,32,0.03244541811713444,0.4981397637016436
인하/NNG@$통화/NNG@$완화/NNG@$정책/NNG,-1,-0.8781869731619333,32,8,24,36,0.04070102952831056,0.626795868738788
인상/NNG@$위안화/NNG@$절상/NNG,-1,-0.8820878843996524,64,17,47,72,0.05518268521471378,0.8797119496855452
금리/NNG@$인하/NNG@$속도/NNG,-1,-0.8829639692138528,50,13,37,16,0.04943656545805285,0.7943691438293095
상승률/NNG@$물가/NNG@$목표/NNG@$통화정책/NNG,-1,-0.884131315409097,25,6,19,49,0.03374680619573323,0.5480538806295577
결정/NNG@$기준금리/NNG@$인하/NNG,-1,-0.884131315409097,25,6,19,17,0.03374680619573323,0.5480538806295577
국채/NNG@$매입/NNG@$통한/VV,-1,-0.885285399340107,36,9,27,36,0.04088963503481748,0.6711365879992423
지속/NNG@$전망/NNG@$통화정책/NNG,-1,-0.885285399340107,36,9,27,12,0.04088963503481748,0.6711365879992423
가치/NNG@$하락/NNG@$막/VV,-1,-0.8900034643214879,29,7,22,23,0.03475742633135519,0.5964083699927762
정책/NNG@$다지기/NNG@$필요/NNG,-1,-0.8911465848473998,40,10,30,27,0.04106591629202344,0.7124761805119798
금리/NNG@$인하/NNG@$배경/NNG,-1,-0.8920727287898377,102,27,75,51,0.05566334915626637,0.974486942472537
경제/NNG@$전망/NNG@$악화/NNG,-1,-0.8952235996062701,33,8,25,37,0.03557337273244688,0.642542955101108
성장세/NNG@$회복/NNG@$지원/NNG@$중기적/NNG,-1,-0.8952235996062701,33,8,25,21,0.03557337273244688,0.642542955101108
회복/NNG@$지원/NNG@$중기적/NNG,-1,-0.8952235996062701,33,8,25,21,0.03557337273244688,0.642542955101108
유로존/NNG@$물가/NNG@$상승률/NNG,-1,-0.8958970455816087,73,19,54,72,0.05065937046111116,0.92127060114514
가계부채/NNG@$급/NNG@$증세/NNG,-1,-0.8959927980311336,44,11,33,22,0.04123071800453258,0.7505320887567583
금리/NNG@$인하/NNG@$시그널/NNG,-1,-0.8974627488470157,55,14,41,41,0.04515507003970051,0.8343789805206188
금리/NNG@$재할인율/NNG@$인하/NNG,-1,-0.8974627488470157,55,14,41,27,0.04515507003970051,0.8343789805206188
정책/NNG@$역량/NNG@$집중/NNG,-1,-0.9042532705605805,26,6,20,27,0.02844936816502019,0.5649229615824135
회복세/NNG@$완만/XR@$예상/NNG,0,-0.9061451698023033,14,3,11,38,0.020422377032005886,0.414101155262159
석유류/NNG@$제품/NNG@$가격/NNG,0,-0.9061451698023033,14,3,11,18,0.020422377032005886,0.414101155262159
경제/NNG@$위기/NNG@$대응/NNG,-1,-0.9068655895070099,30,7,23,20,0.02997058039990097,0.6126324391359551
금융시장/NNG@$불안/NNG@$금리/NNG,-1,-0.9068655895070099,30,7,23,18,0.02997058039990097,0.6126324391359551
기준금리/NNG@$인하/NNG@$가계부채/NNG,-1,-0.9068655895070099,30,7,23,41,0.02997058039990097,0.6126324391359551
고용/NNG@$비용/NNG@$지수/NNG,-1,-0.9068655895070099,30,7,23,26,0.02997058039990097,0.6126324391359551
금리/NNG@$인하/NNG@$가능성/NNG@$시사/NNG,-1,-0.9093217645395076,106,27,79,46,0.046648985795119294,0.980601229933057
금리/NNG@$인하/NNG@$영향/NNG,-1,-0.9095780904971403,34,8,26,36,0.031206373819248644,0.6579289391623717
조정/NNG@$금리/NNG@$인하/NNG,-1,-0.9121411127475423,38,9,29,35,0.03223491085305849,0.7003411201521352
내수/NNG@$부진/NNG@$심화/NNG,-1,-0.9164579747327637,46,11,35,8,0.03385985834383877,0.775329657044085
청구/NNG@$감소/NNG@$기록/NNG,-1,-0.9204337396935257,27,6,21,42,0.024140339195715493,0.5815379483347304
지표/NNG@$시장/NNG@$예상/NNG,-1,-0.9207929991520445,31,7,24,29,0.02596894517571949,0.6285380175220154
경기/NNG@$부진/NNG@$장기화/NNG,-1,-0.921230778681033,23,5,18,14,0.021875245207046146,0.5325141570465055
자금조달/NNG@$어려움/NNG@$겪/VV,-1,-0.9227667613311288,39,9,30,24,0.028750520565780383,0.7143405767449058
경제/NNG@$보/VV@$수출/NNG,-1,-0.9275537488927641,63,15,48,79,0.03357675724123101,0.8914677064294055
위안화/NNG@$변동/NNG@$확대/NNG,-1,-0.9320601098080797,44,10,34,32,0.02695897441997329,0.7649098141429421
투기/NNG@$자금/NNG@$유입/NNG,-1,-0.9334761025783282,28,6,22,34,0.02061902592515425,0.597885515838225
확장/NNG@$국면/NNG@$진입/NNG,-1,-0.9359778425135622,24,5,19,25,0.0182133068476887,0.5494217238476511
기준금리/NNG@$인하/NNG@$통화정책/NNG,-1,-0.9388303094568472,49,11,38,33,0.02559823889771772,0.8092984505779656
경기/NNG@$부양책/NNG@$경제/NNG,-1,-0.9397424883547278,41,9,32,22,0.02308219128170376,0.741118090516341
기준금리/NNG@$인하/NNG@$조치/NNG,-1,-0.9397424883547278,41,9,32,31,0.02308219128170376,0.741118090516341
경로/NNG@$하방/NNG@$위험/NNG,-1,-0.9405646834685853,37,8,29,17,0.021552581435643363,0.7018495020704362
금리/NNG@$인상/NNG@$소수/NNG@$의견/NNG,0,-0.9408237816497113,20,4,16,30,0.015266489540763057,0.4993832804773753
자금/NNG@$유입/NNG@$주가/NNG,0,-0.9408237816497113,20,4,16,21,0.015266489540763057,0.4993832804773753
실업/NNG@$보험/NNG@$청구/NNG@$감소/NNG,-1,-0.9418832177004215,33,7,26,51,0.01978614415774161,0.6593510704529754
보험/NNG@$청구/NNG@$감소/NNG,-1,-0.9418832177004215,33,7,26,51,0.01978614415774161,0.6593510704529754
증시/NNG@$긍정적/NNG@$영향/NNG,-1,-0.9475139693227979,25,5,20,27,0.015302766246797338,0.5661213136451909
자본/NNG@$유출/NNG@$확대/NNG,-1,-0.9475139693227979,25,5,20,18,0.015302766246797338,0.5661213136451909
상승률/NNG@$중기/NNG@$물가/NNG@$목표/NNG,0,-0.9478571657175939,11,2,9,32,0.010226716983452764,0.3808838024910911
전미/NNG@$주택/NNG@$건설/NNG,0,-0.9496202556813342,16,3,13,46,0.011627168783576341,0.44855337070514945
물가/NNG@$상승/NNG@$확대/NNG,-1,-0.9498475856590693,34,7,27,18,0.017396601633574354,0.6742375278304503
가격/NNG@$하락/NNG@$확대/NNG,-1,-0.9531230060931705,21,4,17,14,0.012437666019471806,0.5164751101375831
기업/NNG@$투자/NNG@$심리/NNG,-1,-0.9565049742078933,35,7,28,54,0.015367611164213703,0.6887641720454977
유럽연합/NNG@$통계/NNG@$유로/NNG,-1,-0.9565978493571734,26,5,21,33,0.012970503149640022,0.5825946225985748
기준금리/NNG@$인하/NNG@$배경/NNG,-1,-0.9565978493571734,26,5,21,26,0.012970503149640022,0.5825946225985748
파산/NNG@$보호/NNG@$신청/NNG,-1,-0.9668033871742553,37,7,30,23,0.01215502911423312,0.716703896449648
금융/NNG@$위기/NNG@$실물경제/NNG,-1,-0.9669390885650224,51,10,41,16,0.014196533991481148,0.84055518991494
경기/NNG@$과도/NNG@$위축/NNG,-1,-0.9669390885650224,51,10,41,1,0.014196533991481148,0.84055518991494
자산/NNG@$시장/NNG@$과열/NNG,-1,-0.9694784385576598,23,4,19,26,0.008571516781951798,0.5502138828892533
금융시장/NNG@$불안/NNG@$심리/NNG,-1,-0.9741836057922824,39,7,32,12,0.009778143076302615,0.7431126475636992
기준금리/NNG@$내릴/VV@$가능성/NNG,-1,-0.9741836057922824,39,7,32,36,0.009778143076302615,0.7431126475636992
시장/NNG@$금리/NNG@$인하/NNG@$기대감/NNG,-1,-0.9742017285552613,29,5,24,46,0.00829009394412013,0.6304704747699291
경제/NNG@$성장/NNG@$위협/NNG,-1,-0.9749399417640898,24,4,20,26,0.007238458745310908,0.5668151549352028
경제/NNG@$활력/NNG@$회복/NNG,-1,-0.9749399417640898,24,4,20,20,0.007238458745310908,0.5668151549352028
통화정책/NNG@$결정/NNG@$기준금리/NNG,-1,-0.9810487503500177,31,5,26,20,0.006376479832104479,0.6609250046999755
대미/NNG@$무역/NNG@$흑자/NNG,-1,-0.9816272828581768,20,3,17,31,0.004835657923730432,0.5170120648274938
인플레이션기대심리/NNG@$낮추/VV@$노력/NNG,-1,-0.9816272828581768,20,3,17,47,0.004835657923730432,0.5170120648274938
금리/NNG@$인하/NNG@$환율/NNG,-1,-0.9836838399387103,54,9,45,21,0.00727356502630732,0.875616884347767
수출/NNG@$부진/NNG@$내수/NNG,-1,-0.9851162835219143,21,3,18,38,0.00404651121021974,0.5338899212060516
대출/NNG@$증가/NNG@$속도/NNG,-1,-0.9898327687141939,23,3,20,22,0.0029443894609512433,0.5671718515840418
성장/NNG@$경로/NNG@$하방/NNG@$위험/NNG,-1,-0.991794675887315,31,4,27,15,0.0028401084390115303,0.6759950910901928
국채/NNG@$모기지/NNG@$담보/NNG@$증권/NNG,-1,-0.9927302762952079,25,3,22,26,0.0022366721813560733,0.5996510131152664
채권/NNG@$시장/NNG@$기준금리/NNG@$인하/NNG,-1,-0.9936224313720091,33,4,29,64,0.0023109896783956255,0.7043893454644208
금융/NNG@$위기/NNG@$확산/NNG,-1,-0.9941340660797259,55,7,48,23,0.002715485047806218,0.898137275315955
매입/NNG@$규모/NNG@$줄이/VV,-1,-0.9960596957472655,21,2,19,38,0.0011324122967689327,0.550795710950141
통계/NNG@$유로/NNG@$유로존/NNG,-1,-0.9966392469246336,22,2,20,44,0.0010014143629065691,0.5673302629168422
부양책/NNG@$내놓/VV@$않/VX,0,-0.9976396512499932,14,1,13,44,0.000567491729817984,0.44913451321908476
경기/NNG@$부진/NNG@$완화/NNG,0,-0.9976396512499932,14,1,13,19,0.000567491729817984,0.44913451321908476
유로지역/NNG@$경기/NNG@$부진/NNG,-1,-0.9984493760924738,28,2,26,38,0.0005675556986613242,0.6615738625015747
금리/NNG@$인하/NNG@$공조/NNG,-1,-0.9994853828497698,92,5,87,15,0.00033834992210118203,0.9969844120020048
세월/NNG@$사고/NNG@$영향/NNG,-1,-1.0,29,0,29,21,5.77907003495989e-05,0.7046711097627784
