word,label,polarity,count,pos_count,neg_count,neu_count,pos_score,neg_score
고용/NNG@$취업자/NNG@$증가/NNG,1,1.0,17,16,1,34,0.5671108765911478,0.0006924768806987733
해외/NNG@$불안/NNG@$요인/NNG,1,0.9996006210468931,27,25,2,16,0.7350162807072208,0.0010444384408303566
경로/NNG@$불확실성/NNG@$상존/NNG,1,0.9995102010880352,37,34,3,23,0.8568505448109163,0.0012563525978867313
성장/NNG@$경로/NNG@$불확실성/NNG@$상존/NNG,1,0.9995102010880352,37,34,3,23,0.8568505448109163,0.0012563525978867313
주가/NNG@$환율/NNG@$등가격/NNG@$변수/NNG,1,0.9993079458203138,26,24,2,3,0.7184277747315388,0.0011261533949944707
환율/NNG@$가격/NNG@$변수/NNG,1,0.9989613444679966,25,23,2,22,0.7012600029858819,0.0012209879810211044
환율/NNG@$등가격/NNG@$변수/NNG,1,0.9987623792545457,34,31,3,13,0.821681509873855,0.0015125691159091092
금리/NNG@$인상/NNG@$부동산가격/NNG,1,0.9985582374945641,52,47,5,19,0.9534386890593671,0.0018526486759497425
결정적/NNG@$역할/NNG@$할/VV,1,0.997016568076037,38,34,4,12,0.8566519025225017,0.0023269866442230313
물가/NNG@$경기/NNG@$금융시장/NNG,1,0.996545819770956,37,33,4,18,0.8455160820186985,0.002496575119782708
견조/NNG@$성장/NNG@$지속/NNG@$물가/NNG@$기조/NNG,1,0.9961573839323474,52,46,6,29,0.9484373911748049,0.0029855199142433046
지속/NNG@$물가/NNG@$기조/NNG@$유지/NNG,1,0.9950593778159997,57,50,7,39,0.9651714429314049,0.0035708996944349876
통화정책/NNG@$금융완화/NNG@$기조/NNG@$유지/NNG,1,0.9948641396391742,49,43,6,43,0.9317352927209815,0.0035386928367139654
성장/NNG@$지속/NNG@$물가/NNG@$기조/NNG@$유지/NNG,1,0.9946351387306704,56,49,7,38,0.9614127182781863,0.0037621701715840877
역할/NNG@$할/VV@$기대/NNG,1,0.9924784628596806,52,45,7,16,0.9429246140510579,0.004714133722691598
은행/NNG@$대출/NNG@$증가/NNG,1,0.9921002885969612,38,33,5,18,0.8451716185296342,0.004386617159226092
경기/NNG@$회복/NNG@$진행/NNG,1,0.9921002885969612,38,33,5,28,0.8451716185296342,0.004386617159226092
금융완화/NNG@$기조/NNG@$유지/NNG@$경기/NNG,1,0.9917003706684484,31,27,4,33,0.7659211134337249,0.004129832452269818
경제/NNG@$성장세/NNG@$약화/NNG,1,0.9909705820313954,17,15,2,41,0.5461671444374938,0.003146138168314234
성장세/NNG@$보일/VV@$전망/NNG,1,0.989311749523027,23,20,3,29,0.6462050061315184,0.004264186519771927
경제/NNG@$전망/NNG@$금융시장/NNG,1,0.988447269615953,35,30,5,24,0.8080660309464147,0.005685794958676582
경기/NNG@$물가/NNG@$금융시장/NNG,1,0.9843164129740261,27,23,4,11,0.7006086556100304,0.006397998678267853
기조/NNG@$유지/NNG@$경기/NNG@$회복세/NNG,1,0.9838984632006547,21,18,3,31,0.6071814802227944,0.0056738603476254035
회복세/NNG@$찬물/NNG@$끼얹/VV,1,0.9799764302362846,20,17,3,37,0.5870325421880523,0.006658904543027239
제조업/NNG@$서비스업/NNG@$생산/NNG,0,0.9791888442814993,14,12,2,6,0.4824747845606817,0.005666982375364043
등가격/NNG@$변수/NNG@$변동성/NNG,0,0.9791888442814993,14,12,2,9,0.4824747845606817,0.005666982375364043
경제/NNG@$성장/NNG@$가능/NNG,1,0.9782672787980446,57,47,10,43,0.9511543555820968,0.01162008767674109
물가/NNG@$상승/NNG@$압력/NNG@$크/VA@$않/VX,1,0.9749818026598052,71,58,13,66,0.982861776484085,0.013661953940880536
전망/NNG@$통화정책/NNG@$완화/NNG@$기조/NNG@$유지/NNG,1,0.9725682991084863,34,28,6,21,0.779451828015247,0.011801162904058091
수요/NNG@$압력/NNG@$증대/NNG,1,0.9699523180360701,48,39,9,58,0.9010116925987014,0.014855850786506157
상승/NNG@$기조/NNG@$갈/VX@$전망/NNG,1,0.968523808548533,33,27,6,20,0.7645317632282982,0.013169349402448006
양적완화/NNG@$정책/NNG@$유지/NNG,1,0.9679595596722654,18,15,3,38,0.5456685755803271,0.009558446625463252
경제/NNG@$소비/NNG@$투자/NNG,1,0.9674077713138205,23,19,4,21,0.6262724895150287,0.011149049796002598
대내외/NNG@$위험/NNG@$요인/NNG,1,0.9674077713138205,23,19,4,29,0.6262724895150287,0.011149049796002598
위안화/NNG@$변동/NNG@$확대/NNG,1,0.965127466178642,37,30,7,39,0.8064085152979804,0.01530798157504312
수출/NNG@$높/VA@$증가세/NNG,1,0.9619631071727011,27,22,5,11,0.6819767830552033,0.01406636575335379
금리/NNG@$인상/NNG@$부작용/NNG,1,0.9619631071727011,27,22,5,41,0.6819767830552033,0.01406636575335379
경기/NNG@$회복세/NNG@$지속/NNG@$도움/NNG@$방향/NNG,1,0.9600540837918983,22,18,4,29,0.6064550243115948,0.013111325174794249
회복세/NNG@$지속/NNG@$도움/NNG@$방향/NNG,1,0.9600540837918983,22,18,4,29,0.6064550243115948,0.013111325174794249
경기/NNG@$상승세/NNG@$지속/NNG@$수요/NNG,1,0.9600540837918983,22,18,4,21,0.6064550243115948,0.013111325174794249
지속/NNG@$도움/NNG@$방향/NNG,1,0.9600540837918983,22,18,4,30,0.6064550243115948,0.013111325174794249
외국인/NNG@$증권/NNG@$투자/NNG@$자금/NNG@$유출/NNG,0,0.9598878735527603,12,10,2,21,0.4394564706468087,0.009538942904068471
증권/NNG@$투자/NNG@$자금/NNG@$유출/NNG,0,0.9598878735527603,12,10,2,23,0.4394564706468087,0.009538942904068471
금리/NNG@$인상/NNG@$유동성/NNG,1,0.9592119575206686,92,73,19,75,0.9926749742847809,0.021897022274335383
상승/NNG@$압력/NNG@$증대/NNG,1,0.9586379103948817,17,14,3,28,0.5245453310828727,0.011727815418382043
기준금리/NNG@$유지/NNG@$경제/NNG,1,0.9586379103948817,17,14,3,18,0.5245453310828727,0.011727815418382043
경제/NNG@$견조/NNG@$성장/NNG@$지속/NNG@$물가/NNG,1,0.9583139201056152,63,50,13,29,0.960760747147009,0.021643200343938077
상승/NNG@$수요/NNG@$압력/NNG,1,0.9579520911315977,31,25,6,44,0.7328060587272515,0.016646461128191965
매출액/NNG@$기준/NNG@$기업/NNG,1,0.954695051996354,26,21,5,26,0.6635485488212218,0.016203615160202776
전망/NNG@$불확실성/NNG@$높/VA,1,0.954695051996354,26,21,5,34,0.6635485488212218,0.016203615160202776
인상/NNG@$금융/NNG@$위기/NNG,1,0.954695051996354,26,21,5,25,0.6635485488212218,0.016203615160202776
채권/NNG@$시장/NNG@$주식시장/NNG,1,0.945762301719419,16,13,3,36,0.5031914406145854,0.014653512606467758
석유류/NNG@$가격/NNG@$상승/NNG,1,0.945762301719419,16,13,3,20,0.5031914406145854,0.014653512606467758
공급/NNG@$물가/NNG@$상승/NNG@$압력/NNG,1,0.945762301719419,16,13,3,42,0.5031914406145854,0.014653512606467758
양적완화/NNG@$축소/NNG@$시기/NNG,1,0.945762301719419,16,13,3,28,0.5031914406145854,0.014653512606467758
물가/NNG@$기준금리/NNG@$인상/NNG,1,0.9456533723348315,25,20,5,40,0.6445812000105668,0.01880807159631626
금리/NNG@$인상/NNG@$통한/VV,1,0.9456533723348315,25,20,5,47,0.6445812000105668,0.01880807159631626
상승/NNG@$압력/NNG@$크/VA@$않/VX@$전망/NNG,1,0.9448832749553733,42,33,9,23,0.8412555951774819,0.024889500407975468
유동성/NNG@$증가/NNG@$속도/NNG,1,0.9444604430091057,59,46,13,34,0.9424549137677324,0.028094535526906064
경로/NNG@$크/VA@$벗어나/VV@$않/VX,1,0.9426406572442574,29,23,6,32,0.6986079959801108,0.021499195153430233
통화정책/NNG@$완화/NNG@$축소/NNG,1,0.9381809499497371,20,16,4,21,0.5655693159705585,0.018746007030949804
생산자/NNG@$물가/NNG@$상승/NNG,1,0.9368265571051837,49,38,11,80,0.8893993934362331,0.030121832210482254
지속/NNG@$수요/NNG@$압력/NNG,1,0.9324479318722101,28,22,6,21,0.6806079152858424,0.024644441799277533
삭제/NNG@$금리/NNG@$인상/NNG,1,0.9324479318722101,28,22,6,74,0.6806079152858424,0.024644441799277533
압력/NNG@$크/VA@$않/VX@$전망/NNG,1,0.9306401251669916,48,37,11,25,0.8800901408310335,0.03272125138050661
인상/NNG@$속도/NNG@$시장/NNG,0,0.9276660235223695,15,12,3,24,0.4816535343278876,0.01867810982329819
수요/NNG@$물가/NNG@$상승/NNG@$압력/NNG@$크/VA,1,0.923684073614286,47,36,11,33,0.8701950403696148,0.035615944205365256
기준금리/NNG@$인상/NNG@$이뤄질/VV,1,0.9218663781866718,19,15,4,43,0.5445754151843629,0.022824727703687167
금리/NNG@$인상/NNG@$늦/VA,1,0.9218663781866718,19,15,4,35,0.5445754151843629,0.022824727703687167
회복/NNG@$기조/NNG@$유지/NNG,1,0.9218663781866718,19,15,4,27,0.5445754151843629,0.022824727703687167
증가/NNG@$경기/NNG@$회복/NNG,1,0.9218663781866718,19,15,4,34,0.5445754151843629,0.022824727703687167
물가/NNG@$상승/NNG@$압력/NNG@$커질/VV,1,0.9215733821348686,35,27,8,33,0.7614487651841412,0.03203544732352667
기조/NNG@$유지/NNG@$기준금리/NNG,1,0.9215733821348686,35,27,8,25,0.7614487651841412,0.03203544732352667
우려/NNG@$경기/NNG@$회복/NNG,1,0.9200377501169965,23,18,5,30,0.6051288827469741,0.02596298294278918
상승세/NNG@$지속/NNG@$수요/NNG,1,0.9200377501169965,23,18,5,22,0.6051288827469741,0.02596298294278918
가격/NNG@$경쟁력/NNG@$약화/NNG,1,0.9158493292638095,46,35,11,45,0.8596947444321925,0.038844576990470704
콜금리/NNG@$인상/NNG@$경기/NNG,1,0.9158493292638095,46,35,11,35,0.8596947444321925,0.038844576990470704
콜/NNG@$목표/NNG@$금리/NNG,1,0.9090251129772049,49,37,12,29,0.8777826198713645,0.0429404170554831
경제/NNG@$성장/NNG@$뒷받침/NNG,1,0.9090251129772049,49,37,12,28,0.8777826198713645,0.0429404170554831
경기/NNG@$회복/NNG@$확신/NNG,1,0.9089205131930942,80,60,20,66,0.9767808393126555,0.04783945337378023
불안/NNG@$요인/NNG@$남/VV,1,0.9076383948765814,30,23,7,39,0.6967525473265536,0.034615669418549655
인상/NNG@$물가/NNG@$상승/NNG@$압력/NNG,1,0.9047193013774999,26,20,6,25,0.6428805752008575,0.032973102558542994
물가/NNG@$수요/NNG@$압력/NNG,1,0.9047193013774999,26,20,6,20,0.6428805752008575,0.032973102558542994
경제/NNG@$견실/XR@$성장세/NNG,1,0.9047193013774999,26,20,6,48,0.6428805752008575,0.032973102558542994
물가/NNG@$낮/VA@$유지/NNG,1,0.9047193013774999,26,20,6,20,0.6428805752008575,0.032973102558542994
금융/NNG@$경제/NNG@$고려/NNG,1,0.9046143546949881,87,65,22,62,0.9811723477221527,0.05038077875211562
동결/NNG@$기준금리/NNG@$인상/NNG,1,0.9019187415323451,22,17,5,46,0.5846985169852734,0.030893799353354377
달러화/NNG@$약세/NNG@$지속/NNG,0,0.9018282554806223,14,11,3,36,0.4599735246558492,0.02432672084321413
금융/NNG@$외환시장/NNG@$불안/NNG,0,0.9018282554806223,14,11,3,31,0.4599735246558492,0.02432672084321413
해외/NNG@$위험/NNG@$요인/NNG@$상존/NNG,1,0.9011383449230019,37,28,9,25,0.7743828626549997,0.04125074255450517
금리/NNG@$동반/NNG@$상승/NNG,1,0.9001836299889652,18,14,4,32,0.5232637381253312,0.028150652907673827
경기/NNG@$해외/NNG@$위험/NNG@$요인/NNG@$상존/NNG,1,0.8970402406277178,33,25,8,25,0.7291122020311929,0.0404976555579989
대응/NNG@$금리/NNG@$인상/NNG,1,0.8938118368014314,51,38,13,78,0.8846285965649475,0.050726913135834
금리/NNG@$인상/NNG@$증시/NNG,1,0.8919994212229094,29,22,7,40,0.678554568783574,0.03959715499268057
콜금리/NNG@$인상/NNG@$결정/NNG,1,0.891645954452827,73,54,19,34,0.9633874948082818,0.056409082640335485
기준금리/NNG@$인상/NNG@$물가/NNG,1,0.8822447033880729,57,42,15,61,0.9123222922171904,0.05824109987545659
위험/NNG@$금리/NNG@$인상/NNG,1,0.8799641924006718,39,29,10,29,0.7863921115636371,0.05121644274453776
변화/NNG@$없/VA@$예상/NNG,1,0.8788482732432121,21,16,5,33,0.5638360988110025,0.03707830909689901
유지/NNG@$기준금리/NNG@$동결/NNG,1,0.8788482732432121,21,16,5,34,0.5638360988110025,0.03707830909689901
필요/NNG@$있/VA@$통화정책/NNG,1,0.8732132588303849,28,21,7,22,0.6597459869531435,0.04549989739772998
재정/NNG@$건전성/NNG@$확보/NNG,1,0.872571272965684,35,26,9,51,0.7429453465212864,0.051509992734803146
하방/NNG@$위험/NNG@$남/VV,1,0.871190908537409,17,13,4,35,0.5016678639420015,0.035177314265257796
확대/NNG@$해석/NNG@$경계/NNG,1,0.8667050371280143,45,33,12,57,0.8337199806547311,0.060604346974413276
회복세/NNG@$지속/NNG@$경제/NNG,0,0.8645041001241569,13,10,3,39,0.43818258634337764,0.0324068118646351
금리/NNG@$동결/NNG@$요인/NNG,1,0.8630440605636129,31,23,8,46,0.694136403024642,0.05192049641670177
엔/NNG@$캐리/NNG@$자금/NNG,1,0.8630440605636129,31,23,8,19,0.694136403024642,0.05192049641670177
달러화/NNG@$약세/NNG@$보이/VV,1,0.8627600269321276,24,18,6,38,0.6029727316377684,0.04520035892982675
인상/NNG@$소비자/NNG@$물가/NNG,1,0.8547812709361764,34,25,9,50,0.7261979663524376,0.057794610211736874
선제적/NNG@$대응/NNG@$필요/NNG,1,0.8547812709361764,34,25,9,24,0.7261979663524376,0.057794610211736874
기준금리/NNG@$인상/NNG@$결정/NNG,1,0.8538306328529219,118,85,33,96,0.9785917512263463,0.07842299799649023
예상/NNG@$소비자/NNG@$물가/NNG,1,0.8527374779449048,44,32,12,48,0.8210574701784773,0.06632150934418693
소비자/NNG@$물가/NNG@$석유류/NNG,1,0.849426446116601,20,15,5,13,0.5425678425307082,0.04487578591530782
서비스수지/NNG@$적자/NNG@$확대/NNG,1,0.849426446116601,20,15,5,30,0.5425678425307082,0.04487578591530782
경기동행지수/NNG@$순환/NNG@$변동치/NNG,1,0.849426446116601,20,15,5,23,0.5425678425307082,0.04487578591530782
충격/NNG@$크/VA@$않/VX,1,0.848503731459346,64,46,18,77,0.9294903760922301,0.07738033038489989
국제금융시장/NNG@$불안/NNG@$경기/NNG,1,0.8413803129880377,30,22,8,23,0.6756670813759861,0.05907996969636779
소비자/NNG@$물가/NNG@$안정세/NNG,1,0.837072139928764,43,31,12,43,0.807699452281475,0.07268391204421763
금리/NNG@$인상/NNG@$가계부채/NNG,1,0.837072139928764,43,31,12,49,0.807699452281475,0.07268391204421763
자본/NNG@$유출입/NNG@$규제/NNG,1,0.8363472578859636,73,52,21,79,0.9497015597493863,0.08587099916337906
물가/NNG@$자산/NNG@$가격/NNG,1,0.8344094909666704,56,40,16,29,0.89246401322757,0.08172329142007408
경제/NNG@$성장/NNG@$부진/NNG,1,0.8342243699744671,23,17,6,38,0.5822494311863913,0.053380940303554524
호조/NNG@$지속/NNG@$경제/NNG,1,0.8341566636798812,33,24,9,22,0.7087614610943126,0.0650081835954757
금리/NNG@$인상/NNG@$배경/NNG,1,0.8341566636798812,33,24,9,48,0.7087614610943126,0.0650081835954757
물가/NNG@$상승/NNG@$기대/NNG,1,0.8325900792263641,46,33,13,83,0.8299888586194321,0.07690159364840254
경기/NNG@$상승/NNG@$수요/NNG@$압력/NNG,0,0.8323539674294833,16,12,4,36,0.47981354531525755,0.04452406551874401
상승/NNG@$압력/NNG@$커질/VV,1,0.8305402992529445,59,42,17,54,0.9052231431775479,0.08497952240120238
콜금리/NNG@$목표/NNG@$인상/NNG,1,0.8276980792595334,96,68,28,48,0.9708287753766065,0.09278927012855642
체감/NNG@$경기/NNG@$개선/NNG,1,0.8268464374016471,62,44,18,34,0.9162377101954934,0.08803940051730602
경제/NNG@$전망/NNG@$통화정책/NNG,1,0.8235852277858078,39,28,11,58,0.767786041546627,0.07527948823659614
성장세/NNG@$둔화/NNG@$가능성/NNG,1,0.8235401943336496,26,19,7,16,0.6203443167294206,0.06084001458610335
주택/NNG@$가격/NNG@$상승률/NNG,1,0.819511375864387,42,30,12,42,0.793629011499824,0.07976381677049482
물가/NNG@$상승률/NNG@$금리/NNG,1,0.8158954398498222,29,21,8,42,0.6565502684891951,0.0674249778325425
물가/NNG@$잡/VV@$금리/NNG,1,0.8158954398498222,29,21,8,41,0.6565502684891951,0.0674249778325425
동결/NNG@$경기/NNG@$둔화/NNG,1,0.8158954398498222,29,21,8,29,0.6565502684891951,0.0674249778325425
통화정책/NNG@$완화/NNG@$기조/NNG@$유지/NNG,1,0.8133313039894847,74,52,22,77,0.9459331571510953,0.09861785941429022
성장세/NNG@$둔화/NNG@$우려/NNG,1,0.811975542078939,19,14,5,35,0.5209151117222429,0.05473803412957231
민간/NNG@$자생력/NNG@$회복/NNG,1,0.811975542078939,19,14,5,72,0.5209151117222429,0.05473803412957231
지속/NNG@$성장잠재력/NNG@$훼손/NNG@$않/VX,0,0.8104049915075606,12,9,3,43,0.41629016731712604,0.044142941520120285
실물/NNG@$지표/NNG@$개선/NNG,1,0.8102796719628855,32,23,9,16,0.6906348074067951,0.07328700113639823
확장적/NNG@$정책/NNG@$기조/NNG,1,0.8102796719628855,32,23,9,49,0.6906348074067951,0.07328700113639823
이자/NNG@$부담/NNG@$증가/NNG,1,0.8102796719628855,32,23,9,49,0.6906348074067951,0.07328700113639823
국면/NNG@$예고/NNG@$선행지수/NNG,1,0.8068866116473536,54,38,16,23,0.873540843418679,0.09450998759212408
경기/NNG@$국면/NNG@$예고/NNG@$선행지수/NNG,1,0.8068866116473536,54,38,16,23,0.873540843418679,0.09450998759212408
관심/NNG@$금리/NNG@$인상/NNG,1,0.8060127495110512,35,25,10,37,0.7224338471486133,0.07854869186296444
기준금리/NNG@$인상/NNG@$여부/NNG@$결정/NNG,1,0.8060127495110512,35,25,10,36,0.7224338471486133,0.07854869186296444
경제/NNG@$호조/NNG@$지속/NNG,1,0.8060127495110512,35,25,10,33,0.7224338471486133,0.07854869186296444
경기/NNG@$회복/NNG@$불확실성/NNG,1,0.8026374069769604,38,27,11,41,0.75184689516309,0.08330704246884327
주식/NNG@$투자/NNG@$자금/NNG,1,0.8026374069769604,38,27,11,57,0.75184689516309,0.08330704246884327
경제/NNG@$영향/NNG@$제한적/NNG,1,0.7998452809232222,41,29,12,61,0.778830154796829,0.08763850424092662
인상/NNG@$크/VA@$않/VX,1,0.7991777957098978,22,16,6,33,0.5610361720744264,0.06336254138732372
변동성/NNG@$확대/NNG@$경제/NNG,1,0.7991777957098978,22,16,6,46,0.5610361720744264,0.06336254138732372
통화정책/NNG@$기준금리/NNG@$인상/NNG,1,0.7974277833350123,44,31,13,77,0.8033885962470061,0.09160368303882577
유지/NNG@$민간/NNG@$소비/NNG,1,0.7911188772387692,25,18,7,22,0.5997745391048143,0.07073995942665177
영향/NNG@$크/VA@$않/VX@$전망/NNG,1,0.7911188772387692,25,18,7,27,0.5997745391048143,0.07073995942665177
금리/NNG@$인상/NNG@$배제/NNG,1,0.7911188772387692,25,18,7,31,0.5997745391048143,0.07073995942665177
금리/NNG@$주가/NNG@$환율/NNG,1,0.7911188772387692,25,18,7,20,0.5997745391048143,0.07073995942665177
기준금리/NNG@$인상/NNG@$지연/NNG,1,0.7911188772387692,25,18,7,45,0.5997745391048143,0.07073995942665177
규모/NNG@$자본/NNG@$유출/NNG,1,0.7911188772387692,25,18,7,24,0.5997745391048143,0.07073995942665177
매파적/NNG@$금리/NNG@$인상/NNG,1,0.7860037243023583,28,20,8,23,0.6367914365289821,0.07714408407066128
방향/NNG@$논의/NNG@$기준금리/NNG,1,0.7860037243023583,28,20,8,32,0.6367914365289821,0.07714408407066128
통화정책/NNG@$방향/NNG@$논의/NNG@$기준금리/NNG,1,0.7860037243023583,28,20,8,32,0.6367914365289821,0.07714408407066128
가계/NNG@$실질/NNG@$구매력/NNG,1,0.7827087144368656,31,22,9,29,0.6718177124839825,0.08277902746293665
금리/NNG@$인상/NNG@$원화/NNG,1,0.7827087144368656,31,22,9,44,0.6718177124839825,0.08277902746293665
금리/NNG@$인상/NNG@$시그널/NNG,1,0.7794742698706758,113,78,35,104,0.9652513911419912,0.12090488536069349
경제/NNG@$성장/NNG@$둔화/NNG@$우려/NNG,1,0.7790041339410683,37,26,11,64,0.7351684165348247,0.09230383165091122
기준금리/NNG@$인상/NNG@$가능성/NNG@$시사/NNG,1,0.7778555202383899,40,28,12,42,0.76328782171754,0.09638921485753373
민간/NNG@$소비/NNG@$증가/NNG,1,0.7778555202383899,40,28,12,63,0.76328782171754,0.09638921485753373
문제/NNG@$국제금융시장/NNG@$불안/NNG,1,0.7768946728837518,43,30,13,15,0.7889927951215542,0.10011563709341555
시장/NNG@$콜금리/NNG@$인상/NNG,1,0.7751074964945424,49,34,15,30,0.8332954557549827,0.10668231382712949
경제/NNG@$완만/XR@$성장/NNG,1,0.7751074964945424,49,34,15,40,0.8332954557549827,0.10668231382712949
기조/NNG@$갈/VX@$전망/NNG,1,0.773141250876094,55,38,17,47,0.8686690992595674,0.11229723143431557
경제/NNG@$불확실성/NNG@$확대/NNG,0,0.7646251089481542,18,13,5,36,0.49888984916612417,0.06721197676610197
양적완화/NNG@$종료/NNG@$금리/NNG,0,0.7646251089481542,18,13,5,33,0.49888984916612417,0.06721197676610197
거시/NNG@$경제/NNG@$금융/NNG,0,0.7646251089481542,18,13,5,58,0.49888984916612417,0.06721197676610197
금리/NNG@$인상/NNG@$할/VV,1,0.76029077337635,101,69,32,125,0.9592445267402983,0.13191158896569052
수출/NNG@$민간/NNG@$소비/NNG,1,0.7564140625839386,21,15,6,22,0.5393441585432214,0.07552217775752015
요인/NNG@$크/VA@$않/VX,1,0.7564140625839386,21,15,6,31,0.5393441585432214,0.07552217775752015
규모/NNG@$자산/NNG@$매입/NNG@$프로그램/NNG,1,0.7564140625839386,21,15,6,49,0.5393441585432214,0.07552217775752015
물가/NNG@$목표/NNG@$하단/NNG,1,0.7564140625839386,21,15,6,33,0.5393441585432214,0.07552217775752015
기준금리/NNG@$인하/NNG@$추가경정예산/NNG,1,0.7564140625839386,21,15,6,46,0.5393441585432214,0.07552217775752015
금리/NNG@$인상/NNG@$확대/NNG,1,0.7564140625839386,21,15,6,34,0.5393441585432214,0.07552217775752015
성장/NNG@$모멘텀/NNG@$유지/NNG,1,0.7564140625839386,21,15,6,18,0.5393441585432214,0.07552217775752015
저금리/NNG@$기조/NNG@$장기화/NNG,1,0.7564140625839386,21,15,6,41,0.5393441585432214,0.07552217775752015
인상/NNG@$쉽/VA@$않/VX,1,0.7556690456234674,91,62,29,99,0.9534370525610623,0.13396701191796445
주택/NNG@$담보대출/NNG@$증가/NNG,1,0.7551598643260744,60,41,19,76,0.8872668234646177,0.12496292910051307
필요성/NNG@$크/VA@$않/VX,1,0.7533210677302165,39,27,12,59,0.74698784925198,0.10609942432412457
동결/NNG@$경기/NNG@$회복/NNG,1,0.7525476281248344,24,17,7,42,0.5786377478776795,0.0824791272895785
자금/NNG@$채권/NNG@$시장/NNG,1,0.7525476281248344,24,17,7,25,0.5786377478776795,0.0824791272895785
속도/NNG@$완만/XR@$예상/NNG,1,0.7525476281248344,24,17,7,32,0.5786377478776795,0.0824791272895785
금리/NNG@$하락/NNG@$압력/NNG,1,0.7525476281248344,24,17,7,33,0.5786377478776795,0.0824791272895785
증권/NNG@$기준금리/NNG@$인상/NNG,1,0.751560667581239,33,23,10,33,0.6861472488756641,0.09824513377625221
거시/NNG@$정책/NNG@$기조/NNG@$유지/NNG,1,0.7511102532620997,27,19,8,29,0.616395116702293,0.08843894745844828
환율/NNG@$금리/NNG@$인상/NNG,1,0.7511102532620997,27,19,8,41,0.616395116702293,0.08843894745844828
해외/NNG@$자금/NNG@$유입/NNG,1,0.7511102532620997,27,19,8,60,0.616395116702293,0.08843894745844828
물가/NNG@$상방/NNG@$리스크/NNG,1,0.7511102532620997,27,19,8,14,0.616395116702293,0.08843894745844828
필요/NNG@$있/VA@$의견/NNG@$제시/NNG,0,0.7328993359658704,11,8,3,13,0.39426264924885424,0.0613039766071171
금리/NNG@$인상/NNG@$보/VV,1,0.7315729980269008,44,30,14,55,0.7835434000443823,0.12252656708719685
주택/NNG@$가격/NNG@$상승세/NNG,1,0.7315729980269008,44,30,14,76,0.7835434000443823,0.12252656708719685
성장/NNG@$둔화/NNG@$가능성/NNG,1,0.7260261515790465,38,26,12,42,0.7299168736666058,0.11685227163053684
금리/NNG@$동결/NNG@$인상/NNG,1,0.7260261515790465,38,26,12,69,0.7299168736666058,0.11685227163053684
인상/NNG@$원화/NNG@$강세/NNG,1,0.7260261515790465,38,26,12,33,0.7299168736666058,0.11685227163053684
저금리/NNG@$기조/NNG@$유지/NNG,1,0.7239455149092779,159,107,52,263,0.956049852216018,0.154391971856032
금융시장/NNG@$불안/NNG@$모습/NNG,1,0.7225966565221684,35,24,11,26,0.6995546220136065,0.11360670959049878
예상/NNG@$물가/NNG@$상승률/NNG,1,0.7187882921521369,32,22,10,45,0.6669078184148842,0.11002196450491819
경제/NNG@$전망/NNG@$경기/NNG,1,0.7187882921521369,32,22,10,39,0.6669078184148842,0.11002196450491819
체감/NNG@$경기/NNG@$좋/VA,1,0.7187882921521369,32,22,10,23,0.6669078184148842,0.11002196450491819
상하/NNG@$종합/NNG@$지수/NNG,1,0.7147260480381485,29,20,9,22,0.6321105605460846,0.10602526519706502
경기/NNG@$완만/XR@$회복세/NNG,1,0.7147260480381485,29,20,9,55,0.6321105605460846,0.10602526519706502
예상/NNG@$금리/NNG@$인상/NNG@$가능성/NNG,1,0.7147260480381485,29,20,9,28,0.6321105605460846,0.10602526519706502
수요/NNG@$압력/NNG@$높/VA,1,0.7147260480381485,29,20,9,15,0.6321105605460846,0.10602526519706502
물가/NNG@$오름세/NNG@$지속/NNG,0,0.7125976862995473,14,10,4,36,0.43534520813141764,0.07365294626830661
인플레율/NNG@$억제/NNG@$기준치/NNG@$허용/NNG@$한도/NNG,0,0.7125976862995473,14,10,4,56,0.43534520813141764,0.07365294626830661
불안/NNG@$모습/NNG@$보이/VV,1,0.7102885775863741,78,52,26,73,0.9270255869044844,0.15829967005682063
원자재/NNG@$가격/NNG@$오르/VV,1,0.7101072050228983,46,31,15,29,0.7924262173504237,0.13541372882778338
금리/NNG@$인상/NNG@$전제/NNG,1,0.7070566707359969,23,16,7,45,0.5569372093158207,0.09633711040698244
소비/NNG@$설비투자/NNG@$내수/NNG,1,0.7070566707359969,23,16,7,30,0.5569372093158207,0.09633711040698244
인플레이션/NNG@$우려/NNG@$금리/NNG@$인상/NNG,1,0.7070566707359969,23,16,7,41,0.5569372093158207,0.09633711040698244
금리/NNG@$역전/NNG@$자본/NNG,0,0.7055453023089879,17,12,5,34,0.4764874126654484,0.0829162772376937
기조/NNG@$유지/NNG@$바람직/XR,0,0.7055453023089879,17,12,5,27,0.4764874126654484,0.0829162772376937
물가/NNG@$목표/NNG@$소비자/NNG,0,0.7055453023089879,17,12,5,30,0.4764874126654484,0.0829162772376937
가격/NNG@$변동성/NNG@$확대/NNG,0,0.7055453023089879,17,12,5,24,0.4764874126654484,0.0829162772376937
회복/NNG@$지연/NNG@$가능성/NNG,1,0.7047968513820648,20,14,6,35,0.5171749171835451,0.09026300983951048
경기/NNG@$개선/NNG@$추세/NNG,1,0.7047968513820648,20,14,6,29,0.5171749171835451,0.09026300983951048
금리/NNG@$하락/NNG@$마감/NNG,1,0.7047968513820648,20,14,6,48,0.5171749171835451,0.09026300983951048
자산/NNG@$매입/NNG@$확대/NNG,1,0.7047968513820648,20,14,6,45,0.5171749171835451,0.09026300983951048
기준금리/NNG@$동결/NNG@$기조/NNG,1,0.7013358634065854,40,27,13,66,0.7412104240992388,0.13113448713847894
상태/NNG@$금리/NNG@$인상/NNG,1,0.7013358634065854,40,27,13,38,0.7412104240992388,0.13113448713847894
필요/NNG@$있/VA@$금리/NNG@$인상/NNG,1,0.6957705434963617,37,25,12,51,0.7120621454966042,0.12872695273961093
물가/NNG@$오르/VV@$않/VX,1,0.6893191534956509,34,23,11,40,0.6806010097791674,0.12610733274900163
인상/NNG@$경기/NNG@$회복/NNG,1,0.6870300810564312,97,64,33,88,0.9413818829054349,0.17594040605135097
유지/NNG@$경기/NNG@$회복세/NNG,1,0.6819194577291479,31,21,10,48,0.6469303225843991,0.12324090427276653
흑자/NNG@$기조/NNG@$유지/NNG,1,0.6819194577291479,31,21,10,43,0.6469303225843991,0.12324090427276653
신호/NNG@$보내/VV@$않/VX,1,0.6819194577291479,31,21,10,35,0.6469303225843991,0.12324090427276653
금리/NNG@$인하/NNG@$어려울/VA,1,0.6819194577291479,31,21,10,26,0.6469303225843991,0.12324090427276653
주택/NNG@$매매가격/NNG@$수도권/NNG,1,0.6819194577291479,31,21,10,33,0.6469303225843991,0.12324090427276653
경기/NNG@$회복/NNG@$국면/NNG,1,0.6744627409125812,67,44,23,98,0.889658849967484,0.17419578957618972
금리/NNG@$인상/NNG@$이유/NNG,1,0.6709407923964716,39,26,13,33,0.7236967369534559,0.14352368652755054
콜금리/NNG@$인상/NNG@$전망/NNG,1,0.6709407923964716,39,26,13,34,0.7236967369534559,0.14352368652755054
중소기업/NNG@$대출/NNG@$증가/NNG,1,0.6641998801303408,25,17,8,15,0.5736933065638988,0.11655857625272134
금리/NNG@$인상/NNG@$의미/NNG,1,0.6641998801303408,25,17,8,45,0.5736933065638988,0.11655857625272134
기조/NNG@$유지/NNG@$금리/NNG@$인상/NNG,1,0.6641998801303408,25,17,8,26,0.5736933065638988,0.11655857625272134
외환/NNG@$위기/NNG@$가능성/NNG,1,0.6641998801303408,25,17,8,27,0.5736933065638988,0.11655857625272134
금융시장/NNG@$기준금리/NNG@$인상/NNG,1,0.6641998801303408,25,17,8,32,0.5736933065638988,0.11655857625272134
물가/NNG@$상승/NNG@$목표/NNG,1,0.6641998801303408,25,17,8,43,0.5736933065638988,0.11655857625272134
금리/NNG@$인상/NNG@$명분/NNG,1,0.6640415641196316,47,31,16,56,0.7857310871973693,0.1597286843496107
수출/NNG@$높/VA@$신장세/NNG,1,0.6640415641196316,47,31,16,22,0.7857310871973693,0.1597286843496107
금리/NNG@$인상/NNG@$가계/NNG,1,0.6640415641196316,47,31,16,49,0.7857310871973693,0.1597286843496107
경제/NNG@$기준금리/NNG@$인상/NNG,1,0.6632023131636742,58,38,20,75,0.8502929098577946,0.17336933464574644
경기/NNG@$회복세/NNG@$가시화/NNG,1,0.654052223113877,22,15,7,27,0.5346671184098546,0.11257472756509747
경기/NNG@$나쁘/VA@$않/VX,1,0.654052223113877,22,15,7,28,0.5346671184098546,0.11257472756509747
점진적/NNG@$기준금리/NNG@$인상/NNG,1,0.654052223113877,22,15,7,38,0.5346671184098546,0.11257472756509747
원화/NNG@$가치/NNG@$절상/NNG,1,0.652384486126856,33,22,11,66,0.6608704577682856,0.13995412728976042
물가/NNG@$압력/NNG@$완화/NNG,1,0.652384486126856,33,22,11,29,0.6608704577682856,0.13995412728976042
경기/NNG@$회복/NNG@$자신감/NNG,1,0.6499495270199003,94,61,33,75,0.9303087528892503,0.19867678741419414
경기/NNG@$회복/NNG@$물가/NNG@$상승/NNG,1,0.6479277483033064,41,27,14,31,0.7344885181025718,0.15795056141701258
완화/NNG@$기조/NNG@$유지/NNG,1,0.6472795434898879,166,108,58,187,0.9399823896066973,0.20259094430333316
예상/NNG@$좋/VA@$실적/NNG,0,0.6434832773124839,19,13,6,40,0.49451379804049256,0.10796868684104025
결정/NNG@$기준금리/NNG@$유지/NNG,0,0.6434832773124839,19,13,6,31,0.49451379804049256,0.10796868684104025
콜금리/NNG@$인상/NNG@$단행/NNG,1,0.6411195119102013,57,37,20,43,0.8384680644710261,0.18453606443076404
결정/NNG@$영향/NNG@$않/VX,1,0.6407355564370738,30,20,10,24,0.6262073796606084,0.13799893776595093
상승률/NNG@$목표/NNG@$달성/NNG,1,0.6407355564370738,30,20,10,31,0.6262073796606084,0.13799893776595093
물가/NNG@$상승률/NNG@$목표/NNG@$달성/NNG,1,0.6407355564370738,30,20,10,31,0.6262073796606084,0.13799893776595093
상승/NNG@$원화/NNG@$가치/NNG,1,0.6407355564370738,30,20,10,25,0.6262073796606084,0.13799893776595093
압력/NNG@$높/VA@$금리/NNG,1,0.637713562658426,38,25,13,39,0.7053640758859318,0.1570307186323361
경제/NNG@$성장/NNG@$전망치/NNG,1,0.637713562658426,38,25,13,52,0.7053640758859318,0.1570307186323361
위험/NNG@$요인/NNG@$영향/NNG,1,0.636364822060679,46,30,16,48,0.7701204679269918,0.17222280169228613
결정/NNG@$금융/NNG@$통화/NNG,1,0.636364822060679,46,30,16,50,0.7701204679269918,0.17222280169228613
시중/NNG@$유동성/NNG@$흡수/NNG,1,0.6353161024529057,76,49,27,30,0.9020299948264411,0.2024294264301054
금융/NNG@$위기/NNG@$통화정책/NNG,0,0.6333900966617851,16,11,5,33,0.4536750045364521,0.102466415736225
중소기업/NNG@$금융/NNG@$지원/NNG,0,0.6333900966617851,16,11,5,42,0.4536750045364521,0.102466415736225
통화정책/NNG@$기조/NNG@$경기/NNG,0,0.6333900966617851,16,11,5,37,0.4536750045364521,0.102466415736225
지속/NNG@$필요/NNG@$있/VA,0,0.6333900966617851,16,11,5,31,0.4536750045364521,0.102466415736225
물가/NNG@$상승률/NNG@$기준/NNG,1,0.6271915147170013,27,18,9,34,0.5896197920030378,0.135923069322133
소비자/NNG@$물가/NNG@$수요/NNG,1,0.6271915147170013,27,18,9,16,0.5896197920030378,0.135923069322133
기대/NNG@$심리/NNG@$확산/NNG,1,0.6271915147170013,27,18,9,31,0.5896197920030378,0.135923069322133
필요/NNG@$있/VA@$생각/NNG,1,0.6271915147170013,27,18,9,36,0.5896197920030378,0.135923069322133
인플레/NNG@$우려/NNG@$금리/NNG,1,0.6265452211825755,43,28,15,40,0.7444697953195453,0.17198398435755397
해외/NNG@$위험/NNG@$요인/NNG@$영향/NNG,1,0.6265452211825755,43,28,15,42,0.7444697953195453,0.17198398435755397
기조/NNG@$유지/NNG@$경제/NNG,1,0.6264949269214743,51,33,18,55,0.8004805744022347,0.18495379577862414
기준금리/NNG@$인상/NNG@$경기/NNG,1,0.6264949269214743,51,33,18,64,0.8004805744022347,0.18495379577862414
물가/NNG@$농산물/NNG@$가격/NNG,0,0.6258227853071421,13,9,4,17,0.4126489387731425,0.09555389352211148
금리/NNG@$인상/NNG@$인하/NNG,1,0.6249465371648708,59,38,21,77,0.8429022102379486,0.19574386068144545
금리/NNG@$인상/NNG@$기준금리/NNG,1,0.6249465371648708,59,38,21,79,0.8429022102379486,0.19574386068144545
수출/NNG@$부진/NNG@$지속/NNG,1,0.6220171718437872,67,43,24,64,0.873551321022573,0.20480465639845585
채권/NNG@$시장/NNG@$금리/NNG@$인상/NNG,1,0.6180449416452387,75,48,27,75,0.8946144018552238,0.21245303846742924
인상/NNG@$시장/NNG@$금리/NNG,1,0.6180449416452387,75,48,27,69,0.8946144018552238,0.21245303846742924
물가/NNG@$안정세/NNG@$보이/VV,1,0.6173171338814565,48,31,17,57,0.7782173980054025,0.1852442853412881
경기/NNG@$부정적/NNG@$영향/NNG,1,0.6161772212527026,64,41,23,55,0.8610416778100719,0.20571108443777564
목표/NNG@$금리/NNG@$인상/NNG,1,0.6150459796801118,40,26,14,41,0.7164879391774068,0.17179733522143148
기준금리/NNG@$동결/NNG@$경제/NNG,1,0.6133032846649642,72,46,26,79,0.8857320120779216,0.2135639072532704
소비/NNG@$지출/NNG@$기업/NNG,1,0.6116632039155587,32,21,11,23,0.6403522343856796,0.1552074459436198
경기/NNG@$회복/NNG@$저해/NNG,1,0.6116632039155587,32,21,11,30,0.6403522343856796,0.1552074459436198
마지막/NNG@$금리/NNG@$인상/NNG,1,0.6116632039155587,32,21,11,36,0.6403522343856796,0.1552074459436198
기록/NNG@$소비자/NNG@$물가/NNG,1,0.6114742172527452,24,16,8,34,0.5513742960737662,0.13372143535782896
장단기/NNG@$금리/NNG@$격차/NNG,1,0.6114742172527452,24,16,8,41,0.5513742960737662,0.13372143535782896
비용/NNG@$상승/NNG@$압력/NNG,1,0.6114742172527452,24,16,8,31,0.5513742960737662,0.13372143535782896
금리/NNG@$인상/NNG@$서두르/VV@$않/VX,1,0.6114742172527452,24,16,8,53,0.5513742960737662,0.13372143535782896
재정위기/NNG@$경기/NNG@$둔화/NNG,1,0.6114742172527452,24,16,8,34,0.5513742960737662,0.13372143535782896
전망/NNG@$채권/NNG@$시장/NNG,1,0.6114742172527452,24,16,8,36,0.5513742960737662,0.13372143535782896
예상/NNG@$기준금리/NNG@$동결/NNG,1,0.6066164508322827,45,29,16,85,0.7536742984955759,0.1856144207696435
통화정책/NNG@$기조/NNG@$유지/NNG,1,0.6035496340909865,99,63,36,115,0.9213032651505189,0.2290930961932762
재정/NNG@$문제/NNG@$국제금융시장/NNG,1,0.6015676918356667,37,24,13,9,0.6861972345261347,0.17169108796694948
인상/NNG@$시중/NNG@$유동성/NNG,1,0.6015676918356667,37,24,13,24,0.6861972345261347,0.17169108796694948
물가/NNG@$상승/NNG@$압력/NNG@$지속/NNG,1,0.599371611615455,50,32,18,38,0.7856050291577545,0.19791166797463478
성장률/NNG@$전망치/NNG@$제시/NNG,1,0.5951215405190162,29,19,10,47,0.604728308165143,0.15436112229676507
경제/NNG@$완만/XR@$회복세/NNG@$갈/VX,1,0.5951215405190162,29,19,10,15,0.604728308165143,0.15436112229676507
경기/NNG@$둔화/NNG@$우려/NNG@$금리/NNG,1,0.5951215405190162,29,19,10,47,0.604728308165143,0.15436112229676507
금리/NNG@$올릴/VV@$있/VA,1,0.5951215405190162,29,19,10,23,0.604728308165143,0.15436112229676507
원화/NNG@$강세/NNG@$요인/NNG,1,0.5951215405190162,29,19,10,34,0.604728308165143,0.15436112229676507
경제성장률/NNG@$전망치/NNG@$상향/NNG@$조정/NNG,1,0.5941307877806221,42,27,15,78,0.7268131275600415,0.18609092610605465
통화정책/NNG@$금융/NNG@$경제/NNG,1,0.5941307877806221,42,27,15,26,0.7268131275600415,0.18609092610605465
가계부채/NNG@$상환/NNG@$부담/NNG,1,0.5932684229840242,21,14,7,22,0.5118069866308605,0.13138924839012114
흑자/NNG@$기조/NNG@$지속/NNG,1,0.5932684229840242,21,14,7,19,0.5118069866308605,0.13138924839012114
동향/NNG@$그린북/NNG@$경제/NNG,1,0.5927457813185497,55,35,20,40,0.8125480720157702,0.20892936633369846
금리/NNG@$인상/NNG@$임박/XR,1,0.5879811195431515,47,30,17,61,0.7621365991091438,0.198840776603437
기준금리/NNG@$동결/NNG@$배경/NNG,1,0.5870771565059361,76,48,28,83,0.887270957575721,0.23212519742380947
임금/NNG@$인상/NNG@$요구/NNG,1,0.5857425518560999,34,22,12,46,0.653669583328269,0.17170490605671637
콜금리/NNG@$동결/NNG@$가능성/NNG,1,0.5795426339052538,39,25,14,21,0.6976336426166846,0.1867095844325823
가격/NNG@$상승/NNG@$우려/NNG,1,0.5756136866267183,26,17,9,28,0.5673071148583851,0.153622488339636
금융/NNG@$경제/NNG@$위험/NNG@$요인/NNG,1,0.5756136866267183,26,17,9,35,0.5673071148583851,0.153622488339636
경제/NNG@$성장세/NNG@$완만/XR,1,0.5756136866267183,26,17,9,28,0.5673071148583851,0.153622488339636
금리/NNG@$인상/NNG@$반영/NNG,1,0.5747476843484631,44,28,16,53,0.736371264072759,0.19991819758788348
경기/NNG@$모멘텀/NNG@$둔화/NNG,0,0.5722201985499507,18,12,6,33,0.47131987464877695,0.12892214330461257
유로지역/NNG@$재정/NNG@$문제/NNG,0,0.5722201985499507,18,12,6,26,0.47131987464877695,0.12892214330461257
경제/NNG@$활력/NNG@$제고/NNG,0,0.5722201985499507,18,12,6,39,0.47131987464877695,0.12892214330461257
개선/NNG@$추세/NNG@$이어지/VV,0,0.5722201985499507,18,12,6,21,0.47131987464877695,0.12892214330461257
금리/NNG@$인상/NNG@$부정적/NNG,1,0.5704974937613732,49,31,18,83,0.7698916565750076,0.21166685292243417
상승/NNG@$압력/NNG@$지속/NNG,1,0.5683191687635636,83,52,31,59,0.8946621723377756,0.24755377055366884
금리/NNG@$하락/NNG@$추세/NNG,1,0.5671124875509967,31,20,11,20,0.6190330653239303,0.171895278760892
경제/NNG@$성장/NNG@$달성/NNG,1,0.5671124875509967,31,20,11,41,0.6190330653239303,0.171895278760892
경제/NNG@$안정적/NNG@$성장/NNG,1,0.5671124875509967,31,20,11,68,0.6190330653239303,0.171895278760892
시장/NNG@$금리/NNG@$인상/NNG@$전망/NNG,1,0.5671124875509967,31,20,11,20,0.6190330653239303,0.171895278760892
성장/NNG@$발목/NNG@$잡/VV,1,0.5671124875509967,31,20,11,45,0.6190330653239303,0.171895278760892
기준금리/NNG@$동결/NNG@$물가/NNG,1,0.5671124875509967,31,20,11,39,0.6190330653239303,0.171895278760892
기준금리/NNG@$인상/NNG@$통화정책/NNG,1,0.56637513807211,54,34,20,32,0.7983982136511243,0.2221820355129554
금리/NNG@$인상/NNG@$가능성/NNG@$배제/NNG@$없/VA,1,0.5624637255683929,36,23,13,47,0.6661805624835251,0.1875188352577518
금리/NNG@$인상/NNG@$쉽/VA@$않/VX,1,0.5621898137393206,59,37,22,59,0.8222288645296518,0.231628534517687
원화/NNG@$가치/NNG@$상승/NNG,1,0.5594929411563796,123,77,46,181,0.9165795319722982,0.260238680382896
경기/NNG@$불확실성/NNG@$높/VA,1,0.5593499183276043,41,26,15,46,0.708288470965611,0.20118328134117155
모기지/NNG@$금리/NNG@$상승/NNG,1,0.5567061413869843,46,29,17,119,0.7451948003076828,0.21329062427186707
가능성/NNG@$크/VA@$보/VX,1,0.5567061413869843,46,29,17,58,0.7451948003076828,0.21329062427186707
성장률/NNG@$기록/NNG@$전망/NNG,1,0.5567061413869843,46,29,17,66,0.7451948003076828,0.21329062427186707
인상/NNG@$단행/NNG@$예상/NNG,1,0.5567061413869843,46,29,17,72,0.7451948003076828,0.21329062427186707
성장률/NNG@$전망치/NNG@$낮/VA,1,0.5525014963091144,23,15,8,42,0.5283828051813954,0.15307430129153834
상승/NNG@$압력/NNG@$높/VA@$않/VX,1,0.5525014963091144,23,15,8,25,0.5283828051813954,0.15307430129153834
자본/NNG@$유출/NNG@$발생/NNG,1,0.5525014963091144,23,15,8,31,0.5283828051813954,0.15307430129153834
통화정책/NNG@$방향/NNG@$경기/NNG,1,0.5488359644469585,74,46,28,42,0.8700904464045374,0.2547228687808422
가격/NNG@$변수/NNG@$변동성/NNG@$확대/NNG,0,0.547937182836316,15,10,5,9,0.43037225005386315,0.12631631720125946
인상/NNG@$시기/NNG@$가능성/NNG,0,0.547937182836316,15,10,5,34,0.43037225005386315,0.12631631720125946
경상수지/NNG@$흑자/NNG@$축소/NNG,0,0.547937182836316,15,10,5,40,0.43037225005386315,0.12631631720125946
경기/NNG@$위축/NNG@$가능성/NNG,1,0.5450970537123507,28,18,10,26,0.5824769118316604,0.1723441526010399
변수/NNG@$변동성/NNG@$확대/NNG,1,0.5450970537123507,28,18,10,17,0.5824769118316604,0.1723441526010399
자산/NNG@$시장/NNG@$버블/NNG,1,0.5450970537123507,28,18,10,30,0.5824769118316604,0.1723441526010399
고용/NNG@$시장/NNG@$호조/NNG,1,0.5441963200648485,79,49,30,93,0.87976087373443,0.26096972360523396
가능성/NNG@$높/VA@$경제/NNG,1,0.542414198403478,33,21,12,36,0.6325501404145161,0.188585125894821
기준금리/NNG@$인상/NNG@$출구전략/NNG,1,0.542414198403478,33,21,12,36,0.6325501404145161,0.188585125894821
성장/NNG@$동력/NNG@$약화/NNG,1,0.542414198403478,33,21,12,23,0.6325501404145161,0.188585125894821
인상/NNG@$속도/NNG@$완만/XR,1,0.542414198403478,33,21,12,47,0.6325501404145161,0.188585125894821
가계/NNG@$대출/NNG@$증가세/NNG,1,0.542414198403478,33,21,12,44,0.6325501404145161,0.188585125894821
비철/NNG@$금속/NNG@$가격/NNG,1,0.542414198403478,33,21,12,30,0.6325501404145161,0.188585125894821
상승/NNG@$기준금리/NNG@$인상/NNG,1,0.542414198403478,33,21,12,58,0.6325501404145161,0.188585125894821
수출/NNG@$경기/NNG@$회복/NNG,1,0.5413982768882863,38,24,14,47,0.6779081613574758,0.20268770593641208
경제/NNG@$회복세/NNG@$지속/NNG,1,0.5407186722508632,71,44,27,101,0.8592746354769725,0.2574066051626403
환율/NNG@$상승/NNG@$수출/NNG,1,0.5398435584221901,48,30,18,50,0.7533166316408385,0.22622169133893516
인플레이션/NNG@$금리/NNG@$인상/NNG,1,0.5398435584221901,48,30,18,38,0.7533166316408385,0.22622169133893516
소비자/NNG@$물가/NNG@$급등/NNG,1,0.5385080986478139,53,33,20,70,0.7834197415467525,0.23614557217613932
단행/NNG@$금리/NNG@$인상/NNG,1,0.5385080986478139,53,33,20,64,0.7834197415467525,0.23614557217613932
상승/NNG@$압력/NNG@$커지/VV,1,0.5385080986478139,53,33,20,52,0.7834197415467525,0.23614557217613932
인상/NNG@$가능성/NNG@$시사/NNG,1,0.5358957865165355,214,133,81,245,0.9125278337245668,0.277081618943163
고용/NNG@$시장/NNG@$개선/NNG,1,0.5276552941983601,123,76,47,282,0.9076817471638455,0.281990525475453
기준금리/NNG@$인상/NNG@$관측/NNG,0,0.524922490602505,20,13,7,45,0.48831316381041395,0.15285132276925428
억제/NNG@$기준금리/NNG@$인상/NNG,0,0.524922490602505,20,13,7,50,0.48831316381041395,0.15285132276925428
개선/NNG@$추세/NNG@$보이/VV,0,0.524922490602505,20,13,7,28,0.48831316381041395,0.15285132276925428
장단기/NNG@$금리/NNG@$역전/NNG,0,0.524922490602505,20,13,7,43,0.48831316381041395,0.15285132276925428
확대/NNG@$금리/NNG@$인상/NNG,1,0.5240220749097073,50,31,19,60,0.7607697842714993,0.2387253682363279
금리/NNG@$인상/NNG@$인플레이션/NNG,1,0.5240220749097073,50,31,19,70,0.7607697842714993,0.2387253682363279
금리/NNG@$인상/NNG@$경기/NNG@$회복/NNG,1,0.5238036034279627,55,34,21,51,0.7892617515601421,0.24781459815711507
수요/NNG@$물가/NNG@$압력/NNG,1,0.523472996285872,45,28,17,41,0.7273700600385619,0.22858899659169973
물가/NNG@$상승/NNG@$속도/NNG,1,0.5221944009247801,40,25,15,54,0.688876855081091,0.21725199844449444
금리/NNG@$인상/NNG@$앞두/VV,1,0.5221944009247801,40,25,15,61,0.688876855081091,0.21725199844449444
인상/NNG@$경기/NNG@$둔화/NNG,1,0.5213054981509724,65,40,25,103,0.8328864108082252,0.2633083606419692
경제/NNG@$체질/NNG@$개선/NNG,1,0.5213054981509724,65,40,25,97,0.8328864108082252,0.2633083606419692
사상/NNG@$최대/NNG@$규모/NNG,1,0.5204170110057555,35,22,13,57,0.6452972000772673,0.20450009428200824
양적완화/NNG@$축소/NNG@$가능성/NNG,1,0.5204170110057555,35,22,13,97,0.6452972000772673,0.20450009428200824
우려/NNG@$적/VA@$않/VX,1,0.5204170110057555,35,22,13,45,0.6452972000772673,0.20450009428200824
소비자/NNG@$물가/NNG@$농산물/NNG,0,0.5199917436412254,12,8,4,17,0.38946664034720124,0.12356868527140165
필요/NNG@$의견/NNG@$제시/NNG,0,0.5199917436412254,12,8,4,18,0.38946664034720124,0.12356868527140165
물가/NNG@$보/VV@$소비자/NNG,0,0.5199917436412254,12,8,4,5,0.38946664034720124,0.12356868527140165
개선/NNG@$모습/NNG@$보였/VV,0,0.5199917436412254,12,8,4,27,0.38946664034720124,0.12356868527140165
인상/NNG@$전망/NNG@$힘/NNG,1,0.5189440162063004,25,16,9,35,0.544253525640457,0.17317327832804238
금리/NNG@$인하/NNG@$가능성/NNG@$제기/NNG,1,0.5189440162063004,25,16,9,29,0.544253525640457,0.17317327832804238
달러화/NNG@$엔화/NNG@$달러당/NNG@$거래/NNG@$가격/NNG,1,0.5187934830297249,30,19,11,21,0.5968953489484924,0.19000106720713358
지준율/NNG@$인상/NNG@$조치/NNG,1,0.5187934830297249,30,19,11,23,0.5968953489484924,0.19000106720713358
대외/NNG@$경제/NNG@$불확실성/NNG,1,0.5187934830297249,30,19,11,41,0.5968953489484924,0.19000106720713358
동결/NNG@$기조/NNG@$이어질/VV,1,0.5187934830297249,30,19,11,54,0.5968953489484924,0.19000106720713358
인플레이션/NNG@$압력/NNG@$대응/NNG,1,0.5187934830297249,30,19,11,29,0.5968953489484924,0.19000106720713358
결정/NNG@$시장/NNG@$예상/NNG,1,0.5187934830297249,30,19,11,46,0.5968953489484924,0.19000106720713358
달러당/NNG@$거래/NNG@$가격/NNG,1,0.5187934830297249,30,19,11,21,0.5968953489484924,0.19000106720713358
수출/NNG@$호조/NNG@$소비/NNG,1,0.5187934830297249,30,19,11,15,0.5968953489484924,0.19000106720713358
엔화/NNG@$달러당/NNG@$거래/NNG@$가격/NNG,1,0.5187934830297249,30,19,11,21,0.5968953489484924,0.19000106720713358
속도/NNG@$금리/NNG@$인상/NNG,1,0.518013654099502,88,54,34,116,0.8856998565407551,0.28253162239014606
금리/NNG@$인상/NNG@$요인/NNG,1,0.5091250800208191,52,32,20,49,0.7675871580687198,0.2508153169592518
고용/NNG@$지표/NNG@$경제/NNG,1,0.5045661502173062,42,26,16,26,0.6991123086362534,0.23125001226459982
지속적/NNG@$경제/NNG@$성장/NNG,1,0.5045661502173062,42,26,16,53,0.6991123086362534,0.23125001226459982
동향/NNG@$소비자/NNG@$물가/NNG,1,0.5006361304008033,37,23,14,48,0.6572933679159405,0.2197071369540986
기준금리/NNG@$유지/NNG@$했/VV,1,0.5006361304008033,37,23,14,106,0.6572933679159405,0.2197071369540986
경제/NNG@$회복/NNG@$지연/NNG,1,0.5006361304008033,37,23,14,74,0.6572933679159405,0.2197071369540986
고용/NNG@$시장/NNG@$악화/NNG,1,0.5006361304008033,37,23,14,48,0.6572933679159405,0.2197071369540986
투자/NNG@$증권/NNG@$동결/NNG,1,0.5006361304008033,37,23,14,56,0.6572933679159405,0.2197071369540986
물가/NNG@$경제/NNG@$성장/NNG,1,0.5006361304008033,37,23,14,48,0.6572933679159405,0.2197071369540986
금리/NNG@$인상/NNG@$가능성/NNG@$열/VV,1,0.4971072597576385,64,39,25,119,0.8204570298870024,0.2768255909138941
상승/NNG@$기조/NNG@$유지/NNG,1,0.4971072597576385,64,39,25,63,0.8204570298870024,0.2768255909138941
가계부채/NNG@$문제/NNG@$해결/NNG,1,0.49582029331192934,32,20,12,36,0.6105746573885408,0.20671269503367012
경기/NNG@$회복/NNG@$긍정적/NNG,1,0.49582029331192934,32,20,12,45,0.6105746573885408,0.20671269503367012
경제/NNG@$기준금리/NNG@$동결/NNG,1,0.49582029331192934,32,20,12,39,0.6105746573885408,0.20671269503367012
인상/NNG@$기대/NNG@$높/VA,1,0.49582029331192934,32,20,12,20,0.6105746573885408,0.20671269503367012
원유/NNG@$가격/NNG@$상승/NNG,1,0.4923505488461082,49,30,19,60,0.7436820483365001,0.25409029633412406
농산물/NNG@$석유류/NNG@$가격/NNG,0,0.49163977861081953,17,11,6,25,0.44750971714693477,0.15318448872907228
정책금리/NNG@$인상/NNG@$시장/NNG,0,0.49163977861081953,17,11,6,25,0.44750971714693477,0.15318448872907228
초과/NNG@$지준/NNG@$금리/NNG@$인하/NNG,0,0.49163977861081953,17,11,6,40,0.44750971714693477,0.15318448872907228
기조/NNG@$유지/NNG@$통화정책/NNG,0,0.49163977861081953,17,11,6,37,0.44750971714693477,0.15318448872907228
통화정책/NNG@$방향/NNG@$금리/NNG,0,0.49163977861081953,17,11,6,33,0.44750971714693477,0.15318448872907228
시중/NNG@$자금/NNG@$단기/NNG@$부동화/NNG,1,0.490838385660227,27,17,10,23,0.5594283293944489,0.19189819826924623
금리/NNG@$상승/NNG@$주택/NNG,1,0.490838385660227,27,17,10,41,0.5594283293944489,0.19189819826924623
금리/NNG@$인상/NNG@$기정사실/NNG,1,0.490838385660227,27,17,10,29,0.5594283293944489,0.19189819826924623
경제성장률/NNG@$상향/NNG@$조정/NNG,1,0.490838385660227,27,17,10,47,0.5594283293944489,0.19189819826924623
가능/NNG@$금리/NNG@$인상/NNG,1,0.490838385660227,27,17,10,44,0.5594283293944489,0.19189819826924623
긴축/NNG@$기조/NNG@$전환/NNG,1,0.488281804648554,44,27,17,50,0.7086411165849659,0.24471620156484672
물가/NNG@$오름세/NNG@$확대/NNG,1,0.488281804648554,44,27,17,39,0.7086411165849659,0.24471620156484672
성장/NNG@$모멘텀/NNG@$약화/NNG,1,0.488281804648554,44,27,17,50,0.7086411165849659,0.24471620156484672
채권/NNG@$기준금리/NNG@$전망/NNG,1,0.487649037427341,22,14,8,38,0.5046756611046014,0.17456914945540644
주택/NNG@$판매/NNG@$증가/NNG,1,0.487649037427341,22,14,8,48,0.5046756611046014,0.17456914945540644
금융/NNG@$불안/NNG@$확산/NNG,1,0.487649037427341,22,14,8,23,0.5046756611046014,0.17456914945540644
환율/NNG@$상승/NNG@$요인/NNG,1,0.487649037427341,22,14,8,29,0.5046756611046014,0.17456914945540644
하락/NNG@$금리/NNG@$인하/NNG,1,0.487649037427341,22,14,8,46,0.5046756611046014,0.17456914945540644
경제/NNG@$하방/NNG@$위험/NNG,1,0.48529922681084137,71,43,28,143,0.8396768189667737,0.2922344450642741
고려/NNG@$필요/NNG@$있/VA,1,0.48529922681084137,71,43,28,103,0.8396768189667737,0.2922344450642741
고려/NNG@$금리/NNG@$인상/NNG,1,0.48484472874413576,148,90,58,196,0.8970068540446172,0.3125571067917595
기조/NNG@$유지/NNG@$필요/NNG@$있/VA,1,0.48268904465722695,39,24,15,89,0.6685591173492407,0.23426592484052586
기준금리/NNG@$올릴/VV@$예상/NNG,1,0.48268904465722695,39,24,15,28,0.6685591173492407,0.23426592484052586
경기/NNG@$회복/NNG@$강도/NNG,1,0.48268904465722695,39,24,15,59,0.6685591173492407,0.23426592484052586
동행지수/NNG@$순환/NNG@$변동/NNG,1,0.4817248634327467,56,34,22,38,0.7794443045507692,0.27380519938081294
자산/NNG@$가격/NNG@$상승/NNG,1,0.48067776594699607,209,127,82,227,0.8965164406426741,0.3157869526193118
가격/NNG@$상승/NNG@$경기/NNG,1,0.47550192588906204,34,21,13,18,0.6235279810067362,0.22258655860406762
가능성/NNG@$크/VA@$않/VX@$전망/NNG,1,0.47550192588906204,34,21,13,44,0.6235279810067362,0.22258655860406762
기준금리/NNG@$인상/NNG@$기조/NNG,1,0.47550192588906204,34,21,13,53,0.6235279810067362,0.22258655860406762
동향/NNG@$금리/NNG@$인상/NNG,1,0.47550192588906204,34,21,13,39,0.6235279810067362,0.22258655860406762
물가/NNG@$상승/NNG@$위험/NNG,1,0.47422336619589833,73,44,29,65,0.8412171801288816,0.3012866883993947
하방/NNG@$위험/NNG@$요인/NNG,1,0.47422336619589833,73,44,29,71,0.8412171801288816,0.3012866883993947
생산/NNG@$소비/NNG@$투자/NNG,1,0.47315336826715026,46,28,18,43,0.7174905637165482,0.2576807928601719
경제/NNG@$성장/NNG@$동력/NNG,1,0.47315336826715026,46,28,18,88,0.7174905637165482,0.2576807928601719
연속적/NNG@$금리/NNG@$인상/NNG,1,0.47185247149381593,63,38,25,73,0.8072560883493258,0.29088867497867826
경기/NNG@$하강/NNG@$우려/NNG,1,0.4690667728046274,58,35,23,30,0.784547524683354,0.28472874123514197
예상/NNG@$경기/NNG@$회복/NNG,1,0.4690667728046274,58,35,23,51,0.784547524683354,0.28472874123514197
잠정/NNG@$주택/NNG@$판매/NNG,1,0.4690667728046274,58,35,23,72,0.784547524683354,0.28472874123514197
공개/NNG@$시장/NNG@$금리/NNG@$인상/NNG,1,0.4668801126319837,29,18,11,41,0.5739146330376583,0.20945118245919686
완화/NNG@$필요/NNG@$있/VA,1,0.4668801126319837,29,18,11,23,0.5739146330376583,0.20945118245919686
예측/NNG@$가능/NNG@$속도/NNG@$금리/NNG@$인상/NNG,1,0.4668801126319837,29,18,11,24,0.5739146330376583,0.20945118245919686
금리/NNG@$인상/NNG@$이어지/VV,1,0.4668801126319837,29,18,11,32,0.5739146330376583,0.20945118245919686
기금/NNG@$금리/NNG@$동결/NNG,1,0.4668801126319837,29,18,11,46,0.5739146330376583,0.20945118245919686
가능/NNG@$속도/NNG@$금리/NNG@$인상/NNG,1,0.4668801126319837,29,18,11,24,0.5739146330376583,0.20945118245919686
완화적/NNG@$통화정책/NNG@$기조/NNG@$유지/NNG,1,0.4662740626182065,41,25,16,39,0.6791161472658451,0.24822764368283318
물가/NNG@$상승/NNG@$전망/NNG,1,0.4662740626182065,41,25,16,90,0.6791161472658451,0.24822764368283318
유지/NNG@$경기/NNG@$회복/NNG,1,0.4662740626182065,41,25,16,63,0.6791161472658451,0.24822764368283318
기업/NNG@$채산성/NNG@$악화/NNG,1,0.4662740626182065,41,25,16,59,0.6791161472658451,0.24822764368283318
경제/NNG@$내수/NNG@$회복세/NNG,1,0.4662740626182065,41,25,16,13,0.6791161472658451,0.24822764368283318
금리/NNG@$인상/NNG@$통화정책/NNG,1,0.4639732507236882,80,48,32,122,0.853779879472447,0.31390150071740097
선제적/NNG@$금리/NNG@$인상/NNG,1,0.46380361755844945,85,51,34,96,0.8626429143230259,0.31729675716853417
회복세/NNG@$갈/VX@$전망/NNG,1,0.46356600934325587,75,45,30,26,0.8424403317537305,0.3100528541100694
통화정책/NNG@$방향/NNG@$의결/NNG,1,0.46121889650341297,100,60,40,96,0.8783328432908363,0.3251920652747712
물가/NNG@$상승/NNG@$예상/NNG,1,0.45902775737262536,48,29,19,57,0.7256884022884208,0.2701700112397642
민간/NNG@$소비/NNG@$개선/NNG,1,0.4575605026046563,24,15,9,26,0.5204180352605043,0.19446753979420425
경제/NNG@$회복/NNG@$기대/NNG,1,0.4575605026046563,24,15,9,27,0.5204180352605043,0.19446753979420425
결정/NNG@$중요/NNG@$변수/NNG,1,0.4575605026046563,24,15,9,25,0.5204180352605043,0.19446753979420425
고용/NNG@$지표/NNG@$좋/VA,1,0.4575605026046563,24,15,9,30,0.5204180352605043,0.19446753979420425
매파적/NNG@$통화/NNG@$긴축/NNG@$선호/NNG,1,0.4575605026046563,24,15,9,35,0.5204180352605043,0.19446753979420425
외국인/NNG@$주식/NNG@$투자/NNG@$자금/NNG,1,0.4575605026046563,24,15,9,41,0.5204180352605043,0.19446753979420425
동결/NNG@$금리/NNG@$인상/NNG@$가능성/NNG,1,0.4575605026046563,24,15,9,35,0.5204180352605043,0.19446753979420425
금리/NNG@$인상/NNG@$크/VA,1,0.4575605026046563,24,15,9,31,0.5204180352605043,0.19446753979420425
사상/NNG@$최대/NNG@$기록/NNG,1,0.45732358260398387,36,22,14,52,0.6357696432779845,0.23771354670657913
금리/NNG@$인상/NNG@$단행/NNG@$예상/NNG,1,0.45732358260398387,36,22,14,59,0.6357696432779845,0.23771354670657913
경기/NNG@$회복세/NNG@$뚜렷/XR,1,0.45732358260398387,36,22,14,66,0.6357696432779845,0.23771354670657913
국고채/NNG@$금리/NNG@$하락/NNG,1,0.45732358260398387,36,22,14,50,0.6357696432779845,0.23771354670657913
환율/NNG@$변동성/NNG@$확대/NNG,1,0.45330446834994276,77,46,31,117,0.8433709605425826,0.31853850441101195
기준금리/NNG@$인상/NNG@$시장/NNG,1,0.45175747806581845,72,43,29,89,0.8300210072300797,0.3147142891230402
시장/NNG@$금리/NNG@$정책금리/NNG,0,0.45072189842768284,14,9,5,32,0.40641699049620456,0.15449874094873003
전망/NNG@$지수/NNG@$하락/NNG,0,0.45072189842768284,14,9,5,36,0.40641699049620456,0.15449874094873003
경제/NNG@$성장/NNG@$속도/NNG@$둔화/NNG,0,0.4498168722804412,19,12,7,32,0.46410567024334287,0.1768286725015616
물가/NNG@$목표/NNG@$크/VA,0,0.4498168722804412,19,12,7,31,0.46410567024334287,0.1768286725015616
채권/NNG@$시장/NNG@$기준금리/NNG@$인상/NNG,0,0.4498168722804412,19,12,7,36,0.46410567024334287,0.1768286725015616
제시/NNG@$금리/NNG@$인상/NNG,0,0.4498168722804412,19,12,7,33,0.46410567024334287,0.1768286725015616
과거/NNG@$금융/NNG@$위기/NNG,0,0.4498168722804412,19,12,7,34,0.46410567024334287,0.1768286725015616
유지/NNG@$금융/NNG@$경제/NNG@$고려/NNG,1,0.44611638030878864,31,19,12,20,0.5877193565110235,0.22600272294563778
경제/NNG@$경기/NNG@$둔화/NNG,1,0.4457796675386487,50,30,20,69,0.7332626458148778,0.28220655882948076
금리/NNG@$인상/NNG@$경기/NNG@$둔화/NNG,1,0.4457796675386487,50,30,20,85,0.7332626458148778,0.28220655882948076
경로/NNG@$불확실성/NNG@$높/VA,1,0.4451039763914155,89,53,36,95,0.8616105087417804,0.3321607385451708
금리/NNG@$인상/NNG@$지속/NNG,1,0.44128798798247937,139,83,56,135,0.8826903125853498,0.34352386205945035
금리/NNG@$동결/NNG@$경기/NNG,1,0.4408917078319967,38,23,15,56,0.6473152943705637,0.252168234128017
채권/NNG@$가격/NNG@$하락/NNG,1,0.4408917078319967,38,23,15,39,0.6473152943705637,0.252168234128017
원자재/NNG@$가격/NNG@$상승/NNG@$물가/NNG,1,0.4408917078319967,38,23,15,45,0.6473152943705637,0.252168234128017
인하/NNG@$가능성/NNG@$제기/NNG,1,0.4408917078319967,38,23,15,49,0.6473152943705637,0.252168234128017
상승률/NNG@$높/VA@$않/VX,1,0.4408917078319967,38,23,15,19,0.6473152943705637,0.252168234128017
불확실성/NNG@$금리/NNG@$인상/NNG,1,0.4408917078319967,38,23,15,52,0.6473152943705637,0.252168234128017
모기지/NNG@$담보/NNG@$증권/NNG@$매입/NNG,1,0.4371337409846088,45,27,18,96,0.6981960466875716,0.27452521428952825
국제금융시장/NNG@$변동성/NNG@$확대/NNG,1,0.4345515310668584,64,38,26,65,0.7969205524507942,0.31534055599879296
기준금리/NNG@$인상/NNG@$않/VX,1,0.43330590331174546,52,31,21,95,0.7402413807035714,0.29381016305746416
우려/NNG@$기준금리/NNG@$인상/NNG,1,0.43330590331174546,52,31,21,63,0.7402413807035714,0.29381016305746416
민간/NNG@$소비/NNG@$투자/NNG,1,0.43330590331174546,52,31,21,58,0.7402413807035714,0.29381016305746416
경기/NNG@$회복세/NNG@$이어지/VV,1,0.43268227556511585,26,16,10,34,0.5355445243592325,0.2128891725909117
물가/NNG@$상승률/NNG@$지속/NNG,1,0.43268227556511585,26,16,10,38,0.5355445243592325,0.2128891725909117
금융정책/NNG@$열/VV@$기준금리/NNG,1,0.43268227556511585,26,16,10,39,0.5355445243592325,0.2128891725909117
콜금리/NNG@$인상/NNG@$시장/NNG,1,0.43268227556511585,26,16,10,24,0.5355445243592325,0.2128891725909117
완화적/NNG@$기조/NNG@$유지/NNG,1,0.43268227556511585,26,16,10,40,0.5355445243592325,0.2128891725909117
기업/NNG@$투자/NNG@$확대/NNG,1,0.43268227556511585,26,16,10,35,0.5355445243592325,0.2128891725909117
시장/NNG@$충격/NNG@$최소화/NNG,1,0.43268227556511585,26,16,10,33,0.5355445243592325,0.2128891725909117
시중/NNG@$유동성/NNG@$증가세/NNG,1,0.43268227556511585,26,16,10,22,0.5355445243592325,0.2128891725909117
우려/NNG@$크/VA@$않/VX,1,0.42895878321795444,59,35,24,85,0.7739442938778307,0.3104748032905296
상승/NNG@$크/VA@$않/VX,1,0.4278506668631401,33,20,13,40,0.6008498832572537,0.2416894904974173
금리/NNG@$올릴/VV@$없/VA,1,0.4278506668631401,33,20,13,36,0.6008498832572537,0.2416894904974173
원유/NNG@$원자재/NNG@$가격/NNG@$상승/NNG,1,0.4278506668631401,33,20,13,31,0.6008498832572537,0.2416894904974173
실질/NNG@$국내총생산/NNG@$성장률/NNG,1,0.4278506668631401,33,20,13,48,0.6008498832572537,0.2416894904974173
경제/NNG@$전망/NNG@$불확실성/NNG,1,0.4278506668631401,33,20,13,53,0.6008498832572537,0.2416894904974173
성장/NNG@$경로/NNG@$불확실성/NNG@$높/VA,1,0.42646527213018737,88,52,36,91,0.8532760043439022,0.344388457525434
시장/NNG@$예상/NNG@$크/VA,1,0.42406564703111327,47,28,19,68,0.7067669877866879,0.28692724002314146
생각/NNG@$금리/NNG@$인상/NNG,1,0.42406564703111327,47,28,19,44,0.7067669877866879,0.28692724002314146
자본/NNG@$유출/NNG@$압력/NNG,1,0.42406564703111327,47,28,19,35,0.7067669877866879,0.28692724002314146
인상/NNG@$가능성/NNG@$열/VV,1,0.4216751382174986,110,65,45,172,0.8700962507178194,0.3552903796638686
기준금리/NNG@$인상/NNG@$시작/NNG,1,0.4215209097323491,54,32,22,82,0.7466525970379149,0.3049981062901312
금리/NNG@$인상/NNG@$가능성/NNG@$높/VA,1,0.4181283331040355,179,106,73,232,0.8761214370426159,0.3608353188763565
주택/NNG@$경기/NNG@$둔화/NNG,1,0.4181265420743485,61,36,25,88,0.7784315073484223,0.32060258414100506
성장/NNG@$둔화/NNG@$위험/NNG,0,0.41764897066011586,21,13,8,32,0.4801794894963197,0.19799364236332903
생산자/NNG@$물가/NNG@$소비자/NNG,0,0.41764897066011586,21,13,8,25,0.4801794894963197,0.19799364236332903
대출/NNG@$증가세/NNG@$둔화/NNG,0,0.41764897066011586,21,13,8,15,0.4801794894963197,0.19799364236332903
경제/NNG@$전망/NNG@$불확실/NNG,0,0.41764897066011586,21,13,8,36,0.4801794894963197,0.19799364236332903
원자재/NNG@$가격/NNG@$약세/NNG,0,0.41764897066011586,21,13,8,33,0.4801794894963197,0.19799364236332903
필요/NNG@$있/VA@$권고/NNG,0,0.41764897066011586,21,13,8,43,0.4801794894963197,0.19799364236332903
경기/NNG@$회복/NNG@$시작/NNG,0,0.41764897066011586,21,13,8,25,0.4801794894963197,0.19799364236332903
지수/NNG@$오른/VV@$종합/NNG,0,0.41764897066011586,21,13,8,61,0.4801794894963197,0.19799364236332903
예상/NNG@$깨/VV@$기준금리/NNG,0,0.41764897066011586,21,13,8,42,0.4801794894963197,0.19799364236332903
시장/NNG@$금리/NNG@$경기/NNG,0,0.41764897066011586,21,13,8,30,0.4801794894963197,0.19799364236332903
금리/NNG@$결정/NNG@$시장/NNG,0,0.41764897066011586,21,13,8,33,0.4801794894963197,0.19799364236332903
금리/NNG@$인상/NNG@$요구/NNG,0,0.41764897066011586,21,13,8,32,0.4801794894963197,0.19799364236332903
하방/NNG@$위험/NNG@$상존/NNG,0,0.41764897066011586,21,13,8,27,0.4801794894963197,0.19799364236332903
제로/NNG@$금리/NNG@$유지/NNG,0,0.41764897066011586,21,13,8,33,0.4801794894963197,0.19799364236332903
금리/NNG@$인상/NNG@$조건/NNG,0,0.41764897066011586,21,13,8,55,0.4801794894963197,0.19799364236332903
인플레/NNG@$기대/NNG@$심리/NNG,1,0.4124869592984388,220,130,90,308,0.8743285313926591,0.3650249853404486
채권/NNG@$시장/NNG@$관심/NNG,1,0.41212303199011036,42,25,17,59,0.6683879166745939,0.2792905332391638
인플레이션/NNG@$목표/NNG@$달성/NNG,1,0.4116541190766696,28,17,11,27,0.5500560431421129,0.23010368804991466
동결/NNG@$기조/NNG@$지속/NNG,1,0.4116541190766696,28,17,11,34,0.5500560431421129,0.23010368804991466
소비자/NNG@$물가/NNG@$오르/VV,1,0.4116541190766696,28,17,11,36,0.5500560431421129,0.23010368804991466
경기/NNG@$회복/NNG@$둔화/NNG,1,0.4116541190766696,28,17,11,65,0.5500560431421129,0.23010368804991466
인상/NNG@$압력/NNG@$높/VA,1,0.4116541190766696,28,17,11,26,0.5500560431421129,0.23010368804991466
금리/NNG@$인상/NNG@$물가/NNG@$상승/NNG,1,0.4116541190766696,28,17,11,24,0.5500560431421129,0.23010368804991466
외환/NNG@$위기/NNG@$발생/NNG,1,0.4116541190766696,28,17,11,40,0.5500560431421129,0.23010368804991466
금리/NNG@$인상/NNG@$필요/NNG@$있/VA,1,0.4116541190766696,28,17,11,41,0.5500560431421129,0.23010368804991466
회복/NNG@$물가/NNG@$상승/NNG@$압력/NNG,1,0.4116541190766696,28,17,11,30,0.5500560431421129,0.23010368804991466
인하/NNG@$기조/NNG@$유지/NNG,1,0.4116541190766696,28,17,11,25,0.5500560431421129,0.23010368804991466
마련/NNG@$필요/NNG@$있/VA,1,0.4115695577135896,35,21,14,35,0.6133146964470249,0.25661862454873885
채권/NNG@$시장/NNG@$체감/NNG@$지표/NNG,1,0.4115695577135896,35,21,14,41,0.6133146964470249,0.25661862454873885
기준금리/NNG@$인하/NNG@$기조/NNG,1,0.4115695577135896,35,21,14,26,0.6133146964470249,0.25661862454873885
금리/NNG@$동결/NNG@$반대/NNG,1,0.4115695577135896,35,21,14,32,0.6133146964470249,0.25661862454873885
금리/NNG@$인상/NNG@$대외/NNG,1,0.4115695577135896,35,21,14,26,0.6133146964470249,0.25661862454873885
시장/NNG@$체감/NNG@$지표/NNG,1,0.4115695577135896,35,21,14,41,0.6133146964470249,0.25661862454873885
경기/NNG@$회복/NNG@$기조/NNG,1,0.4085323477039946,119,70,49,106,0.868445440286378,0.36602355957574323
목표/NNG@$하향/NNG@$조정/NNG,0,0.40340457042851696,16,10,6,44,0.42293023320165557,0.18044799300355963
출구전략/NNG@$시행/NNG@$시기/NNG,0,0.40340457042851696,16,10,6,59,0.42293023320165557,0.18044799300355963
금융/NNG@$통화정책/NNG@$기준금리/NNG@$동결/NNG,0,0.40340457042851696,16,10,6,41,0.42293023320165557,0.18044799300355963
소비/NNG@$지출/NNG@$물가/NNG,0,0.40340457042851696,16,10,6,46,0.42293023320165557,0.18044799300355963
인플레이션/NNG@$압력/NNG@$증대/NNG,0,0.40340457042851696,16,10,6,26,0.42293023320165557,0.18044799300355963
물가/NNG@$상승/NNG@$압력/NNG@$높/VA,1,0.40087696324682054,116,68,48,130,0.8647924666686294,0.37119866039027866
경기/NNG@$부양적/NNG@$통화정책/NNG,1,0.4003104171013907,51,30,21,64,0.7220952945714109,0.3103654968065524
인플레이션/NNG@$압력/NNG@$증가/NNG,1,0.4003104171013907,51,30,21,37,0.7220952945714109,0.3103654968065524
개선/NNG@$모습/NNG@$보이/VV,1,0.3993662434519287,44,26,18,40,0.6779527165002898,0.29204621775771256
부진/NNG@$금리/NNG@$인하/NNG,1,0.3993662434519287,44,26,18,42,0.6779527165002898,0.29204621775771256
원자재/NNG@$가격/NNG@$급락/NNG,1,0.3993662434519287,44,26,18,49,0.6779527165002898,0.29204621775771256
자금/NNG@$단기화/NNG@$현상/NNG,0,0.39876891668422143,11,7,4,30,0.36546857601386923,0.15765854080838265
실업률/NNG@$물가/NNG@$상승률/NNG,0,0.39876891668422143,11,7,4,41,0.36546857601386923,0.15765854080838265
시장/NNG@$예상/NNG@$깨/VV,1,0.3968902013000535,37,22,15,54,0.6251237455026177,0.2708734193741949
금리/NNG@$인상/NNG@$걸림돌/NNG,1,0.3968902013000535,37,22,15,31,0.6251237455026177,0.2708734193741949
금융/NNG@$금리/NNG@$인상/NNG,1,0.3968902013000535,37,22,15,62,0.6251237455026177,0.2708734193741949
자산/NNG@$가격/NNG@$버블/NNG,1,0.3950606263116203,72,42,30,109,0.807615012617455,0.35146646055552655
정책/NNG@$공조/NNG@$차원/NNG,1,0.3935307270236852,30,18,12,58,0.5639524175412348,0.24631498563428042
환시/NNG@$달러화/NNG@$엔화/NNG@$달러당/NNG@$거래/NNG,1,0.3935307270236852,30,18,12,20,0.5639524175412348,0.24631498563428042
금리/NNG@$인하/NNG@$동결/NNG,0,0.3920647838282929,23,14,9,41,0.4957350529151748,0.21726971840717216
수출/NNG@$타격/NNG@$입/VV,0,0.3920647838282929,23,14,9,31,0.4957350529151748,0.21726971840717216
금융시장/NNG@$불안/NNG@$가능성/NNG,0,0.3920647838282929,23,14,9,16,0.4957350529151748,0.21726971840717216
지준/NNG@$금리/NNG@$인하/NNG,0,0.3920647838282929,23,14,9,43,0.4957350529151748,0.21726971840717216
필요/NNG@$있/VA@$경기/NNG,0,0.3920647838282929,23,14,9,27,0.4957350529151748,0.21726971840717216
금리/NNG@$인상/NNG@$가능성/NNG@$크/VA,1,0.39152005931458533,79,46,33,86,0.8235796051248776,0.36142023643553706
경제/NNG@$위험/NNG@$요인/NNG,1,0.3897911217435208,125,73,52,151,0.8629601200122442,0.3802459931906299
물가/NNG@$상승률/NNG@$높/VA,1,0.38784139546801866,318,186,132,335,0.8655854384630619,0.38315386560956144
금리/NNG@$인상/NNG@$논의/NNG,1,0.3874866394247185,46,27,19,105,0.6868968888371669,0.3043101273482375
담보/NNG@$증권/NNG@$매입/NNG,1,0.3874866394247185,46,27,19,102,0.6868968888371669,0.3043101273482375
규모/NNG@$크/VA@$않/VX,1,0.3874866394247185,46,27,19,50,0.6868968888371669,0.3043101273482375
금리/NNG@$인상/NNG@$문제/NNG,1,0.3874866394247185,46,27,19,67,0.6868968888371669,0.3043101273482375
수출/NNG@$호조/NNG@$내수/NNG,1,0.38352341969080994,39,23,16,35,0.636288608684415,0.28451861039473797
가격/NNG@$상승/NNG@$압력/NNG,1,0.38352341969080994,39,23,16,53,0.636288608684415,0.28451861039473797
인상/NNG@$여부/NNG@$결정/NNG,1,0.3833557486269048,93,54,39,107,0.8428487952340049,0.3770304724765629
금리/NNG@$인상/NNG@$신중/NNG,1,0.38189320277352445,105,61,44,119,0.8526160346734093,0.3827051016232594
성장/NNG@$둔화/NNG@$우려/NNG,1,0.37963532226634555,88,51,37,143,0.8348410030782616,0.37670528192135505
경기/NNG@$조절적/NNG@$통화정책/NNG,1,0.37764476252987755,32,19,13,55,0.577233866615998,0.261675078314413
경기/NNG@$둔화/NNG@$심화/NNG,1,0.37764476252987755,32,19,13,26,0.577233866615998,0.261675078314413
경제/NNG@$리스크/NNG@$요인/NNG,1,0.37764476252987755,32,19,13,37,0.577233866615998,0.261675078314413
기준금리/NNG@$조정/NNG@$여부/NNG,1,0.37764476252987755,32,19,13,24,0.577233866615998,0.261675078314413
외환/NNG@$위기/NNG@$금융/NNG,1,0.3763670991813113,48,28,20,51,0.6952418326334135,0.31610868728427116
경기/NNG@$수출/NNG@$호조/NNG,1,0.3712479102917341,41,24,17,36,0.6468225102315511,0.2976047601826922
기준금리/NNG@$낮/VA@$유지/NNG,1,0.3712479102917341,41,24,17,40,0.6468225102315511,0.2976047601826922
전통적/NNG@$통화정책/NNG@$수단/NNG,1,0.37110245902609784,25,15,10,24,0.5107677665343393,0.2350846892278645
경제/NNG@$성장/NNG@$기대/NNG,1,0.37110245902609784,25,15,10,31,0.5107677665343393,0.2350846892278645
투자/NNG@$심리/NNG@$긍정적/NNG,1,0.37110245902609784,25,15,10,31,0.5107677665343393,0.2350846892278645
지표/NNG@$개인/NNG@$소비/NNG@$지출/NNG@$물가지수/NNG,1,0.37110245902609784,25,15,10,39,0.5107677665343393,0.2350846892278645
달러/NNG@$환율/NNG@$하락/NNG,1,0.37110245902609784,25,15,10,32,0.5107677665343393,0.2350846892278645
외환시장/NNG@$달러/NNG@$환율/NNG,1,0.37110245902609784,25,15,10,29,0.5107677665343393,0.2350846892278645
투자/NNG@$심리/NNG@$부정적/NNG,1,0.37110245902609784,25,15,10,25,0.5107677665343393,0.2350846892278645
기금/NNG@$금리선물/NNG@$시장/NNG@$금리/NNG@$인상/NNG,1,0.37110245902609784,25,15,10,39,0.5107677665343393,0.2350846892278645
소비자물가지수/NNG@$상승률/NNG@$기록/NNG,0,0.3693126546697665,18,11,7,38,0.4390470540888366,0.20291232072512527
지속/NNG@$소비자/NNG@$물가/NNG,0,0.3693126546697665,18,11,7,39,0.4390470540888366,0.20291232072512527
상향/NNG@$조정/NNG@$예상/NNG,0,0.3693126546697665,18,11,7,35,0.4390470540888366,0.20291232072512527
고용/NNG@$시장/NNG@$부진/NNG,0,0.3693126546697665,18,11,7,39,0.4390470540888366,0.20291232072512527
기조/NNG@$변화/NNG@$가능성/NNG,0,0.3693126546697665,18,11,7,23,0.4390470540888366,0.20291232072512527
기조/NNG@$유지/NNG@$가능성/NNG,0,0.3693126546697665,18,11,7,30,0.4390470540888366,0.20291232072512527
공격적/NNG@$금리/NNG@$인상/NNG,1,0.36745868246857416,133,77,56,127,0.8558310441033707,0.3972312471117302
기준금리/NNG@$인상/NNG@$시기/NNG,1,0.36705374105944255,188,109,79,317,0.8577906473120107,0.3985126504160368
금리/NNG@$동결/NNG@$경제/NNG,1,0.36351662513535055,34,20,14,38,0.5899019189142821,0.27629702627711433
인상/NNG@$시장/NNG@$예상/NNG,1,0.36351662513535055,34,20,14,37,0.5899019189142821,0.27629702627711433
통화정책/NNG@$방향/NNG@$물가/NNG,1,0.36351662513535055,34,20,14,36,0.5899019189142821,0.27629702627711433
지수/NNG@$오른/VV@$기록/NNG,1,0.36351662513535055,34,20,14,85,0.5899019189142821,0.27629702627711433
소비/NNG@$투자/NNG@$수출/NNG,1,0.36351662513535055,34,20,14,32,0.5899019189142821,0.27629702627711433
콜금리/NNG@$인상/NNG@$예상/NNG,1,0.36351662513535055,34,20,14,23,0.5899019189142821,0.27629702627711433
소비/NNG@$심리/NNG@$회복/NNG,1,0.36138721999305745,80,46,34,92,0.8131487820832597,0.38272769264162104
경제/NNG@$성장세/NNG@$지속/NNG,1,0.35989211912088925,43,25,18,72,0.6567402389160306,0.31017172124041836
물가/NNG@$상승/NNG@$가능성/NNG,1,0.35989211912088925,43,25,18,33,0.6567402389160306,0.31017172124041836
금리/NNG@$인상/NNG@$계획/NNG,1,0.3560467924737689,52,30,22,83,0.7102227920772287,0.33839480391762783
시장/NNG@$불안/NNG@$심리/NNG,1,0.3560467924737689,52,30,22,46,0.7102227920772287,0.33839480391762783
경상수지/NNG@$흑자/NNG@$규모/NNG,1,0.3537321194303167,82,47,35,122,0.8138908998306302,0.38984257329441857
소비/NNG@$지출/NNG@$증가/NNG,1,0.3537321194303167,82,47,35,94,0.8138908998306302,0.38984257329441857
기준금리/NNG@$유지/NNG@$결정/NNG,1,0.35364892453590224,120,69,51,149,0.8479538403425496,0.40623529714308926
경기/NNG@$부양/NNG@$통화정책/NNG,1,0.3534815114036578,27,16,11,44,0.5252692102645975,0.2517405226103796
에너지/NNG@$가격/NNG@$급등/NNG,1,0.3534815114036578,27,16,11,40,0.5252692102645975,0.2517405226103796
지수/NNG@$낮/VA@$기술/NNG,1,0.3507953663053578,36,21,15,40,0.6019599264382851,0.2902652461895683
정책/NNG@$경기/NNG@$부양/NNG,1,0.3507953663053578,36,21,15,50,0.6019599264382851,0.2902652461895683
인상/NNG@$가능성/NNG@$전망/NNG,1,0.3507953663053578,36,21,15,37,0.6019599264382851,0.2902652461895683
가능성/NNG@$낮/VA@$보/VX,1,0.3507953663053578,36,21,15,32,0.6019599264382851,0.2902652461895683
인상/NNG@$시기/NNG@$전망/NNG,1,0.3493213920585958,45,26,19,67,0.6660580037475677,0.32225130438298144
경기/NNG@$금리/NNG@$인상/NNG,1,0.3493213920585958,45,26,19,40,0.6660580037475677,0.32225130438298144
금리/NNG@$인상/NNG@$검토/NNG,1,0.3493213920585958,45,26,19,79,0.6660580037475677,0.32225130438298144
회복/NNG@$조짐/NNG@$보이/VV,1,0.3454442883070108,91,52,39,104,0.8247270913229762,0.4025431877929522
인플레율/NNG@$상승/NNG@$압력/NNG,0,0.34520928095531156,13,8,5,56,0.38150139878648653,0.1863071421449786
금리/NNG@$상승/NNG@$속도/NNG,0,0.34520928095531156,13,8,5,39,0.38150139878648653,0.1863071421449786
경제/NNG@$성장/NNG@$기여/NNG,0,0.34352906907394853,20,12,8,30,0.4547744197337164,0.22293630197444478
결정/NNG@$기준금리/NNG@$인상/NNG,0,0.34352906907394853,20,12,8,28,0.4547744197337164,0.22293630197444478
경제/NNG@$회복/NNG@$기대감/NNG,0,0.34352906907394853,20,12,8,32,0.4547744197337164,0.22293630197444478
금리/NNG@$상승/NNG@$마감/NNG,0,0.34352906907394853,20,12,8,33,0.4547744197337164,0.22293630197444478
회복/NNG@$속도/NNG@$완만/XR,0,0.34352906907394853,20,12,8,46,0.4547744197337164,0.22293630197444478
주택/NNG@$경기/NNG@$부진/NNG,0,0.34352906907394853,20,12,8,47,0.4547744197337164,0.22293630197444478
제기/NNG@$금리/NNG@$인하/NNG,0,0.34352906907394853,20,12,8,31,0.4547744197337164,0.22293630197444478
경기/NNG@$부진/NNG@$지속/NNG,0,0.34352906907394853,20,12,8,45,0.4547744197337164,0.22293630197444478
정책/NNG@$기조/NNG@$유지/NNG,1,0.34278400539478326,124,71,53,212,0.8446190178482884,0.41474123658696216
필요/NNG@$금리/NNG@$인상/NNG,1,0.34269954587631957,63,36,27,106,0.7553942255546863,0.3709991626083473
장기/NNG@$국채/NNG@$수익률/NNG,1,0.34269954587631957,63,36,27,38,0.7553942255546863,0.3709991626083473
고용/NNG@$지표/NNG@$금리/NNG@$인상/NNG,1,0.33942877003287086,47,27,20,31,0.6747932532915726,0.3338693094692631
시중/NNG@$유동성/NNG@$풍부/XR,1,0.33942877003287086,47,27,20,65,0.6747932532915726,0.3338693094692631
자산/NNG@$가격/NNG@$거품/NNG,1,0.33942877003287086,47,27,20,41,0.6747932532915726,0.3338693094692631
엔화/NNG@$가치/NNG@$하락/NNG,1,0.33921968972694394,38,22,16,81,0.6134133005274106,0.303643266212632
지속/NNG@$기준금리/NNG@$인상/NNG,1,0.33921968972694394,38,22,16,41,0.6134133005274106,0.303643266212632
상향/NNG@$조정/NNG@$경제/NNG,1,0.33921968972694394,38,22,16,40,0.6134133005274106,0.303643266212632
경제/NNG@$완만/XR@$성장세/NNG,1,0.33921968972694394,38,22,16,59,0.6134133005274106,0.303643266212632
고려/NNG@$기준금리/NNG@$인상/NNG,1,0.33921968972694394,38,22,16,70,0.6134133005274106,0.303643266212632
반영/NNG@$금리/NNG@$인상/NNG@$가능성/NNG,1,0.33834360809999264,29,17,12,31,0.5392300630264335,0.2674495867106972
진행/NNG@$금리/NNG@$인상/NNG,1,0.33834360809999264,29,17,12,52,0.5392300630264335,0.2674495867106972
인플레이션/NNG@$압력/NNG@$커지/VV,1,0.33834360809999264,29,17,12,51,0.5392300630264335,0.2674495867106972
상환/NNG@$부담/NNG@$증가/NNG,1,0.33834360809999264,29,17,12,32,0.5392300630264335,0.2674495867106972
강세/NNG@$보일/VV@$전망/NNG,1,0.33834360809999264,29,17,12,26,0.5392300630264335,0.2674495867106972
물가/NNG@$불안/NNG@$심리/NNG,1,0.33834360809999264,29,17,12,25,0.5392300630264335,0.2674495867106972
금리/NNG@$인상/NNG@$자산/NNG,1,0.33834360809999264,29,17,12,53,0.5392300630264335,0.2674495867106972
금리/NNG@$인상/NNG@$강력/XR,1,0.33834360809999264,29,17,12,23,0.5392300630264335,0.2674495867106972
동결/NNG@$예상/NNG@$금리/NNG,1,0.33834360809999264,29,17,12,42,0.5392300630264335,0.2674495867106972
인상/NNG@$물가/NNG@$상승률/NNG,1,0.33834360809999264,29,17,12,26,0.5392300630264335,0.2674495867106972
금리/NNG@$인상/NNG@$점치/VV,1,0.33834360809999264,29,17,12,31,0.5392300630264335,0.2674495867106972
은행/NNG@$기준금리/NNG@$인상/NNG,1,0.3378344661588919,56,32,24,85,0.7230769235578931,0.3590462047209256
개선/NNG@$금리/NNG@$인상/NNG,1,0.3378344661588919,56,32,24,58,0.7230769235578931,0.3590462047209256
수출/NNG@$비중/NNG@$높/VA,1,0.3375980798016027,72,41,31,111,0.7832265693563771,0.3891207591827759
억제/NNG@$금리/NNG@$인상/NNG,1,0.3318125475136593,81,46,35,119,0.8023896499082703,0.403856334585569
자산/NNG@$가격/NNG@$급등/NNG,1,0.33012831990228997,49,28,21,71,0.6829644777431416,0.34504706052268636
통화/NNG@$가치/NNG@$급락/NNG,1,0.33012831990228997,49,28,21,57,0.6829644777431416,0.34504706052268636
금리/NNG@$인상/NNG@$의지/NNG,1,0.3293907819698709,58,33,25,55,0.7287639048697372,0.36879413258375393
하락/NNG@$경기/NNG@$둔화/NNG,1,0.3293907819698709,58,33,25,54,0.7287639048697372,0.36879413258375393
금리/NNG@$인하/NNG@$어렵/VA,1,0.3285918491057809,40,23,17,38,0.6242695599737046,0.3164794258482148
경제/NNG@$수출/NNG@$호조/NNG,1,0.3285918491057809,40,23,17,28,0.6242695599737046,0.3164794258482148
디플레이션/NNG@$물가/NNG@$하락/NNG,1,0.3285918491057809,40,23,17,44,0.6242695599737046,0.3164794258482148
금리/NNG@$인상/NNG@$가능성/NNG@$시사/NNG,1,0.3277865817542567,130,74,56,164,0.8396833346234543,0.4264525606869272
전망/NNG@$힘/NNG@$실리/VV,1,0.325097810055168,31,18,13,29,0.5526418807786466,0.2823620440495862
경제/NNG@$전망/NNG@$금리/NNG,1,0.325097810055168,31,18,13,61,0.5526418807786466,0.2823620440495862
둔화/NNG@$가능성/NNG@$높/VA,1,0.325097810055168,31,18,13,42,0.5526418807786466,0.2823620440495862
인플레이션/NNG@$물가/NNG@$상승/NNG,1,0.325097810055168,31,18,13,35,0.5526418807786466,0.2823620440495862
인상/NNG@$서두르/VV@$않/VX,1,0.325097810055168,31,18,13,67,0.5526418807786466,0.2823620440495862
매입/NNG@$규모/NNG@$늘리/VV,1,0.325097810055168,31,18,13,32,0.5526418807786466,0.2823620440495862
물가/NNG@$목표치/NNG@$달성/NNG,0,0.32321308494561296,22,13,9,26,0.4701019025714717,0.2412010264387331
거시/NNG@$경제/NNG@$영향/NNG,0,0.32321308494561296,22,13,9,20,0.4701019025714717,0.2412010264387331
금리/NNG@$인상/NNG@$진행/NNG,0,0.32321308494561296,22,13,9,31,0.4701019025714717,0.2412010264387331
외환/NNG@$위기/NNG@$이전/NNG,0,0.32321308494561296,22,13,9,41,0.4701019025714717,0.2412010264387331
제품/NNG@$가격/NNG@$상승/NNG,0,0.32321308494561296,22,13,9,58,0.4701019025714717,0.2412010264387331
경제/NNG@$위협/NNG@$요인/NNG,0,0.32321308494561296,22,13,9,46,0.4701019025714717,0.2412010264387331
예상/NNG@$물가/NNG@$상승/NNG,0,0.32321308494561296,22,13,9,35,0.4701019025714717,0.2412010264387331
경기/NNG@$개선/NNG@$기대/NNG,0,0.32321308494561296,22,13,9,38,0.4701019025714717,0.2412010264387331
사회/NNG@$기반/NNG@$시설/NNG,0,0.32321308494561296,22,13,9,39,0.4701019025714717,0.2412010264387331
부동산/NNG@$경기/NNG@$둔화/NNG,0,0.32321308494561296,22,13,9,35,0.4701019025714717,0.2412010264387331
콜금리/NNG@$인상/NNG@$가능성/NNG,1,0.32275174054108935,139,79,60,116,0.8387674512167104,0.43079927870320867
금리/NNG@$인상/NNG@$자제/NNG,1,0.32135024757742636,51,29,22,61,0.6905910072721291,0.35580256159058704
금리/NNG@$인상/NNG@$결정/NNG,1,0.3197080737870095,322,183,139,344,0.839174912017585,0.4339366509558601
금리/NNG@$인상/NNG@$이뤄질/VV,1,0.319359542704142,92,52,40,151,0.81468151196419,0.4215974812448986
경제/NNG@$심리/NNG@$위축/NNG,1,0.3187598949703323,42,24,18,39,0.6345382558498274,0.32881103012210783
물가/NNG@$상승/NNG@$압력/NNG@$커지/VV,1,0.3187598949703323,42,24,18,41,0.6345382558498274,0.32881103012210783
인상/NNG@$가능성/NNG@$높/VA,1,0.3159091508236225,319,181,138,374,0.8376021175121282,0.43679014499616087
금리/NNG@$인상/NNG@$불가피/XR,1,0.31363887472655017,62,35,27,65,0.7387720295753878,0.3871942165212045
콜/NNG@$인상/NNG@$가능성/NNG,1,0.31363887472655017,62,35,27,62,0.7387720295753878,0.3871942165212045
요인/NNG@$물가/NNG@$상승/NNG,1,0.3133269609566456,33,19,14,27,0.5654981262812042,0.2965850739276857
인플레이션/NNG@$압력/NNG@$크/VA,1,0.3133269609566456,33,19,14,34,0.5654981262812042,0.2965850739276857
부동산/NNG@$대책/NNG@$효과/NNG,1,0.3133269609566456,33,19,14,23,0.5654981262812042,0.2965850739276857
금리/NNG@$인상/NNG@$주택/NNG,1,0.3133269609566456,33,19,14,27,0.5654981262812042,0.2965850739276857
시장/NNG@$관심/NNG@$금리/NNG,1,0.3133269609566456,33,19,14,37,0.5654981262812042,0.2965850739276857
동결/NNG@$인상/NNG@$가능성/NNG,1,0.3133269609566456,33,19,14,23,0.5654981262812042,0.2965850739276857
정책/NNG@$수단/NNG@$활용/NNG,1,0.3133269609566456,33,19,14,38,0.5654981262812042,0.2965850739276857
기준금리/NNG@$인상/NNG@$전망/NNG,1,0.31104815486791026,219,124,95,308,0.8355660054244611,0.44043977173000387
확장/NNG@$국면/NNG@$지속/NNG,0,0.31001117897470243,15,9,6,24,0.3973109910920987,0.2099088304043904
자산/NNG@$축소/NNG@$계획/NNG,0,0.31001117897470243,15,9,6,41,0.3973109910920987,0.2099088304043904
경제/NNG@$민간/NNG@$소비/NNG,0,0.31001117897470243,15,9,6,27,0.3973109910920987,0.2099088304043904
시장/NNG@$영향/NNG@$제한적/NNG,0,0.3066518833010834,24,14,10,39,0.4850111104979761,0.2581477019756635
기준금리/NNG@$만장일치/NNG@$동결/NNG,0,0.3066518833010834,24,14,10,48,0.4850111104979761,0.2581477019756635
경기/NNG@$상승세/NNG@$둔화/NNG,0,0.3066518833010834,24,14,10,21,0.4850111104979761,0.2581477019756635
농산물/NNG@$가격/NNG@$하락/NNG,0,0.3066518833010834,24,14,10,48,0.4850111104979761,0.2581477019756635
원유/NNG@$재고/NNG@$증가/NNG,0,0.3066518833010834,24,14,10,33,0.4850111104979761,0.2581477019756635
증가/NNG@$민간/NNG@$소비/NNG,0,0.3066518833010834,24,14,10,23,0.4850111104979761,0.2581477019756635
인하/NNG@$가능성/NNG@$없/VA,0,0.3066518833010834,24,14,10,32,0.4850111104979761,0.2581477019756635
소폭/NNG@$하향/NNG@$조정/NNG,0,0.3066518833010834,24,14,10,63,0.4850111104979761,0.2581477019756635
기업/NNG@$구조조정/NNG@$진행/NNG,0,0.3066518833010834,24,14,10,44,0.4850111104979761,0.2581477019756635
기준금리/NNG@$동결/NNG@$열/VV,0,0.3066518833010834,24,14,10,26,0.4850111104979761,0.2581477019756635
시장/NNG@$고용/NNG@$지표/NNG,0,0.3066518833010834,24,14,10,37,0.4850111104979761,0.2581477019756635
경기/NNG@$부진/NNG@$우려/NNG,0,0.3066518833010834,24,14,10,35,0.4850111104979761,0.2581477019756635
증가/NNG@$물가/NNG@$상승/NNG,0,0.3066518833010834,24,14,10,40,0.4850111104979761,0.2581477019756635
물가/NNG@$상승/NNG@$주도/NNG,0,0.3066518833010834,24,14,10,22,0.4850111104979761,0.2581477019756635
국고채/NNG@$금리/NNG@$내린/VV,0,0.3066518833010834,24,14,10,26,0.4850111104979761,0.2581477019756635
통화/NNG@$증가율/NNG@$높/VA,0,0.3066518833010834,24,14,10,13,0.4850111104979761,0.2581477019756635
대외/NNG@$불안/NNG@$요인/NNG,1,0.30525852610524495,73,41,32,93,0.7715134352003737,0.41190023587688945
경기/NNG@$둔화/NNG@$물가/NNG,1,0.30525852610524495,73,41,32,62,0.7715134352003737,0.41190023587688945
필요/NNG@$있/VA@$조언/NNG,1,0.30514194203367606,55,31,24,75,0.7042903368832296,0.37610721836366234
소비/NNG@$지출/NNG@$가격지수/NNG,1,0.30514194203367606,55,31,24,56,0.7042903368832296,0.37610721836366234
개인/NNG@$소비/NNG@$지출/NNG@$가격지수/NNG,1,0.30514194203367606,55,31,24,54,0.7042903368832296,0.37610721836366234
인상/NNG@$금리/NNG@$동결/NNG,1,0.30514194203367606,55,31,24,57,0.7042903368832296,0.37610721836366234
경상수지/NNG@$흑자/NNG@$기조/NNG,1,0.30514194203367606,55,31,24,86,0.7042903368832296,0.37610721836366234
금리/NNG@$인상/NNG@$대응/NNG,1,0.30272978284034613,35,20,15,66,0.5777947125203958,0.3101960656526551
장단기/NNG@$금리차/NNG@$축소/NNG,1,0.30272978284034613,35,20,15,24,0.5777947125203958,0.3101960656526551
더블딥/NNG@$경기/NNG@$상승/NNG@$하강/NNG,1,0.30272978284034613,35,20,15,48,0.5777947125203958,0.3101960656526551
우려/NNG@$금리/NNG@$동결/NNG,1,0.30272978284034613,35,20,15,44,0.5777947125203958,0.3101960656526551
대외/NNG@$불확실성/NNG@$확대/NNG,1,0.30272978284034613,35,20,15,32,0.5777947125203958,0.3101960656526551
감소/NNG@$금리/NNG@$인상/NNG,1,0.30272978284034613,35,20,15,18,0.5777947125203958,0.3101960656526551
상품/NNG@$가격/NNG@$급등/NNG,1,0.30272978284034613,35,20,15,40,0.5777947125203958,0.3101960656526551
경제/NNG@$동향/NNG@$그린북/NNG,1,0.3018756351138032,142,80,62,122,0.8302783335604109,0.44658174009602364
채권/NNG@$시장/NNG@$통화정책/NNG,1,0.3010348261414777,46,26,20,43,0.6533603610361182,0.35207193370919193
경기/NNG@$회복/NNG@$추세/NNG,1,0.29862304418433827,75,42,33,83,0.7737392346811728,0.41914996687640704
금리/NNG@$인상/NNG@$고려/NNG,1,0.29376855995717355,93,52,41,103,0.8043987258818359,0.4404099603007547
기준금리/NNG@$인상/NNG@$적절/XR,1,0.29308415386072517,37,21,16,69,0.5895302301206895,0.3232516522898542
제조업/NNG@$평균/NNG@$가동률/NNG,1,0.29308415386072517,37,21,16,36,0.5895302301206895,0.3232516522898542
기준금리/NNG@$인상/NNG@$필요/NNG,1,0.29308415386072517,37,21,16,47,0.5895302301206895,0.3232516522898542
지수/NNG@$하락/NNG@$기록/NNG,1,0.29308415386072517,37,21,16,63,0.5895302301206895,0.3232516522898542
시장/NNG@$경기/NNG@$둔화/NNG,1,0.29308415386072517,37,21,16,56,0.5895302301206895,0.3232516522898542
공개/NNG@$금리/NNG@$인상/NNG,1,0.29308415386072517,37,21,16,65,0.5895302301206895,0.3232516522898542
상승/NNG@$기대/NNG@$심리/NNG,0,0.29276699619956803,26,15,11,30,0.4994810390445339,0.2740654533589113
수출/NNG@$호조세/NNG@$지속/NNG,0,0.29276699619956803,26,15,11,26,0.4994810390445339,0.2740654533589113
금리/NNG@$상승/NNG@$채권/NNG,0,0.29276699619956803,26,15,11,37,0.4994810390445339,0.2740654533589113
경기/NNG@$호전/NNG@$예상/NNG,0,0.29276699619956803,26,15,11,38,0.4994810390445339,0.2740654533589113
물가/NNG@$상승률/NNG@$고려/NNG,0,0.29276699619956803,26,15,11,35,0.4994810390445339,0.2740654533589113
고용/NNG@$지표/NNG@$예상/NNG,1,0.292234556629132,77,43,34,62,0.7756798872950224,0.4261106129324716
금리/NNG@$인상/NNG@$예고/NNG,1,0.2906163986124153,86,48,38,105,0.7928925477434781,0.43710568455444415
농산물/NNG@$가격/NNG@$상승/NNG,1,0.29045152950606745,59,33,26,51,0.7160555468268395,0.3948888443192421
금리/NNG@$인상/NNG@$우려/NNG,1,0.29038453862036406,180,101,79,279,0.8266209774167547,0.4559297905451616
사상/NNG@$최고치/NNG@$기록/NNG,1,0.28905790458192393,118,66,52,142,0.8201452983232417,0.4536670536506945
금리/NNG@$기조/NNG@$유지/NNG,1,0.28818366862022526,95,53,42,144,0.8041811558373008,0.4456836716945032
지표/NNG@$금리/NNG@$인상/NNG,1,0.2860804090017941,79,44,35,73,0.7773542956137687,0.4327909199951797
개선/NNG@$조짐/NNG@$보이/VV,1,0.285360553502211,50,28,22,64,0.6699899109930766,0.3735997987902928
채권/NNG@$투자/NNG@$자금/NNG,1,0.285360553502211,50,28,22,58,0.6699899109930766,0.3735997987902928
차액/NNG@$결제/NNG@$선물환/NNG@$시장/NNG,0,0.2851052950668844,17,10,7,37,0.41290716742086,0.23037299773634803
결제/NNG@$선물환/NNG@$시장/NNG,0,0.2851052950668844,17,10,7,37,0.41290716742086,0.23037299773634803
부정적/NNG@$영향/NNG@$크/VA@$않/VX,0,0.2851052950668844,17,10,7,27,0.41290716742086,0.23037299773634803
인상/NNG@$어려울/VA@$전망/NNG,0,0.2851052950668844,17,10,7,33,0.41290716742086,0.23037299773634803
잠재적/NNG@$불안/NNG@$요인/NNG,0,0.2851052950668844,17,10,7,33,0.41290716742086,0.23037299773634803
금리/NNG@$정상화/NNG@$추진/NNG,0,0.2851052950668844,17,10,7,30,0.41290716742086,0.23037299773634803
물가/NNG@$상승률/NNG@$기준금리/NNG,0,0.2851052950668844,17,10,7,39,0.41290716742086,0.23037299773634803
방향/NNG@$금리/NNG@$인상/NNG,0,0.2851052950668844,17,10,7,31,0.41290716742086,0.23037299773634803
강구/NNG@$필요/NNG@$있/VA,0,0.2851052950668844,17,10,7,39,0.41290716742086,0.23037299773634803
물가/NNG@$상승률/NNG@$달성/NNG,1,0.28422323494910495,39,22,17,38,0.6007059703957944,0.33579393104718874
전세/NNG@$가격/NNG@$상승/NNG,1,0.28422323494910495,39,22,17,42,0.6007059703957944,0.33579393104718874
금리/NNG@$인상/NNG@$동결/NNG,1,0.28422323494910495,39,22,17,54,0.6007059703957944,0.33579393104718874
통화정책/NNG@$경기/NNG@$회복/NNG,1,0.28422323494910495,39,22,17,56,0.6007059703957944,0.33579393104718874
시장/NNG@$국고채/NNG@$금리/NNG,1,0.28422323494910495,39,22,17,36,0.6007059703957944,0.33579393104718874
채권/NNG@$시장/NNG@$국고채/NNG@$금리/NNG,1,0.28422323494910495,39,22,17,32,0.6007059703957944,0.33579393104718874
요인/NNG@$금리/NNG@$인상/NNG,1,0.28359440747913633,61,34,27,76,0.7212649614585692,0.4037368680053077
물가/NNG@$상승/NNG@$요인/NNG,1,0.2826676710600007,113,63,50,102,0.8152494376544601,0.4572641266255866
인상/NNG@$이뤄질/VV@$전망/NNG,1,0.2808521243450348,28,16,12,38,0.5134910926901688,0.2891468585323501
경기/NNG@$둔화/NNG@$기준금리/NNG,1,0.2808521243450348,28,16,12,29,0.5134910926901688,0.2891468585323501
경기/NNG@$회복/NNG@$발목/NNG@$잡/VV,1,0.2808521243450348,28,16,12,21,0.5134910926901688,0.2891468585323501
기업들/NNG@$체감/NNG@$경기/NNG,1,0.2808521243450348,28,16,12,25,0.5134910926901688,0.2891468585323501
상승/NNG@$압력/NNG@$가능성/NNG,1,0.2808521243450348,28,16,12,25,0.5134910926901688,0.2891468585323501
자본/NNG@$유출입/NNG@$변동성/NNG,1,0.2808521243450348,28,16,12,61,0.5134910926901688,0.2891468585323501
경제/NNG@$성장/NNG@$영향/NNG,1,0.2808521243450348,28,16,12,48,0.5134910926901688,0.2891468585323501
금리/NNG@$인상/NNG@$여지/NNG,1,0.2808521243450348,28,16,12,53,0.5134910926901688,0.2891468585323501
수단/NNG@$금리/NNG@$인상/NNG,1,0.2808521243450348,28,16,12,30,0.5134910926901688,0.2891468585323501
통화정책/NNG@$긴축/NNG@$기조/NNG,1,0.2808521243450348,28,16,12,26,0.5134910926901688,0.2891468585323501
통화정책/NNG@$기조/NNG@$전환/NNG,1,0.2808521243450348,28,16,12,36,0.5134910926901688,0.2891468585323501
시장/NNG@$금리/NNG@$역전/NNG,1,0.2808521243450348,28,16,12,48,0.5134910926901688,0.2891468585323501
금리/NNG@$인상/NNG@$성장/NNG,1,0.2808521243450348,28,16,12,45,0.5134910926901688,0.2891468585323501
경기/NNG@$회복세/NNG@$약화/NNG,1,0.2808521243450348,28,16,12,38,0.5134910926901688,0.2891468585323501
전망치/NNG@$상향/NNG@$조정/NNG,1,0.27705383325123334,190,106,84,300,0.8208166653180237,0.4660161162574215
이유/NNG@$금리/NNG@$인상/NNG,1,0.277028688372025,63,35,28,79,0.7260532889007743,0.4122369051484679
경기/NNG@$회복/NNG@$도움/NNG,1,0.2760195805725689,41,23,18,45,0.6113258182993346,0.347854782757176
시장/NNG@$기준금리/NNG@$동결/NNG,1,0.2738764161870917,92,51,41,96,0.7938748322486185,0.4538228712677689
유지/NNG@$금리/NNG@$인상/NNG,1,0.27338179208569,167,93,74,195,0.8189404623048642,0.46865148595936734
대출/NNG@$금리/NNG@$인상/NNG,1,0.271890619501725,126,70,56,172,0.8147151627969618,0.467734565952616
구조/NNG@$개혁/NNG@$추진/NNG,1,0.2712913431002868,54,30,24,65,0.6845569723181708,0.3935174088335311
주택/NNG@$가격/NNG@$하락세/NNG,1,0.27042847037691753,30,17,13,32,0.5270227614969145,0.30352235811830097
국채/NNG@$매입/NNG@$계획/NNG,1,0.27042847037691753,30,17,13,68,0.5270227614969145,0.30352235811830097
시장/NNG@$예상/NNG@$금리/NNG@$인상/NNG,1,0.27042847037691753,30,17,13,39,0.5270227614969145,0.30352235811830097
매입/NNG@$규모/NNG@$축소/NNG,1,0.27042847037691753,30,17,13,108,0.5270227614969145,0.30352235811830097
둔화/NNG@$경기/NNG@$회복/NNG,1,0.27042847037691753,30,17,13,26,0.5270227614969145,0.30352235811830097
기업/NNG@$수익성/NNG@$악화/NNG,1,0.27042847037691753,30,17,13,39,0.5270227614969145,0.30352235811830097
금리/NNG@$경기/NNG@$회복/NNG,1,0.27042847037691753,30,17,13,45,0.5270227614969145,0.30352235811830097
금리/NNG@$인상/NNG@$단행/NNG@$않/VX,1,0.27042847037691753,30,17,13,54,0.5270227614969145,0.30352235811830097
해외/NNG@$자본/NNG@$유입/NNG,1,0.27042847037691753,30,17,13,55,0.5270227614969145,0.30352235811830097
금리/NNG@$인상/NNG@$시기/NNG@$전망/NNG,1,0.27042847037691753,30,17,13,46,0.5270227614969145,0.30352235811830097
위험/NNG@$요인/NNG@$상존/NNG,1,0.2689149821575263,85,47,38,71,0.7809579379062558,0.45123565533094323
유지/NNG@$필요/NNG@$있/VA,1,0.2686817140769149,94,52,42,150,0.7938956985319691,0.45894126487600306
위안화/NNG@$절상/NNG@$속도/NNG,1,0.2683743306728137,43,24,19,63,0.62139606541634,0.35945889780371737
소득/NNG@$주도/NNG@$성장/NNG,1,0.2683743306728137,43,24,19,45,0.62139606541634,0.35945889780371737
유지/NNG@$기준금리/NNG@$인하/NNG,0,0.26643309137006055,19,11,8,29,0.4282681494979073,0.24877593316851807
규모/NNG@$인프라/NNG@$투자/NNG,0,0.26643309137006055,19,11,8,30,0.4282681494979073,0.24877593316851807
위안화/NNG@$절상/NNG@$문제/NNG,0,0.26643309137006055,19,11,8,30,0.4282681494979073,0.24877593316851807
인하/NNG@$효과/NNG@$지켜볼/VV,0,0.26643309137006055,19,11,8,48,0.4282681494979073,0.24877593316851807
가격/NNG@$상승세/NNG@$지속/NNG,0,0.26643309137006055,19,11,8,29,0.4282681494979073,0.24877593316851807
국내총생산/NNG@$증가율/NNG@$전망치/NNG,0,0.26643309137006055,19,11,8,33,0.4282681494979073,0.24877593316851807
억제/NNG@$기준치/NNG@$허용/NNG@$한도/NNG,0,0.26643309137006055,19,11,8,82,0.4282681494979073,0.24877593316851807
기준금리/NNG@$인상/NNG@$신중/NNG,0,0.26643309137006055,19,11,8,42,0.4282681494979073,0.24877593316851807
내수/NNG@$수출/NNG@$부진/NNG,0,0.26643309137006055,19,11,8,22,0.4282681494979073,0.24877593316851807
가계/NNG@$이자/NNG@$부담/NNG,1,0.2646895619382812,67,37,30,75,0.7344485394282623,0.42823244428713914
가능성/NNG@$배제/NNG@$어렵/VA,1,0.262244332937845,78,43,35,76,0.7637752977821353,0.44767306088775655
신중/NNG@$금리/NNG@$인상/NNG,1,0.26120971092982903,45,25,20,40,0.6309251772610702,0.37062591245094106
자금/NNG@$단기/NNG@$부동화/NNG,1,0.26120971092982903,45,25,20,51,0.6309251772610702,0.37062591245094106
축소/NNG@$금리/NNG@$인상/NNG,1,0.26120971092982903,45,25,20,65,0.6309251772610702,0.37062591245094106
조정/NNG@$필요/NNG@$있/VA,1,0.26120971092982903,45,25,20,61,0.6309251772610702,0.37062591245094106
경제/NNG@$침체/NNG@$가능성/NNG,1,0.26116159811923745,32,18,14,46,0.5400605047490956,0.3172817469617436
채권/NNG@$시장/NNG@$투자/NNG,1,0.26116159811923745,32,18,14,28,0.5400605047490956,0.3172817469617436
금리/NNG@$올릴/VV@$필요/NNG,1,0.26116159811923745,32,18,14,34,0.5400605047490956,0.3172817469617436
기조/NNG@$이어질/VV@$전망/NNG,1,0.26116159811923745,32,18,14,54,0.5400605047490956,0.3172817469617436
성장률/NNG@$전망/NNG@$제시/NNG,1,0.26116159811923745,32,18,14,54,0.5400605047490956,0.3172817469617436
성장률/NNG@$전망치/NNG@$낮췄/VV,1,0.26116159811923745,32,18,14,25,0.5400605047490956,0.3172817469617436
종료/NNG@$금리/NNG@$인상/NNG,1,0.26116159811923745,32,18,14,73,0.5400605047490956,0.3172817469617436
경기/NNG@$확장/NNG@$국면/NNG,1,0.2585237711600834,58,32,26,101,0.697204512780629,0.4119214581658083
가격/NNG@$상승/NNG@$물가/NNG,1,0.2584594449936728,89,49,40,108,0.7823423771874891,0.46228608502030627
경기/NNG@$둔화/NNG@$경제/NNG,1,0.25685649534000055,80,44,36,73,0.7655418199174528,0.45391115071450183
전망/NNG@$금리/NNG@$인상/NNG,1,0.2567095447350447,143,79,64,242,0.8102666474808357,0.48058060324768104
경기/NNG@$하강/NNG@$속도/NNG,1,0.2544637335332147,47,26,21,33,0.6399235384477691,0.3813719262419343
물가/NNG@$고공/NNG@$행진/NNG,1,0.2544637335332147,47,26,21,50,0.6399235384477691,0.3813719262419343
경기/NNG@$부양/NNG@$나설/VV,1,0.2528117622379318,34,19,15,71,0.5525921559298684,0.3304878346051956
위안화/NNG@$가치/NNG@$하락/NNG,1,0.2528117622379318,34,19,15,48,0.5525921559298684,0.3304878346051956
정책/NNG@$기조/NNG@$전환/NNG,1,0.2528117622379318,34,19,15,38,0.5525921559298684,0.3304878346051956
부진/NNG@$경기/NNG@$회복세/NNG,1,0.2528117622379318,34,19,15,26,0.5525921559298684,0.3304878346051956
물가/NNG@$상승/NNG@$유발/NNG,1,0.2528117622379318,34,19,15,25,0.5525921559298684,0.3304878346051956
위험/NNG@$요인/NNG@$가능성/NNG,1,0.252558494255563,60,33,27,44,0.702855173885419,0.42058238118562313
금리/NNG@$인상/NNG@$금융/NNG,1,0.252558494255563,60,33,27,60,0.702855173885419,0.42058238118562313
문제/NNG@$금리/NNG@$인상/NNG,1,0.252558494255563,60,33,27,74,0.702855173885419,0.42058238118562313
확인/NNG@$금리/NNG@$인상/NNG,1,0.252558494255563,60,33,27,86,0.702855173885419,0.42058238118562313
산업/NNG@$평균/NNG@$지수/NNG@$하락/NNG@$거래/NNG,1,0.252558494255563,60,33,27,76,0.702855173885419,0.42058238118562313
평균/NNG@$지수/NNG@$하락/NNG@$거래/NNG@$마쳤/VV,1,0.252558494255563,60,33,27,76,0.702855173885419,0.42058238118562313
변화/NNG@$금리/NNG@$인상/NNG,0,0.25178391866751504,21,12,9,36,0.4433597391815613,0.26574087648999817
인플레이션/NNG@$압력/NNG@$억제/NNG,0,0.25178391866751504,21,12,9,31,0.4433597391815613,0.26574087648999817
시장/NNG@$안정화/NNG@$조치/NNG,0,0.25178391866751504,21,12,9,47,0.4433597391815613,0.26574087648999817
금융/NNG@$위기/NNG@$금리/NNG@$인상/NNG,0,0.25178391866751504,21,12,9,35,0.4433597391815613,0.26574087648999817
외국/NNG@$자본/NNG@$유출/NNG,0,0.25178391866751504,21,12,9,30,0.4433597391815613,0.26574087648999817
시장/NNG@$금리/NNG@$인상/NNG@$가능성/NNG@$반영/NNG,0,0.25178391866751504,21,12,9,42,0.4433597391815613,0.26574087648999817
주택/NNG@$판매/NNG@$지수/NNG,0,0.25178391866751504,21,12,9,30,0.4433597391815613,0.26574087648999817
부동산/NNG@$거품/NNG@$붕괴/NNG,0,0.25178391866751504,21,12,9,31,0.4433597391815613,0.26574087648999817
금리/NNG@$정상화/NNG@$의지/NNG,0,0.25178391866751504,21,12,9,89,0.4433597391815613,0.26574087648999817
경제/NNG@$수출/NNG@$내수/NNG,0,0.25178391866751504,21,12,9,21,0.4433597391815613,0.26574087648999817
위기/NNG@$경제/NNG@$성장/NNG,0,0.25178391866751504,21,12,9,31,0.4433597391815613,0.26574087648999817
기준금리/NNG@$인상/NNG@$어려울/VA,0,0.25178391866751504,21,12,9,32,0.4433597391815613,0.26574087648999817
금융시장/NNG@$영향/NNG@$제한적/NNG,0,0.25178391866751504,21,12,9,35,0.4433597391815613,0.26574087648999817
기준금리/NNG@$결정/NNG@$앞두/VV,0,0.25178391866751504,21,12,9,40,0.4433597391815613,0.26574087648999817
안정적/NNG@$모습/NNG@$보이/VV,0,0.25178391866751504,21,12,9,28,0.4433597391815613,0.26574087648999817
주택/NNG@$담보대출/NNG@$증가세/NNG,1,0.24808639082076067,49,27,22,46,0.6484031919186537,0.3917105838735834
경기/NNG@$회복/NNG@$지원/NNG,1,0.24808639082076067,49,27,22,69,0.6484031919186537,0.3917105838735834
예상/NNG@$기준금리/NNG@$인상/NNG,1,0.24791737921604495,73,40,33,99,0.7443856876880225,0.44985676316608353
국채/NNG@$금리/NNG@$단기금리/NNG@$없/VA,1,0.24664882838934443,84,46,38,140,0.7683682043212249,0.4656039503658615
금리/NNG@$단기금리/NNG@$없/VA,1,0.24664882838934443,84,46,38,140,0.7683682043212249,0.4656039503658615
경기/NNG@$둔화/NNG@$예상/NNG,1,0.245203163989411,36,20,16,59,0.5646090335070423,0.3431853020799533
긴축/NNG@$기조/NNG@$유지/NNG,1,0.245203163989411,36,20,16,46,0.5646090335070423,0.3431853020799533
인플레이션/NNG@$압력/NNG@$낮/VA,1,0.245203163989411,36,20,16,47,0.5646090335070423,0.3431853020799533
금리/NNG@$동결/NNG@$배경/NNG,1,0.2427372557515739,75,41,34,108,0.7470662099781926,0.4564701518738464
대출/NNG@$금리/NNG@$상승/NNG,1,0.2427372557515739,75,41,34,70,0.7470662099781926,0.4564701518738464
고용/NNG@$지표/NNG@$부진/NNG,1,0.24181270170474134,86,47,39,79,0.7694603684608737,0.47107582791760727
지수/NNG@$하락/NNG@$거래/NNG@$마쳤/VV,1,0.24135961053955035,64,35,29,83,0.712905304277008,0.4368712266503589
인상/NNG@$가능성/NNG@$배제/NNG@$없/VA,1,0.24135961053955035,64,35,29,82,0.712905304277008,0.4368712266503589
금리/NNG@$인상/NNG@$리스크/NNG,0,0.23986719239720533,23,13,10,43,0.4581443504088758,0.2816416613132579
증가/NNG@$속도/NNG@$둔화/NNG,0,0.23986719239720533,23,13,10,33,0.4581443504088758,0.2816416613132579
금리/NNG@$인상/NNG@$마무리/NNG,0,0.23986719239720533,23,13,10,39,0.4581443504088758,0.2816416613132579
목표/NNG@$소비자/NNG@$물가/NNG,0,0.23986719239720533,23,13,10,42,0.4581443504088758,0.2816416613132579
소비/NNG@$회복/NNG@$조짐/NNG,0,0.23986719239720533,23,13,10,24,0.4581443504088758,0.2816416613132579
동결/NNG@$기준금리/NNG@$인하/NNG,0,0.23986719239720533,23,13,10,50,0.4581443504088758,0.2816416613132579
환율/NNG@$하락/NNG@$수출/NNG,0,0.23986719239720533,23,13,10,29,0.4581443504088758,0.2816416613132579
경제/NNG@$성장/NNG@$지지/NNG,0,0.23986719239720533,23,13,10,32,0.4581443504088758,0.2816416613132579
수출/NNG@$경제/NNG@$성장/NNG,0,0.23986719239720533,23,13,10,43,0.4581443504088758,0.2816416613132579
개선/NNG@$금리/NNG@$인하/NNG,0,0.23986719239720533,23,13,10,31,0.4581443504088758,0.2816416613132579
은행/NNG@$통화/NNG@$완화/NNG@$정책/NNG@$종료/NNG,0,0.23986719239720533,23,13,10,30,0.4581443504088758,0.2816416613132579
환율/NNG@$변동/NNG@$확대/NNG,0,0.23986719239720533,23,13,10,50,0.4581443504088758,0.2816416613132579
금리/NNG@$인상/NNG@$조치/NNG,1,0.2396476495717128,97,53,44,131,0.7831973694846014,0.48169003884357753
수요/NNG@$인플레이션/NNG@$압력/NNG,1,0.23820430633410727,38,21,17,42,0.5761058695419528,0.3554065547662672
경제/NNG@$회복/NNG@$수출/NNG,1,0.23820430633410727,38,21,17,36,0.5761058695419528,0.3554065547662672
동결/NNG@$가능성/NNG@$크/VA,1,0.23820430633410727,38,21,17,56,0.5761058695419528,0.3554065547662672
물가/NNG@$상승/NNG@$압력/NNG@$완화/NNG,1,0.23628155406126972,53,29,24,52,0.6638613170190822,0.4112125465807171
부정적/NNG@$영향/NNG@$가능성/NNG,1,0.23609219916611002,66,36,30,42,0.7173427318084391,0.44451816076559786
개인/NNG@$소비/NNG@$지출/NNG@$물가/NNG,0,0.23596028875555053,12,7,5,42,0.3550441446619896,0.22007273187828735
증후군/NNG@$메르스/NNG@$사태/NNG,1,0.2317150799675245,40,22,18,47,0.5870806265359084,0.36717565594550955
공개/NNG@$시장/NNG@$기준금리/NNG,1,0.2317150799675245,40,22,18,45,0.5870806265359084,0.36717565594550955
인상/NNG@$시기/NNG@$예상/NNG,1,0.2317150799675245,40,22,18,77,0.5870806265359084,0.36717565594550955
경기/NNG@$완만/XR@$회복/NNG,1,0.2317150799675245,40,22,18,54,0.5870806265359084,0.36717565594550955
호흡기/NNG@$증후군/NNG@$메르스/NNG@$사태/NNG,1,0.2317150799675245,40,22,18,47,0.5870806265359084,0.36717565594550955
유지/NNG@$기준금리/NNG@$인상/NNG,1,0.2317150799675245,40,22,18,44,0.5870806265359084,0.36717565594550955
금리/NNG@$인하/NNG@$시기/NNG,1,0.23079238513415046,55,30,25,91,0.6708699306006605,0.4203967683161665
석유/NNG@$제품/NNG@$가격/NNG,0,0.2298849136517218,25,14,11,22,0.4725853712491439,0.29670982017388003
인상/NNG@$전제/NNG@$조건/NNG,0,0.2298849136517218,25,14,11,48,0.4725853712491439,0.29670982017388003
회복세/NNG@$보이/VV@$경제/NNG,0,0.2298849136517218,25,14,11,37,0.4725853712491439,0.29670982017388003
산업/NNG@$생산/NNG@$예상/NNG,0,0.2298849136517218,25,14,11,51,0.4725853712491439,0.29670982017388003
예상/NNG@$기업/NNG@$많/VA,0,0.2298849136517218,25,14,11,39,0.4725853712491439,0.29670982017388003
인상/NNG@$시기/NNG@$늦추/VV,0,0.2298849136517218,25,14,11,26,0.4725853712491439,0.29670982017388003
국채/NNG@$매입/NNG@$확대/NNG,0,0.2298849136517218,25,14,11,40,0.4725853712491439,0.29670982017388003
리스크/NNG@$금리/NNG@$인상/NNG,0,0.2298849136517218,25,14,11,33,0.4725853712491439,0.29670982017388003
경기/NNG@$상승/NNG@$국면/NNG,0,0.2298849136517218,25,14,11,43,0.4725853712491439,0.29670982017388003
확대/NNG@$필요/NNG@$있/VA,0,0.2298849136517218,25,14,11,32,0.4725853712491439,0.29670982017388003
정상화/NNG@$금리/NNG@$인상/NNG,0,0.2298849136517218,25,14,11,40,0.4725853712491439,0.29670982017388003
금리/NNG@$인상/NNG@$속도/NNG@$예상/NNG,0,0.2298849136517218,25,14,11,29,0.4725853712491439,0.29670982017388003
엔화/NNG@$약세/NNG@$수출/NNG,0,0.2298849136517218,25,14,11,54,0.4725853712491439,0.29670982017388003
회복/NNG@$찬물/NNG@$끼얹/VV,0,0.2298849136517218,25,14,11,29,0.4725853712491439,0.29670982017388003
경제/NNG@$금리/NNG@$동결/NNG,0,0.2298849136517218,25,14,11,28,0.4725853712491439,0.29670982017388003
주의/NNG@$필요/NNG@$있/VA,0,0.2298849136517218,25,14,11,41,0.4725853712491439,0.29670982017388003
금리/NNG@$인상/NNG@$지연/NNG,0,0.22924899010512445,132,72,60,170,0.7958520653282476,0.5003407038266499
민간/NNG@$소비/NNG@$설비투자/NNG,1,0.2282862884685506,81,44,37,116,0.7534631637051427,0.47465275143489943
경기/NNG@$둔화/NNG@$지속/NNG,1,0.22565805708817965,42,23,19,37,0.5975342482167004,0.3785110075337515
변동성/NNG@$음식/NNG@$에너지/NNG,1,0.22565805708817965,42,23,19,13,0.5975342482167004,0.3785110075337515
물가/NNG@$하락/NNG@$압력/NNG,1,0.2255458071552836,57,31,26,47,0.6774196866229426,0.4292161304287178
금리/NNG@$인상/NNG@$시장/NNG,0,0.22423405991958822,178,97,81,229,0.796086981627187,0.5057970199532951
기준금리/NNG@$인상/NNG@$가능/NNG,0,0.22131981617410368,27,15,12,58,0.4866492848245157,0.31109260347236395
국채/NNG@$수익률/NNG@$하락/NNG,0,0.22131981617410368,27,15,12,42,0.4866492848245157,0.31109260347236395
국내총생산/NNG@$성장률/NNG@$기록/NNG,0,0.22131981617410368,27,15,12,43,0.4866492848245157,0.31109260347236395
완화/NNG@$조정/NNG@$필요/NNG,0,0.22131981617410368,27,15,12,55,0.4866492848245157,0.31109260347236395
출구전략/NNG@$금리/NNG@$인상/NNG,0,0.22131981617410368,27,15,12,44,0.4866492848245157,0.31109260347236395
소비자/NNG@$물가/NNG@$상승률/NNG@$목표치/NNG,0,0.22131981617410368,27,15,12,38,0.4866492848245157,0.31109260347236395
소비자/NNG@$물가/NNG@$상승률/NNG@$중기/NNG,0,0.22131981617410368,27,15,12,36,0.4866492848245157,0.31109260347236395
끝/NNG@$나지/NNG@$않/VX,0,0.22131981617410368,27,15,12,23,0.4866492848245157,0.31109260347236395
반응/NNG@$보이/VV@$않/VX,0,0.22131981617410368,27,15,12,47,0.4866492848245157,0.31109260347236395
우려/NNG@$가시/VV@$않/VX,0,0.22131981617410368,27,15,12,26,0.4866492848245157,0.31109260347236395
가능성/NNG@$높/VA@$않/VX,0,0.22112769306037006,127,69,58,166,0.7908563087792154,0.5057620903777926
금융/NNG@$위기/NNG@$발생/NNG,1,0.22003789384832229,96,52,44,131,0.772297746091674,0.49502412875595825
심리/NNG@$부정적/NNG@$영향/NNG,1,0.21997248880385656,44,24,20,32,0.6074703747191816,0.38942719645197765
성장/NNG@$하방/NNG@$리스크/NNG,1,0.2169314378214724,74,40,34,73,0.7316082770019162,0.4720062760288333
금리/NNG@$인상/NNG@$신호/NNG,1,0.21570334507420252,61,33,28,103,0.6892102050796364,0.4457974718099351
기금/NNG@$금리/NNG@$인하/NNG,1,0.2146100832989164,46,25,21,28,0.6168950428215574,0.3999362751514952
물가/NNG@$불안/NNG@$우려/NNG,1,0.2146100832989164,46,25,21,54,0.6168950428215574,0.3999362751514952
회복/NNG@$조짐/NNG@$나타나/VV,0,0.2141153286572517,14,8,6,34,0.37017603617577177,0.24023557395182918
모니터링/NNG@$필요/NNG@$있/VA,0,0.2141153286572517,14,8,6,28,0.37017603617577177,0.24023557395182918
중단/NNG@$가능성/NNG@$시사/NNG,0,0.2141153286572517,14,8,6,36,0.37017603617577177,0.24023557395182918
금융/NNG@$경제/NNG@$검토/NNG@$기준금리/NNG@$유지/NNG,0,0.2141153286572517,14,8,6,43,0.37017603617577177,0.24023557395182918
장단기/NNG@$시장/NNG@$금리/NNG,0,0.2141153286572517,14,8,6,20,0.37017603617577177,0.24023557395182918
정책/NNG@$방향/NNG@$결정/NNG,0,0.2141153286572517,14,8,6,26,0.37017603617577177,0.24023557395182918
경제/NNG@$검토/NNG@$기준금리/NNG@$유지/NNG,0,0.2141153286572517,14,8,6,44,0.37017603617577177,0.24023557395182918
거시/NNG@$건전성/NNG@$조치/NNG,0,0.2141153286572517,14,8,6,41,0.37017603617577177,0.24023557395182918
경제/NNG@$영향/NNG@$않/VX,1,0.2138232987789035,29,16,13,30,0.5003066612384651,0.32488568370846316
기록/NNG@$금리/NNG@$인상/NNG,1,0.2138232987789035,29,16,13,38,0.5003066612384651,0.32488568370846316
인도/NNG@$금리/NNG@$인상/NNG,1,0.2138232987789035,29,16,13,32,0.5003066612384651,0.32488568370846316
상승률/NNG@$석유류/NNG@$가격/NNG,1,0.2138232987789035,29,16,13,20,0.5003066612384651,0.32488568370846316
달러/NNG@$강세/NNG@$지속/NNG,1,0.2138232987789035,29,16,13,30,0.5003066612384651,0.32488568370846316
경기/NNG@$회복세/NNG@$유지/NNG,1,0.2138232987789035,29,16,13,38,0.5003066612384651,0.32488568370846316
확대/NNG@$경기/NNG@$회복/NNG,1,0.2138232987789035,29,16,13,25,0.5003066612384651,0.32488568370846316
금리/NNG@$인상/NNG@$의견/NNG,1,0.2138232987789035,29,16,13,47,0.5003066612384651,0.32488568370846316
물가/NNG@$상승률/NNG@$석유류/NNG@$가격/NNG,1,0.2138232987789035,29,16,13,20,0.5003066612384651,0.32488568370846316
인상/NNG@$나서/VV@$않/VX,1,0.2138232987789035,29,16,13,54,0.5003066612384651,0.32488568370846316
우려/NNG@$있/VA@$금리/NNG,1,0.2138232987789035,29,16,13,21,0.5003066612384651,0.32488568370846316
인상/NNG@$시기/NNG@$지연/NNG,1,0.2138232987789035,29,16,13,38,0.5003066612384651,0.32488568370846316
금리/NNG@$인상/NNG@$가능성/NNG@$무게/NNG,1,0.2138232987789035,29,16,13,27,0.5003066612384651,0.32488568370846316
소비자/NNG@$물가/NNG@$상승률/NNG@$석유류/NNG@$가격/NNG,1,0.2138232987789035,29,16,13,20,0.5003066612384651,0.32488568370846316
원자재/NNG@$가격/NNG@$하락/NNG,0,0.2135345542738496,236,128,108,293,0.7909365843483696,0.513923180249904
수출/NNG@$부정적/NNG@$영향/NNG,1,0.21127139974463183,89,48,41,98,0.7587659634564139,0.49535750281937657
정책/NNG@$기조/NNG@$변화/NNG,1,0.21107561432549882,63,34,29,108,0.6944855439408881,0.4535777483899246
성장률/NNG@$상향/NNG@$조정/NNG,1,0.21107561432549882,63,34,29,79,0.6944855439408881,0.4535777483899246
갭/NNG@$마이너스/NNG@$상태/NNG,1,0.20715270086817839,31,17,14,39,0.513532552320667,0.33815233164821823
압력/NNG@$선제적/NNG@$대응/NNG,1,0.20715270086817839,31,17,14,18,0.513532552320667,0.33815233164821823
경제/NNG@$경착륙/NNG@$가능성/NNG,1,0.20715270086817839,31,17,14,36,0.513532552320667,0.33815233164821823
통화/NNG@$가치/NNG@$절상/NNG,1,0.20715270086817839,31,17,14,31,0.513532552320667,0.33815233164821823
경기/NNG@$회복/NNG@$않/VX,1,0.20715270086817839,31,17,14,34,0.513532552320667,0.33815233164821823
소비자/NNG@$물가/NNG@$낮/VA,1,0.20715270086817839,31,17,14,44,0.513532552320667,0.33815233164821823
발생/NNG@$가능성/NNG@$크/VA,1,0.20715270086817839,31,17,14,29,0.513532552320667,0.33815233164821823
금리/NNG@$기준금리/NNG@$인상/NNG,1,0.20715270086817839,31,17,14,29,0.513532552320667,0.33815233164821823
우려/NNG@$경기/NNG@$둔화/NNG,1,0.20715270086817839,31,17,14,26,0.513532552320667,0.33815233164821823
시장/NNG@$관심/NNG@$쏠리/VV,1,0.20715270086817839,31,17,14,32,0.513532552320667,0.33815233164821823
조업/NNG@$일수/NNG@$감소/NNG,1,0.2047065683126057,50,27,23,35,0.6342443394028446,0.41977371126263924
서비스/NNG@$금리/NNG@$비교/NNG@$보/VV@$장기금리/NNG,1,0.2042928177213823,80,43,37,120,0.7391453049047768,0.48962406730005475
대응/NNG@$필요/NNG@$있/VA,1,0.20234279900457652,67,36,31,86,0.7038837851593049,0.46816300457825427
물가/NNG@$관리/NNG@$목표치/NNG,1,0.2011344510982891,33,18,15,49,0.5263065560309169,0.3509350689173052
이자/NNG@$상환/NNG@$부담/NNG,1,0.2011344510982891,33,18,15,45,0.5263065560309169,0.3509350689173052
기술/NNG@$지수/NNG@$내린/VV@$마감/NNG,1,0.2011344510982891,33,18,15,31,0.5263065560309169,0.3509350689173052
전망/NNG@$물가/NNG@$상승률/NNG,1,0.2011344510982891,33,18,15,43,0.5263065560309169,0.3509350689173052
경제/NNG@$성장률/NNG@$기록/NNG,1,0.2011344510982891,33,18,15,44,0.5263065560309169,0.3509350689173052
양적완화/NNG@$규모/NNG@$축소/NNG,1,0.20036919528576003,82,44,38,386,0.7411446518247703,0.494973749228088
가격/NNG@$상승/NNG@$경제/NNG,1,0.20010783230301055,52,28,24,48,0.6421903695856183,0.4291202367367105
경기/NNG@$전망/NNG@$지수/NNG,1,0.20010783230301055,52,28,24,97,0.6421903695856183,0.4291202367367105
금융시장/NNG@$변동성/NNG@$확대/NNG,0,0.19998652675519635,95,51,44,176,0.7608391426510552,0.5085311831363555
회복/NNG@$모습/NNG@$보이/VV,0,0.19877195185974794,16,9,7,26,0.38530223168172795,0.25818004870016464
기준금리/NNG@$인상/NNG@$검토/NNG,0,0.19877195185974794,16,9,7,40,0.38530223168172795,0.25818004870016464
가능성/NNG@$높/VA@$덧붙였/VV,0,0.19877195185974794,16,9,7,40,0.38530223168172795,0.25818004870016464
금리/NNG@$인상/NNG@$부동산시장/NNG,0,0.19877195185974794,16,9,7,36,0.38530223168172795,0.25818004870016464
무역수지/NNG@$흑자/NNG@$규모/NNG,0,0.19877195185974794,16,9,7,29,0.38530223168172795,0.25818004870016464
하방/NNG@$위험/NNG@$확대/NNG,0,0.19877195185974794,16,9,7,25,0.38530223168172795,0.25818004870016464
양적완화/NNG@$축소/NNG@$시작/NNG,0,0.19877195185974794,16,9,7,54,0.38530223168172795,0.25818004870016464
자금/NNG@$유입/NNG@$확대/NNG,0,0.19877195185974794,16,9,7,35,0.38530223168172795,0.25818004870016464
시장/NNG@$금리/NNG@$인상/NNG@$예상/NNG,0,0.19877195185974794,16,9,7,32,0.38530223168172795,0.25818004870016464
금리/NNG@$상승/NNG@$기조/NNG,0,0.19877195185974794,16,9,7,29,0.38530223168172795,0.25818004870016464
저금리/NNG@$정책/NNG@$유지/NNG,0,0.19877195185974794,16,9,7,35,0.38530223168172795,0.25818004870016464
수출/NNG@$호조/NNG@$보이/VV,1,0.19821666793113146,69,37,32,61,0.7080415754522292,0.4749862014188433
중기/NNG@$물가/NNG@$목표/NNG,0,0.19684131620627077,121,65,56,164,0.7768999646460879,0.5226704436680537
금리/NNG@$올리/VV@$않/VX,0,0.1960605230686523,184,99,85,236,0.7820445827201016,0.5269851064322036
완화/NNG@$금리/NNG@$인상/NNG,1,0.19564149477442538,35,19,16,62,0.5386126915793322,0.363262970762015
금리/NNG@$인상/NNG@$움직임/NNG,1,0.19564149477442538,35,19,16,56,0.5386126915793322,0.363262970762015
기준금리/NNG@$동결/NNG@$가능성/NNG@$높/VA,1,0.19564149477442538,35,19,16,27,0.5386126915793322,0.363262970762015
경제지표/NNG@$금리/NNG@$인상/NNG,1,0.19564149477442538,35,19,16,41,0.5386126915793322,0.363262970762015
경제/NNG@$경착륙/NNG@$우려/NNG,1,0.19564149477442538,35,19,16,34,0.5386126915793322,0.363262970762015
가능성/NNG@$높/VA@$예상/NNG,1,0.19423871963826866,71,38,33,83,0.711861490872303,0.48150861895230807
금리/NNG@$인상/NNG@$출구전략/NNG,1,0.19423871963826866,71,38,33,112,0.711861490872303,0.48150861895230807
우려/NNG@$금리/NNG@$인상/NNG@$가능성/NNG,1,0.19057896055402068,37,20,17,21,0.5504391641524844,0.3751563618453553
고공/NNG@$행진/NNG@$지속/NNG,1,0.18747242461932156,58,31,27,76,0.6632692194928489,0.45497291723789246
위험/NNG@$선호/NNG@$심리/NNG,0,0.18732458481432412,18,10,8,27,0.4003536071355867,0.2747086086228962
검토/NNG@$기준금리/NNG@$유지/NNG,0,0.18732458481432412,18,10,8,48,0.4003536071355867,0.2747086086228962
시차/NNG@$소비자/NNG@$물가/NNG,0,0.18732458481432412,18,10,8,28,0.4003536071355867,0.2747086086228962
수출/NNG@$증가세/NNG@$지속/NNG,0,0.18732458481432412,18,10,8,20,0.4003536071355867,0.2747086086228962
대응/NNG@$방안/NNG@$마련/NNG,0,0.18732458481432412,18,10,8,25,0.4003536071355867,0.2747086086228962
정책금리/NNG@$인상/NNG@$시기/NNG,0,0.18732458481432412,18,10,8,21,0.4003536071355867,0.2747086086228962
경기/NNG@$부양/NNG@$양적완화/NNG,0,0.18732458481432412,18,10,8,47,0.4003536071355867,0.2747086086228962
인상/NNG@$강하/VA@$시사/NNG,0,0.18732458481432412,18,10,8,36,0.4003536071355867,0.2747086086228962
국채/NNG@$수익률/NNG@$상승/NNG,1,0.18669716096939193,75,40,35,74,0.7185552754478383,0.4936877003798697
물가/NNG@$금리/NNG@$인상/NNG,1,0.18669716096939193,75,40,35,98,0.7185552754478383,0.4936877003798697
동결/NNG@$기조/NNG@$유지/NNG,0,0.18596899207536244,90,48,42,123,0.7469839385162227,0.5139931343854918
고려/NNG@$기준금리/NNG@$동결/NNG,1,0.18587477046299772,39,21,18,42,0.5617780660580172,0.3866298979958819
금융시장/NNG@$혼란/NNG@$경제/NNG,1,0.18587477046299772,39,21,18,21,0.5617780660580172,0.3866298979958819
부정적/NNG@$영향/NNG@$예상/NNG,1,0.18587477046299772,39,21,18,44,0.5617780660580172,0.3866298979958819
금리/NNG@$올릴/VV@$가능성/NNG,0,0.18361850126353785,105,56,49,151,0.7616699956242972,0.526650514955381
조짐/NNG@$보이/VV@$않/VX,1,0.18359594090669829,60,32,28,67,0.6694241942410601,0.46288947826158666
단행/NNG@$가능성/NNG@$높/VA,1,0.18359594090669829,60,32,28,52,0.6694241942410601,0.46288947826158666
최대/NNG@$채권/NNG@$펀드/NNG,1,0.18359594090669829,60,32,28,75,0.6694241942410601,0.46288947826158666
부진/NNG@$금리/NNG@$인상/NNG,1,0.18312037828773264,77,41,36,68,0.7214621414265819,0.49936263864038094
금리/NNG@$비교/NNG@$보/VV@$장기금리/NNG@$국고채/NNG,1,0.18312037828773264,77,41,36,101,0.7214621414265819,0.49936263864038094
비교/NNG@$보/VV@$장기금리/NNG@$국고채/NNG,1,0.18312037828773264,77,41,36,101,0.7214621414265819,0.49936263864038094
금리/NNG@$인상/NNG@$카드/NNG,0,0.18266896993878756,92,49,43,104,0.7479745745233317,0.5181961623360415
금리/NNG@$인하/NNG@$고려/NNG,1,0.181473319009966,41,22,19,76,0.5726250437204561,0.3976946193594459
정책금리/NNG@$인하/NNG@$가능성/NNG,1,0.181473319009966,41,22,19,41,0.5726250437204561,0.3976946193594459
통화/NNG@$가치/NNG@$절하/NNG,1,0.17986679004233097,62,33,29,70,0.6751692329273877,0.47046972770081735
광공업/NNG@$생산/NNG@$감소/NNG,1,0.17986679004233097,62,33,29,34,0.6751692329273877,0.47046972770081735
저금리/NNG@$기조/NNG@$지속/NNG,1,0.17986679004233097,62,33,29,44,0.6751692329273877,0.47046972770081735
경기/NNG@$회복/NNG@$지연/NNG,0,0.17911538845887076,135,72,63,169,0.7709294089264485,0.5380302776368583
채권/NNG@$가격/NNG@$상승/NNG,0,0.1783815469716281,20,11,9,34,0.41526393812224355,0.29025083342823826
요인/NNG@$경기/NNG@$회복/NNG,0,0.1783815469716281,20,11,9,28,0.41526393812224355,0.29025083342823826
회복/NNG@$국면/NNG@$접어들/VV,0,0.1783815469716281,20,11,9,33,0.41526393812224355,0.29025083342823826
중개인/NNG@$주택/NNG@$판매/NNG,0,0.1783815469716281,20,11,9,52,0.41526393812224355,0.29025083342823826
가능성/NNG@$높/VA@$시장/NNG,0,0.1783815469716281,20,11,9,26,0.41526393812224355,0.29025083342823826
내수/NNG@$경기/NNG@$부진/NNG,0,0.1783815469716281,20,11,9,29,0.41526393812224355,0.29025083342823826
재정/NNG@$건전성/NNG@$유지/NNG,0,0.1783815469716281,20,11,9,36,0.41526393812224355,0.29025083342823826
인상/NNG@$가능성/NNG@$크/VA@$않/VX,1,0.17733111620210296,43,23,20,47,0.5829789499882584,0.408359331310328
인상/NNG@$단행/NNG@$않/VX,1,0.17733111620210296,43,23,20,62,0.5829789499882584,0.408359331310328
가능/NNG@$경제/NNG@$성장/NNG,0,0.17632658578598726,81,43,38,61,0.726475524413916,0.5099287810584419
경제/NNG@$금리/NNG@$인상/NNG,0,0.17395437970575034,169,90,79,278,0.7703730830181611,0.5433894124861581
금리/NNG@$인상/NNG@$효과/NNG,0,0.1734249840060964,98,52,46,159,0.750026094076673,0.529614241074914
콜금리/NNG@$목표/NNG@$동결/NNG,1,0.17341372133074784,45,24,21,39,0.5928414951004772,0.4186315364796413
콜금리/NNG@$동결/NNG@$전망/NNG,1,0.17341372133074784,45,24,21,22,0.5928414951004772,0.4186315364796413
침체/NNG@$빠지/VV@$않/VX,1,0.17341372133074784,45,24,21,30,0.5928414951004772,0.4186315364796413
금리/NNG@$인하/NNG@$경제/NNG,0,0.17309982704816296,83,44,39,79,0.7286126835026557,0.5148380200128789
개인/NNG@$소비/NNG@$지출/NNG@$물가지수/NNG@$상승률/NNG,0,0.1711352814235887,22,12,10,33,0.4299731798630911,0.30504950062801583
하방/NNG@$리스크/NNG@$요인/NNG,0,0.1711352814235887,22,12,10,24,0.4299731798630911,0.30504950062801583
소비/NNG@$지출/NNG@$물가지수/NNG@$상승률/NNG,0,0.1711352814235887,22,12,10,33,0.4299731798630911,0.30504950062801583
내수/NNG@$수출/NNG@$균형/NNG,0,0.1711352814235887,22,12,10,22,0.4299731798630911,0.30504950062801583
가계/NNG@$소비/NNG@$지출/NNG,0,0.1711352814235887,22,12,10,31,0.4299731798630911,0.30504950062801583
소비자들/NNG@$경제/NNG@$심리/NNG@$나타내/VV@$소비자심리지수/NNG,0,0.1711352814235887,22,12,10,51,0.4299731798630911,0.30504950062801583
콜금리/NNG@$동결/NNG@$경기/NNG,0,0.1711352814235887,22,12,10,28,0.4299731798630911,0.30504950062801583
정책/NNG@$일관성/NNG@$유지/NNG,0,0.1711352814235887,22,12,10,39,0.4299731798630911,0.30504950062801583
금리/NNG@$인상/NNG@$그칠/VV,0,0.1711352814235887,22,12,10,31,0.4299731798630911,0.30504950062801583
만장일치/NNG@$기준금리/NNG@$동결/NNG,1,0.1696935455257289,47,25,22,64,0.6022169056459757,0.428518061703805
경제/NNG@$성장/NNG@$예상/NNG,1,0.1696935455257289,47,25,22,73,0.6022169056459757,0.428518061703805
채권/NNG@$시장/NNG@$금리/NNG@$인하/NNG,1,0.16624637945262855,70,37,33,76,0.6943718908690849,0.4976035717689755
가능성/NNG@$크/VA@$덧붙였/VV,0,0.16508650556407622,24,13,11,28,0.44442824232399736,0.31924705722314833
소비자/NNG@$물가/NNG@$상승/NNG@$압력/NNG,0,0.16508650556407622,24,13,11,30,0.44442824232399736,0.31924705722314833
경제/NNG@$둘러싼/VV@$불확실성/NNG,0,0.16508650556407622,24,13,11,33,0.44442824232399736,0.31924705722314833
성장/NNG@$둔화/NNG@$인플레/NNG,0,0.16508650556407622,24,13,11,28,0.44442824232399736,0.31924705722314833
금리/NNG@$인상/NNG@$많/VA,0,0.16508650556407622,24,13,11,29,0.44442824232399736,0.31924705722314833
금리/NNG@$인상/NNG@$나서/VV@$않/VX,0,0.16508650556407622,24,13,11,33,0.44442824232399736,0.31924705722314833
금리/NNG@$인상/NNG@$강하/VA,0,0.16508650556407622,24,13,11,43,0.44442824232399736,0.31924705722314833
경제/NNG@$회복세/NNG@$완만/XR,0,0.16508650556407622,24,13,11,58,0.44442824232399736,0.31924705722314833
고려/NNG@$금리/NNG@$동결/NNG,0,0.16508650556407622,24,13,11,36,0.44442824232399736,0.31924705722314833
성장률/NNG@$소비자/NNG@$물가/NNG,0,0.16508650556407622,24,13,11,26,0.44442824232399736,0.31924705722314833
경제/NNG@$성장/NNG@$부정적/NNG,0,0.16508650556407622,24,13,11,32,0.44442824232399736,0.31924705722314833
경제/NNG@$수출/NNG@$부진/NNG,0,0.16508650556407622,24,13,11,19,0.44442824232399736,0.31924705722314833
양적완화/NNG@$축소/NNG@$우려/NNG,0,0.16508650556407622,24,13,11,80,0.44442824232399736,0.31924705722314833
회복/NNG@$기대/NNG@$어렵/VA,0,0.16508650556407622,24,13,11,43,0.44442824232399736,0.31924705722314833
압력/NNG@$금리/NNG@$인상/NNG,0,0.16312998495669828,72,38,34,73,0.6983091558335032,0.503635219675781
콜금리/NNG@$동결/NNG@$예상/NNG,0,0.16312998495669828,72,38,34,41,0.6983091558335032,0.503635219675781
금리/NNG@$인상/NNG@$사이클/NNG,0,0.16055841796831083,123,65,58,165,0.7583108318595349,0.5498002807691948
지속/NNG@$가능/NNG@$경제/NNG@$성장/NNG,0,0.1601176598812859,74,39,35,54,0.7019331581695409,0.5093844082906153
기준금리/NNG@$인상/NNG@$속도/NNG,0,0.1601176598812859,74,39,35,108,0.7019331581695409,0.5093844082906153
금리/NNG@$인상/NNG@$경제/NNG@$성장/NNG,0,0.15991087039815666,26,14,12,42,0.45858293062898847,0.33292910164855427
은행권/NNG@$가계/NNG@$대출/NNG,0,0.15991087039815666,26,14,12,36,0.45858293062898847,0.33292910164855427
기준금리/NNG@$인상/NNG@$할/VX,0,0.15991087039815666,26,14,12,26,0.45858293062898847,0.33292910164855427
국내총생산/NNG@$증가율/NNG@$전망/NNG,0,0.15991087039815666,26,14,12,28,0.45858293062898847,0.33292910164855427
물가/NNG@$상승/NNG@$압력/NNG@$금리/NNG,0,0.15991087039815666,26,14,12,32,0.45858293062898847,0.33292910164855427
인상/NNG@$시기/NNG@$가늠/NNG,0,0.15991087039815666,26,14,12,24,0.45858293062898847,0.33292910164855427
변화/NNG@$없/VA@$전망/NNG,0,0.15991087039815666,26,14,12,32,0.45858293062898847,0.33292910164855427
상승/NNG@$환율/NNG@$하락/NNG,0,0.15991087039815666,26,14,12,23,0.45858293062898847,0.33292910164855427
인상/NNG@$지연/NNG@$가능성/NNG,0,0.15991087039815666,26,14,12,25,0.45858293062898847,0.33292910164855427
반대/NNG@$금리/NNG@$인상/NNG,0,0.15991087039815666,26,14,12,36,0.45858293062898847,0.33292910164855427
금융/NNG@$위기/NNG@$이전/NNG@$회복/NNG,0,0.15991087039815666,26,14,12,40,0.45858293062898847,0.33292910164855427
통화정책/NNG@$결정/NNG@$영향/NNG,0,0.15991087039815666,26,14,12,22,0.45858293062898847,0.33292910164855427
금융/NNG@$규제/NNG@$완화/NNG,0,0.15991087039815666,26,14,12,41,0.45858293062898847,0.33292910164855427
자산/NNG@$축소/NNG@$시작/NNG,0,0.15991087039815666,26,14,12,58,0.45858293062898847,0.33292910164855427
기업/NNG@$경기/NNG@$전망/NNG,1,0.15639424952696923,55,29,26,49,0.6350020725816478,0.46433982759488535
금리/NNG@$인상/NNG@$예상/NNG,0,0.15592490430765715,426,225,201,547,0.7608926018434934,0.5569307819500153
전망/NNG@$경기/NNG@$회복/NNG,0,0.15538922156514978,28,15,13,32,0.47239761308681777,0.3461477365330932
증가/NNG@$시장/NNG@$예상치/NNG,0,0.15538922156514978,28,15,13,39,0.47239761308681777,0.3461477365330932
인플레/NNG@$상승/NNG@$압력/NNG,0,0.15538922156514978,28,15,13,41,0.47239761308681777,0.3461477365330932
통화정책/NNG@$변화/NNG@$가능성/NNG,0,0.15538922156514978,28,15,13,22,0.47239761308681777,0.3461477365330932
경기/NNG@$회복/NNG@$촉진/NNG,0,0.15538922156514978,28,15,13,20,0.47239761308681777,0.3461477365330932
정책/NNG@$기조/NNG@$변경/NNG,0,0.15538922156514978,28,15,13,37,0.47239761308681777,0.3461477365330932
경기/NNG@$둔화/NNG@$가능성/NNG,0,0.15524194189011986,250,132,118,279,0.760519642636965,0.5574360828582481
금리/NNG@$인하/NNG@$사이클/NNG,1,0.15339448797457966,57,30,27,35,0.6420715554610656,0.47239881333992206
경제/NNG@$회복/NNG@$국면/NNG,0,0.15136871183796363,30,16,14,30,0.48583880734031576,0.358934810620922
소비/NNG@$투자/NNG@$위축/NNG,0,0.15136871183796363,30,16,14,24,0.48583880734031576,0.358934810620922
담보대출/NNG@$모기지/NNG@$금리/NNG,0,0.15136871183796363,30,16,14,32,0.48583880734031576,0.358934810620922
하향/NNG@$조정/NNG@$성장률/NNG,0,0.15136871183796363,30,16,14,31,0.48583880734031576,0.358934810620922
기준금리/NNG@$추이/NNG@$열/VV,0,0.15136871183796363,30,16,14,54,0.48583880734031576,0.358934810620922
기술/NNG@$지수/NNG@$높/VA,0,0.15136871183796363,30,16,14,26,0.48583880734031576,0.358934810620922
결정/NNG@$금리/NNG@$인상/NNG,0,0.15086578883682633,99,52,47,112,0.7386808458770202,0.5462939854311817
인상/NNG@$가능성/NNG@$제기/NNG,1,0.15050420063898828,59,31,28,75,0.6487152742534802,0.4801141115253585
금리/NNG@$인상/NNG@$정책/NNG,0,0.1487622212683819,118,62,56,144,0.7500619999491603,0.5570989400013951
기준금리/NNG@$인상/NNG@$단행/NNG,0,0.14848801381367505,101,53,48,154,0.7392479464669216,0.5493743692002245
투자/NNG@$채권/NNG@$시장/NNG,0,0.147739938924359,32,17,15,40,0.4988787472004538,0.3713097670732631
중기/NNG@$물가/NNG@$목표치/NNG,0,0.147739938924359,32,17,15,34,0.4988787472004538,0.3713097670732631
투자/NNG@$증권/NNG@$기준금리/NNG,0,0.147739938924359,32,17,15,50,0.4988787472004538,0.3713097670732631
인상/NNG@$가능성/NNG@$희박/XR,0,0.147739938924359,32,17,15,32,0.4988787472004538,0.3713097670732631
인상/NNG@$가능성/NNG@$있/VA,0,0.147739938924359,32,17,15,71,0.4988787472004538,0.3713097670732631
의미/NNG@$금리/NNG@$인상/NNG,0,0.147739938924359,32,17,15,26,0.4988787472004538,0.3713097670732631
통화/NNG@$달러/NNG@$가치/NNG,0,0.147739938924359,32,17,15,32,0.4988787472004538,0.3713097670732631
경제/NNG@$전망/NNG@$밝/VA,0,0.147739938924359,32,17,15,34,0.4988787472004538,0.3713097670732631
통화정책/NNG@$정상화/NNG@$속도/NNG,0,0.147739938924359,32,17,15,29,0.4988787472004538,0.3713097670732631
주택/NNG@$착공/NNG@$실적/NNG,1,0.14442289626506932,34,18,16,59,0.5114949492560129,0.38328446178644887
기조/NNG@$유지/NNG@$예상/NNG,1,0.14442289626506932,34,18,16,39,0.5114949492560129,0.38328446178644887
기준금리/NNG@$동결/NNG@$시장/NNG,1,0.14442289626506932,34,18,16,51,0.5114949492560129,0.38328446178644887
고용/NNG@$시장/NNG@$회복/NNG,1,0.14442289626506932,34,18,16,55,0.5114949492560129,0.38328446178644887
민간/NNG@$소비/NNG@$증가율/NNG,0,0.14241904032687902,65,34,31,126,0.6662332684236354,0.5012795256774457
금리/NNG@$인상/NNG@$적절/XR,0,0.14160549050104598,88,46,42,99,0.7198100965519603,0.5424896241811664
경기/NNG@$선행/NNG@$지표/NNG,1,0.14135801007866822,36,19,17,42,0.5236697846830457,0.3948662018544765
투자/NNG@$활성화/NNG@$대책/NNG,1,0.14135801007866822,36,19,17,42,0.5236697846830457,0.3948662018544765
금리/NNG@$인상/NNG@$지지/NNG,0,0.13990014510780102,67,35,32,103,0.6713173855542282,0.5077030704115055
실시/NNG@$기준금리/NNG@$동결/NNG,1,0.1385002355826459,38,20,18,28,0.5353900582991499,0.4060596975189206
선행지수/NNG@$순환/NNG@$변동/NNG,1,0.1385002355826459,38,20,18,23,0.5353900582991499,0.4060596975189206
회복세/NNG@$보일/VV@$전망/NNG,1,0.1385002355826459,38,20,18,41,0.5353900582991499,0.4060596975189206
시기/NNG@$금리/NNG@$인상/NNG,1,0.1358150600677004,40,21,19,63,0.5466465967315706,0.416868328708462
물가/NNG@$상승/NNG@$억제/NNG,0,0.1348815538386814,94,49,45,123,0.7242372105560102,0.5533469736147848
가능성/NNG@$금리/NNG@$인상/NNG,0,0.1348815538386814,94,49,45,154,0.7242372105560102,0.5533469736147848
통화정책/NNG@$파급/NNG@$경로/NNG,1,0.13327573214390664,42,22,20,56,0.5574338480726186,0.4272949671492725
기대/NNG@$금리/NNG@$인상/NNG,1,0.13327573214390664,42,22,20,58,0.5574338480726186,0.4272949671492725
소비자/NNG@$물가/NNG@$상승률/NNG@$낮/VA,0,0.13281060682644097,73,38,35,106,0.6845157604607339,0.5252044843304253
필요/NNG@$있/VA@$덧붙였/VV,0,0.13278394686812867,96,50,46,133,0.7253763907902179,0.5565855399071451
투자/NNG@$심리/NNG@$회복/NNG,1,0.1308613013031703,44,23,21,77,0.5677494957629733,0.43734250384597295
하락/NNG@$금리/NNG@$인상/NNG,1,0.1308613013031703,44,23,21,69,0.5677494957629733,0.43734250384597295
가격/NNG@$상승/NNG@$영향/NNG,1,0.1308613013031703,44,23,21,39,0.5677494957629733,0.43734250384597295
인상/NNG@$채권/NNG@$시장/NNG,1,0.1308613013031703,44,23,21,44,0.5677494957629733,0.43734250384597295
주택/NNG@$가격/NNG@$급등/NNG,1,0.1308613013031703,44,23,21,46,0.5677494957629733,0.43734250384597295
금리/NNG@$인상/NNG@$부담/NNG,0,0.1287927522089034,100,52,48,123,0.7272187891786539,0.5625410575002163
금리/NNG@$인상/NNG@$할/VX,1,0.1285552060432249,46,24,22,57,0.57759408948594,0.4470141779521476
금리/NNG@$인상/NNG@$은행/NNG,1,0.1285552060432249,46,24,22,43,0.57759408948594,0.4470141779521476
산업/NNG@$활동/NNG@$동향/NNG@$보/VV,1,0.1285552060432249,46,24,22,26,0.57759408948594,0.4470141779521476
성장/NNG@$둔화/NNG@$인플레이션/NNG,1,0.1285552060432249,46,24,22,38,0.57759408948594,0.4470141779521476
활동/NNG@$동향/NNG@$보/VV,1,0.1285552060432249,46,24,22,27,0.57759408948594,0.4470141779521476
사드/NNG@$고고/NNG@$미사일/NNG@$방어/NNG@$체계/NNG,1,0.1285552060432249,46,24,22,44,0.57759408948594,0.4470141779521476
금리/NNG@$인상/NNG@$않/VX,0,0.12710032183144215,167,87,80,239,0.7445790980333524,0.577951986070459
매입/NNG@$프로그램/NNG@$종료/NNG,0,0.12653394911509186,11,6,5,44,0.32591438536788614,0.253269872892994
회복세/NNG@$갈/VX@$예상/NNG,0,0.12653394911509186,11,6,5,8,0.32591438536788614,0.253269872892994
금리/NNG@$인상/NNG@$가능성/NNG@$낮/VA,0,0.1263542017544419,79,41,38,115,0.6949496480386357,0.5402461969838018
물가/NNG@$상승률/NNG@$예상/NNG,0,0.12433079269666947,81,42,39,106,0.6978820543579456,0.5447569170379636
동결/NNG@$전망/NNG@$우세/NNG,1,0.12216726664281863,52,27,25,42,0.6043428493885031,0.4738150828156209
경제/NNG@$둔화/NNG@$가능성/NNG,1,0.12018564812689925,54,28,26,55,0.612354278349975,0.4820276843892651
인상/NNG@$가능성/NNG@$낮/VA,0,0.1199369493750555,133,69,64,171,0.7379577888562306,0.5811918698764995
금융시장/NNG@$금리/NNG@$인상/NNG,0,0.1186190994990588,87,45,42,132,0.70523966565102,0.5569085115040379
국채/NNG@$금리/NNG@$상승/NNG,0,0.11832885587244912,112,58,54,255,0.7299840145140459,0.5767873265874378
기준금리/NNG@$인상/NNG@$나서/VV,0,0.11736458730936583,13,7,6,38,0.34067216206600354,0.2697036599785137
금리/NNG@$상승/NNG@$주가/NNG,0,0.11736458730936583,13,7,6,19,0.34067216206600354,0.2697036599785137
금리/NNG@$인상/NNG@$기대/NNG,0,0.11700337969580366,216,112,104,265,0.7390215401504904,0.5854972135985099
경제/NNG@$경기/NNG@$회복/NNG,0,0.11460142017513775,60,31,29,71,0.6338137148416535,0.5045919091779817
재정/NNG@$확대/NNG@$정책/NNG,0,0.11460142017513775,60,31,29,65,0.6338137148416535,0.5045919091779817
소비/NNG@$심리/NNG@$개선/NNG,0,0.11341219760141819,93,48,45,118,0.710715559787982,0.5671777245323054
경제/NNG@$불안/NNG@$요인/NNG,0,0.11284684786587129,62,32,30,84,0.640148758571363,0.5114471837989026
경제/NNG@$회복세/NNG@$보이/VV,0,0.11114057591942395,64,33,31,84,0.6460965720191456,0.5179830410316991
브렉시트/NNG@$국민/NNG@$투표/NNG,0,0.11109742153448599,15,8,7,48,0.3555859193524706,0.2851021841660685
훼손/NNG@$않/VX@$중기적/NNG@$소비자/NNG@$물가/NNG,0,0.11109742153448599,15,8,7,48,0.3555859193524706,0.2851021841660685
성장잠재력/NNG@$훼손/NNG@$않/VX@$중기적/NNG@$소비자/NNG,0,0.11109742153448599,15,8,7,48,0.3555859193524706,0.2851021841660685
양적완화/NNG@$축소/NNG@$경제/NNG,0,0.11109742153448599,15,8,7,45,0.3555859193524706,0.2851021841660685
정책/NNG@$수단/NNG@$개발/NNG,0,0.11109742153448599,15,8,7,27,0.3555859193524706,0.2851021841660685
유동성/NNG@$증가세/NNG@$둔화/NNG,0,0.11109742153448599,15,8,7,26,0.3555859193524706,0.2851021841660685
가계부채/NNG@$증가세/NNG@$통화정책/NNG,0,0.11109742153448599,15,8,7,34,0.3555859193524706,0.2851021841660685
저축/NNG@$은행/NNG@$부실/NNG,0,0.11109742153448599,15,8,7,35,0.3555859193524706,0.2851021841660685
유로존/NNG@$부채/NNG@$위기/NNG,0,0.11109742153448599,15,8,7,44,0.3555859193524706,0.2851021841660685
정책/NNG@$다지기/NNG@$필요/NNG,0,0.11109742153448599,15,8,7,52,0.3555859193524706,0.2851021841660685
축소/NNG@$기준금리/NNG@$인상/NNG,0,0.10657710265791653,17,9,8,33,0.3705385776061499,0.29981668531129196
인플레/NNG@$압력/NNG@$가중/NNG,0,0.10657710265791653,17,9,8,34,0.3705385776061499,0.29981668531129196
채권/NNG@$기준금리/NNG@$동결/NNG,0,0.10657710265791653,17,9,8,37,0.3705385776061499,0.29981668531129196
금리/NNG@$인상/NNG@$어렵/VA,0,0.1062895848855514,70,36,34,79,0.6617559329312259,0.5357625649836647
영향/NNG@$경기/NNG@$회복/NNG,0,0.10317510873442837,19,10,9,21,0.3854378613213983,0.3140214485742332
금리/NNG@$인상/NNG@$국제금융시장/NNG,0,0.10317510873442837,19,10,9,39,0.3854378613213983,0.3140214485742332
이례적/NNG@$낮/VA@$금리/NNG,0,0.10317510873442837,19,10,9,44,0.3854378613213983,0.3140214485742332
달러화/NNG@$강세/NNG@$지속/NNG,0,0.10317510873442837,19,10,9,23,0.3854378613213983,0.3140214485742332
통화정책/NNG@$완화/NNG@$조정/NNG@$필요/NNG,0,0.10052082597871936,21,11,10,51,0.4002083813517245,0.3278058560992504
흑자/NNG@$규모/NNG@$축소/NNG,0,0.10052082597871936,21,11,10,28,0.4002083813517245,0.3278058560992504
자산/NNG@$매입/NNG@$프로그램/NNG@$규모/NNG,0,0.10052082597871936,21,11,10,30,0.4002083813517245,0.3278058560992504
동결/NNG@$경제/NNG@$동향/NNG,0,0.10052082597871936,21,11,10,30,0.4002083813517245,0.3278058560992504
정책적/NNG@$노력/NNG@$필요/NNG,0,0.10052082597871936,21,11,10,19,0.4002083813517245,0.3278058560992504
원자재/NNG@$가격/NNG@$불안/NNG,0,0.10052082597871936,21,11,10,24,0.4002083813517245,0.3278058560992504
통화/NNG@$달러화/NNG@$가치/NNG,0,0.10052082597871936,21,11,10,45,0.4002083813517245,0.3278058560992504
통화정책/NNG@$완화적/NNG@$기조/NNG,0,0.10052082597871936,21,11,10,26,0.4002083813517245,0.3278058560992504
가계/NNG@$소비/NNG@$여력/NNG,0,0.10052082597871936,21,11,10,28,0.4002083813517245,0.3278058560992504
체감/NNG@$경기/NNG@$수치화/NNG,0,0.10052082597871936,21,11,10,29,0.4002083813517245,0.3278058560992504
자산/NNG@$매입/NNG@$규모/NNG@$축소/NNG,0,0.10052082597871936,21,11,10,98,0.4002083813517245,0.3278058560992504
기준금리/NNG@$인상/NNG@$고려/NNG,0,0.10052082597871936,21,11,10,35,0.4002083813517245,0.3278058560992504
물가/NNG@$상승/NNG@$경기/NNG,0,0.10052082597871936,21,11,10,32,0.4002083813517245,0.3278058560992504
물가/NNG@$목표/NNG@$근접/NNG,0,0.09838237243295711,23,12,11,10,0.41478711072332136,0.3412153151112007
인플레이션/NNG@$우려/NNG@$높/VA,0,0.09838237243295711,23,12,11,37,0.41478711072332136,0.3412153151112007
예정/NNG@$기준금리/NNG@$인상/NNG,0,0.09838237243295711,23,12,11,32,0.41478711072332136,0.3412153151112007
물가/NNG@$상승세/NNG@$확대/NNG,0,0.09838237243295711,23,12,11,38,0.41478711072332136,0.3412153151112007
지출/NNG@$물가지수/NNG@$상승률/NNG,0,0.09838237243295711,23,12,11,33,0.41478711072332136,0.3412153151112007
경제/NNG@$심리/NNG@$나타내/VV@$소비자심리지수/NNG,0,0.09838237243295711,23,12,11,58,0.41478711072332136,0.3412153151112007
유지/NNG@$소비자/NNG@$물가/NNG,0,0.09838237243295711,23,12,11,43,0.41478711072332136,0.3412153151112007
소폭/NNG@$상향/NNG@$조정/NNG,0,0.09838237243295711,23,12,11,53,0.41478711072332136,0.3412153151112007
기업/NNG@$투자/NNG@$위축/NNG,0,0.09838237243295711,23,12,11,37,0.41478711072332136,0.3412153151112007
은행/NNG@$금리/NNG@$인상/NNG@$가능성/NNG,0,0.09838237243295711,23,12,11,41,0.41478711072332136,0.3412153151112007
금리/NNG@$내린/VV@$마감/NNG,0,0.09838237243295711,23,12,11,55,0.41478711072332136,0.3412153151112007
인상/NNG@$전망/NNG@$금리/NNG,0,0.09838237243295711,23,12,11,36,0.41478711072332136,0.3412153151112007
증권/NNG@$금리/NNG@$인상/NNG,0,0.09766024690900066,82,42,40,99,0.6845283636663032,0.5639322468588623
지수/NNG@$상승/NNG@$기록/NNG,0,0.0966080250907877,25,13,12,66,0.42912071208522173,0.3542713358362127
금리/NNG@$상승/NNG@$가계부채/NNG,0,0.0966080250907877,25,13,12,33,0.42912071208522173,0.3542713358362127
투자/NNG@$증권/NNG@$금리/NNG@$인상/NNG,0,0.0966080250907877,25,13,12,35,0.42912071208522173,0.3542713358362127
금리/NNG@$인상/NNG@$멈출/VV,0,0.0966080250907877,25,13,12,25,0.42912071208522173,0.3542713358362127
성장/NNG@$물가/NNG@$상승/NNG,0,0.0966080250907877,25,13,12,33,0.42912071208522173,0.3542713358362127
수출/NNG@$호조/NNG@$힘입/VV,0,0.0966080250907877,25,13,12,37,0.42912071208522173,0.3542713358362127
물가/NNG@$지표/NNG@$개인/NNG@$소비/NNG@$지출/NNG,0,0.0966080250907877,25,13,12,51,0.42912071208522173,0.3542713358362127
민간/NNG@$소비/NNG@$위축/NNG,0,0.0966080250907877,25,13,12,54,0.42912071208522173,0.3542713358362127
금리/NNG@$결정/NNG@$경제/NNG,0,0.0966080250907877,25,13,12,33,0.42912071208522173,0.3542713358362127
기업/NNG@$많/VA@$의미/NNG,0,0.09509504271342095,27,14,13,24,0.44316388039458404,0.36698215717553806
자금/NNG@$유입/NNG@$지속/NNG,0,0.09509504271342095,27,14,13,35,0.44316388039458404,0.36698215717553806
급등/NNG@$금리/NNG@$인상/NNG,0,0.09509504271342095,27,14,13,32,0.44316388039458404,0.36698215717553806
경제/NNG@$성장/NNG@$회복/NNG,0,0.09509504271342095,27,14,13,24,0.44316388039458404,0.36698215717553806
경제/NNG@$영향/NNG@$크/VA@$않/VX,0,0.09509504271342095,27,14,13,33,0.44316388039458404,0.36698215717553806
인상/NNG@$단행/NNG@$가능성/NNG@$높/VA,0,0.09509504271342095,27,14,13,29,0.44316388039458404,0.36698215717553806
제품/NNG@$가격/NNG@$인상/NNG,0,0.09509504271342095,27,14,13,35,0.44316388039458404,0.36698215717553806
가계/NNG@$대출/NNG@$증가/NNG,0,0.09507343404206026,86,44,42,72,0.6899981281139839,0.5714094426396902
가능성/NNG@$열/VV@$둔/VX,0,0.09377198387416374,29,15,14,50,0.4568782481296373,0.3793487090640536
사상/NNG@$최고/NNG@$기록/NNG,0,0.09377198387416374,29,15,14,43,0.4568782481296373,0.3793487090640536
요인/NNG@$자본/NNG@$유출입/NNG,0,0.09377198387416374,29,15,14,22,0.4568782481296373,0.3793487090640536
상승/NNG@$경제/NNG@$성장/NNG,0,0.09377198387416374,29,15,14,45,0.4568782481296373,0.3793487090640536
금리/NNG@$동결/NNG@$이유/NNG,0,0.09377198387416374,29,15,14,57,0.4568782481296373,0.3793487090640536
전망/NNG@$소비자/NNG@$물가/NNG@$상승률/NNG,0,0.09377198387416374,29,15,14,36,0.4568782481296373,0.3793487090640536
부정적/NNG@$영향/NNG@$최소화/NNG,0,0.09377198387416374,29,15,14,34,0.4568782481296373,0.3793487090640536
건강/NNG@$보험/NNG@$개혁/NNG,0,0.09377198387416374,29,15,14,29,0.4568782481296373,0.3793487090640536
상승/NNG@$지수/NNG@$오른/VV,0,0.09377198387416374,29,15,14,21,0.4568782481296373,0.3793487090640536
금융/NNG@$투자/NNG@$채권/NNG@$시장/NNG,0,0.09258814647385516,31,16,15,36,0.47023160460857866,0.3913681081946054
민간/NNG@$소비/NNG@$회복세/NNG,0,0.09258814647385516,31,16,15,28,0.47023160460857866,0.3913681081946054
성장/NNG@$부정적/NNG@$영향/NNG,0,0.09258814647385516,31,16,15,41,0.47023160460857866,0.3913681081946054
모습/NNG@$보이/VV@$경기/NNG,0,0.09258814647385516,31,16,15,33,0.47023160460857866,0.3913681081946054
실질/NNG@$국내총생산/NNG@$증가율/NNG,0,0.09258814647385516,31,16,15,49,0.47023160460857866,0.3913681081946054
인상/NNG@$달러화/NNG@$강세/NNG,0,0.09258814647385516,31,16,15,48,0.47023160460857866,0.3913681081946054
발생/NNG@$가능성/NNG@$낮/VA,0,0.09258814647385516,31,16,15,20,0.47023160460857866,0.3913681081946054
광/NNG@$통화/NNG@$증가율/NNG,0,0.09258814647385516,31,16,15,30,0.47023160460857866,0.3913681081946054
경기/NNG@$둔화/NNG@$영향/NNG,0,0.09258814647385516,31,16,15,47,0.47023160460857866,0.3913681081946054
소비/NNG@$위축/NNG@$우려/NNG,0,0.09258814647385516,31,16,15,31,0.47023160460857866,0.3913681081946054
상승/NNG@$가능성/NNG@$높/VA,0,0.09258814647385516,31,16,15,39,0.47023160460857866,0.3913681081946054
달러화/NNG@$가치/NNG@$상승/NNG,0,0.09150698377028421,33,17,16,49,0.4831972913846494,0.4030357704285849
회복/NNG@$쉽/VA@$않/VX,0,0.09150698377028421,33,17,16,33,0.4831972913846494,0.4030357704285849
강세/NNG@$금리/NNG@$인상/NNG,0,0.09150698377028421,33,17,16,47,0.4831972913846494,0.4030357704285849
주택/NNG@$담보대출/NNG@$규제/NNG,0,0.09150698377028421,33,17,16,41,0.4831972913846494,0.4030357704285849
전격적/NNG@$금리/NNG@$인상/NNG,0,0.09150698377028421,33,17,16,34,0.4831972913846494,0.4030357704285849
물가/NNG@$상승률/NNG@$넘/VV,0,0.09150698377028421,33,17,16,40,0.4831972913846494,0.4030357704285849
금리/NNG@$인상/NNG@$금융시장/NNG,0,0.09144830107028712,92,47,45,98,0.6965786106861168,0.5810861833857379
확장/NNG@$기조/NNG@$유지/NNG,0,0.09050184849353848,35,18,17,33,0.495753696739275,0.4143467080648716
인상/NNG@$가능성/NNG@$커지/VV,0,0.09050184849353848,35,18,17,47,0.495753696739275,0.4143467080648716
부진/NNG@$경기/NNG@$둔화/NNG,0,0.09050184849353848,35,18,17,47,0.495753696739275,0.4143467080648716
경기/NNG@$위축/NNG@$우려/NNG,0,0.09050184849353848,35,18,17,39,0.495753696739275,0.4143467080648716
경기/NNG@$둔화/NNG@$인플레/NNG,0,0.09050184849353848,35,18,17,39,0.495753696739275,0.4143467080648716
기준금리/NNG@$동결/NNG@$인상/NNG,0,0.09050184849353848,35,18,17,54,0.495753696739275,0.4143467080648716
부동산/NNG@$담보대출/NNG@$모기지/NNG,0,0.09050184849353848,35,18,17,27,0.495753696739275,0.4143467080648716
경제/NNG@$전망/NNG@$정책/NNG,0,0.09050184849353848,35,18,17,70,0.495753696739275,0.4143467080648716
상승/NNG@$압력/NNG@$가중/NNG,0,0.09050184849353848,35,18,17,53,0.495753696739275,0.4143467080648716
금리/NNG@$인상/NNG@$영향/NNG,0,0.09030625976414197,94,48,46,134,0.6983882474764367,0.583936801066915
기준금리/NNG@$사상/NNG@$최저치/NNG,1,0.08955315606876257,37,19,18,64,0.5078838067933046,0.4252963263984747
전망/NNG@$좋/VA@$않/VX,1,0.08955315606876257,37,19,18,45,0.5078838067933046,0.4252963263984747
시장/NNG@$투자/NNG@$심리/NNG,1,0.08955315606876257,37,19,18,40,0.5078838067933046,0.4252963263984747
가능성/NNG@$높/VA@$진단/NNG,1,0.08955315606876257,37,19,18,51,0.5078838067933046,0.4252963263984747
사상/NNG@$최고치/NNG@$경신/NNG,0,0.08943812089725811,172,88,84,218,0.7226353809177252,0.6052670597508687
전망/NNG@$기준금리/NNG@$인상/NNG,1,0.0886464435390455,39,20,19,53,0.5195747905379084,0.43588090211025615
사상/NNG@$최대치/NNG@$기록/NNG,1,0.08691895423069207,43,22,21,47,0.5416066330126218,0.4559458768120978
금리/NNG@$인상/NNG@$기정사실화/NNG,1,0.08691895423069207,43,22,21,45,0.5416066330126218,0.4559458768120978
회복/NNG@$속도/NNG@$둔화/NNG,1,0.08691895423069207,43,22,21,43,0.5416066330126218,0.4559458768120978
회복/NNG@$발목/NNG@$잡/VV,1,0.08691895423069207,43,22,21,33,0.5416066330126218,0.4559458768120978
인상/NNG@$금리/NNG@$인하/NNG,1,0.08691895423069207,43,22,21,49,0.5416066330126218,0.4559458768120978
실제/NNG@$금리/NNG@$인상/NNG,1,0.08691895423069207,43,22,21,68,0.5416066330126218,0.4559458768120978
기준금리/NNG@$인상/NNG@$시사/NNG,1,0.08608445955415567,45,23,22,54,0.5519393003806234,0.46542498068454136
기준금리/NNG@$인상/NNG@$예상/NNG,0,0.08490163408235829,145,74,71,201,0.7188442217764824,0.6076120090644658
부담/NNG@$금리/NNG@$인상/NNG,1,0.08445240349411787,49,25,24,45,0.5712385540592608,0.48328289063440455
동결/NNG@$가능성/NNG@$높/VA,0,0.08412559264247776,106,54,52,111,0.7059994574981202,0.5976868298022693
통화정책/NNG@$기준금리/NNG@$동결/NNG,1,0.0836496591929321,51,26,25,115,0.580212318380702,0.4916679248392131
기준금리/NNG@$동결/NNG@$경기/NNG,1,0.0836496591929321,51,26,25,87,0.580212318380702,0.4916679248392131
경기/NNG@$회복/NNG@$신호/NNG,1,0.08285360644011286,53,27,26,63,0.5887434948430867,0.4996963076640954
소비/NNG@$투자/NNG@$심리/NNG@$위축/NNG,1,0.08285360644011286,53,27,26,38,0.5887434948430867,0.4996963076640954
수출/NNG@$호조/NNG@$지속/NNG,1,0.08285360644011286,53,27,26,47,0.5887434948430867,0.4996963076640954
금리/NNG@$인상/NNG@$시작/NNG,0,0.08277393816891476,200,102,98,260,0.718754683968199,0.61014107853673
물가/NNG@$상승률/NNG@$낮/VA,0,0.0826006527464449,251,128,123,314,0.718661004177868,0.6102741161774947
투자/NNG@$증권/NNG@$채권/NNG,0,0.08127825723822757,57,29,28,65,0.6045113510133271,0.5147066202572811
물가/NNG@$상승률/NNG@$상승/NNG,0,0.07972312967027984,61,31,30,55,0.6186204583921286,0.5283684193067444
초저/NNG@$금리/NNG@$기조/NNG@$유지/NNG,0,0.07895322043630659,63,32,31,101,0.6250815779418186,0.5347134498052218
경기/NNG@$둔화/NNG@$조짐/NNG,0,0.07895322043630659,63,32,31,64,0.6250815779418186,0.5347134498052218
금리/NNG@$인상/NNG@$환율/NNG,0,0.07818876013489517,65,33,32,58,0.6311636468350796,0.540746086767319
금리/NNG@$인상/NNG@$어려울/VA,0,0.07818876013489517,65,33,32,94,0.6311636468350796,0.540746086767319
시장/NNG@$금리/NNG@$동결/NNG,0,0.07667779220366366,69,35,34,98,0.6422429324924889,0.5519107416858503
금리/NNG@$인상/NNG@$충격/NNG,0,0.07519400550822297,73,37,36,91,0.6519653740812155,0.5619376644201434
상승/NNG@$압력/NNG@$완화/NNG,0,0.07446365130318156,75,38,37,82,0.6563518190327562,0.5665486175178318
초저/NNG@$금리/NNG@$유지/NNG,0,0.07433797655566932,132,67,65,225,0.7107046496463972,0.6136196109683564
전망/NNG@$힘/NNG@$얻/VV,0,0.07374174541041079,77,39,38,123,0.6604399165940605,0.5709042159514243
둔화/NNG@$금리/NNG@$인상/NNG,0,0.06987851533462308,150,76,74,176,0.7100600644162891,0.618574975786726
경기/NNG@$상승/NNG@$기조/NNG,0,0.06897281208445394,91,46,45,57,0.6818166417250857,0.5950507879104434
상승/NNG@$소비자/NNG@$물가/NNG,0,0.06897281208445394,91,46,45,100,0.6818166417250857,0.5950507879104434
경제/NNG@$부정적/NNG@$영향/NNG,0,0.06425061824947265,186,94,92,220,0.7073740509200758,0.6232304484890288
금리/NNG@$단기금리/NNG@$국채/NNG,0,0.06377637444182027,109,55,54,234,0.695614836647785,0.6134530210003499
보유/NNG@$자산/NNG@$축소/NNG,0,0.06377637444182027,109,55,54,198,0.695614836647785,0.6134530210003499
채권/NNG@$금리/NNG@$상승/NNG,0,0.06327441903238928,111,56,55,140,0.6964976656282934,0.6148499964426035
물가/NNG@$상승/NNG@$우려/NNG,0,0.06327441903238928,111,56,55,149,0.6964976656282934,0.6148499964426035
기준금리/NNG@$동결/NNG@$전망/NNG,0,0.06271619008079754,200,101,99,254,0.7064518754475548,0.6243355895129861
소비/NNG@$투자/NNG@$내수/NNG,0,0.06100147389529509,121,61,60,121,0.6995996938388997,0.6204085322417552
기준금리/NNG@$사상/NNG@$최저/NNG,0,0.05982418378686116,127,64,63,157,0.7006540035932635,0.6228111777580339
산업/NNG@$생산/NNG@$증가/NNG,0,0.059113448379598754,131,66,65,199,0.7011155103370614,0.6241096183412139
채권/NNG@$시장/NNG@$강세/NNG,0,0.04639029386584004,74,37,37,120,0.6374919355384091,0.5821168067534782
목표치/NNG@$허용/NNG@$한도/NNG,0,0.04631529780197363,70,35,35,73,0.6274310431737753,0.5730158316585202
경제/NNG@$성장/NNG@$인플레이션/NNG,0,0.046239485117800516,68,34,34,101,0.6219050395206462,0.5680552523201383
에너지/NNG@$상품/NNG@$가격/NNG,0,0.04613492678003417,66,33,33,38,0.6160314281281419,0.5628079692690299
억제/NNG@$목표치/NNG@$허용/NNG@$한도/NNG,0,0.04613492678003417,66,33,33,72,0.6160314281281419,0.5628079692690299
자산/NNG@$매입/NNG@$축소/NNG,0,0.046065210625381825,88,44,44,166,0.6636625071767355,0.6064084415571847
소비자/NNG@$물가/NNG@$상승률/NNG@$기록/NNG,0,0.045622197135024134,60,30,30,98,0.5961997993470471,0.5452488591026621
주식/NNG@$채권/NNG@$시장/NNG,0,0.045622197135024134,60,30,30,93,0.5961997993470471,0.5452488591026621
엔/NNG@$원/NNG@$환율/NNG,0,0.04537526533959135,58,29,29,73,0.5888126286495287,0.5387591222151372
영향/NNG@$주지/NNG@$않/VX,0,0.04508504794206636,56,28,28,54,0.58101875030598,0.5319365813501198
이상/NNG@$금리/NNG@$인상/NNG,0,0.044869862458834175,108,54,54,102,0.683207653061976,0.6257623323422857
등락/NNG@$장기금리/NNG@$국채/NNG,0,0.044869862458834175,108,54,54,233,0.683207653061976,0.6257623323422857
채권/NNG@$시장/NNG@$우호적/NNG,0,0.044748096697529105,54,27,27,56,0.5728083119335894,0.5247733992967901
시장/NNG@$변동성/NNG@$확대/NNG,0,0.044748096697529105,54,27,27,96,0.5728083119335894,0.5247733992967901
둔화/NNG@$우려/NNG@$금리/NNG,0,0.044748096697529105,54,27,27,62,0.5728083119335894,0.5247733992967901
국채/NNG@$금리/NNG@$서비스/NNG,0,0.04474214229171425,110,55,55,240,0.6843649127257702,0.6269824873705987
상승/NNG@$금리/NNG@$인상/NNG,0,0.04461628541169094,112,56,56,164,0.6854141116375513,0.6281018564392025
유럽연합/NNG@$탈퇴/NNG@$브렉시트/NNG,0,0.04436076246230902,52,26,26,131,0.5641724893786217,0.5172624670264371
통화정책/NNG@$금리/NNG@$인하/NNG,0,0.04391918815612672,50,25,25,52,0.5551036804841841,0.509397542603313
기준금리/NNG@$인상/NNG@$가능성/NNG@$높/VA,0,0.04341930333618804,48,24,24,54,0.5455957159128665,0.501173402347565
지속/NNG@$금리/NNG@$인상/NNG,0,0.043213723894445666,142,71,71,152,0.6927442058286024,0.6366028479313863
차원/NNG@$금리/NNG@$인상/NNG,1,0.04285682082105624,46,23,23,59,0.5356440861324893,0.49258600374545486
전망/NNG@$경제/NNG@$성장/NNG,1,0.04285682082105624,46,23,23,80,0.5356440861324893,0.49258600374545486
경제/NNG@$기초/NNG@$체력/NNG,1,0.04222723583555643,44,22,22,61,0.5252461829681395,0.48363265916790665
인상/NNG@$필요/NNG@$있/VA,1,0.04222723583555643,44,22,22,70,0.5252461829681395,0.48363265916790665
기준금리/NNG@$인상/NNG@$나설/VV,1,0.04222723583555643,44,22,22,79,0.5252461829681395,0.48363265916790665
산업/NNG@$생산/NNG@$증가세/NNG,1,0.04222723583555643,44,22,22,32,0.5252461829681395,0.48363265916790665
임금/NNG@$상승/NNG@$압력/NNG,1,0.04152582817405048,42,21,21,58,0.5144015532971128,0.4743122189493556
주택/NNG@$판매/NNG@$감소/NNG,1,0.040747667894894146,40,20,20,48,0.503112161519976,0.4646252617964689
경기/NNG@$회복/NNG@$불씨/NNG,1,0.040747667894894146,40,20,20,39,0.503112161519976,0.4646252617964689
물가/NNG@$상승률/NNG@$중기/NNG,1,0.040747667894894146,40,20,20,50,0.503112161519976,0.4646252617964689
둔화/NNG@$물가/NNG@$상승/NNG,1,0.040747667894894146,40,20,20,51,0.503112161519976,0.4646252617964689
변동성/NNG@$심한/VA@$에너지/NNG,1,0.040747667894894146,40,20,20,36,0.503112161519976,0.4646252617964689
금리/NNG@$인상/NNG@$압박/NNG,1,0.040747667894894146,40,20,20,59,0.503112161519976,0.4646252617964689
상승/NNG@$최고치/NNG@$기록/NNG,0,0.039887625060055054,38,19,19,52,0.4913826563940089,0.4545742898465502
구조/NNG@$개혁/NNG@$정책/NNG,0,0.039887625060055054,38,19,19,43,0.4913826563940089,0.4545742898465502
공개/NNG@$시장/NNG@$열/VV,0,0.039887625060055054,38,19,19,28,0.4913826563940089,0.4545742898465502
인상/NNG@$경제/NNG@$성장/NNG,0,0.039887625060055054,38,19,19,67,0.4913826563940089,0.4545742898465502
서두/NNG@$필요/NNG@$없/VA,0,0.0389403840167164,36,18,18,48,0.47922063668867304,0.44416392499001134
동결/NNG@$시장/NNG@$예상/NNG,0,0.0389403840167164,36,18,18,70,0.47922063668867304,0.44416392499001134
인상/NNG@$가능성/NNG@$커졌/VV,0,0.0389403840167164,36,18,18,41,0.47922063668867304,0.44416392499001134
산업/NNG@$생산/NNG@$수출/NNG,0,0.0389403840167164,36,18,18,42,0.47922063668867304,0.44416392499001134
경기/NNG@$둔화/NNG@$전망/NNG,0,0.0389403840167164,36,18,18,32,0.47922063668867304,0.44416392499001134
가격/NNG@$상승/NNG@$소비/NNG,0,0.0389403840167164,36,18,18,25,0.47922063668867304,0.44416392499001134
예정/NNG@$금리/NNG@$인상/NNG,0,0.0389403840167164,36,18,18,63,0.47922063668867304,0.44416392499001134
수출/NNG@$차지/NNG@$비중/NNG,0,0.0389403840167164,36,18,18,32,0.47922063668867304,0.44416392499001134
인상/NNG@$속도/NNG@$예상/NNG,0,0.0389403840167164,36,18,18,44,0.47922063668867304,0.44416392499001134
인상/NNG@$경제/NNG@$영향/NNG,0,0.0389403840167164,36,18,18,34,0.47922063668867304,0.44416392499001134
호조/NNG@$금리/NNG@$인상/NNG,0,0.03790046267795866,34,17,17,44,0.46663690895293736,0.43340110232853063
경제/NNG@$비추/VV@$성장/NNG@$경로/NNG@$불확실성/NNG,0,0.03790046267795866,34,17,17,31,0.46663690895293736,0.43340110232853063
인상/NNG@$가능성/NNG@$높이/VV,0,0.03790046267795866,34,17,17,29,0.46663690895293736,0.43340110232853063
둔화/NNG@$경제/NNG@$성장/NNG,0,0.03790046267795866,34,17,17,72,0.46663690895293736,0.43340110232853063
금리/NNG@$인상/NNG@$행진/NNG@$중단/NNG,0,0.03790046267795866,34,17,17,38,0.46663690895293736,0.43340110232853063
가계부채/NNG@$종합/NNG@$대책/NNG,0,0.03790046267795866,34,17,17,23,0.46663690895293736,0.43340110232853063
하강/NNG@$국면/NNG@$진입/NNG,0,0.03790046267795866,34,17,17,27,0.46663690895293736,0.43340110232853063
둔화/NNG@$조짐/NNG@$보이/VV,0,0.03790046267795866,34,17,17,85,0.46663690895293736,0.43340110232853063
금리/NNG@$인상/NNG@$가능성/NNG@$제기/NNG,0,0.03790046267795866,34,17,17,52,0.46663690895293736,0.43340110232853063
전망/NNG@$하방/NNG@$리스크/NNG,0,0.03676223719324723,32,16,16,44,0.45364572952179216,0.4222952558864611
유로화/NNG@$사용/NNG@$경제/NNG,0,0.03676223719324723,32,16,16,46,0.45364572952179216,0.4222952558864611
전망/NNG@$대외/NNG@$경제/NNG,0,0.03676223719324723,32,16,16,18,0.45364572952179216,0.4222952558864611
기준금리/NNG@$인상/NNG@$우려/NNG,0,0.03676223719324723,32,16,16,57,0.45364572952179216,0.4222952558864611
경제/NNG@$불확실성/NNG@$높/VA,0,0.03676223719324723,32,16,16,41,0.45364572952179216,0.4222952558864611
금리선물/NNG@$시장/NNG@$금리/NNG@$인상/NNG@$가능성/NNG,0,0.03676223719324723,32,16,16,46,0.45364572952179216,0.4222952558864611
통화/NNG@$완화/NNG@$기조/NNG@$유지/NNG,0,0.03676223719324723,32,16,16,25,0.45364572952179216,0.4222952558864611
시장/NNG@$충격/NNG@$않/VX,0,0.03676223719324723,32,16,16,42,0.45364572952179216,0.4222952558864611
경상수지/NNG@$적자/NNG@$확대/NNG,0,0.03676223719324723,32,16,16,52,0.45364572952179216,0.4222952558864611
경제/NNG@$성장률/NNG@$전망/NNG,0,0.03676223719324723,32,16,16,46,0.45364572952179216,0.4222952558864611
금리/NNG@$하향/NNG@$조정/NNG,0,0.03551997230278525,30,15,15,27,0.44026502179934246,0.4108584909619228
금리/NNG@$인상/NNG@$부동산/NNG,0,0.03551997230278525,30,15,15,41,0.44026502179934246,0.4108584909619228
경제/NNG@$구조/NNG@$개혁/NNG,0,0.03551997230278525,30,15,15,15,0.44026502179934246,0.4108584909619228
경제/NNG@$성장/NNG@$경로/NNG,0,0.03551997230278525,30,15,15,41,0.44026502179934246,0.4108584909619228
증가/NNG@$경제/NNG@$성장/NNG,0,0.03551997230278525,30,15,15,41,0.44026502179934246,0.4108584909619228
추경/NNG@$금리/NNG@$인하/NNG,0,0.03551997230278525,30,15,15,59,0.44026502179934246,0.4108584909619228
위험/NNG@$크/VA@$않/VX,0,0.03551997230278525,30,15,15,28,0.44026502179934246,0.4108584909619228
인플레이션/NNG@$억제/NNG@$금리/NNG@$인상/NNG,0,0.03551997230278525,30,15,15,35,0.44026502179934246,0.4108584909619228
인상/NNG@$전망/NNG@$우세/NNG,0,0.03551997230278525,30,15,15,24,0.44026502179934246,0.4108584909619228
가능성/NNG@$적/VA@$않/VX,0,0.03551997230278525,30,15,15,25,0.44026502179934246,0.4108584909619228
금리/NNG@$인하/NNG@$아니/VCN,0,0.03551997230278525,30,15,15,22,0.44026502179934246,0.4108584909619228
인상/NNG@$시기/NNG@$결정/NNG,0,0.03551997230278525,30,15,15,35,0.44026502179934246,0.4108584909619228
정책/NNG@$방향/NNG@$제시/NNG,0,0.03416785754006413,28,14,14,18,0.4265165589180638,0.3991057368383779
수출/NNG@$부진/NNG@$내수/NNG,0,0.03416785754006413,28,14,14,31,0.4265165589180638,0.3991057368383779
금융/NNG@$위기/NNG@$최저/NNG,0,0.03416785754006413,28,14,14,24,0.4265165589180638,0.3991057368383779
차원/NNG@$금리/NNG@$인하/NNG,0,0.03416785754006413,28,14,14,59,0.4265165589180638,0.3991057368383779
금리/NNG@$인상/NNG@$확실/XR,0,0.03416785754006413,28,14,14,68,0.4265165589180638,0.3991057368383779
예상/NNG@$경기/NNG@$둔화/NNG,0,0.03416785754006413,28,14,14,37,0.4265165589180638,0.3991057368383779
금리/NNG@$동결/NNG@$예상/NNG,0,0.033449516054791184,217,108,109,258,0.6879578235676742,0.6446701374965311
동향/NNG@$산업/NNG@$생산/NNG,0,0.03270004928281711,26,13,13,31,0.41242610117993733,0.387054873027568
급등/NNG@$소비자/NNG@$물가/NNG,0,0.03270004928281711,26,13,13,29,0.41242610117993733,0.387054873027568
공격적/NNG@$통화/NNG@$완화/NNG,0,0.03270004928281711,26,13,13,42,0.41242610117993733,0.387054873027568
역전/NNG@$자본/NNG@$유출/NNG,0,0.03270004928281711,26,13,13,47,0.41242610117993733,0.387054873027568
영향/NNG@$금리/NNG@$인하/NNG,0,0.03270004928281711,26,13,13,25,0.41242610117993733,0.387054873027568
통화정책/NNG@$기조/NNG@$변경/NNG,0,0.03270004928281711,26,13,13,27,0.41242610117993733,0.387054873027568
부채/NNG@$상환/NNG@$부담/NNG,0,0.03270004928281711,26,13,13,28,0.41242610117993733,0.387054873027568
금리/NNG@$결정/NNG@$앞두/VV,0,0.03270004928281711,26,13,13,32,0.41242610117993733,0.387054873027568
경제/NNG@$성장/NNG@$완만/XR,0,0.03270004928281711,26,13,13,32,0.41242610117993733,0.387054873027568
상승/NNG@$원자재/NNG@$가격/NNG,0,0.03270004928281711,26,13,13,35,0.41242610117993733,0.387054873027568
금리/NNG@$인상/NNG@$없/VA,0,0.03220705394360657,191,95,96,224,0.687136832848053,0.6455020235485307
종합/NNG@$지수/NNG@$상승/NNG,0,0.031110718454635755,24,12,12,65,0.39802347733536425,0.3747268218368589
소비자/NNG@$물가/NNG@$올랐/VV,0,0.031110718454635755,24,12,12,33,0.39802347733536425,0.3747268218368589
약세/NNG@$보일/VV@$전망/NNG,0,0.031110718454635755,24,12,12,27,0.39802347733536425,0.3747268218368589
대책/NNG@$금리/NNG@$인상/NNG,0,0.031110718454635755,24,12,12,30,0.39802347733536425,0.3747268218368589
과거/NNG@$외환/NNG@$위기/NNG,0,0.031110718454635755,24,12,12,32,0.39802347733536425,0.3747268218368589
완화적/NNG@$통화정책/NNG@$유지/NNG,0,0.031110718454635755,24,12,12,37,0.39802347733536425,0.3747268218368589
성장/NNG@$모멘텀/NNG@$둔화/NNG,0,0.031110718454635755,24,12,12,23,0.39802347733536425,0.3747268218368589
가격/NNG@$급등/NNG@$물가/NNG,0,0.031110718454635755,24,12,12,40,0.39802347733536425,0.3747268218368589
경상수지/NNG@$적자/NNG@$기록/NNG,0,0.031110718454635755,24,12,12,30,0.39802347733536425,0.3747268218368589
경제/NNG@$금융/NNG@$기준금리/NNG,0,0.031110718454635755,24,12,12,25,0.39802347733536425,0.3747268218368589
제시/NNG@$성장률/NNG@$전망치/NNG,0,0.031110718454635755,24,12,12,27,0.39802347733536425,0.3747268218368589
경제/NNG@$물가/NNG@$상승/NNG,0,0.031110718454635755,24,12,12,52,0.39802347733536425,0.3747268218368589
통화/NNG@$달러/NNG@$지수/NNG,0,0.031110718454635755,24,12,12,44,0.39802347733536425,0.3747268218368589
경제/NNG@$성장/NNG@$하방/NNG@$위험/NNG,0,0.031110718454635755,24,12,12,42,0.39802347733536425,0.3747268218368589
에너지/NNG@$가격/NNG@$상승/NNG,0,0.029673445468039628,151,75,76,205,0.684780311840311,0.6465541949024959
기조/NNG@$금리/NNG@$인상/NNG,0,0.029394103450812503,22,11,11,38,0.38334259885220884,0.3621455999081371
기대/NNG@$쉽/VA@$않/VX,0,0.029394103450812503,22,11,11,29,0.38334259885220884,0.3621455999081371
매입/NNG@$프로그램/NNG@$규모/NNG,0,0.029394103450812503,22,11,11,32,0.38334259885220884,0.3621455999081371
금융/NNG@$시스템/NNG@$불안/NNG,0,0.029394103450812503,22,11,11,26,0.38334259885220884,0.3621455999081371
금융/NNG@$시스템/NNG@$안정성/NNG,0,0.029394103450812503,22,11,11,47,0.38334259885220884,0.3621455999081371
원화/NNG@$강세/NNG@$지속/NNG,0,0.029394103450812503,22,11,11,61,0.38334259885220884,0.3621455999081371
수출/NNG@$내수/NNG@$부진/NNG,0,0.029394103450812503,22,11,11,35,0.38334259885220884,0.3621455999081371
자본/NNG@$유출/NNG@$위험/NNG,0,0.029394103450812503,22,11,11,40,0.38334259885220884,0.3621455999081371
금리/NNG@$인상/NNG@$달러화/NNG@$강세/NNG,0,0.029394103450812503,22,11,11,42,0.38334259885220884,0.3621455999081371
소비/NNG@$지출/NNG@$위축/NNG,0,0.029394103450812503,22,11,11,28,0.38334259885220884,0.3621455999081371
채권/NNG@$시장/NNG@$경제/NNG,0,0.029394103450812503,22,11,11,28,0.38334259885220884,0.3621455999081371
요인/NNG@$가능성/NNG@$있/VA,0,0.029394103450812503,22,11,11,26,0.38334259885220884,0.3621455999081371
경제/NNG@$동향/NNG@$인플레율/NNG,0,0.0275445676085182,20,10,10,32,0.3684213969660009,0.34933832152106276
금리/NNG@$인상/NNG@$기업/NNG,0,0.0275445676085182,20,10,10,29,0.3684213969660009,0.34933832152106276
경제/NNG@$경기/NNG@$부양/NNG,0,0.0275445676085182,20,10,10,42,0.3684213969660009,0.34933832152106276
경제/NNG@$성장/NNG@$금리/NNG,0,0.0275445676085182,20,10,10,32,0.3684213969660009,0.34933832152106276
기준금리/NNG@$유지/NNG@$통화정책/NNG@$경제/NNG,0,0.0275445676085182,20,10,10,29,0.3684213969660009,0.34933832152106276
국고채/NNG@$금리/NNG@$기준금리/NNG,0,0.0275445676085182,20,10,10,36,0.3684213969660009,0.34933832152106276
경기/NNG@$회복/NNG@$속도/NNG@$둔화/NNG,0,0.0275445676085182,20,10,10,29,0.3684213969660009,0.34933832152106276
지속/NNG@$경제/NNG@$성장/NNG,0,0.0275445676085182,20,10,10,25,0.3684213969660009,0.34933832152106276
외국인/NNG@$채권/NNG@$투자/NNG@$자금/NNG,0,0.0275445676085182,20,10,10,37,0.3684213969660009,0.34933832152106276
금리/NNG@$인상/NNG@$마지막/NNG,0,0.0275445676085182,20,10,10,38,0.3684213969660009,0.34933832152106276
유지/NNG@$통화정책/NNG@$경제/NNG,0,0.0275445676085182,20,10,10,29,0.3684213969660009,0.34933832152106276
금리/NNG@$인상/NNG@$시기/NNG@$예상/NNG,0,0.0275445676085182,20,10,10,44,0.3684213969660009,0.34933832152106276
소수/NNG@$의견/NNG@$나오/VV,0,0.0275445676085182,20,10,10,36,0.3684213969660009,0.34933832152106276
금융/NNG@$위기/NNG@$경제/NNG,0,0.02655259679244293,115,57,58,126,0.6754160781669586,0.6417024055882985
가능성/NNG@$배제/NNG@$않/VX,0,0.025578801112013494,107,53,54,126,0.6703099504206239,0.6380915763492248
인상/NNG@$성장/NNG@$둔화/NNG,0,0.02555666027247505,18,9,9,33,0.35330167356261716,0.33633514694512573
방향/NNG@$기준금리/NNG@$유지/NNG@$통화정책/NNG@$경제/NNG,0,0.02555666027247505,18,9,9,27,0.35330167356261716,0.33633514694512573
비교/NNG@$장기금리/NNG@$국채/NNG,0,0.02555666027247505,18,9,9,89,0.35330167356261716,0.33633514694512573
인플레이션/NNG@$압력/NNG@$금리/NNG,0,0.02555666027247505,18,9,9,42,0.35330167356261716,0.33633514694512573
가격/NNG@$상승/NNG@$소비자/NNG,0,0.02555666027247505,18,9,9,30,0.35330167356261716,0.33633514694512573
성장/NNG@$물가/NNG@$전망/NNG,0,0.02555666027247505,18,9,9,28,0.35330167356261716,0.33633514694512573
금리/NNG@$비교/NNG@$장기금리/NNG@$국채/NNG,0,0.02555666027247505,18,9,9,89,0.35330167356261716,0.33633514694512573
물가/NNG@$경기/NNG@$회복/NNG,0,0.02555666027247505,18,9,9,32,0.35330167356261716,0.33633514694512573
경기/NNG@$회복/NNG@$가시화/NNG,0,0.024380195711558805,99,49,50,90,0.6631537610842207,0.6327930373268612
경기/NNG@$부양/NNG@$의지/NNG,0,0.024034568982358007,97,48,49,126,0.6609749911202163,0.6311497215085288
서비스/NNG@$금리/NNG@$비교/NNG@$장기금리/NNG@$국채/NNG,0,0.023425180235347565,16,8,8,81,0.33802885887780115,0.32316917000606615
하락/NNG@$경기/NNG@$회복/NNG,0,0.023425180235347565,16,8,8,29,0.33802885887780115,0.32316917000606615
경제/NNG@$성장/NNG@$목표/NNG,0,0.023425180235347565,16,8,8,32,0.33802885887780115,0.32316917000606615
추이/NNG@$열/VV@$기준금리/NNG,0,0.023425180235347565,16,8,8,35,0.33802885887780115,0.32316917000606615
금리/NNG@$인상/NNG@$가능성/NNG@$반영/NNG,0,0.02194059517938607,87,43,44,116,0.647222565876656,0.6206088045724926
통화/NNG@$완화/NNG@$정책/NNG@$종료/NNG,0,0.02194059517938607,87,43,44,143,0.647222565876656,0.6206088045724926
불안/NNG@$심리/NNG@$완화/NNG,0,0.021145240072791394,14,7,7,24,0.32265167161473995,0.3098762403289018
경제/NNG@$전망/NNG@$개선/NNG,0,0.021145240072791394,14,7,7,31,0.32265167161473995,0.3098762403289018
가능성/NNG@$낮/VA@$진/VX,0,0.021145240072791394,14,7,7,34,0.32265167161473995,0.3098762403289018
기준금리/NNG@$결정/NNG@$금융/NNG,0,0.021145240072791394,14,7,7,40,0.32265167161473995,0.3098762403289018
국채/NNG@$금리/NNG@$낮/VA,0,0.021145240072791394,14,7,7,34,0.32265167161473995,0.3098762403289018
가격/NNG@$하락/NNG@$축소/NNG,0,0.021145240072791394,14,7,7,14,0.32265167161473995,0.3098762403289018
성장세/NNG@$둔화/NNG@$경제/NNG,0,0.021145240072791394,14,7,7,25,0.32265167161473995,0.3098762403289018
둔화/NNG@$금리/NNG@$인하/NNG,0,0.020892244318373443,83,41,42,84,0.6401770928889424,0.6151400329260784
금리/NNG@$인상/NNG@$시사/NNG,0,0.020351709910272575,269,133,136,403,0.6794755020651062,0.653606907477875
소비자/NNG@$물가/NNG@$하락/NNG,0,0.02031313617246311,81,40,41,88,0.6362760686089857,0.6120993035098682
가능성/NNG@$높/VA@$진/VX,0,0.019693697425055445,79,39,40,89,0.6321064785127409,0.6088410845671575
美/NNG@$실업/NNG@$수당/NNG,0,0.018712329664378746,12,6,6,43,0.3072216803419219,0.2964947174345085
금융시장/NNG@$기준금리/NNG@$인하/NNG,0,0.018712329664378746,12,6,6,21,0.3072216803419219,0.2964947174345085
금리/NNG@$결정/NNG@$영향/NNG,0,0.018321637307367578,75,37,38,63,0.6229116821141132,0.6016314273027609
금리/NNG@$인상/NNG@$압력/NNG,0,0.014947647178505052,67,33,34,86,0.6007476331626341,0.5841481106574716
경기/NNG@$회복세/NNG@$둔화/NNG,0,0.013949789308825844,65,32,33,134,0.5943475997414778,0.5790778949705486
영향/NNG@$금리/NNG@$인상/NNG,0,0.013949789308825844,65,32,33,77,0.5943475997414778,0.5790778949705486
경기/NNG@$둔화/NNG@$수출/NNG,0,0.011736326663657426,61,30,31,85,0.5804326751056719,0.568026058633768
은행권/NNG@$채권/NNG@$딜러/NNG,0,0.010509956915463858,59,29,30,48,0.5728953176336766,0.5620246691158182
시장/NNG@$금리/NNG@$인하/NNG@$기대/NNG,0,0.010509956915463858,59,29,30,73,0.5728953176336766,0.5620246691158182
정책/NNG@$금리/NNG@$인하/NNG,0,0.006277849424099591,53,26,27,60,0.5478424104068177,0.5420087863415964
금융/NNG@$위기/NNG@$여파/NNG,0,0.006277849424099591,53,26,27,64,0.5478424104068177,0.5420087863415964
경제/NNG@$성장/NNG@$모멘텀/NNG,0,0.006277849424099591,53,26,27,63,0.5478424104068177,0.5420087863415964
경기/NNG@$회복/NNG@$가능성/NNG,0,0.006277849424099591,53,26,27,57,0.5478424104068177,0.5420087863415964
채권/NNG@$시장/NNG@$콜금리/NNG,0,0.00465881482311814,51,25,26,34,0.5386492456136096,0.5346393198895643
상승/NNG@$경기/NNG@$회복/NNG,0,0.00465881482311814,51,25,26,68,0.5386492456136096,0.5346393198895643
금리/NNG@$인하/NNG@$가능성/NNG@$반영/NNG,0,0.0010574702575909534,47,23,24,50,0.5189604212737037,0.5188148694568302
소비/NNG@$심리/NNG@$악화/NNG,0,0.0010574702575909534,47,23,24,34,0.5189604212737037,0.5188148694568302
완화/NNG@$정책/NNG@$종료/NNG,0,-0.001704922012847998,88,43,45,146,0.6337214803692282,0.6370482665726606
소비자/NNG@$물가/NNG@$상승률/NNG@$높/VA,0,-0.0027737375900399597,86,42,44,81,0.630128252628328,0.6347896232043396
산업/NNG@$생산/NNG@$증가율/NNG,0,-0.0027737375900399597,86,42,44,101,0.630128252628328,0.6347896232043396
경제/NNG@$둔화/NNG@$우려/NNG,-1,-0.003097250967876497,43,21,22,67,0.497511216010164,0.5015154524207834
증가/NNG@$금리/NNG@$인상/NNG,-1,-0.003097250967876497,43,21,22,63,0.497511216010164,0.5015154524207834
인상/NNG@$기조/NNG@$지속/NNG,-1,-0.003097250967876497,43,21,22,41,0.497511216010164,0.5015154524207834
금리/NNG@$인상/NNG@$여부/NNG@$결정/NNG,-1,-0.003097250967876497,43,21,22,57,0.497511216010164,0.5015154524207834
조치/NNG@$취할/VV@$준비/NNG,-1,-0.003097250967876497,43,21,22,71,0.497511216010164,0.5015154524207834
투자/NNG@$자금/NNG@$유출/NNG,-1,-0.003097250967876497,43,21,22,68,0.497511216010164,0.5015154524207834
지속적/NNG@$금리/NNG@$인상/NNG,0,-0.0038986763054820184,84,41,43,102,0.6262908044691025,0.6323427450192796
악화/NNG@$금리/NNG@$인하/NNG,0,-0.005412769230013437,41,20,21,37,0.48612438104005323,0.4923082003306029
경제/NNG@$성장/NNG@$이끌/VV,0,-0.005412769230013437,41,20,21,45,0.48612438104005323,0.4923082003306029
경제/NNG@$성장/NNG@$전망/NNG,0,-0.0076029269711370695,199,97,102,322,0.6609621213474667,0.6723041496419495
규모/NNG@$경상수지/NNG@$흑자/NNG,0,-0.007906705780200807,39,19,20,58,0.47429904373324105,0.48273072973012976
상승/NNG@$압력/NNG@$낮/VA,0,-0.010596548548664209,37,18,19,49,0.46204024194691085,0.4727870253492525
경기/NNG@$회복/NNG@$여부/NNG,0,-0.010596548548664209,37,18,19,43,0.46204024194691085,0.4727870253492525
소비/NNG@$투자/NNG@$부진/NNG,0,-0.010596548548664209,37,18,19,36,0.46204024194691085,0.4727870253492525
인상/NNG@$행진/NNG@$중단/NNG,0,-0.010596548548664209,37,18,19,40,0.46204024194691085,0.4727870253492525
소매/NNG@$판매/NNG@$증가/NNG,0,-0.012045105793402011,72,35,37,138,0.597467086028063,0.6131351359070407
최고/NNG@$투자/NNG@$책임자/NNG,0,-0.01209397225272757,146,71,75,180,0.6569098635635463,0.6742025473518146
인플레이션/NNG@$압력/NNG@$높/VA,0,-0.013131300653227429,107,52,55,168,0.645088306010082,0.6634429431038286
국채/NNG@$매입/NNG@$양적완화/NNG,0,-0.01350268178755476,35,17,18,34,0.44935533931713767,0.46248373886397215
주택/NNG@$가격/NNG@$급락/NNG,0,-0.01350268178755476,35,17,18,23,0.44935533931713767,0.46248373886397215
실시/NNG@$금리/NNG@$인상/NNG,0,-0.01350268178755476,35,17,18,44,0.44935533931713767,0.46248373886397215
부진/NNG@$모습/NNG@$보였/VV,0,-0.01664921913056261,33,16,17,53,0.43625400527466895,0.45183052742109525
수출/NNG@$경기/NNG@$둔화/NNG,0,-0.01664921913056261,33,16,17,26,0.43625400527466895,0.45183052742109525
가격/NNG@$고공/NNG@$행진/NNG,0,-0.01664921913056261,33,16,17,47,0.43625400527466895,0.45183052742109525
콜금리/NNG@$동결/NNG@$결정/NNG,0,-0.01664921913056261,33,16,17,53,0.43625400527466895,0.45183052742109525
인상/NNG@$가능성/NNG@$없/VA,0,-0.01664921913056261,33,16,17,56,0.43625400527466895,0.45183052742109525
경기/NNG@$부양/NNG@$기조/NNG,0,-0.01664921913056261,33,16,17,49,0.43625400527466895,0.45183052742109525
수출/NNG@$산업/NNG@$생산/NNG,0,-0.01664921913056261,33,16,17,20,0.43625400527466895,0.45183052742109525
경기/NNG@$저점/NNG@$통과/NNG,0,-0.0200651726895682,31,15,16,34,0.42274807089241095,0.4408404296995628
과거/NNG@$금리/NNG@$인상/NNG,0,-0.0200651726895682,31,15,16,36,0.42274807089241095,0.4408404296995628
금리/NNG@$정상화/NNG@$기조/NNG,0,-0.0200651726895682,31,15,16,98,0.42274807089241095,0.4408404296995628
준비/NNG@$금리/NNG@$인상/NNG,0,-0.0200651726895682,31,15,16,38,0.42274807089241095,0.4408404296995628
인하/NNG@$시장/NNG@$기대/NNG,0,-0.0200651726895682,31,15,16,27,0.42274807089241095,0.4408404296995628
정책/NNG@$결정/NNG@$영향/NNG,0,-0.0200651726895682,31,15,16,22,0.42274807089241095,0.4408404296995628
시장/NNG@$경기/NNG@$회복/NNG,0,-0.0200651726895682,31,15,16,44,0.42274807089241095,0.4408404296995628
영향/NNG@$제한적/NNG@$전망/NNG,0,-0.0200651726895682,31,15,16,34,0.42274807089241095,0.4408404296995628
필요/NNG@$조치/NNG@$취할/VV,0,-0.021198576716687234,62,30,32,58,0.5645233544250213,0.5900177998265147
인상/NNG@$가능성/NNG@$반영/NNG,0,-0.022641789322126127,337,163,174,379,0.6508047546963555,0.6821599490158198
동결/NNG@$결정/NNG@$금리/NNG,0,-0.023786126909284833,29,14,15,26,0.4088511997959662,0.42953029289789674
호흡기/NNG@$증후군/NNG@$메르스/NNG@$여파/NNG,0,-0.023786126909284833,29,14,15,21,0.4088511997959662,0.42953029289789674
경제/NNG@$성장/NNG@$견인/NNG,0,-0.023786126909284833,29,14,15,34,0.4088511997959662,0.42953029289789674
증후군/NNG@$메르스/NNG@$여파/NNG,0,-0.023786126909284833,29,14,15,21,0.4088511997959662,0.42953029289789674
내수/NNG@$부진/NNG@$수출/NNG,0,-0.023786126909284833,29,14,15,40,0.4088511997959662,0.42953029289789674
상승률/NNG@$최고치/NNG@$기록/NNG,0,-0.023786126909284833,29,14,15,59,0.4088511997959662,0.42953029289789674
금리/NNG@$오른/VV@$마감/NNG,0,-0.023786126909284833,29,14,15,47,0.4088511997959662,0.42953029289789674
경제/NNG@$침체/NNG@$빠질/VV,0,-0.023786126909284833,29,14,15,47,0.4088511997959662,0.42953029289789674
금리/NNG@$상승/NNG@$요인/NNG,0,-0.023786126909284833,29,14,15,59,0.4088511997959662,0.42953029289789674
가계/NNG@$대출/NNG@$주택/NNG@$담보대출/NNG@$크/VA,0,-0.023786126909284833,29,14,15,15,0.4088511997959662,0.42953029289789674
전망/NNG@$금리/NNG@$동결/NNG,0,-0.023786126909284833,29,14,15,42,0.4088511997959662,0.42953029289789674
상승/NNG@$인플레이션/NNG@$압력/NNG,0,-0.02565284851408356,58,28,30,90,0.5487216493804818,0.5786295679563224
금리/NNG@$인상/NNG@$이어질/VV,0,-0.02785668909570027,27,13,14,36,0.3945782800375269,0.41792127345775365
인상/NNG@$없/VA@$전망/NNG,0,-0.02785668909570027,27,13,14,39,0.3945782800375269,0.41792127345775365
유로존/NNG@$경기/NNG@$회복/NNG,0,-0.02785668909570027,27,13,14,43,0.3945782800375269,0.41792127345775365
지수/NNG@$내린/VV@$기술/NNG,0,-0.02785668909570027,27,13,14,24,0.3945782800375269,0.41792127345775365
인하/NNG@$가능성/NNG@$전망/NNG,0,-0.02785668909570027,27,13,14,29,0.3945782800375269,0.41792127345775365
상승률/NNG@$물가/NNG@$목표치/NNG,0,-0.02785668909570027,27,13,14,30,0.3945782800375269,0.41792127345775365
금리/NNG@$인상/NNG@$늦출/VV,0,-0.02785668909570027,27,13,14,28,0.3945782800375269,0.41792127345775365
규모/NNG@$국채/NNG@$매입/NNG,0,-0.02785668909570027,27,13,14,85,0.3945782800375269,0.41792127345775365
금리/NNG@$인상/NNG@$자금/NNG,0,-0.02785668909570027,27,13,14,42,0.3945782800375269,0.41792127345775365
소비자/NNG@$물가/NNG@$예상/NNG,0,-0.02785668909570027,27,13,14,33,0.3945782800375269,0.41792127345775365
인상/NNG@$예상/NNG@$시장/NNG,0,-0.02785668909570027,27,13,14,24,0.3945782800375269,0.41792127345775365
소비자/NNG@$물가/NNG@$상승률/NNG@$하락/NNG,0,-0.02785668909570027,27,13,14,28,0.3945782800375269,0.41792127345775365
지수/NNG@$내린/VV@$종합/NNG,0,-0.02785668909570027,27,13,14,55,0.3945782800375269,0.41792127345775365
필요/NNG@$있/VA@$진단/NNG,0,-0.030661896947848155,54,26,28,60,0.5312982169075232,0.5658935373480579
모습/NNG@$보이/VV@$경제/NNG,0,-0.032334168824902476,25,12,13,33,0.3799443845081623,0.4060394502158864
최대/NNG@$낙폭/NNG@$기록/NNG,0,-0.032334168824902476,25,12,13,27,0.3799443845081623,0.4060394502158864
위기/NNG@$금리/NNG@$인하/NNG,0,-0.032334168824902476,25,12,13,31,0.3799443845081623,0.4060394502158864
인하/NNG@$금리/NNG@$인상/NNG,0,-0.032334168824902476,25,12,13,39,0.3799443845081623,0.4060394502158864
물가/NNG@$상승/NNG@$금리/NNG@$인상/NNG,0,-0.032334168824902476,25,12,13,32,0.3799443845081623,0.4060394502158864
외환/NNG@$건전성/NNG@$부담금/NNG,0,-0.032334168824902476,25,12,13,40,0.3799443845081623,0.4060394502158864
시작/NNG@$금리/NNG@$인상/NNG,0,-0.033400988988514624,52,25,27,78,0.5219573715724605,0.5589970384348182
수출/NNG@$가격/NNG@$경쟁력/NNG,0,-0.033400988988514624,52,25,27,42,0.5219573715724605,0.5589970384348182
구조/NNG@$개혁/NNG@$경제/NNG,0,-0.033400988988514624,52,25,27,45,0.5219573715724605,0.5589970384348182
가능성/NNG@$배제/NNG@$없/VA,0,-0.033558161895979266,630,303,327,709,0.6433374268672529,0.689207128700128
고용/NNG@$지표/NNG@$호조/NNG,0,-0.03475133741830061,104,50,54,139,0.6286155849576021,0.6750441189255394
예금/NNG@$대출/NNG@$금리/NNG,0,-0.036312927105134896,50,24,26,55,0.5121878929967368,0.5517374100677493
압력/NNG@$높/VA@$않/VX,0,-0.036312927105134896,50,24,26,76,0.5121878929967368,0.5517374100677493
위안화/NNG@$절상/NNG@$압력/NNG,0,-0.036312927105134896,50,24,26,92,0.5121878929967368,0.5517374100677493
인상/NNG@$나설/VV@$예상/NNG,0,-0.03729426610196751,23,11,12,40,0.3649630404870253,0.3939166157339128
유통/NNG@$구조/NNG@$개선/NNG,0,-0.03729426610196751,23,11,12,34,0.3649630404870253,0.3939166157339128
성장세/NNG@$갈/VX@$전망/NNG,0,-0.03729426610196751,23,11,12,50,0.3649630404870253,0.3939166157339128
개선/NNG@$기준금리/NNG@$인상/NNG,0,-0.03729426610196751,23,11,12,32,0.3649630404870253,0.3939166157339128
성장률/NNG@$예상/NNG@$높/VA,0,-0.03729426610196751,23,11,12,29,0.3649630404870253,0.3939166157339128
구매자/NNG@$관리/NNG@$지수/NNG,0,-0.03729426610196751,23,11,12,33,0.3649630404870253,0.3939166157339128
예상/NNG@$벗어나/VV@$않/VX,0,-0.03729426610196751,23,11,12,33,0.3649630404870253,0.3939166157339128
이중/NNG@$침체/NNG@$우려/NNG,0,-0.03729426610196751,23,11,12,31,0.3649630404870253,0.3939166157339128
식료품/NNG@$가격/NNG@$급등/NNG,0,-0.03729426610196751,23,11,12,25,0.3649630404870253,0.3939166157339128
결정/NNG@$기준금리/NNG@$동결/NNG,0,-0.03729426610196751,23,11,12,29,0.3649630404870253,0.3939166157339128
증가/NNG@$소매/NNG@$판매/NNG,0,-0.03729426610196751,23,11,12,26,0.3649630404870253,0.3939166157339128
시중/NNG@$유동성/NNG@$확대/NNG,0,-0.03729426610196751,23,11,12,43,0.3649630404870253,0.3939166157339128
경기/NNG@$회복세/NNG@$이어질/VV,0,-0.03729426610196751,23,11,12,22,0.3649630404870253,0.3939166157339128
물가/NNG@$목표/NNG@$상한선/NNG,0,-0.03729426610196751,23,11,12,27,0.3649630404870253,0.3939166157339128
인하/NNG@$필요성/NNG@$제기/NNG,0,-0.03729426610196751,23,11,12,27,0.3649630404870253,0.3939166157339128
금리/NNG@$상승/NNG@$경기/NNG,0,-0.03729426610196751,23,11,12,34,0.3649630404870253,0.3939166157339128
금융/NNG@$균형/NNG@$누적/NNG,0,-0.03729426610196751,23,11,12,19,0.3649630404870253,0.3939166157339128
둔화/NNG@$우려/NNG@$있/VA,0,-0.03729426610196751,23,11,12,26,0.3649630404870253,0.3939166157339128
금리/NNG@$상향/NNG@$조정/NNG,0,-0.03729426610196751,23,11,12,28,0.3649630404870253,0.3939166157339128
둔화/NNG@$인플레이션/NNG@$압력/NNG,0,-0.03941187484036557,48,23,25,51,0.5019843296969193,0.5441077753589352
이전/NNG@$금리/NNG@$인상/NNG,0,-0.03941187484036557,48,23,25,57,0.5019843296969193,0.5441077753589352
금리/NNG@$인상/NNG@$단행/NNG@$가능성/NNG,0,-0.04245854998034959,71,34,37,111,0.5763215663184026,0.6285018267983191
시장/NNG@$관심/NNG@$집중/NNG,0,-0.04245854998034959,71,34,37,111,0.5763215663184026,0.6285018267983191
성장/NNG@$속도/NNG@$둔화/NNG,-1,-0.04271378318436636,46,22,24,59,0.49134253937669065,0.5361024751560904
속도/NNG@$빠르/VA@$않/VX,-1,-0.04271378318436636,46,22,24,57,0.49134253937669065,0.5361024751560904
광공업/NNG@$생산/NNG@$증가/NNG,-1,-0.04271378318436636,46,22,24,58,0.49134253937669065,0.5361024751560904
인상/NNG@$가능성/NNG@$무게/NNG,-1,-0.04271378318436636,46,22,24,53,0.49134253937669065,0.5361024751560904
시장/NNG@$금리/NNG@$상승세/NNG,0,-0.04284017148401986,21,10,11,37,0.34964334266626623,0.3815913584670411
시장/NNG@$금리/NNG@$결정/NNG,0,-0.04284017148401986,21,10,11,48,0.34964334266626623,0.3815913584670411
인상/NNG@$단행/NNG@$시사/NNG,0,-0.04284017148401986,21,10,11,36,0.34964334266626623,0.3815913584670411
장기/NNG@$시장/NNG@$금리/NNG@$상승/NNG,0,-0.04284017148401986,21,10,11,24,0.34964334266626623,0.3815913584670411
금융/NNG@$불안/NNG@$가능성/NNG,0,-0.04284017148401986,21,10,11,21,0.34964334266626623,0.3815913584670411
경기/NNG@$회복/NNG@$경제/NNG,0,-0.04284017148401986,21,10,11,27,0.34964334266626623,0.3815913584670411
경제/NNG@$전망/NNG@$물가/NNG,0,-0.04284017148401986,21,10,11,31,0.34964334266626623,0.3815913584670411
경기/NNG@$둔화/NNG@$대응/NNG,0,-0.04284017148401986,21,10,11,37,0.34964334266626623,0.3815913584670411
금리/NNG@$인하/NNG@$가능성/NNG@$배제/NNG@$없/VA,0,-0.04284017148401986,21,10,11,34,0.34964334266626623,0.3815913584670411
상승/NNG@$압력/NNG@$우려/NNG,0,-0.04284017148401986,21,10,11,32,0.34964334266626623,0.3815913584670411
상승/NNG@$공공요금/NNG@$인상/NNG,0,-0.04284017148401986,21,10,11,22,0.34964334266626623,0.3815913584670411
해외/NNG@$자본/NNG@$유출/NNG,0,-0.04284017148401986,21,10,11,35,0.34964334266626623,0.3815913584670411
금리/NNG@$인하/NNG@$예상/NNG,0,-0.04332407040354458,163,78,85,169,0.6363324906745228,0.6951489107255187
국채/NNG@$매입/NNG@$규모/NNG,0,-0.04494521583010669,69,33,36,98,0.5699094593487157,0.6246092739635851
통화/NNG@$가치/NNG@$하락/NNG,0,-0.04532603129481305,92,44,48,155,0.61044067173525,0.6695407158246224
물가/NNG@$목표/NNG@$달성/NNG,0,-0.0459114154974386,136,65,71,189,0.6327720910952781,0.6948477071664654
인상/NNG@$소수/NNG@$의견/NNG,-1,-0.04623676457904813,44,21,23,69,0.4802597859673352,0.5277172885926205
금리/NNG@$인상/NNG@$늦추/VV,-1,-0.04623676457904813,44,21,23,41,0.4802597859673352,0.5277172885926205
위기/NNG@$이전/NNG@$회복/NNG,-1,-0.04623676457904813,44,21,23,67,0.4802597859673352,0.5277172885926205
경기/NNG@$회복/NNG@$예상/NNG,-1,-0.04623676457904813,44,21,23,51,0.4802597859673352,0.5277172885926205
금리/NNG@$인상/NNG@$기대감/NNG,0,-0.047561582624375154,67,32,35,75,0.56314713264754,0.6204382595147528
경기/NNG@$둔화/NNG@$추세/NNG,0,-0.04911773250231366,19,9,10,30,0.33398502370529654,0.3691106316940326
물가/NNG@$목표/NNG@$하한/NNG,0,-0.04911773250231366,19,9,10,21,0.33398502370529654,0.3691106316940326
인상/NNG@$속도/NNG@$점진적/NNG,0,-0.04911773250231366,19,9,10,43,0.33398502370529654,0.3691106316940326
관심/NNG@$가질/VV@$필요/NNG@$있/VA,0,-0.04911773250231366,19,9,10,17,0.33398502370529654,0.3691106316940326
외국인투자/NNG@$자금/NNG@$이탈/NNG,0,-0.04911773250231366,19,9,10,29,0.33398502370529654,0.3691106316940326
사상/NNG@$최저/NNG@$유지/NNG,0,-0.04911773250231366,19,9,10,39,0.33398502370529654,0.3691106316940326
국채/NNG@$가격/NNG@$동향/NNG@$기준금리/NNG@$인상/NNG,0,-0.04911773250231366,19,9,10,49,0.33398502370529654,0.3691106316940326
동향/NNG@$기준금리/NNG@$인상/NNG@$확률/NNG,0,-0.04911773250231366,19,9,10,49,0.33398502370529654,0.3691106316940326
동결/NNG@$결정/NNG@$내렸/VV,0,-0.04911773250231366,19,9,10,31,0.33398502370529654,0.3691106316940326
가격/NNG@$동향/NNG@$기준금리/NNG@$인상/NNG@$확률/NNG,0,-0.04911773250231366,19,9,10,49,0.33398502370529654,0.3691106316940326
금리/NNG@$통화정책/NNG@$결정/NNG,0,-0.04911773250231366,19,9,10,44,0.33398502370529654,0.3691106316940326
성장세/NNG@$둔화/NNG@$예상/NNG,0,-0.04911773250231366,19,9,10,26,0.33398502370529654,0.3691106316940326
기준금리/NNG@$동결/NNG@$통화정책/NNG@$방향/NNG,0,-0.04911773250231366,19,9,10,33,0.33398502370529654,0.3691106316940326
경기/NNG@$상승/NNG@$하강/NNG,-1,-0.050001579782319006,42,20,22,51,0.46873480339162127,0.5189496758802424
기준치/NNG@$허용/NNG@$한도/NNG,-1,-0.050001579782319006,42,20,22,111,0.46873480339162127,0.5189496758802424
기준금리/NNG@$인상/NNG@$가능성/NNG@$크/VA,-1,-0.050001579782319006,42,20,22,45,0.46873480339162127,0.5189496758802424
금리/NNG@$인상/NNG@$경로/NNG,-1,-0.050001579782319006,42,20,22,84,0.46873480339162127,0.5189496758802424
인상/NNG@$단행/NNG@$전망/NNG,0,-0.05031605137689932,65,31,34,79,0.5560233101992361,0.6159769833850639
경기/NNG@$둔화/NNG@$리스크/NNG,-1,-0.05403228058441045,40,19,21,60,0.4567678070355163,0.5097990442414874
기대/NNG@$금리/NNG@$인하/NNG,-1,-0.05403228058441045,40,19,21,40,0.4567678070355163,0.5097990442414874
금리/NNG@$인하/NNG@$가능성/NNG@$높/VA,0,-0.05405175624988934,84,40,44,74,0.5939924861257928,0.6629815192715152
기준금리/NNG@$인상/NNG@$경제/NNG,0,-0.05627664504286156,61,29,32,86,0.5406477454384792,0.6061365980648048
국내총생산/NNG@$성장률/NNG@$전망치/NNG,0,-0.05627664504286156,61,29,32,90,0.5406477454384792,0.6061365980648048
인상/NNG@$가능성/NNG@$시장/NNG,0,-0.056342017258428134,17,8,9,40,0.31796968379062135,0.35653215702486496
전망/NNG@$기준금리/NNG@$동결/NNG,0,-0.056342017258428134,17,8,9,44,0.31796968379062135,0.35653215702486496
인하/NNG@$기대/NNG@$높/VA,0,-0.056342017258428134,17,8,9,30,0.31796968379062135,0.35653215702486496
저금리/NNG@$정책/NNG@$기조/NNG,0,-0.056342017258428134,17,8,9,38,0.31796968379062135,0.35653215702486496
주택/NNG@$가격/NNG@$상승/NNG@$기대/NNG,0,-0.056342017258428134,17,8,9,22,0.31796968379062135,0.35653215702486496
가능성/NNG@$높/VA@$기준금리/NNG,0,-0.056342017258428134,17,8,9,36,0.31796968379062135,0.35653215702486496
위축/NNG@$소비/NNG@$심리/NNG,0,-0.056342017258428134,17,8,9,30,0.31796968379062135,0.35653215702486496
강세/NNG@$엔화/NNG@$약세/NNG,0,-0.056342017258428134,17,8,9,35,0.31796968379062135,0.35653215702486496
하락/NNG@$거래/NNG@$마쳤/VV,0,-0.0577854378895607,101,48,53,123,0.6107840274949942,0.6868417752309331
경기/NNG@$회복/NNG@$금리/NNG@$인상/NNG,-1,-0.05835707086870168,38,18,20,46,0.44436042609458987,0.5002670379519168
종합/NNG@$지수/NNG@$오른/VV,-1,-0.05835707086870168,38,18,20,94,0.44436042609458987,0.5002670379519168
금리/NNG@$인상/NNG@$예측/NNG,-1,-0.05835707086870168,38,18,20,43,0.44436042609458987,0.5002670379519168
기조/NNG@$지속/NNG@$전망/NNG,-1,-0.05835707086870168,38,18,20,47,0.44436042609458987,0.5002670379519168
투자/NNG@$자금/NNG@$유입/NNG,0,-0.05992410103356871,99,47,52,106,0.6076763399396924,0.6862822677914112
물가/NNG@$상승률/NNG@$목표치/NNG,0,-0.059969239508632644,234,111,123,273,0.624985769354821,0.705894619058758
시장/NNG@$기준금리/NNG@$인상/NNG@$가능성/NNG@$반영/NNG,0,-0.06167577738786412,211,100,111,183,0.6237845288531336,0.7069521335951412
경기/NNG@$하강/NNG@$리스크/NNG,0,-0.06170097511400985,78,37,41,129,0.5788813312021459,0.6560952493177631
기준금리/NNG@$인상/NNG@$가능성/NNG@$반영/NNG,0,-0.0617568198910835,230,109,121,207,0.6237297864636413,0.7070049527769472
성장률/NNG@$전망치/NNG@$상향/NNG@$조정/NNG,0,-0.06291070252957598,57,27,30,79,0.5237004135799026,0.5949954146096109
시중/NNG@$유동성/NNG@$공급/NNG,0,-0.06291070252957598,57,27,30,83,0.5237004135799026,0.5949954146096109
목표/NNG@$물가/NNG@$상승률/NNG,0,-0.06300947848896177,36,17,19,33,0.43151551838029145,0.49035785371100454
금융정책/NNG@$결정/NNG@$열/VV,0,-0.06300947848896177,36,17,19,56,0.43151551838029145,0.49035785371100454
기업/NNG@$투자/NNG@$활성화/NNG,0,-0.06300947848896177,36,17,19,36,0.43151551838029145,0.49035785371100454
조정/NNG@$금리/NNG@$인상/NNG,0,-0.06300947848896177,36,17,19,57,0.43151551838029145,0.49035785371100454
금리/NNG@$인상/NNG@$반대/NNG,0,-0.06447313804781196,95,45,50,123,0.6008698664661255,0.684812748104916
경제/NNG@$전망/NNG@$경제성장률/NNG,0,-0.06449380251576586,76,36,40,111,0.5732545115142099,0.6533665422083024
경기/NNG@$부양책/NNG@$효과/NNG,0,-0.06449380251576586,76,36,40,62,0.5732545115142099,0.6533665422083024
기준금리/NNG@$인하/NNG@$동결/NNG,0,-0.06484679258192327,15,7,8,41,0.3015442438301332,0.3439282954320361
소매/NNG@$판매/NNG@$설비투자/NNG,0,-0.06484679258192327,15,7,8,21,0.3015442438301332,0.3439282954320361
산업/NNG@$생산/NNG@$부진/NNG,0,-0.06484679258192327,15,7,8,34,0.3015442438301332,0.3439282954320361
채무/NNG@$상환/NNG@$능력/NNG,0,-0.06484679258192327,15,7,8,39,0.3015442438301332,0.3439282954320361
기준금리/NNG@$인상/NNG@$금융시장/NNG,0,-0.06484679258192327,15,7,8,36,0.3015442438301332,0.3439282954320361
공개/NNG@$기준금리/NNG@$인상/NNG,0,-0.06484679258192327,15,7,8,39,0.3015442438301332,0.3439282954320361
원/NNG@$환율/NNG@$하락/NNG,0,-0.06651110717647524,55,26,29,97,0.5146140428448728,0.5889091624850523
금리/NNG@$인상/NNG@$불확실성/NNG,0,-0.06651110717647524,55,26,29,83,0.5146140428448728,0.5889091624850523
경제성장률/NNG@$전망/NNG@$하향/NNG@$조정/NNG,0,-0.06651110717647524,55,26,29,72,0.5146140428448728,0.5889091624850523
채권/NNG@$시장/NNG@$경기/NNG,0,-0.06651110717647524,55,26,29,83,0.5146140428448728,0.5889091624850523
주시/NNG@$필요/NNG@$있/VA,0,-0.06742001925352481,74,35,39,79,0.5673135124553093,0.6504017667950954
예금금리/NNG@$한계/NNG@$대출/NNG,0,-0.06802997757784224,34,16,18,37,0.41823681147152164,0.480078583090604
기준금리/NNG@$인상/NNG@$영향/NNG,0,-0.06802997757784224,34,16,18,34,0.41823681147152164,0.480078583090604
채권/NNG@$금리/NNG@$급등/NNG,0,-0.06802997757784224,34,16,18,47,0.41823681147152164,0.480078583090604
투자/NNG@$심리/NNG@$악화/NNG,0,-0.06802997757784224,34,16,18,41,0.41823681147152164,0.480078583090604
금리/NNG@$인상/NNG@$긴축/NNG,0,-0.0704875390165981,72,34,38,82,0.5610468027732765,0.6471888766060055
정책/NNG@$금리/NNG@$인상/NNG,0,-0.0704875390165981,72,34,38,66,0.5610468027732765,0.6471888766060055
가격/NNG@$금리/NNG@$인상/NNG,0,-0.07346827693072044,32,15,17,34,0.404528286136806,0.46943958475544884
경제지표/NNG@$호조/NNG@$보이/VV,0,-0.07346827693072044,32,15,17,44,0.404528286136806,0.46943958475544884
가능성/NNG@$높/VA@$경기/NNG,0,-0.07346827693072044,32,15,17,26,0.404528286136806,0.46943958475544884
위기/NNG@$금리/NNG@$인상/NNG,0,-0.07346827693072044,32,15,17,50,0.404528286136806,0.46943958475544884
금리/NNG@$격차/NNG@$축소/NNG,0,-0.07346827693072044,32,15,17,37,0.404528286136806,0.46943958475544884
경기/NNG@$부양/NNG@$기준금리/NNG@$인하/NNG,0,-0.07346827693072044,32,15,17,54,0.404528286136806,0.46943958475544884
채권/NNG@$시장/NNG@$부담/NNG,0,-0.07346827693072044,32,15,17,22,0.404528286136806,0.46943958475544884
인하/NNG@$효과/NNG@$지켜보/VV,0,-0.07346827693072044,32,15,17,29,0.404528286136806,0.46943958475544884
국내총생산/NNG@$증가율/NNG@$기록/NNG,0,-0.07346827693072044,32,15,17,29,0.404528286136806,0.46943958475544884
경기/NNG@$둔화/NNG@$인플레이션/NNG,0,-0.07370490066891822,70,33,37,72,0.5544429465857117,0.6437155998898729
검토/NNG@$필요/NNG@$있/VA,-1,-0.07435254611560127,51,24,27,90,0.4951756081041463,0.575653644208068
하락/NNG@$종합/NNG@$지수/NNG,0,-0.07518417419696322,13,6,7,38,0.2845871998278206,0.33139256633239755
양적완화/NNG@$규모/NNG@$줄이/VV,0,-0.07518417419696322,13,6,7,44,0.2845871998278206,0.33139256633239755
선제/NNG@$안내/NNG@$포워드가이던스/NNG,0,-0.07518417419696322,13,6,7,40,0.2845871998278206,0.33139256633239755
하방/NNG@$리스크/NNG@$높/VA,0,-0.07518417419696322,13,6,7,28,0.2845871998278206,0.33139256633239755
자금/NNG@$해외/NNG@$유출/NNG,0,-0.07518417419696322,13,6,7,59,0.2845871998278206,0.33139256633239755
회복세/NNG@$나타낼/VV@$전망/NNG,0,-0.07518417419696322,13,6,7,43,0.2845871998278206,0.33139256633239755
의견/NNG@$적/VA@$않/VX,0,-0.07938661625025523,30,14,16,30,0.3903931722259451,0.4584548906649715
금리/NNG@$올리/VV@$경기/NNG,0,-0.07938661625025523,30,14,16,30,0.3903931722259451,0.4584548906649715
외국인투자/NNG@$자금/NNG@$유출/NNG,0,-0.07938661625025523,30,14,16,46,0.3903931722259451,0.4584548906649715
대출/NNG@$주택/NNG@$담보대출/NNG@$크/VA,0,-0.07938661625025523,30,14,16,15,0.3903931722259451,0.4584548906649715
경제/NNG@$침체/NNG@$빠지/VV,0,-0.07938661625025523,30,14,16,33,0.3903931722259451,0.4584548906649715
기준금리/NNG@$결정/NNG@$전문가별/NNG,0,-0.07938661625025523,30,14,16,58,0.3903931722259451,0.4584548906649715
유로존/NNG@$유로화/NNG@$사용/NNG@$경제/NNG,0,-0.07938661625025523,30,14,16,46,0.3903931722259451,0.4584548906649715
경기/NNG@$회복/NNG@$부진/NNG,0,-0.07938661625025523,30,14,16,28,0.3903931722259451,0.4584548906649715
금리/NNG@$인상/NNG@$소비/NNG,0,-0.07938661625025523,30,14,16,38,0.3903931722259451,0.4584548906649715
휘발유/NNG@$가격/NNG@$상승/NNG,0,-0.07938661625025523,30,14,16,40,0.3903931722259451,0.4584548906649715
콜금리/NNG@$인상/NNG@$효과/NNG,0,-0.07938661625025523,30,14,16,18,0.3903931722259451,0.4584548906649715
금융/NNG@$위기/NNG@$대응/NNG,0,-0.08065549899215751,83,39,44,86,0.5749694105002208,0.676934782041846
인플레/NNG@$압력/NNG@$완화/NNG,-1,-0.08316870561207923,47,22,25,55,0.474005929322655,0.5608936114286341
인하/NNG@$단행/NNG@$가능성/NNG,0,-0.0837833145921908,81,38,43,76,0.5697392086058806,0.6750091629658044
물가/NNG@$상승률/NNG@$전망치/NNG,0,-0.08386008985252857,143,67,76,172,0.6068866949585583,0.7191313820424391
회복/NNG@$금리/NNG@$인상/NNG,0,-0.08435249630820729,64,30,34,91,0.5324967018422008,0.631608104964906
외환시장/NNG@$변동성/NNG@$확대/NNG,0,-0.0858646281140093,28,13,15,46,0.37583234968976437,0.4471426526741862
금리/NNG@$인하/NNG@$명분/NNG,0,-0.0858646281140093,28,13,15,39,0.37583234968976437,0.4471426526741862
인상/NNG@$가능성/NNG@$배제/NNG@$않/VX,0,-0.0858646281140093,28,13,15,40,0.37583234968976437,0.4471426526741862
고려/NNG@$않/VX@$없/VA,0,-0.0858646281140093,28,13,15,42,0.37583234968976437,0.4471426526741862
소비/NNG@$기업/NNG@$투자/NNG,0,-0.0858646281140093,28,13,15,32,0.37583234968976437,0.4471426526741862
금리/NNG@$상승/NNG@$경제/NNG,0,-0.0858646281140093,28,13,15,44,0.37583234968976437,0.4471426526741862
고용/NNG@$지표/NNG@$시장/NNG,0,-0.0882700796005833,62,29,33,49,0.524433732008285,0.6269673858373486
완화적/NNG@$정책/NNG@$기조/NNG@$유지/NNG,0,-0.0883469769978964,11,5,6,20,0.26683243204734464,0.31905104427331826
대응/NNG@$한계/NNG@$있/VA,0,-0.0883469769978964,11,5,6,43,0.26683243204734464,0.31905104427331826
경기/NNG@$하방/NNG@$위험/NNG,0,-0.08963814221769395,137,64,73,178,0.6021555974808256,0.7218702847733484
물가/NNG@$상승률/NNG@$둔화/NNG,0,-0.09047026178055406,77,36,41,121,0.5583951128503871,0.6705323233410727
상품/NNG@$가격/NNG@$하락/NNG,0,-0.09096779325874382,92,43,49,79,0.5797714179446539,0.6968993276326372
고용/NNG@$지표/NNG@$개선/NNG,0,-0.09239277231889576,60,28,32,86,0.5159798433071258,0.6220029883974472
불안/NNG@$경기/NNG@$둔화/NNG,0,-0.09239277231889576,60,28,32,53,0.5159798433071258,0.6220029883974472
동결/NNG@$통화정책/NNG@$방향/NNG,0,-0.09300670731146643,26,12,14,46,0.36084181077359284,0.4355256387980723
통화/NNG@$완화/NNG@$정책/NNG@$유지/NNG,0,-0.09300670731146643,26,12,14,30,0.36084181077359284,0.4355256387980723
영향/NNG@$소비자/NNG@$물가/NNG,0,-0.09300670731146643,26,12,14,25,0.36084181077359284,0.4355256387980723
확대/NNG@$가능성/NNG@$높/VA,0,-0.09300670731146643,26,12,14,24,0.36084181077359284,0.4355256387980723
확산/NNG@$금리/NNG@$인상/NNG,0,-0.09300670731146643,26,12,14,26,0.36084181077359284,0.4355256387980723
종합/NNG@$지수/NNG@$내린/VV,0,-0.09300670731146643,26,12,14,34,0.36084181077359284,0.4355256387980723
통화정책/NNG@$열/VV@$기준금리/NNG@$동결/NNG,0,-0.09300670731146643,26,12,14,47,0.36084181077359284,0.4355256387980723
경기/NNG@$둔화/NNG@$금리/NNG@$인하/NNG,0,-0.09300670731146643,26,12,14,32,0.36084181077359284,0.4355256387980723
금리/NNG@$인상/NNG@$실시/NNG,0,-0.09300670731146643,26,12,14,29,0.36084181077359284,0.4355256387980723
예상/NNG@$금리/NNG@$동결/NNG,-1,-0.09314144131704927,43,20,23,71,0.45106573109776654,0.5445711063385127
상승/NNG@$압력/NNG@$금리/NNG,-1,-0.09314144131704927,43,20,23,44,0.45106573109776654,0.5445711063385127
조치/NNG@$금리/NNG@$인상/NNG,-1,-0.09314144131704927,43,20,23,44,0.45106573109776654,0.5445711063385127
기조/NNG@$변화/NNG@$없/VA,-1,-0.09314144131704927,43,20,23,52,0.45106573109776654,0.5445711063385127
경기/NNG@$회복/NNG@$조짐/NNG,0,-0.09404568759916676,75,35,40,102,0.5522585734223231,0.6679569856010198
기준금리/NNG@$하향/NNG@$조정/NNG,0,-0.09408145836318715,90,42,48,60,0.5753986562731432,0.6959950919947812
자본/NNG@$확충/NNG@$펀드/NNG,0,-0.09673505389926773,58,27,31,74,0.5071254006889102,0.6167022861424146
경기/NNG@$하강/NNG@$위험/NNG,0,-0.0971626366947923,172,80,92,138,0.5984123422515008,0.7283416399495375
경기/NNG@$좋/VA@$않/VX,0,-0.09732736332223502,88,41,47,102,0.5707789084916829,0.6949391223949621
금리/NNG@$인상/NNG@$준비/NNG,-1,-0.09863458853792484,41,19,22,68,0.438923275915408,0.5358118721156332
물가/NNG@$상승/NNG@$압박/NNG,-1,-0.09863458853792484,41,19,22,42,0.438923275915408,0.5358118721156332
내수/NNG@$회복세/NNG@$약화/NNG,-1,-0.09863458853792484,41,19,22,8,0.438923275915408,0.5358118721156332
시장/NNG@$예상치/NNG@$웃돌/VV,-1,-0.09863458853792484,41,19,22,62,0.438923275915408,0.5358118721156332
금융/NNG@$위기/NNG@$충격/NNG,-1,-0.09863458853792484,41,19,22,37,0.438923275915408,0.5358118721156332
금리/NNG@$인하/NNG@$필요성/NNG,0,-0.09980012167198704,155,72,83,153,0.5961571105299575,0.7294667182316168
인하/NNG@$가능성/NNG@$반영/NNG,0,-0.1007122635612,86,40,46,92,0.5659014060696667,0.6937208573730207
상승/NNG@$주택/NNG@$가격/NNG,0,-0.10095353962203435,24,11,13,26,0.34540858863414947,0.4236317912316986
상승/NNG@$물가/NNG@$불안/NNG,0,-0.10095353962203435,24,11,13,30,0.34540858863414947,0.4236317912316986
물가/NNG@$상승/NNG@$인플레이션/NNG,0,-0.10095353962203435,24,11,13,33,0.34540858863414947,0.4236317912316986
금리/NNG@$인상/NNG@$시기/NNG@$결정/NNG,0,-0.10095353962203435,24,11,13,27,0.34540858863414947,0.4236317912316986
반영/NNG@$기준금리/NNG@$인상/NNG,0,-0.10095353962203435,24,11,13,38,0.34540858863414947,0.4236317912316986
부정적/NNG@$영향/NNG@$전망/NNG,0,-0.10095353962203435,24,11,13,31,0.34540858863414947,0.4236317912316986
인플레이션/NNG@$우려/NNG@$커지/VV,0,-0.10095353962203435,24,11,13,31,0.34540858863414947,0.4236317912316986
인하/NNG@$전망/NNG@$유지/NNG,0,-0.10095353962203435,24,11,13,30,0.34540858863414947,0.4236317912316986
경제/NNG@$더블딥/NNG@$이중/NNG@$침체/NNG,0,-0.10095353962203435,24,11,13,29,0.34540858863414947,0.4236317912316986
경제/NNG@$회복/NNG@$기조/NNG,0,-0.10095353962203435,24,11,13,29,0.34540858863414947,0.4236317912316986
경제/NNG@$외환/NNG@$위기/NNG,0,-0.10095353962203435,24,11,13,24,0.34540858863414947,0.4236317912316986
이전/NNG@$금리/NNG@$인하/NNG,0,-0.10095353962203435,24,11,13,34,0.34540858863414947,0.4236317912316986
금리/NNG@$동결/NNG@$기조/NNG@$유지/NNG,0,-0.10095353962203435,24,11,13,39,0.34540858863414947,0.4236317912316986
달러/NNG@$환율/NNG@$기록/NNG,0,-0.10095353962203435,24,11,13,28,0.34540858863414947,0.4236317912316986
경제/NNG@$회복세/NNG@$둔화/NNG,0,-0.10095353962203435,24,11,13,24,0.34540858863414947,0.4236317912316986
단행/NNG@$가능성/NNG@$크/VA,0,-0.10095353962203435,24,11,13,42,0.34540858863414947,0.4236317912316986
전망/NNG@$경제성장률/NNG@$전망치/NNG,0,-0.10095353962203435,24,11,13,31,0.34540858863414947,0.4236317912316986
내외/NNG@$금리/NNG@$역전/NNG,0,-0.10095353962203435,24,11,13,61,0.34540858863414947,0.4236317912316986
기준금리/NNG@$동결/NNG@$예상/NNG,0,-0.10189869917363303,194,90,104,255,0.595100181428797,0.7312634194108374
경기/NNG@$회복/NNG@$기대/NNG,0,-0.10287083191845636,179,83,96,289,0.5943502384881783,0.7317763522144396
전망/NNG@$힘/NNG@$실/VV,-1,-0.10451518305221308,39,18,21,50,0.42632935863059984,0.5266510933453136
대외/NNG@$불확실성/NNG@$높/VA,-1,-0.10451518305221308,39,18,21,38,0.42632935863059984,0.5266510933453136
주택/NNG@$담보대출/NNG@$크/VA,-1,-0.10451518305221308,39,18,21,19,0.42632935863059984,0.5266510933453136
담보인정비율/NNG@$부채/NNG@$상환/NNG,-1,-0.10451518305221308,39,18,21,56,0.42632935863059984,0.5266510933453136
수출/NNG@$감소세/NNG@$지속/NNG,0,-0.10581130541428352,69,32,37,70,0.5318558727580865,0.658731671853259
외국인/NNG@$자금/NNG@$이탈/NNG,0,-0.10581130541428352,69,32,37,86,0.5318558727580865,0.658731671853259
유지/NNG@$금리/NNG@$인하/NNG,-1,-0.10614450437112677,54,25,29,55,0.4881789587022755,0.6050425869499596
채권/NNG@$시장/NNG@$기준금리/NNG@$동결/NNG,-1,-0.10614450437112677,54,25,29,44,0.4881789587022755,0.6050425869499596
기조/NNG@$유지/NNG@$전망/NNG,-1,-0.10614450437112677,54,25,29,60,0.4881789587022755,0.6050425869499596
경제성장률/NNG@$전망치/NNG@$하향/NNG@$조정/NNG,0,-0.10792829264482162,82,38,44,139,0.5553295205933729,0.6907531151306145
외환시장/NNG@$달러/NNG@$원/NNG,0,-0.10990082128260059,22,10,12,30,0.3295040758900497,0.41149485861266283
원화/NNG@$강세/NNG@$기조/NNG,0,-0.10990082128260059,22,10,12,41,0.3295040758900497,0.41149485861266283
시장/NNG@$예상치/NNG@$밑돌/VV,0,-0.10990082128260059,22,10,12,30,0.3295040758900497,0.41149485861266283
위안화/NNG@$절상/NNG@$가능성/NNG,0,-0.10990082128260059,22,10,12,65,0.3295040758900497,0.41149485861266283
오름세/NNG@$지속/NNG@$예상/NNG,0,-0.10990082128260059,22,10,12,17,0.3295040758900497,0.41149485861266283
금리/NNG@$인하/NNG@$검토/NNG,0,-0.10990082128260059,22,10,12,34,0.3295040758900497,0.41149485861266283
금융/NNG@$중개/NNG@$기능/NNG,0,-0.10990082128260059,22,10,12,35,0.3295040758900497,0.41149485861266283
금리/NNG@$인상/NNG@$추세/NNG,0,-0.10990082128260059,22,10,12,48,0.3295040758900497,0.41149485861266283
정책/NNG@$여력/NNG@$확보/NNG,0,-0.10990082128260059,22,10,12,64,0.3295040758900497,0.41149485861266283
하방/NNG@$위험/NNG@$높/VA,0,-0.10990082128260059,22,10,12,31,0.3295040758900497,0.41149485861266283
채권/NNG@$시장/NNG@$자금/NNG,0,-0.10990082128260059,22,10,12,40,0.3295040758900497,0.41149485861266283
구조/NNG@$개혁/NNG@$노력/NNG,0,-0.10990082128260059,22,10,12,33,0.3295040758900497,0.41149485861266283
인상/NNG@$긴축/NNG@$기조/NNG,0,-0.10990082128260059,22,10,12,28,0.3295040758900497,0.41149485861266283
경제/NNG@$하강/NNG@$리스크/NNG,0,-0.10990082128260059,22,10,12,35,0.3295040758900497,0.41149485861266283
경제/NNG@$전망/NNG@$하방/NNG,0,-0.10990082128260059,22,10,12,28,0.3295040758900497,0.41149485861266283
금리/NNG@$인하/NNG@$중단/NNG,-1,-0.11082978962325496,37,17,20,38,0.4132817040483615,0.5170892810774906
전망/NNG@$밝/VA@$않/VX,-1,-0.11082978962325496,37,17,20,47,0.4132817040483615,0.5170892810774906
우려/NNG@$고개/NNG@$들/VV,-1,-0.11082978962325496,37,17,20,46,0.4132817040483615,0.5170892810774906
소비자/NNG@$물가/NNG@$상승률/NNG@$상승/NNG,-1,-0.11082978962325496,37,17,20,31,0.4132817040483615,0.5170892810774906
금리/NNG@$인상/NNG@$점쳤/VV,-1,-0.11082978962325496,37,17,20,32,0.4132817040483615,0.5170892810774906
금리/NNG@$인상/NNG@$무게/NNG,-1,-0.11082978962325496,37,17,20,46,0.4132817040483615,0.5170892810774906
가능성/NNG@$가격/NNG@$반영/NNG,-1,-0.11124975188429187,52,24,28,68,0.47807046940969733,0.5986598071874177
금리/NNG@$인하/NNG@$통화정책/NNG,-1,-0.11124975188429187,52,24,28,60,0.47807046940969733,0.5986598071874177
인상/NNG@$예상/NNG@$금리/NNG,-1,-0.11124975188429187,52,24,28,57,0.47807046940969733,0.5986598071874177
금리/NNG@$역전/NNG@$현상/NNG,-1,-0.11124975188429187,52,24,28,80,0.47807046940969733,0.5986598071874177
금리선물/NNG@$시장/NNG@$기준금리/NNG@$인상/NNG@$가능성/NNG,0,-0.11145107036074509,221,102,119,206,0.5881999095955631,0.7368684386257072
물가/NNG@$상승률/NNG@$기록/NNG,0,-0.11158857837315372,106,49,57,188,0.5769728858130474,0.7230048066587934
경제/NNG@$회복/NNG@$속도/NNG,0,-0.11177529673883502,80,37,43,137,0.549613128434201,0.6889804289629384
변동성/NNG@$확대/NNG@$가능성/NNG,0,-0.11203711332752753,93,43,50,91,0.5664046238096512,0.7104059017120338
자본/NNG@$유출/NNG@$우려/NNG,0,-0.11219286168250975,143,66,77,189,0.5865332738495959,0.7358838013091573
기금/NNG@$금리선물/NNG@$시장/NNG@$기준금리/NNG@$인상/NNG,0,-0.11286499923355786,219,101,118,208,0.5871730307886037,0.7376887950584919
금리/NNG@$인하/NNG@$필요/NNG,0,-0.11373565210187808,117,54,63,144,0.5805290426161129,0.7306276029261871
소비자/NNG@$물가/NNG@$높/VA,0,-0.11463033346531493,65,30,35,58,0.5164827913322302,0.6511998501583741
경제성장률/NNG@$하향/NNG@$조정/NNG,0,-0.11579315809778079,78,36,42,85,0.5435950153037236,0.686999029111154
인상/NNG@$기조/NNG@$유지/NNG,0,-0.11579315809778079,78,36,42,87,0.5435950153037236,0.686999029111154
금리/NNG@$인상/NNG@$있/VA,-1,-0.11665154857930127,50,23,27,88,0.46752848811069475,0.5918934235010107
금융/NNG@$위기/NNG@$가능성/NNG,-1,-0.11665154857930127,50,23,27,36,0.46752848811069475,0.5918934235010107
전망/NNG@$기준금리/NNG@$인하/NNG,-1,-0.11763532097406049,35,16,19,47,0.39977733148863626,0.5071294308383301
인상/NNG@$필요성/NNG@$제기/NNG,-1,-0.11763532097406049,35,16,19,57,0.39977733148863626,0.5071294308383301
종사자/NNG@$기준금리/NNG@$동결/NNG,-1,-0.11763532097406049,35,16,19,31,0.39977733148863626,0.5071294308383301
투자/NNG@$증권/NNG@$경기/NNG,-1,-0.11763532097406049,35,16,19,45,0.39977733148863626,0.5071294308383301
금리/NNG@$인상/NNG@$포함/NNG,-1,-0.11763532097406049,35,16,19,43,0.39977733148863626,0.5071294308383301
성장/NNG@$둔화/NNG@$경제/NNG,-1,-0.11763532097406049,35,16,19,57,0.39977733148863626,0.5071294308383301
금리/NNG@$유지/NNG@$결정/NNG,-1,-0.11763532097406049,35,16,19,39,0.39977733148863626,0.5071294308383301
금리/NNG@$인상/NNG@$아니/VCN,0,-0.11937051611648097,63,29,34,85,0.508232763623261,0.6469785603041044
주식/NNG@$부동산/NNG@$자산/NNG,0,-0.12013103020578364,20,9,11,39,0.3130726828864722,0.39915510561704004
둔화/NNG@$수출/NNG@$감소/NNG,0,-0.12013103020578364,20,9,11,24,0.3130726828864722,0.39915510561704004
경제/NNG@$전망/NNG@$하향/NNG@$조정/NNG,0,-0.12013103020578364,20,9,11,33,0.3130726828864722,0.39915510561704004
소비자/NNG@$물가/NNG@$상승률/NNG@$농산물/NNG@$가격/NNG,0,-0.12013103020578364,20,9,11,22,0.3130726828864722,0.39915510561704004
가격/NNG@$상승/NNG@$가능성/NNG,0,-0.12013103020578364,20,9,11,19,0.3130726828864722,0.39915510561704004
금리/NNG@$동결/NNG@$물가/NNG,0,-0.12013103020578364,20,9,11,37,0.3130726828864722,0.39915510561704004
둔화/NNG@$수출/NNG@$부진/NNG,0,-0.12013103020578364,20,9,11,31,0.3130726828864722,0.39915510561704004
외환/NNG@$위기/NNG@$겪/VV,0,-0.12013103020578364,20,9,11,36,0.3130726828864722,0.39915510561704004
금리/NNG@$동결/NNG@$시장/NNG@$예상/NNG,0,-0.12013103020578364,20,9,11,48,0.3130726828864722,0.39915510561704004
기준금리/NNG@$인상/NNG@$논의/NNG,0,-0.12013103020578364,20,9,11,42,0.3130726828864722,0.39915510561704004
주택/NNG@$경기/NNG@$회복/NNG,0,-0.12013103020578364,20,9,11,37,0.3130726828864722,0.39915510561704004
금융/NNG@$위기/NNG@$우려/NNG,0,-0.12013103020578364,20,9,11,40,0.3130726828864722,0.39915510561704004
금융/NNG@$위기/NNG@$낮/VA,0,-0.12013103020578364,20,9,11,38,0.3130726828864722,0.39915510561704004
부동산/NNG@$중개인/NNG@$주택/NNG,0,-0.12013103020578364,20,9,11,46,0.3130726828864722,0.39915510561704004
수출/NNG@$견조/NNG@$증가세/NNG,0,-0.12013103020578364,20,9,11,12,0.3130726828864722,0.39915510561704004
통화/NNG@$긴축/NNG@$선호/NNG,0,-0.12438001963435308,74,34,40,118,0.5306093091911217,0.6823590880729475
국채/NNG@$가격/NNG@$하락/NNG,0,-0.1250025831446756,33,15,18,73,0.3858114253017004,0.49677731514599355
물가/NNG@$하방/NNG@$압력/NNG,0,-0.1250025831446756,33,15,18,29,0.3858114253017004,0.49677731514599355
위기/NNG@$발생/NNG@$가능성/NNG,0,-0.1250025831446756,33,15,18,44,0.3858114253017004,0.49677731514599355
시장/NNG@$신뢰/NNG@$회복/NNG,0,-0.1250025831446756,33,15,18,49,0.3858114253017004,0.49677731514599355
일본식/NNG@$장기/NNG@$불황/NNG,0,-0.1250025831446756,33,15,18,15,0.3858114253017004,0.49677731514599355
소수/NNG@$의견/NNG@$등장/NNG,0,-0.1250025831446756,33,15,18,35,0.3858114253017004,0.49677731514599355
인프라/NNG@$투자/NNG@$확대/NNG,0,-0.1250025831446756,33,15,18,37,0.3858114253017004,0.49677731514599355
예상/NNG@$크/VA@$않/VX,0,-0.1250025831446756,33,15,18,29,0.3858114253017004,0.49677731514599355
물가/NNG@$원자재/NNG@$가격/NNG,0,-0.1250025831446756,33,15,18,34,0.3858114253017004,0.49677731514599355
통화정책/NNG@$경기/NNG@$부양/NNG,0,-0.1250025831446756,33,15,18,45,0.3858114253017004,0.49677731514599355
상승/NNG@$수입/NNG@$물가/NNG,0,-0.1250025831446756,33,15,18,40,0.3858114253017004,0.49677731514599355
동결/NNG@$금리/NNG@$인하/NNG,0,-0.12608524716083813,109,50,59,131,0.5683317519194863,0.7334031348280907
경기/NNG@$회복세/NNG@$보이/VV,-1,-0.12845304629212728,46,21,25,87,0.44511752640354735,0.577169334643561
공급/NNG@$과잉/NNG@$우려/NNG,-1,-0.12845304629212728,46,21,25,63,0.44511752640354735,0.577169334643561
정책금리/NNG@$인상/NNG@$가능성/NNG,-1,-0.12958869767241998,59,27,32,94,0.4905549824190891,0.6375555324628766
우려/NNG@$금리/NNG@$인하/NNG,0,-0.1299651667311602,129,59,70,137,0.5718983799109759,0.743843117242044
통계/NNG@$유로/NNG@$유로존/NNG,0,-0.13207030683325705,18,8,10,48,0.29601169871836674,0.3866600624933185
기업/NNG@$체감/NNG@$경기/NNG,0,-0.13207030683325705,18,8,10,42,0.29601169871836674,0.3866600624933185
인하/NNG@$경기/NNG@$부양/NNG@$효과/NNG,0,-0.13207030683325705,18,8,10,41,0.29601169871836674,0.3866600624933185
거시/NNG@$건전성/NNG@$규제/NNG,0,-0.13207030683325705,18,8,10,44,0.29601169871836674,0.3866600624933185
전미/NNG@$부동산/NNG@$중개인/NNG@$주택/NNG,0,-0.13207030683325705,18,8,10,35,0.29601169871836674,0.3866600624933185
우려/NNG@$커지/VV@$금리/NNG,0,-0.13207030683325705,18,8,10,39,0.29601169871836674,0.3866600624933185
개인/NNG@$서비스/NNG@$요금/NNG,0,-0.13207030683325705,18,8,10,20,0.29601169871836674,0.3866600624933185
인플레이션/NNG@$상승/NNG@$위험/NNG,0,-0.13207030683325705,18,8,10,42,0.29601169871836674,0.3866600624933185
해소/NNG@$금리/NNG@$인상/NNG,0,-0.13207030683325705,18,8,10,33,0.29601169871836674,0.3866600624933185
수출/NNG@$증가세/NNG@$유지/NNG,0,-0.13207030683325705,18,8,10,29,0.29601169871836674,0.3866600624933185
통화정책/NNG@$기조/NNG@$완화/NNG,0,-0.13207030683325705,18,8,10,33,0.29601169871836674,0.3866600624933185
경기/NNG@$하강/NNG@$가능성/NNG,0,-0.13207030683325705,18,8,10,29,0.29601169871836674,0.3866600624933185
주가/NNG@$상승/NNG@$환율/NNG,0,-0.13207030683325705,18,8,10,28,0.29601169871836674,0.3866600624933185
경제/NNG@$회복/NNG@$전망/NNG,0,-0.13207030683325705,18,8,10,29,0.29601169871836674,0.3866600624933185
성장/NNG@$둔화/NNG@$금리/NNG,0,-0.13302142290671337,31,14,17,41,0.3713756038517913,0.486041772374152
필요/NNG@$있/VA@$기준금리/NNG,0,-0.13302142290671337,31,14,17,41,0.3713756038517913,0.486041772374152
기대/NNG@$심리/NNG@$높/VA,0,-0.13302142290671337,31,14,17,46,0.3713756038517913,0.486041772374152
가능성/NNG@$낮/VA@$전망/NNG,0,-0.13302142290671337,31,14,17,29,0.3713756038517913,0.486041772374152
신용등급/NNG@$상향/NNG@$조정/NNG,0,-0.13302142290671337,31,14,17,71,0.3713756038517913,0.486041772374152
중기적/NNG@$물가/NNG@$상승률/NNG@$목표/NNG,0,-0.13302142290671337,31,14,17,31,0.3713756038517913,0.486041772374152
경제/NNG@$회복/NNG@$조짐/NNG,0,-0.13302142290671337,31,14,17,37,0.3713756038517913,0.486041772374152
악화/NNG@$금리/NNG@$인상/NNG,0,-0.13302142290671337,31,14,17,20,0.3713756038517913,0.486041772374152
물가/NNG@$상승/NNG@$압력/NNG@$낮/VA,0,-0.13302142290671337,31,14,17,37,0.3713756038517913,0.486041772374152
원화/NNG@$가치/NNG@$하락/NNG,0,-0.1337739764982564,70,32,38,70,0.5162841904259677,0.6767272561163621
통화/NNG@$완화/NNG@$선호/NNG,-1,-0.13491786246652893,44,20,24,63,0.4332363305506202,0.5691938457620175
금융시장/NNG@$불안/NNG@$요인/NNG,-1,-0.1351023697067235,57,26,31,40,0.4811079700874975,0.6323257941369387
원화/NNG@$강세/NNG@$수출/NNG,0,-0.1388042509230204,68,31,37,94,0.5085921491336396,0.6735045476925337
단기/NNG@$외화/NNG@$차입/NNG,0,-0.1388042509230204,68,31,37,41,0.5085921491336396,0.6735045476925337
긴급/NNG@$금리/NNG@$인하/NNG,0,-0.1408449414262437,90,41,49,53,0.5433754601505416,0.7225640952595177
금리/NNG@$내릴/VV@$가능성/NNG,-1,-0.1409130856372296,55,25,30,59,0.47124333798904244,0.6267320263834432
개선/NNG@$추세/NNG@$지속/NNG,-1,-0.1409130856372296,55,25,30,48,0.47124333798904244,0.6267320263834432
성장세/NNG@$회복/NNG@$이어지/VV@$중기적/NNG@$물가/NNG,-1,-0.1409130856372296,55,25,30,43,0.47124333798904244,0.6267320263834432
모기지/NNG@$주택/NNG@$담보대출/NNG,0,-0.14180838478968005,29,13,16,31,0.3564552659403638,0.4749349765853492
국내총생산/NNG@$기준/NNG@$경제성장률/NNG,0,-0.14180838478968005,29,13,16,25,0.3564552659403638,0.4749349765853492
의심/NNG@$여지/NNG@$없/VA,0,-0.14180838478968005,29,13,16,41,0.3564552659403638,0.4749349765853492
회복/NNG@$속도/NNG@$예상/NNG,0,-0.14180838478968005,29,13,16,44,0.3564552659403638,0.4749349765853492
지속/NNG@$경기/NNG@$둔화/NNG,0,-0.14180838478968005,29,13,16,30,0.3564552659403638,0.4749349765853492
가능성/NNG@$있/VA@$전망/NNG,0,-0.14180838478968005,29,13,16,38,0.3564552659403638,0.4749349765853492
은행/NNG@$가계/NNG@$대출/NNG@$주택/NNG@$담보대출/NNG,-1,-0.1418117724142578,42,19,23,24,0.4208967398391917,0.5607995805314754
회복/NNG@$국면/NNG@$진입/NNG,0,-0.14407532345919682,66,30,36,44,0.5005328893680365,0.6699913513661406
시장/NNG@$금리/NNG@$인상/NNG@$시기/NNG,0,-0.14639716749553733,16,7,9,34,0.27813343068278573,0.37406514377877675
주택/NNG@$착공/NNG@$감소/NNG,0,-0.14639716749553733,16,7,9,40,0.27813343068278573,0.37406514377877675
경기동행지수/NNG@$순환/NNG@$변동/NNG,0,-0.14639716749553733,16,7,9,34,0.27813343068278573,0.37406514377877675
사상/NNG@$최저/NNG@$동결/NNG,0,-0.14639716749553733,16,7,9,43,0.27813343068278573,0.37406514377877675
상승/NNG@$압력/NNG@$전망/NNG,0,-0.14639716749553733,16,7,9,32,0.27813343068278573,0.37406514377877675
소비자/NNG@$물가/NNG@$반영/NNG,0,-0.14639716749553733,16,7,9,28,0.27813343068278573,0.37406514377877675
성장/NNG@$전망치/NNG@$하향/NNG,0,-0.14639716749553733,16,7,9,33,0.27813343068278573,0.37406514377877675
가능성/NNG@$높/VA@$보/VX,-1,-0.1470446153583077,53,24,29,70,0.4609524029830051,0.6207605574469466
금리/NNG@$인상/NNG@$단행/NNG@$전망/NNG,-1,-0.1470446153583077,53,24,29,52,0.4609524029830051,0.6207605574469466
투자/NNG@$심리/NNG@$위축/NNG,0,-0.14851415236726262,97,44,53,200,0.5446445356885605,0.7356722730066884
기준금리/NNG@$인상/NNG@$필요성/NNG,-1,-0.149184247182109,40,18,22,58,0.4080923660874996,0.5519810280679854
완화/NNG@$정책/NNG@$유지/NNG,-1,-0.149184247182109,40,18,22,40,0.4080923660874996,0.5519810280679854
부담/NNG@$크/VA@$않/VX,-1,-0.149184247182109,40,18,22,40,0.4080923660874996,0.5519810280679854
소비/NNG@$지출/NNG@$둔화/NNG,-1,-0.149184247182109,40,18,22,66,0.4080923660874996,0.5519810280679854
부동산/NNG@$자산/NNG@$가격/NNG,-1,-0.1496028532467235,64,29,35,58,0.4920959690217488,0.666172799760539
금리/NNG@$동결/NNG@$인하/NNG,0,-0.15151842147446493,27,12,15,35,0.34102548411859934,0.463472662693945
양적/NNG@$통화/NNG@$완화/NNG,0,-0.15151842147446493,27,12,15,27,0.34102548411859934,0.463472662693945
금리/NNG@$인상/NNG@$미루/VV,0,-0.15151842147446493,27,12,15,25,0.34102548411859934,0.463472662693945
경제/NNG@$성장/NNG@$둔화/NNG@$인플레이션/NNG,0,-0.15151842147446493,27,12,15,24,0.34102548411859934,0.463472662693945
장기/NNG@$시장/NNG@$금리/NNG@$하락/NNG,0,-0.15151842147446493,27,12,15,24,0.34102548411859934,0.463472662693945
인상/NNG@$가능성/NNG@$금리/NNG,0,-0.15151842147446493,27,12,15,69,0.34102548411859934,0.463472662693945
지수/NNG@$높/VA@$마감/NNG,0,-0.15151842147446493,27,12,15,23,0.34102548411859934,0.463472662693945
금리/NNG@$인상/NNG@$인내심/NNG,0,-0.15151842147446493,27,12,15,70,0.34102548411859934,0.463472662693945
경기/NNG@$회복/NNG@$지속/NNG,-1,-0.15352400817449463,51,23,28,78,0.45022680829301526,0.614398043749061
경기/NNG@$회복/NNG@$기대감/NNG,0,-0.15367121726311572,184,83,101,255,0.5571995810437282,0.7606065072925703
소비자/NNG@$물가/NNG@$상승세/NNG,-1,-0.15540412609655418,62,28,34,57,0.4832711631748332,0.6620337532118727
상승/NNG@$지수/NNG@$높/VA,-1,-0.15709533268273923,38,17,21,44,0.3948156481767982,0.5427344201616042
금융/NNG@$통화정책/NNG@$열/VV@$기준금리/NNG,-1,-0.15709533268273923,38,17,21,62,0.3948156481767982,0.5427344201616042
성장률/NNG@$전망/NNG@$상향/NNG@$조정/NNG,-1,-0.15709533268273923,38,17,21,53,0.3948156481767982,0.5427344201616042
성장률/NNG@$하향/NNG@$조정/NNG,0,-0.15902092403458712,102,46,56,161,0.5408276541069463,0.7463887130133596
내수/NNG@$경기/NNG@$회복/NNG,0,-0.15902092403458712,102,46,56,115,0.5408276541069463,0.7463887130133596
금리/NNG@$인상/NNG@$자본/NNG@$유출/NNG,-1,-0.16038232601408953,49,22,27,82,0.43905842257338945,0.6076316011126214
금리/NNG@$인하/NNG@$통한/VV,-1,-0.16038232601408953,49,22,27,43,0.43905842257338945,0.6076316011126214
경제/NNG@$성장/NNG@$물가/NNG,0,-0.16104017707261542,120,54,66,140,0.547229160782334,0.7583558816624622
금리/NNG@$인상/NNG@$재개/NNG,-1,-0.16149832832953948,60,27,33,74,0.4740484810567984,0.6575588482849825
지표/NNG@$호조/NNG@$보이/VV,0,-0.16236338438268205,25,11,14,33,0.32504453603789063,0.4516742624363795
원유/NNG@$도입/NNG@$단가/NNG,0,-0.16236338438268205,25,11,14,21,0.32504453603789063,0.4516742624363795
채권/NNG@$시장/NNG@$전망/NNG,0,-0.16236338438268205,25,11,14,40,0.32504453603789063,0.4516742624363795
경제/NNG@$완만/XR@$속도/NNG,0,-0.16236338438268205,25,11,14,51,0.32504453603789063,0.4516742624363795
전망/NNG@$고개/NNG@$들/VV,0,-0.16236338438268205,25,11,14,28,0.32504453603789063,0.4516742624363795
가격/NNG@$상승/NNG@$인플레/NNG,0,-0.16236338438268205,25,11,14,50,0.32504453603789063,0.4516742624363795
접근/NNG@$필요/NNG@$있/VA,0,-0.16426789486878568,14,6,8,29,0.25908879732219275,0.361433554289767
유로존/NNG@$국채/NNG@$매입/NNG,0,-0.16426789486878568,14,6,8,58,0.25908879732219275,0.361433554289767
가계부채/NNG@$구조/NNG@$개선/NNG,0,-0.16426789486878568,14,6,8,42,0.25908879732219275,0.361433554289767
지수/NNG@$뛴/VV@$기록/NNG,0,-0.16426789486878568,14,6,8,37,0.25908879732219275,0.361433554289767
물가/NNG@$상승률/NNG@$전망/NNG,0,-0.16557807310625283,136,61,75,189,0.5467673843912731,0.7648050387194152
달러/NNG@$원/NNG@$환율/NNG@$하락/NNG,-1,-0.16561910593311635,36,16,20,68,0.38105677294185003,0.5330579484520707
효과/NNG@$지켜볼/VV@$필요/NNG@$있/VA,-1,-0.16561910593311635,36,16,20,70,0.38105677294185003,0.5330579484520707
금융/NNG@$위기/NNG@$기준금리/NNG,-1,-0.16561910593311635,36,16,20,67,0.38105677294185003,0.5330579484520707
둔화/NNG@$우려/NNG@$커지/VV,-1,-0.16561910593311635,36,16,20,60,0.38105677294185003,0.5330579484520707
둔화/NNG@$인플레/NNG@$압력/NNG,-1,-0.16561910593311635,36,16,20,40,0.38105677294185003,0.5330579484520707
금리/NNG@$사상/NNG@$최저/NNG,-1,-0.16561910593311635,36,16,20,68,0.38105677294185003,0.5330579484520707
경제/NNG@$동향/NNG@$경기/NNG,0,-0.16667565822833985,89,40,49,66,0.5243954387299108,0.735167300774505
가격/NNG@$반대/NNG@$움직이/VV@$수익률/NNG,-1,-0.16765560062263674,47,21,26,70,0.4274391637124427,0.6004489495933534
반대/NNG@$움직이/VV@$수익률/NNG,-1,-0.16765560062263674,47,21,26,70,0.4274391637124427,0.6004489495933534
인상/NNG@$자본/NNG@$유출/NNG,-1,-0.1679068862080838,58,26,32,91,0.46441816845040335,0.6527325562564775
지속/NNG@$금리/NNG@$인하/NNG,-1,-0.1679068862080838,58,26,32,41,0.46441816845040335,0.6527325562564775
경제/NNG@$성장/NNG@$도움/NNG,0,-0.17464232270975777,23,10,13,30,0.30844345488124414,0.4395628704418904
물가/NNG@$상승/NNG@$경제/NNG,0,-0.17464232270975777,23,10,13,27,0.30844345488124414,0.4395628704418904
가능성/NNG@$높/VA@$내/VX,0,-0.17464232270975777,23,10,13,27,0.30844345488124414,0.4395628704418904
추진/NNG@$필요/NNG@$있/VA,0,-0.17464232270975777,23,10,13,25,0.30844345488124414,0.4395628704418904
물가/NNG@$목표/NNG@$하회/NNG,0,-0.17464232270975777,23,10,13,15,0.30844345488124414,0.4395628704418904
전망/NNG@$국내총생산/NNG@$성장률/NNG,0,-0.17464232270975777,23,10,13,50,0.30844345488124414,0.4395628704418904
금리/NNG@$인상/NNG@$채권/NNG,-1,-0.17484860577846073,34,15,19,39,0.3668020696198966,0.5229519656093634
통화정책/NNG@$방향/NNG@$전환/NNG,-1,-0.17484860577846073,34,15,19,14,0.3668020696198966,0.5229519656093634
결정/NNG@$금리/NNG@$동결/NNG,-1,-0.17484860577846073,34,15,19,36,0.3668020696198966,0.5229519656093634
금융시장/NNG@$가격/NNG@$변수/NNG,-1,-0.17484860577846073,34,15,19,43,0.3668020696198966,0.5229519656093634
최대/NNG@$경제/NNG@$국인/NNG,-1,-0.17484860577846073,34,15,19,62,0.3668020696198966,0.5229519656093634
경기/NNG@$회복/NNG@$수출/NNG,-1,-0.17484860577846073,34,15,19,56,0.3668020696198966,0.5229519656093634
금리/NNG@$인하/NNG@$양적완화/NNG,-1,-0.17538609853829468,45,20,25,37,0.4153607164658888,0.5928385704583615
금리/NNG@$인하/NNG@$반대/NNG,-1,-0.17538609853829468,45,20,25,50,0.4153607164658888,0.5928385704583615
산업/NNG@$생산/NNG@$감소/NNG,-1,-0.17898836561500553,65,29,36,81,0.4760711148045876,0.6845560534568927
물가/NNG@$상승률/NNG@$하락/NNG,-1,-0.17898836561500553,65,29,36,91,0.4760711148045876,0.6845560534568927
인상/NNG@$단행/NNG@$금리/NNG,-1,-0.18176663619294764,54,24,30,71,0.44389666970029135,0.6419632971674581
지수/NNG@$내린/VV@$마감/NNG,-1,-0.18362401456680144,43,19,24,44,0.4028141008034093,0.5847898725412868
가계/NNG@$기업/NNG@$부채/NNG,-1,-0.18490301599734937,32,14,18,45,0.3520316216524871,0.5124191509245317
곡물/NNG@$가격/NNG@$상승/NNG,-1,-0.18490301599734937,32,14,18,50,0.3520316216524871,0.5124191509245317
금리/NNG@$인하/NNG@$인상/NNG,-1,-0.18490301599734937,32,14,18,29,0.3520316216524871,0.5124191509245317
성장/NNG@$경로/NNG@$크/VA,-1,-0.18490301599734937,32,14,18,24,0.3520316216524871,0.5124191509245317
유동성/NNG@$공급/NNG@$정책/NNG,-1,-0.18490301599734937,32,14,18,42,0.3520316216524871,0.5124191509245317
시장/NNG@$금리/NNG@$영향/NNG,-1,-0.18490301599734937,32,14,18,37,0.3520316216524871,0.5124191509245317
은행/NNG@$기준금리/NNG@$인하/NNG,-1,-0.18490301599734937,32,14,18,47,0.3520316216524871,0.5124191509245317
금리/NNG@$내릴/VV@$전망/NNG,-1,-0.18490301599734937,32,14,18,32,0.3520316216524871,0.5124191509245317
원달러/NNG@$환율/NNG@$하락/NNG,-1,-0.18490301599734937,32,14,18,39,0.3520316216524871,0.5124191509245317
금리/NNG@$인하/NNG@$단행/NNG@$가능성/NNG,-1,-0.18557363044395403,63,28,35,57,0.4670643902104888,0.6808051725044352
안전자산/NNG@$선호/NNG@$현상/NNG,-1,-0.1874763330229413,72,32,40,112,0.485482579588849,0.7104438976984797
순이익/NNG@$주당/NNG@$기록/NNG,0,-0.18783467837350398,12,5,7,72,0.2381990382523707,0.3488336274946062
수당/NNG@$청구/NNG@$예상/NNG,0,-0.18879333197588788,21,9,12,57,0.2911085893236569,0.42716488772817557
순환/NNG@$변동/NNG@$하락/NNG,0,-0.18879333197588788,21,9,12,27,0.2911085893236569,0.42716488772817557
실업/NNG@$수당/NNG@$청구/NNG@$예상/NNG,0,-0.18879333197588788,21,9,12,57,0.2911085893236569,0.42716488772817557
인상/NNG@$출구전략/NNG@$시행/NNG,0,-0.18879333197588788,21,9,12,28,0.2911085893236569,0.42716488772817557
인상/NNG@$속도/NNG@$빨라/VA,0,-0.18879333197588788,21,9,12,30,0.2911085893236569,0.42716488772817557
물가/NNG@$목표제/NNG@$채택/NNG,0,-0.18879333197588788,21,9,12,31,0.2911085893236569,0.42716488772817557
인상/NNG@$가능성/NNG@$가격/NNG@$반영/NNG,0,-0.18879333197588788,21,9,12,38,0.2911085893236569,0.42716488772817557
상승/NNG@$인플레/NNG@$압력/NNG,0,-0.18879333197588788,21,9,12,35,0.2911085893236569,0.42716488772817557
내수/NNG@$회복/NNG@$지연/NNG,0,-0.18879333197588788,21,9,12,27,0.2911085893236569,0.42716488772817557
상승/NNG@$종합/NNG@$지수/NNG@$오른/VV,0,-0.18879333197588788,21,9,12,49,0.2911085893236569,0.42716488772817557
유지/NNG@$가능성/NNG@$높/VA,-1,-0.18927630539170304,52,23,29,50,0.432986811918687,0.6359891285099745
시장/NNG@$금리/NNG@$하락/NNG,0,-0.18972691049045431,131,58,73,128,0.5282525669009905,0.7766441767789088
금리/NNG@$동결/NNG@$결정/NNG,0,-0.19175823411810133,240,106,134,332,0.5288823930004247,0.7808511421918276
경제/NNG@$동향/NNG@$성장률/NNG,-1,-0.19242977041445752,41,18,23,27,0.3897890301298677,0.576293363353251
통화정책/NNG@$방향/NNG@$기준금리/NNG@$유지/NNG,-1,-0.19386463378724306,70,31,39,98,0.47742314352111803,0.7079627819856346
증권사/NNG@$채권/NNG@$딜러/NNG,0,-0.19512122244257923,186,82,104,205,0.526327386005809,0.7825207320204796
체감/NNG@$경기/NNG@$악화/NNG,-1,-0.19593837849069062,30,13,17,39,0.3367156916363652,0.5014646101165214
전세/NNG@$가격/NNG@$수도권/NNG,-1,-0.19593837849069062,30,13,17,29,0.3367156916363652,0.5014646101165214
경기/NNG@$신뢰/NNG@$지수/NNG,-1,-0.19593837849069062,30,13,17,69,0.3367156916363652,0.5014646101165214
원유/NNG@$재고/NNG@$감소/NNG,-1,-0.19593837849069062,30,13,17,47,0.3367156916363652,0.5014646101165214
회복/NNG@$이어지/VV@$중기적/NNG@$물가/NNG@$상승률/NNG,-1,-0.19593837849069062,30,13,17,29,0.3367156916363652,0.5014646101165214
금융/NNG@$위기/NNG@$겪/VV,-1,-0.19593837849069062,30,13,17,61,0.3367156916363652,0.5014646101165214
가능성/NNG@$크/VA@$금리/NNG,-1,-0.19593837849069062,30,13,17,38,0.3367156916363652,0.5014646101165214
금융/NNG@$위기/NNG@$대처/NNG,-1,-0.19721885936631023,50,22,28,17,0.42163172541555677,0.6296013672140082
인상/NNG@$전망/NNG@$유지/NNG,-1,-0.19721885936631023,50,22,28,75,0.42163172541555677,0.6296013672140082
금리/NNG@$인하/NNG@$행진/NNG,-1,-0.19721885936631023,50,22,28,30,0.42163172541555677,0.6296013672140082
국채/NNG@$금리/NNG@$급등/NNG,-1,-0.19721885936631023,50,22,28,89,0.42163172541555677,0.6296013672140082
매입/NNG@$규모/NNG@$확대/NNG,-1,-0.20009696896944607,77,34,43,68,0.4857426994317915,0.7296892797268985
경제/NNG@$차지/NNG@$소비/NNG,-1,-0.2018771815104612,39,17,22,43,0.37627297234961515,0.5673408177051045
정책/NNG@$대응/NNG@$필요/NNG,-1,-0.2018771815104612,39,17,22,40,0.37627297234961515,0.5673408177051045
경기/NNG@$부양/NNG@$효과/NNG,0,-0.20470160612795485,187,82,105,234,0.5191458580782883,0.7873832651923113
기업/NNG@$투자/NNG@$부진/NNG,0,-0.2054869286034403,19,8,11,32,0.2728513125328844,0.4145090415035146
경제/NNG@$성장/NNG@$하방/NNG@$리스크/NNG,0,-0.2054869286034403,19,8,11,28,0.2728513125328844,0.4145090415035146
상승/NNG@$압력/NNG@$기준금리/NNG,0,-0.2054869286034403,19,8,11,45,0.2728513125328844,0.4145090415035146
경제/NNG@$성장/NNG@$주도/NNG,0,-0.2054869286034403,19,8,11,29,0.2728513125328844,0.4145090415035146
유럽연합/NNG@$통계/NNG@$유로/NNG,0,-0.2054869286034403,19,8,11,40,0.2728513125328844,0.4145090415035146
상승/NNG@$인플레이션/NNG@$우려/NNG,0,-0.2054869286034403,19,8,11,35,0.2728513125328844,0.4145090415035146
물가/NNG@$상승률/NNG@$최고치/NNG,0,-0.2054869286034403,19,8,11,32,0.2728513125328844,0.4145090415035146
하지/NNG@$않/VX@$생각/NNG,0,-0.2054869286034403,19,8,11,39,0.2728513125328844,0.4145090415035146
채권/NNG@$시장/NNG@$변동성/NNG,0,-0.2054869286034403,19,8,11,30,0.2728513125328844,0.4145090415035146
경제/NNG@$회복/NNG@$신호/NNG,0,-0.2054869286034403,19,8,11,33,0.2728513125328844,0.4145090415035146
상승/NNG@$경기/NNG@$둔화/NNG,0,-0.2054869286034403,19,8,11,33,0.2728513125328844,0.4145090415035146
금리/NNG@$인하/NNG@$기대감/NNG,0,-0.206008517419068,178,78,100,244,0.518127727728589,0.7879837640960852
전망/NNG@$금리/NNG@$인하/NNG,-1,-0.20754524860328938,66,29,37,88,0.46020238956790904,0.7021371467261772
美/NNG@$금리/NNG@$인상/NNG,-1,-0.20754524860328938,66,29,37,74,0.46020238956790904,0.7021371467261772
지속/NNG@$물가/NNG@$상승/NNG@$압력/NNG,0,-0.20816400085657405,28,12,16,27,0.32080930419127274,0.4900958619870261
금리/NNG@$인상/NNG@$필요성/NNG@$제기/NNG,0,-0.20816400085657405,28,12,16,38,0.32080930419127274,0.4900958619870261
걱정/NNG@$필요/NNG@$없/VA,0,-0.20816400085657405,28,12,16,39,0.32080930419127274,0.4900958619870261
물가/NNG@$상승률/NNG@$농산물/NNG@$가격/NNG,0,-0.20816400085657405,28,12,16,32,0.32080930419127274,0.4900958619870261
상승률/NNG@$농산물/NNG@$가격/NNG,0,-0.20816400085657405,28,12,16,33,0.32080930419127274,0.4900958619870261
기준금리/NNG@$인하/NNG@$경기/NNG@$부양/NNG,0,-0.20816400085657405,28,12,16,36,0.32080930419127274,0.4900958619870261
경기/NNG@$둔화/NNG@$신호/NNG,0,-0.20816400085657405,28,12,16,26,0.32080930419127274,0.4900958619870261
경제/NNG@$지속/NNG@$가능/NNG,0,-0.20816400085657405,28,12,16,53,0.32080930419127274,0.4900958619870261
기준금리/NNG@$내릴/VV@$전망/NNG,0,-0.20816400085657405,28,12,16,40,0.32080930419127274,0.4900958619870261
금리/NNG@$상승/NNG@$가능성/NNG,0,-0.20816400085657405,28,12,16,56,0.32080930419127274,0.4900958619870261
우려/NNG@$필요/NNG@$없/VA,0,-0.20816400085657405,28,12,16,53,0.32080930419127274,0.4900958619870261
통화정책/NNG@$금리/NNG@$인상/NNG,-1,-0.21090201575475842,82,36,46,141,0.4855569132825408,0.7460337964547256
美/NNG@$국채/NNG@$수익률/NNG,-1,-0.21205789114373252,37,16,21,46,0.36224978729313684,0.5579254328447473
시장/NNG@$예상치/NNG@$크/VA,-1,-0.21205789114373252,37,16,21,43,0.36224978729313684,0.5579254328447473
경제/NNG@$성장/NNG@$저해/NNG,-1,-0.21205789114373252,37,16,21,41,0.36224978729313684,0.5579254328447473
시장/NNG@$예상/NNG@$기준금리/NNG,-1,-0.2145776839799649,46,20,26,55,0.39754626322264935,0.6155251678496202
가계부채/NNG@$증가/NNG@$속도/NNG,-1,-0.2145776839799649,46,20,26,65,0.39754626322264935,0.6155251678496202
경기/NNG@$회복/NNG@$전망/NNG,-1,-0.2145776839799649,46,20,26,54,0.39754626322264935,0.6155251678496202
은행/NNG@$대출/NNG@$금리/NNG,-1,-0.21487748022381947,64,28,36,69,0.4510205449952447,0.6987585066812168
단기/NNG@$경제/NNG@$관측/NNG,-1,-0.2154368185363944,55,24,31,64,0.4269732138402375,0.6622777877147734
경제/NNG@$성장률/NNG@$전망치/NNG,0,-0.22186835231675128,26,11,15,57,0.30424389399310414,0.4783226358117139
금리/NNG@$상승/NNG@$예상/NNG,0,-0.22186835231675128,26,11,15,33,0.30424389399310414,0.4783226358117139
외국인투자/NNG@$자금/NNG@$유입/NNG,0,-0.22186835231675128,26,11,15,51,0.30424389399310414,0.4783226358117139
인하/NNG@$가능성/NNG@$무게/NNG,0,-0.22186835231675128,26,11,15,29,0.30424389399310414,0.4783226358117139
문제/NNG@$해결/NNG@$없/VA,0,-0.22186835231675128,26,11,15,32,0.30424389399310414,0.4783226358117139
유지/NNG@$물가/NNG@$상승/NNG,0,-0.22186835231675128,26,11,15,22,0.30424389399310414,0.4783226358117139
소비자/NNG@$물가/NNG@$상승률/NNG@$둔화/NNG,0,-0.22186835231675128,26,11,15,36,0.30424389399310414,0.4783226358117139
물가/NNG@$상승률/NNG@$억제/NNG,0,-0.22186835231675128,26,11,15,33,0.30424389399310414,0.4783226358117139
상승/NNG@$소비/NNG@$지출/NNG,0,-0.22186835231675128,26,11,15,32,0.30424389399310414,0.4783226358117139
국고채/NNG@$금리/NNG@$오른/VV,0,-0.22186835231675128,26,11,15,24,0.30424389399310414,0.4783226358117139
모습/NNG@$보이/VV@$금리/NNG,0,-0.22186835231675128,26,11,15,33,0.30424389399310414,0.4783226358117139
모습/NNG@$보일/VV@$전망/NNG,0,-0.22186835231675128,26,11,15,38,0.30424389399310414,0.4783226358117139
자금/NNG@$중개/NNG@$기능/NNG,0,-0.22186835231675128,26,11,15,14,0.30424389399310414,0.4783226358117139
단기/NNG@$시장/NNG@$금리/NNG,0,-0.22186835231675128,26,11,15,38,0.30424389399310414,0.4783226358117139
영향/NNG@$않/VX@$전망/NNG,0,-0.22186835231675128,26,11,15,32,0.30424389399310414,0.4783226358117139
완화/NNG@$정책/NNG@$필요/NNG,0,-0.22186835231675128,26,11,15,28,0.30424389399310414,0.4783226358117139
시장/NNG@$예상치/NNG@$상회/NNG,0,-0.22186835231675128,26,11,15,37,0.30424389399310414,0.4783226358117139
수입/NNG@$물가/NNG@$상승/NNG,-1,-0.2220989581534386,94,41,53,150,0.4900806036245954,0.7708626370499979
해외/NNG@$경제/NNG@$포커스/NNG,-1,-0.2225680371966553,62,27,35,56,0.44144415735526,0.6950456707013475
금리/NNG@$인상/NNG@$기조/NNG@$지속/NNG,-1,-0.22308769023378583,35,15,20,31,0.3476977534714467,0.5480419536752573
부양/NNG@$기준금리/NNG@$인하/NNG,-1,-0.22308769023378583,35,15,20,56,0.3476977534714467,0.5480419536752573
주택/NNG@$담보대출/NNG@$급증/NNG,-1,-0.22308769023378583,35,15,20,18,0.3476977534714467,0.5480419536752573
인하/NNG@$가능성/NNG@$배제/NNG@$없/VA,-1,-0.22308769023378583,35,15,20,55,0.3476977534714467,0.5480419536752573
종합/NNG@$지수/NNG@$하락/NNG,-1,-0.22308769023378583,35,15,20,66,0.3476977534714467,0.5480419536752573
브렉시트/NNG@$유럽연합/NNG@$탈퇴/NNG,-1,-0.22336523049026835,101,44,57,207,0.4939688534943398,0.779049189464721
서브프라임모기지/NNG@$부실/NNG@$사태/NNG,-1,-0.22392861520516283,53,23,30,60,0.4158844930374922,0.6566780664028669
인플레율/NNG@$억제/NNG@$목표치/NNG@$허용/NNG@$한도/NNG,-1,-0.2241022109849402,44,19,25,59,0.38479379254981416,0.6078079719746026
경기/NNG@$회복/NNG@$정책/NNG,0,-0.22580470774903438,17,7,10,35,0.2533528869807978,0.4016241621913381
하방/NNG@$리스크/NNG@$우세/NNG,0,-0.22580470774903438,17,7,10,31,0.2533528869807978,0.4016241621913381
금융/NNG@$경제/NNG@$전망/NNG,0,-0.22580470774903438,17,7,10,32,0.2533528869807978,0.4016241621913381
완화/NNG@$정책/NNG@$지속/NNG,0,-0.22580470774903438,17,7,10,35,0.2533528869807978,0.4016241621913381
통화정책/NNG@$변경/NNG@$가능성/NNG,0,-0.22580470774903438,17,7,10,35,0.2533528869807978,0.4016241621913381
필요/NNG@$있/VA@$주문/NNG,0,-0.22580470774903438,17,7,10,36,0.2533528869807978,0.4016241621913381
경제/NNG@$보/VV@$회복세/NNG,0,-0.22580470774903438,17,7,10,25,0.2533528869807978,0.4016241621913381
가능성/NNG@$있/VA@$덧붙였/VV,0,-0.22580470774903438,17,7,10,36,0.2533528869807978,0.4016241621913381
제품/NNG@$가격/NNG@$하락/NNG,0,-0.22580470774903438,17,7,10,30,0.2533528869807978,0.4016241621913381
부채/NNG@$상환/NNG@$능력/NNG,0,-0.22580470774903438,17,7,10,35,0.2533528869807978,0.4016241621913381
금리/NNG@$인하/NNG@$기대/NNG,0,-0.22602956940195373,367,159,208,460,0.503144241876816,0.7979800637972146
금리/NNG@$인상/NNG@$전망/NNG,0,-0.2280434161556525,513,222,291,719,0.5016276848393914,0.7989562430138827
금리/NNG@$인상/NNG@$가능/NNG,-1,-0.2306116260979184,148,64,84,233,0.49906168896868136,0.7991850228505688
사상/NNG@$최저/NNG@$기준금리/NNG,-1,-0.23064314618093884,60,26,34,76,0.4314630975598611,0.6909802611195874
비둘기파/NNG@$통화/NNG@$완화/NNG@$선호/NNG,-1,-0.2351157025522168,33,14,19,41,0.3325867024249658,0.5376867435988824
변동성/NNG@$크/VA@$확대/NNG,-1,-0.2351157025522168,33,14,19,41,0.3325867024249658,0.5376867435988824
메르스/NNG@$호흡기/NNG@$증후군/NNG,-1,-0.2351157025522168,33,14,19,49,0.3325867024249658,0.5376867435988824
심리/NNG@$나타내/VV@$소비자심리지수/NNG,-1,-0.2351157025522168,33,14,19,66,0.3325867024249658,0.5376867435988824
환매/NNG@$조건/NNG@$부채권/NNG@$금리/NNG,-1,-0.2351157025522168,33,14,19,38,0.3325867024249658,0.5376867435988824
조건/NNG@$부채권/NNG@$금리/NNG,-1,-0.2351157025522168,33,14,19,38,0.3325867024249658,0.5376867435988824
채권/NNG@$금리/NNG@$하락/NNG,-1,-0.23528916195089766,67,29,38,90,0.4445302503948155,0.7189274355697226
확장적/NNG@$거시/NNG@$정책/NNG,-1,-0.23528916195089766,67,29,38,90,0.4445302503948155,0.7189274355697226
수출/NNG@$기업/NNG@$채산성/NNG@$악화/NNG,0,-0.23746135704492088,24,10,14,30,0.2869141430084323,0.46615635369769376
시장/NNG@$영향/NNG@$크/VA@$않/VX,0,-0.23746135704492088,24,10,14,29,0.2869141430084323,0.46615635369769376
지수/NNG@$오른/VV@$거래/NNG,0,-0.23746135704492088,24,10,14,28,0.2869141430084323,0.46615635369769376
인상/NNG@$통화/NNG@$긴축/NNG,0,-0.23746135704492088,24,10,14,37,0.2869141430084323,0.46615635369769376
가격/NNG@$상승/NNG@$기대/NNG,0,-0.23746135704492088,24,10,14,42,0.2869141430084323,0.46615635369769376
대내외/NNG@$경제/NNG@$환경/NNG,0,-0.23746135704492088,24,10,14,29,0.2869141430084323,0.46615635369769376
상승/NNG@$가능성/NNG@$크/VA,0,-0.23746135704492088,24,10,14,36,0.2869141430084323,0.46615635369769376
압력/NNG@$기준금리/NNG@$인상/NNG,0,-0.23746135704492088,24,10,14,48,0.2869141430084323,0.46615635369769376
경제/NNG@$금융시장/NNG@$불안/NNG,0,-0.23746135704492088,24,10,14,32,0.2869141430084323,0.46615635369769376
외국인/NNG@$채권/NNG@$자금/NNG,0,-0.23746135704492088,24,10,14,22,0.2869141430084323,0.46615635369769376
지수/NNG@$오른/VV@$마감/NNG,-1,-0.23832717895796618,74,32,42,89,0.45536274931974435,0.7411964272397222
경제성장률/NNG@$물가/NNG@$상승률/NNG,-1,-0.23913243311287347,58,25,33,67,0.4210671993107324,0.6865434241892512
금리/NNG@$상승/NNG@$가계/NNG,-1,-0.24241161984986637,49,21,28,44,0.3923555736136579,0.6441933175774887
경기/NNG@$부양/NNG@$조치/NNG,-1,-0.24333076966674505,65,28,37,160,0.4351829545837309,0.7159053695642238
인플레이션/NNG@$상승/NNG@$압력/NNG,-1,-0.24333076966674505,65,28,37,114,0.4351829545837309,0.7159053695642238
경제/NNG@$구조적/NNG@$문제/NNG,-1,-0.2452012458692996,40,17,23,29,0.3577999178883854,0.5909484523459222
식품/NNG@$가격/NNG@$상승/NNG,-1,-0.2452012458692996,40,17,23,56,0.3577999178883854,0.5909484523459222
기준금리/NNG@$인상/NNG@$확률/NNG,-1,-0.2452012458692996,40,17,23,81,0.3577999178883854,0.5909484523459222
경제/NNG@$위기/NNG@$극복/NNG,-1,-0.24735226161265655,79,34,45,75,0.4566996310652684,0.7577510432719704
금리/NNG@$올리/VV@$시작/NNG,-1,-0.24806962429868873,56,24,32,52,0.41024615503055356,0.6817158710904738
소비자/NNG@$물가/NNG@$상승률/NNG@$목표/NNG,-1,-0.24833802675659733,31,13,18,47,0.3168738282220624,0.5268577644604788
금리/NNG@$인하/NNG@$있/VA,-1,-0.24833802675659733,31,13,18,47,0.3168738282220624,0.5268577644604788
소비자/NNG@$동향/NNG@$소비자심리지수/NNG,-1,-0.24833802675659733,31,13,18,39,0.3168738282220624,0.5268577644604788
결정/NNG@$쉽/VA@$않/VX,-1,-0.24833802675659733,31,13,18,27,0.3168738282220624,0.5268577644604788
금리/NNG@$인상/NNG@$지급준비율/NNG,-1,-0.24833802675659733,31,13,18,41,0.3168738282220624,0.5268577644604788
회복세/NNG@$지속/NNG@$예상/NNG,0,-0.2516067040311063,15,6,9,21,0.23205868622710968,0.38853438959878656
성장/NNG@$경로/NNG@$하방/NNG@$리스크/NNG,0,-0.2516067040311063,15,6,9,29,0.23205868622710968,0.38853438959878656
상승률/NNG@$중기/NNG@$물가/NNG@$목표/NNG,0,-0.2516067040311063,15,6,9,28,0.23205868622710968,0.38853438959878656
상품/NNG@$수지/NNG@$흑자/NNG,-1,-0.2517599364587718,63,27,36,55,0.4254438049094216,0.71255068312353
경제/NNG@$성장세/NNG@$둔화/NNG,-1,-0.2518790936524825,178,76,102,267,0.48358604472780947,0.810135541705635
경제/NNG@$완만/XR@$회복/NNG,-1,-0.2525063797568057,47,20,27,57,0.37989219288109993,0.6372728779488658
한계/NNG@$대출/NNG@$금리/NNG,-1,-0.2525063797568057,47,20,27,62,0.37989219288109993,0.6372728779488658
상승/NNG@$거래/NNG@$마쳤/VV,-1,-0.25442703730964733,91,39,52,118,0.46469976228654963,0.7827410520020479
물가/NNG@$오름세/NNG@$둔화/NNG,0,-0.25554620850828513,22,9,13,15,0.2686566948244429,0.4536090837001186
가격/NNG@$하락/NNG@$기록/NNG,0,-0.25554620850828513,22,9,13,46,0.2686566948244429,0.4536090837001186
시장/NNG@$교란/NNG@$요인/NNG,0,-0.25554620850828513,22,9,13,29,0.2686566948244429,0.4536090837001186
금리/NNG@$인상/NNG@$시기상조/NNG,0,-0.25554620850828513,22,9,13,47,0.2686566948244429,0.4536090837001186
금리/NNG@$인하/NNG@$물가/NNG,-1,-0.2569717975371597,38,16,22,34,0.3435203386893709,0.5817818574406487
장기금리/NNG@$단기금리/NNG@$등락/NNG,-1,-0.2569717975371597,38,16,22,143,0.3435203386893709,0.5817818574406487
금융시장/NNG@$금리/NNG@$인하/NNG,-1,-0.2569717975371597,38,16,22,51,0.3435203386893709,0.5817818574406487
단기금리/NNG@$등락/NNG@$장기금리/NNG@$국채/NNG,-1,-0.2569717975371597,38,16,22,143,0.3435203386893709,0.5817818574406487
금리/NNG@$인상/NNG@$통화/NNG,-1,-0.2569717975371597,38,16,22,50,0.3435203386893709,0.5817818574406487
가격/NNG@$하락/NNG@$물가/NNG,-1,-0.2569717975371597,38,16,22,40,0.3435203386893709,0.5817818574406487
인하/NNG@$가능성/NNG@$높/VA,-1,-0.25737565217972835,155,66,89,148,0.4791409811299226,0.8121686088111553
경제/NNG@$긍정적/NNG@$영향/NNG,-1,-0.2574934403800718,54,23,31,40,0.39898935926586887,0.6764779278817331
투자/NNG@$심리/NNG@$개선/NNG,-1,-0.2574934403800718,54,23,31,79,0.39898935926586887,0.6764779278817331
은행/NNG@$채권/NNG@$딜러/NNG,-1,-0.26004137459139576,96,41,55,102,0.4644467183782222,0.791766683907044
기술/NNG@$지수/NNG@$오른/VV@$마감/NNG,-1,-0.26060493363747417,61,26,35,57,0.41530268698367584,0.7088437316610953
금리/NNG@$인하/NNG@$않/VX,-1,-0.2627196678491417,75,32,43,81,0.44063246038001336,0.7554951144511337
축소/NNG@$자본/NNG@$유출/NNG,-1,-0.2630184895808212,29,12,17,24,0.30049749619090393,0.5155544104966769
양적/NNG@$질적/NNG@$금융완화/NNG,-1,-0.2630184895808212,29,12,17,24,0.30049749619090393,0.5155544104966769
경기/NNG@$둔화/NNG@$우려/NNG@$커지/VV,-1,-0.2630184895808212,29,12,17,40,0.30049749619090393,0.5155544104966769
부정적/NNG@$영향/NNG@$미쳤/VV,-1,-0.2630184895808212,29,12,17,38,0.30049749619090393,0.5155544104966769
경제/NNG@$성장세/NNG@$유지/NNG,-1,-0.2630184895808212,29,12,17,29,0.30049749619090393,0.5155544104966769
침체/NNG@$빠질/VV@$가능성/NNG,-1,-0.2630184895808212,29,12,17,35,0.30049749619090393,0.5155544104966769
정책/NNG@$효과/NNG@$극대화/NNG,-1,-0.2630184895808212,29,12,17,40,0.30049749619090393,0.5155544104966769
관리/NNG@$필요/NNG@$있/VA,-1,-0.2630184895808212,29,12,17,30,0.30049749619090393,0.5155544104966769
환율/NNG@$상승/NNG@$압력/NNG,-1,-0.2630184895808212,29,12,17,40,0.30049749619090393,0.5155544104966769
지수/NNG@$상승/NNG@$마감/NNG,-1,-0.2630184895808212,29,12,17,24,0.30049749619090393,0.5155544104966769
조치/NNG@$금리/NNG@$인하/NNG,-1,-0.2632557378553009,45,19,26,30,0.36694503765922737,0.6298770664693943
해외/NNG@$투자/NNG@$활성화/NNG,-1,-0.2632557378553009,45,19,26,67,0.36694503765922737,0.6298770664693943
안전자산/NNG@$선호/NNG@$심리/NNG,-1,-0.26744874677415353,52,22,30,53,0.3872856814280307,0.6708095944860026
하락/NNG@$물가/NNG@$상승/NNG,-1,-0.26744874677415353,52,22,30,40,0.3872856814280307,0.6708095944860026
은행/NNG@$자본/NNG@$확충/NNG,-1,-0.269730342320468,36,15,21,24,0.3286836408436006,0.572109470295827
양적완화/NNG@$정책/NNG@$종료/NNG,-1,-0.269730342320468,36,15,21,56,0.3286836408436006,0.572109470295827
모습/NNG@$보일/VV@$예상/NNG,-1,-0.269730342320468,36,15,21,32,0.3286836408436006,0.572109470295827
가계/NNG@$소비/NNG@$위축/NNG,-1,-0.269730342320468,36,15,21,18,0.3286836408436006,0.572109470295827
하락/NNG@$크/VA@$않/VX,-1,-0.269730342320468,36,15,21,17,0.3286836408436006,0.572109470295827
가능성/NNG@$높/VA@$금리/NNG@$인상/NNG,-1,-0.269730342320468,36,15,21,48,0.3286836408436006,0.572109470295827
인상/NNG@$하지/NNG@$않/VX,-1,-0.26989773066080025,59,25,34,76,0.40474937685432316,0.7047642257047769
기준금리/NNG@$인상/NNG@$기대/NNG,-1,-0.26989773066080025,59,25,34,81,0.40474937685432316,0.7047642257047769
금리/NNG@$인하/NNG@$기조/NNG,-1,-0.2702106827797456,118,50,68,62,0.4660707972494012,0.8120867113089454
성장/NNG@$하방/NNG@$위험/NNG,-1,-0.27391303724146165,92,39,53,185,0.45169282127891786,0.793345414176522
금리/NNG@$상승/NNG@$압력/NNG,-1,-0.27452472833489405,147,62,85,145,0.465966261270095,0.8194970655997396
주례/NNG@$경제/NNG@$동향/NNG,-1,-0.27474092311073717,43,18,25,51,0.353497825062453,0.6219887508380649
인상/NNG@$시장/NNG@$기대/NNG,0,-0.27704680674997584,20,8,12,28,0.24921475874167176,0.44069158747535353
경기/NNG@$확장/NNG@$위축/NNG,0,-0.27704680674997584,20,8,12,35,0.24921475874167176,0.44069158747535353
금융/NNG@$위기/NNG@$직전/NNG,0,-0.27704680674997584,20,8,12,46,0.24921475874167176,0.44069158747535353
기준금리/NNG@$인상/NNG@$없/VA,0,-0.27704680674997584,20,8,12,57,0.24921475874167176,0.44069158747535353
필요/NNG@$있/VA@$물가/NNG,0,-0.27704680674997584,20,8,12,24,0.24921475874167176,0.44069158747535353
금리/NNG@$인상/NNG@$점진적/NNG,-1,-0.27798804811042543,50,21,29,69,0.37512314403206204,0.6646906122521392
하락/NNG@$소비자/NNG@$물가/NNG,-1,-0.27798804811042543,50,21,29,43,0.37512314403206204,0.6646906122521392
지수/NNG@$떨어진/VV@$기록/NNG,-1,-0.279521065470675,27,11,16,46,0.2833679778105651,0.5037771120093083
자금/NNG@$이탈/NNG@$우려/NNG,-1,-0.279521065470675,27,11,16,36,0.2833679778105651,0.5037771120093083
금리/NNG@$인상/NNG@$여파/NNG,-1,-0.279521065470675,27,11,16,52,0.2833679778105651,0.5037771120093083
물가/NNG@$압력/NNG@$높/VA,-1,-0.279521065470675,27,11,16,26,0.2833679778105651,0.5037771120093083
금융시장/NNG@$불안/NNG@$경제/NNG,-1,-0.279521065470675,27,11,16,23,0.2833679778105651,0.5037771120093083
외국인/NNG@$자본/NNG@$유출/NNG,-1,-0.279521065470675,27,11,16,49,0.2833679778105651,0.5037771120093083
둔화/NNG@$모습/NNG@$보이/VV,-1,-0.279521065470675,27,11,16,32,0.2833679778105651,0.5037771120093083
회복/NNG@$지연/NNG@$우려/NNG,-1,-0.279521065470675,27,11,16,25,0.2833679778105651,0.5037771120093083
소비자/NNG@$물가/NNG@$전망/NNG,-1,-0.279521065470675,27,11,16,31,0.2833679778105651,0.5037771120093083
차지/NNG@$비중/NNG@$높/VA,-1,-0.279521065470675,27,11,16,29,0.2833679778105651,0.5037771120093083
경제/NNG@$전망/NNG@$성장/NNG,-1,-0.279521065470675,27,11,16,35,0.2833679778105651,0.5037771120093083
곡물/NNG@$가격/NNG@$급등/NNG,-1,-0.279521065470675,27,11,16,41,0.2833679778105651,0.5037771120093083
원리금/NNG@$상환/NNG@$부담/NNG,-1,-0.2800731634661463,64,27,37,80,0.40970196551457927,0.7292481694341845
경기/NNG@$부양/NNG@$필요/NNG,-1,-0.28365446316385345,34,14,20,40,0.31325170269009234,0.5619216224671871
경제/NNG@$성장/NNG@$엔진/NNG,-1,-0.28365446316385345,34,14,20,48,0.31325170269009234,0.5619216224671871
하락/NNG@$환율/NNG@$상승/NNG,-1,-0.28365446316385345,34,14,20,31,0.31325170269009234,0.5619216224671871
개선/NNG@$경기/NNG@$회복/NNG,-1,-0.28365446316385345,34,14,20,58,0.31325170269009234,0.5619216224671871
가격/NNG@$하락/NNG@$경기/NNG,-1,-0.28365446316385345,34,14,20,27,0.31325170269009234,0.5619216224671871
신용등급/NNG@$하향/NNG@$조정/NNG,-1,-0.28365446316385345,34,14,20,40,0.31325170269009234,0.5619216224671871
기준금리/NNG@$인하/NNG@$필요성/NNG,-1,-0.28365446316385345,34,14,20,75,0.31325170269009234,0.5619216224671871
기준금리/NNG@$인하/NNG@$전망/NNG,-1,-0.283903302162797,143,60,83,193,0.45873428785735626,0.8233382405460626
금융/NNG@$위기/NNG@$경기/NNG,-1,-0.2840000079115166,83,35,48,67,0.4364006988567873,0.7834184118536004
소매/NNG@$판매/NNG@$지표/NNG,0,-0.2863537556647656,13,5,8,54,0.20796407290535665,0.37524883304992784
유로/NNG@$유로존/NNG@$재무/NNG,0,-0.2863537556647656,13,5,8,39,0.20796407290535665,0.37524883304992784
불안/NNG@$금리/NNG@$인상/NNG,-1,-0.286440549031157,76,32,44,73,0.42615554166759806,0.7690971456743192
지속/NNG@$가능/NNG@$성장/NNG,-1,-0.289119593844715,100,42,58,149,0.44587822150574286,0.80940022506809
소비자/NNG@$물가/NNG@$상승률/NNG@$전망/NNG,-1,-0.28917344824469304,48,20,28,66,0.3624884750882672,0.658100538838392
기준금리/NNG@$올릴/VV@$가능성/NNG,-1,-0.28917344824469304,48,20,28,69,0.3624884750882672,0.658100538838392
경제/NNG@$좋/VA@$않/VX,-1,-0.2899778634270851,55,23,32,84,0.38236399706054863,0.6954033218762288
확대/NNG@$금리/NNG@$인하/NNG,-1,-0.2899778634270851,55,23,32,58,0.38236399706054863,0.6954033218762288
인플레/NNG@$압력/NNG@$높/VA,-1,-0.2899778634270851,55,23,32,67,0.38236399706054863,0.6954033218762288
기준금리/NNG@$인하/NNG@$기대감/NNG,-1,-0.295162847187429,74,31,43,136,0.4174703554363353,0.7678998932414544
상품/NNG@$가격/NNG@$상승/NNG,-1,-0.29773560248454267,67,28,39,104,0.40427873326833136,0.7478368230387703
통화/NNG@$완화/NNG@$조치/NNG,0,-0.29836201688320396,25,10,15,58,0.26535339177883943,0.49152657767126406
가능성/NNG@$무게/NNG@$실리/VV,0,-0.29836201688320396,25,10,15,25,0.26535339177883943,0.49152657767126406
대출/NNG@$금리/NNG@$예금금리/NNG,0,-0.29836201688320396,25,10,15,30,0.26535339177883943,0.49152657767126406
상승/NNG@$속도/NNG@$둔화/NNG,0,-0.29836201688320396,25,10,15,28,0.26535339177883943,0.49152657767126406
실업/NNG@$보험/NNG@$청구자/NNG,0,-0.29836201688320396,25,10,15,33,0.26535339177883943,0.49152657767126406
제품/NNG@$가격/NNG@$경쟁력/NNG,0,-0.29836201688320396,25,10,15,38,0.26535339177883943,0.49152657767126406
가능성/NNG@$크/VA@$내/VX,0,-0.29836201688320396,25,10,15,49,0.26535339177883943,0.49152657767126406
내수/NNG@$부진/NNG@$지속/NNG,0,-0.29836201688320396,25,10,15,30,0.26535339177883943,0.49152657767126406
가격/NNG@$상승세/NNG@$둔화/NNG,0,-0.29836201688320396,25,10,15,38,0.26535339177883943,0.49152657767126406
경기/NNG@$부양책/NNG@$필요/NNG,0,-0.29836201688320396,25,10,15,31,0.26535339177883943,0.49152657767126406
테이퍼링/NNG@$자산/NNG@$매입/NNG@$축소/NNG,-1,-0.29897758702063915,32,13,19,52,0.2971721186697685,0.5512095710837412
금리/NNG@$인상/NNG@$정당화/NNG,-1,-0.29897758702063915,32,13,19,31,0.2971721186697685,0.5512095710837412
금리/NNG@$인상/NNG@$서두/NNG,-1,-0.29897758702063915,32,13,19,24,0.2971721186697685,0.5512095710837412
유로존/NNG@$소비자/NNG@$물가/NNG,-1,-0.29897758702063915,32,13,19,62,0.2971721186697685,0.5512095710837412
주택담보대출비율/NNG@$부채/NNG@$상환/NNG,-1,-0.29897758702063915,32,13,19,34,0.2971721186697685,0.5512095710837412
경기/NNG@$하강/NNG@$국면/NNG,-1,-0.29969305683311676,60,25,35,58,0.388720073496227,0.7221500342698697
물가/NNG@$불안/NNG@$요인/NNG,-1,-0.29969305683311676,60,25,35,76,0.388720073496227,0.7221500342698697
기준금리/NNG@$무담보/NNG@$콜론/NNG,-1,-0.30034226692173605,39,16,23,71,0.3250182436153067,0.6046681929486619
시장/NNG@$금리/NNG@$기준금리/NNG,-1,-0.30034226692173605,39,16,23,41,0.3250182436153067,0.6046681929486619
경기/NNG@$부양/NNG@$노력/NNG,-1,-0.30034226692173605,39,16,23,63,0.3250182436153067,0.6046681929486619
상회/NNG@$증가세/NNG@$갔/VV,-1,-0.30034226692173605,39,16,23,21,0.3250182436153067,0.6046681929486619
국채/NNG@$가격/NNG@$상승/NNG,-1,-0.30034226692173605,39,16,23,32,0.3250182436153067,0.6046681929486619
기준금리/NNG@$인하/NNG@$예상/NNG,-1,-0.30064685004907055,91,38,53,122,0.4319991490184817,0.8042345727878386
지수/NNG@$높/VA@$기술/NNG,-1,-0.30085556940522673,53,22,31,52,0.3705096272294225,0.6900783799502208
시장/NNG@$국채/NNG@$가격/NNG,-1,-0.3010792464059596,46,19,27,65,0.34936649344524207,0.6510188280472748
도시/NNG@$주택/NNG@$가격/NNG,-1,-0.3010792464059596,46,19,27,75,0.34936649344524207,0.6510188280472748
생산/NNG@$소매/NNG@$판매/NNG,-1,-0.3010792464059596,46,19,27,45,0.34936649344524207,0.6510188280472748
전망치/NNG@$하향/NNG@$조정/NNG,-1,-0.3018795072362259,340,141,199,538,0.44596127823507253,0.8324786558606297
영향력/NNG@$크/VA@$않/VX,0,-0.30344531013339404,18,7,11,41,0.22817766990165797,0.42740978215892367
무담보/NNG@$콜론/NNG@$금리/NNG@$동결/NNG,0,-0.30344531013339404,18,7,11,45,0.22817766990165797,0.42740978215892367
국채/NNG@$매입/NNG@$재개/NNG,0,-0.30344531013339404,18,7,11,99,0.22817766990165797,0.42740978215892367
경제/NNG@$전망/NNG@$낙관적/NNG,0,-0.30344531013339404,18,7,11,32,0.22817766990165797,0.42740978215892367
활용/NNG@$필요/NNG@$있/VA,0,-0.30344531013339404,18,7,11,33,0.22817766990165797,0.42740978215892367
시장/NNG@$예상/NNG@$일치/NNG,0,-0.30344531013339404,18,7,11,37,0.22817766990165797,0.42740978215892367
지수/NNG@$최고치/NNG@$기록/NNG,0,-0.30344531013339404,18,7,11,43,0.22817766990165797,0.42740978215892367
경제정책/NNG@$방향/NNG@$성장률/NNG,0,-0.30344531013339404,18,7,11,32,0.22817766990165797,0.42740978215892367
금리/NNG@$인상/NNG@$속도/NNG@$완만/XR,0,-0.30344531013339404,18,7,11,34,0.22817766990165797,0.42740978215892367
경제/NNG@$성장/NNG@$제약/NNG,0,-0.30344531013339404,18,7,11,37,0.22817766990165797,0.42740978215892367
금융/NNG@$경제/NNG@$부장/NNG,0,-0.30344531013339404,18,7,11,36,0.22817766990165797,0.42740978215892367
가능성/NNG@$유의/NNG@$필요/NNG@$있/VA,0,-0.30344531013339404,18,7,11,12,0.22817766990165797,0.42740978215892367
국제금융시장/NNG@$불안/NNG@$요인/NNG,0,-0.30344531013339404,18,7,11,27,0.22817766990165797,0.42740978215892367
콜론/NNG@$금리/NNG@$동결/NNG,0,-0.30344531013339404,18,7,11,46,0.22817766990165797,0.42740978215892367
경기/NNG@$회복/NNG@$뒷받침/NNG,-1,-0.3060860605189034,140,58,82,114,0.4419270469999348,0.8326210809007168
고고/NNG@$미사일/NNG@$방어/NNG@$체계/NNG,-1,-0.3075179015208206,65,27,38,73,0.3942557492166298,0.7451540914960624
자국/NNG@$통화/NNG@$가치/NNG,-1,-0.3115234440838236,94,39,55,129,0.4263580136203138,0.8129907448469287
가능성/NNG@$금리/NNG@$인하/NNG,-1,-0.3136709327817433,82,34,48,61,0.41490140001781356,0.7949152837379162
자본/NNG@$유출/NNG@$가능성/NNG,-1,-0.31377234149341393,70,29,41,120,0.3990403872263773,0.7646987478991187
금리/NNG@$인하/NNG@$가능성/NNG@$낮/VA,-1,-0.3137954111470468,44,18,26,50,0.33573927302351153,0.6434249106971652
달러/NNG@$원/NNG@$환율하락/NNG,-1,-0.3137954111470468,44,18,26,62,0.33573927302351153,0.6434249106971652
경기/NNG@$부양/NNG@$정책/NNG,-1,-0.31406076749636835,148,61,87,221,0.43628669790668306,0.8366100334708511
원자재/NNG@$가격/NNG@$급등/NNG,-1,-0.31463897326155654,126,52,74,133,0.4343713654050943,0.8340054680835753
경기/NNG@$둔화/NNG@$속도/NNG,-1,-0.31473992540362494,37,15,22,34,0.30992808053542525,0.595204000916235
조정/NNG@$여부/NNG@$결정/NNG,-1,-0.31473992540362494,37,15,22,21,0.30992808053542525,0.595204000916235
사상/NNG@$최저/NNG@$금리/NNG,-1,-0.31473992540362494,37,15,22,45,0.30992808053542525,0.595204000916235
위험/NNG@$요인/NNG@$경제/NNG,-1,-0.31473992540362494,37,15,22,40,0.30992808053542525,0.595204000916235
은행/NNG@$주택/NNG@$담보대출/NNG,-1,-0.3160129517485253,30,12,18,30,0.2803719376405019,0.5399652665294059
금리/NNG@$정상화/NNG@$속도/NNG,-1,-0.3160129517485253,30,12,18,40,0.2803719376405019,0.5399652665294059
체감/NNG@$경기/NNG@$회복/NNG,-1,-0.3160129517485253,30,12,18,58,0.2803719376405019,0.5399652665294059
고려/NNG@$기준금리/NNG@$인하/NNG,-1,-0.3160129517485253,30,12,18,38,0.2803719376405019,0.5399652665294059
엔/NNG@$원/NNG@$재정환율/NNG,-1,-0.3160129517485253,30,12,18,32,0.2803719376405019,0.5399652665294059
성장/NNG@$지속/NNG@$물가/NNG@$유지/NNG,-1,-0.3160129517485253,30,12,18,26,0.2803719376405019,0.5399652665294059
증시/NNG@$금리/NNG@$인상/NNG,-1,-0.3160129517485253,30,12,18,59,0.2803719376405019,0.5399652665294059
금리/NNG@$인상/NNG@$인플레/NNG,-1,-0.3160129517485253,30,12,18,50,0.2803719376405019,0.5399652665294059
필요/NNG@$있/VA@$경제/NNG,-1,-0.3160129517485253,30,12,18,34,0.2803719376405019,0.5399652665294059
지속/NNG@$물가/NNG@$유지/NNG,-1,-0.3160129517485253,30,12,18,26,0.2803719376405019,0.5399652665294059
인상/NNG@$달러/NNG@$강세/NNG,-1,-0.31776936459953686,63,26,37,62,0.3838398916656156,0.7421218641245585
달러/NNG@$원/NNG@$환율/NNG@$상승/NNG,-1,-0.31776936459953686,63,26,37,69,0.3838398916656156,0.7421218641245585
금리/NNG@$인하/NNG@$카드/NNG,-1,-0.3197859741217437,119,49,70,122,0.42952643470375573,0.8341850001734551
은행/NNG@$금융정책/NNG@$결정/NNG@$열/VV,0,-0.3202964264010002,23,9,14,30,0.2462581057320454,0.47880246812448585
달러/NNG@$원/NNG@$상승/NNG,0,-0.3202964264010002,23,9,14,29,0.2462581057320454,0.47880246812448585
금리/NNG@$사상/NNG@$최저치/NNG,0,-0.3202964264010002,23,9,14,37,0.2462581057320454,0.47880246812448585
금리/NNG@$인하/NNG@$이뤄질/VV,0,-0.3202964264010002,23,9,14,31,0.2462581057320454,0.47880246812448585
안정적/NNG@$경제/NNG@$성장/NNG,0,-0.3202964264010002,23,9,14,27,0.2462581057320454,0.47880246812448585
확대/NNG@$가능성/NNG@$크/VA,0,-0.3202964264010002,23,9,14,40,0.2462581057320454,0.47880246812448585
가격/NNG@$낮/VA@$진/VX,0,-0.3202964264010002,23,9,14,29,0.2462581057320454,0.47880246812448585
지수/NNG@$사상/NNG@$최고치/NNG,0,-0.3202964264010002,23,9,14,45,0.2462581057320454,0.47880246812448585
소매/NNG@$판매/NNG@$부진/NNG,0,-0.3202964264010002,23,9,14,29,0.2462581057320454,0.47880246812448585
하향/NNG@$조정/NNG@$예상/NNG,0,-0.3202964264010002,23,9,14,39,0.2462581057320454,0.47880246812448585
산업/NNG@$생산/NNG@$소매/NNG@$판매/NNG,0,-0.3202964264010002,23,9,14,32,0.2462581057320454,0.47880246812448585
인하/NNG@$단행/NNG@$예상/NNG,0,-0.3202964264010002,23,9,14,32,0.2462581057320454,0.47880246812448585
소비자/NNG@$물가/NNG@$기준/NNG,0,-0.3202964264010002,23,9,14,31,0.2462581057320454,0.47880246812448585
공급/NNG@$관리/NNG@$제조업/NNG@$지수/NNG,-1,-0.32138552385904284,56,23,33,53,0.36606381135568644,0.7134702826869546
규모/NNG@$경기/NNG@$부양책/NNG,-1,-0.32450895715216066,107,44,63,92,0.423108771190751,0.8304171507472037
민간/NNG@$소비/NNG@$회복/NNG,-1,-0.32457222432244626,49,20,29,98,0.34541505628078767,0.6780268518135302
하방/NNG@$리스크/NNG@$크/VA,-1,-0.3274322779616574,42,17,25,23,0.3215850153687798,0.6352982705157963
기준금리/NNG@$올릴/VV@$전망/NNG,-1,-0.3274322779616574,42,17,25,55,0.3215850153687798,0.6352982705157963
신경/NNG@$쓰/VV@$않/VX,-1,-0.3274322779616574,42,17,25,44,0.3215850153687798,0.6352982705157963
금리/NNG@$올릴/VV@$전망/NNG,-1,-0.32852540154848264,61,25,36,82,0.3730214760611845,0.7387174035802636
금리/NNG@$인상/NNG@$관측/NNG,-1,-0.32852540154848264,61,25,36,82,0.3730214760611845,0.7387174035802636
금융/NNG@$위기/NNG@$극복/NNG,-1,-0.32930999808735906,137,56,81,132,0.4243887749394333,0.8419215318207024
기준금리/NNG@$인하/NNG@$효과/NNG,-1,-0.3296672321047772,95,39,56,133,0.41405034696083304,0.8220694990542342
국고채/NNG@$금리/NNG@$상승/NNG,-1,-0.3304568528826728,35,14,21,47,0.294217074433709,0.5851834380468691
채권/NNG@$금리/NNG@$인상/NNG,-1,-0.3304568528826728,35,14,21,35,0.294217074433709,0.5851834380468691
인상/NNG@$가능/NNG@$전망/NNG,-1,-0.3304568528826728,35,14,21,32,0.294217074433709,0.5851834380468691
통화정책/NNG@$기조/NNG@$변화/NNG,-1,-0.33274211864297465,110,45,65,75,0.4180025052861377,0.8356617176230544
금리/NNG@$인상/NNG@$근거/NNG,-1,-0.3331248103139588,54,22,32,67,0.3540804653512479,0.7084789879873576
금리/NNG@$인상/NNG@$기조/NNG@$유지/NNG,-1,-0.3331248103139588,54,22,32,59,0.3540804653512479,0.7084789879873576
청/NNG@$원유/NNG@$재고/NNG,-1,-0.3331248103139588,54,22,32,78,0.3540804653512479,0.7084789879873576
에너지/NNG@$청/NNG@$원유/NNG@$재고/NNG,-1,-0.3331248103139588,54,22,32,78,0.3540804653512479,0.7084789879873576
상승률/NNG@$낮/VA@$물가/NNG,-1,-0.33519031351623785,28,11,17,22,0.26274868845523486,0.5281808948266573
대외/NNG@$의존도/NNG@$높/VA@$경제/NNG,-1,-0.33519031351623785,28,11,17,36,0.26274868845523486,0.5281808948266573
경제/NNG@$성장/NNG@$우려/NNG,-1,-0.33519031351623785,28,11,17,34,0.26274868845523486,0.5281808948266573
경상수지/NNG@$흑자/NNG@$기록/NNG,-1,-0.33519031351623785,28,11,17,28,0.26274868845523486,0.5281808948266573
긍정적/NNG@$영향/NNG@$미쳤/VV,-1,-0.33519031351623785,28,11,17,36,0.26274868845523486,0.5281808948266573
고용/NNG@$지표/NNG@$악화/NNG,-1,-0.33519031351623785,28,11,17,37,0.26274868845523486,0.5281808948266573
가능성/NNG@$높/VA@$전망/NNG,-1,-0.33608938070142347,145,59,86,154,0.41969995328808524,0.8453957160610099
유로존/NNG@$산업/NNG@$생산/NNG,0,-0.33713308137696263,11,4,7,40,0.17916483369314457,0.36173875430426783
미국채/NNG@$금리/NNG@$상승/NNG,0,-0.33713308137696263,11,4,7,39,0.17916483369314457,0.36173875430426783
시장/NNG@$금리/NNG@$오르/VV,0,-0.33713308137696263,11,4,7,38,0.17916483369314457,0.36173875430426783
정상화/NNG@$기조/NNG@$유지/NNG,0,-0.3372488990994347,16,6,10,36,0.20487602813531736,0.41375835708032077
확장/NNG@$국면/NNG@$진입/NNG,0,-0.3372488990994347,16,6,10,33,0.20487602813531736,0.41375835708032077
근거/NNG@$금리/NNG@$인상/NNG,0,-0.3372488990994347,16,6,10,43,0.20487602813531736,0.41375835708032077
가격/NNG@$상승/NNG@$주택/NNG,0,-0.3372488990994347,16,6,10,27,0.20487602813531736,0.41375835708032077
인하/NNG@$가능성/NNG@$있/VA,-1,-0.3375584780835825,47,19,28,61,0.33214531235946126,0.6712539149859149
금리/NNG@$인상/NNG@$나설/VV@$가능성/NNG,-1,-0.3398263130854876,59,24,35,61,0.3617905858994498,0.7349170384093369
콜금리/NNG@$인하/NNG@$가능성/NNG,-1,-0.3421269702191506,40,16,24,38,0.30687653947759796,0.6266185062225574
금리/NNG@$인하/NNG@$시그널/NNG,-1,-0.3421269702191506,40,16,24,56,0.30687653947759796,0.6266185062225574
물가/NNG@$상승률/NNG@$크/VA,-1,-0.3421269702191506,40,16,24,49,0.30687653947759796,0.6266185062225574
통화정책/NNG@$금리/NNG@$동결/NNG,-1,-0.3421269702191506,40,16,24,40,0.30687653947759796,0.6266185062225574
금리/NNG@$인상/NNG@$나설/VV@$전망/NNG,-1,-0.3421269702191506,40,16,24,39,0.30687653947759796,0.6266185062225574
전망/NNG@$하향/NNG@$조정/NNG,-1,-0.34426483969852817,319,129,190,427,0.4141678768779111,0.8498029289819691
투자자들/NNG@$금리/NNG@$인상/NNG,-1,-0.34498860568152656,64,26,38,83,0.3686114125424588,0.7575705821743425
경기/NNG@$둔화/NNG@$금리/NNG@$인상/NNG,-1,-0.34553667601881677,52,21,31,73,0.34164421122011507,0.7030208553016121
경기/NNG@$둔화/NNG@$위험/NNG,-1,-0.34553667601881677,52,21,31,50,0.34164421122011507,0.7030208553016121
금리/NNG@$인하/NNG@$할/VV,-1,-0.34553667601881677,52,21,31,48,0.34164421122011507,0.7030208553016121
시장/NNG@$인상/NNG@$가능성/NNG,0,-0.34646655932354065,21,8,13,29,0.22578937777102176,0.46560116857650297
금리/NNG@$상승/NNG@$영향/NNG,0,-0.34646655932354065,21,8,13,24,0.22578937777102176,0.46560116857650297
수출/NNG@$부진/NNG@$경기/NNG,0,-0.34646655932354065,21,8,13,26,0.22578937777102176,0.46560116857650297
상승세/NNG@$보일/VV@$전망/NNG,0,-0.34646655932354065,21,8,13,30,0.22578937777102176,0.46560116857650297
사태/NNG@$금융/NNG@$위기/NNG,0,-0.34646655932354065,21,8,13,23,0.22578937777102176,0.46560116857650297
정책/NNG@$경기/NNG@$회복/NNG,0,-0.34646655932354065,21,8,13,28,0.22578937777102176,0.46560116857650297
국가신용등급/NNG@$상향/NNG@$조정/NNG,0,-0.34646655932354065,21,8,13,65,0.22578937777102176,0.46560116857650297
부진/NNG@$경제/NNG@$성장/NNG,0,-0.34646655932354065,21,8,13,31,0.22578937777102176,0.46560116857650297
금리/NNG@$상승/NNG@$제한/NNG,0,-0.34646655932354065,21,8,13,33,0.22578937777102176,0.46560116857650297
성장률/NNG@$전망/NNG@$하향/NNG@$조정/NNG,-1,-0.34774255534697196,101,41,60,128,0.4040725113057663,0.8356577903936399
채권/NNG@$시장/NNG@$약세/NNG,-1,-0.34775756089565235,33,13,20,75,0.2778276110478818,0.5745917321526255
기준금리/NNG@$인상/NNG@$동결/NNG,-1,-0.34775756089565235,33,13,20,63,0.2778276110478818,0.5745917321526255
사상/NNG@$최저치/NNG@$기록/NNG,-1,-0.34775756089565235,33,13,20,36,0.2778276110478818,0.5745917321526255
투자/NNG@$내수/NNG@$부진/NNG,-1,-0.34775756089565235,33,13,20,8,0.2778276110478818,0.5745917321526255
금리/NNG@$인상/NNG@$위안화/NNG@$절상/NNG,-1,-0.34775756089565235,33,13,20,62,0.2778276110478818,0.5745917321526255
소비자/NNG@$물가/NNG@$상승률/NNG@$예상/NNG,-1,-0.34775756089565235,33,13,20,30,0.2778276110478818,0.5745917321526255
성장률/NNG@$물가/NNG@$상승률/NNG,-1,-0.34775756089565235,33,13,20,65,0.2778276110478818,0.5745917321526255
기미/NNG@$보이/VV@$않/VX,-1,-0.34779291973933246,116,47,69,158,0.4083470653876971,0.8445946036501655
하향/NNG@$조정/NNG@$가능성/NNG,-1,-0.3478778946285497,111,45,66,145,0.4072082774992904,0.8424018773616104
더블딥/NNG@$이중/NNG@$침체/NNG,-1,-0.3488750563496712,69,28,41,120,0.3746137238708184,0.7767315978588639
금리/NNG@$인하/NNG@$효과/NNG,-1,-0.3490445877601691,372,150,222,368,0.41059921267779903,0.8516729779873476
채권/NNG@$시장/NNG@$국채/NNG@$가격/NNG,-1,-0.3514202848371749,45,18,27,59,0.31837018517363497,0.6639513975386527
가능성/NNG@$높/VA@$관측/NNG,-1,-0.3514202848371749,45,18,27,57,0.31837018517363497,0.6639513975386527
금리/NNG@$인상/NNG@$하지/NNG@$않/VX,-1,-0.3514202848371749,45,18,27,57,0.31837018517363497,0.6639513975386527
물가/NNG@$안정세/NNG@$유지/NNG,-1,-0.35171831082650795,57,23,34,33,0.35013693084821207,0.7306961684322285
관리/NNG@$제조업/NNG@$지수/NNG,-1,-0.35171831082650795,57,23,34,63,0.35013693084821207,0.7306961684322285
금리/NNG@$인하/NNG@$나서/VV,-1,-0.3536874099931784,79,32,47,84,0.38444730180811687,0.805910246374728
기준금리/NNG@$인하/NNG@$단행/NNG,-1,-0.35640092135130785,62,25,37,84,0.3576899986598816,0.7544843877187357
시장/NNG@$예상/NNG@$뛰어넘/VV,-1,-0.3571133910510347,26,10,16,56,0.24415753488781364,0.5158480829482893
예상/NNG@$좋/VA@$않/VX,-1,-0.3571133910510347,26,10,16,33,0.24415753488781364,0.5158480829482893
예상/NNG@$크/VA@$벗어나/VV@$않/VX,-1,-0.3571133910510347,26,10,16,36,0.24415753488781364,0.5158480829482893
가능성/NNG@$없/VA@$않/VX,-1,-0.3571133910510347,26,10,16,29,0.24415753488781364,0.5158480829482893
인하/NNG@$효과/NNG@$나타나/VV,-1,-0.3571133910510347,26,10,16,27,0.24415753488781364,0.5158480829482893
하락/NNG@$물가/NNG@$상승률/NNG,-1,-0.3571133910510347,26,10,16,31,0.24415753488781364,0.5158480829482893
경제/NNG@$전망/NNG@$내놓/VV,-1,-0.3571133910510347,26,10,16,43,0.24415753488781364,0.5158480829482893
장기/NNG@$채권/NNG@$금리/NNG,-1,-0.3571133910510347,26,10,16,46,0.24415753488781364,0.5158480829482893
금리/NNG@$인하/NNG@$추경/NNG,-1,-0.3571133910510347,26,10,16,40,0.24415753488781364,0.5158480829482893
부동산/NNG@$문제/NNG@$심각/XR,-1,-0.35805227107002724,38,15,23,34,0.2915792743026793,0.6173653672394425
정책/NNG@$목표/NNG@$달성/NNG,-1,-0.35805227107002724,38,15,23,46,0.2915792743026793,0.6173653672394425
문제/NNG@$해결/NNG@$않/VX,-1,-0.35805227107002724,38,15,23,43,0.2915792743026793,0.6173653672394425
경기/NNG@$살아나/VV@$않/VX,-1,-0.35805227107002724,38,15,23,41,0.2915792743026793,0.6173653672394425
금리/NNG@$인하/NNG@$논의/NNG,-1,-0.35805227107002724,38,15,23,38,0.2915792743026793,0.6173653672394425
의존도/NNG@$높/VA@$경제/NNG,-1,-0.35805227107002724,38,15,23,46,0.2915792743026793,0.6173653672394425
금융시장/NNG@$불안/NNG@$경기/NNG,-1,-0.3586919804719789,50,20,30,29,0.32874141729872364,0.6970706216622764
불확실성/NNG@$높/VA@$진/VX,-1,-0.3586919804719789,50,20,30,46,0.32874141729872364,0.6970706216622764
미사일/NNG@$방어/NNG@$체계/NNG,-1,-0.35983803439333817,67,27,40,76,0.3643753007818432,0.7746630974223376
회복세/NNG@$지속/NNG@$전망/NNG,-1,-0.35983803439333817,67,27,40,72,0.3643753007818432,0.7746630974223376
인상/NNG@$나설/VV@$가능성/NNG,-1,-0.36381650866475357,77,31,46,84,0.3754340793136197,0.805506424531353
자금/NNG@$유출/NNG@$우려/NNG,-1,-0.3642548028398197,55,22,33,63,0.3380496563447555,0.7260292784743343
이상/NNG@$금리/NNG@$인하/NNG,-1,-0.3642548028398197,55,22,33,41,0.3380496563447555,0.7260292784743343
매파/NNG@$통화/NNG@$긴축/NNG@$선호/NNG,-1,-0.36627602558313466,43,17,26,78,0.30406743264828334,0.6560953753714642
불안/NNG@$심리/NNG@$확산/NNG,-1,-0.36627602558313466,43,17,26,22,0.30406743264828334,0.6560953753714642
공급/NNG@$제조업/NNG@$지수/NNG,-1,-0.36699429602908396,31,12,19,41,0.2606819193844677,0.5634143025409991
양적완화/NNG@$축소/NNG@$테이퍼링/NNG,-1,-0.36699429602908396,31,12,19,51,0.2606819193844677,0.5634143025409991
문제/NNG@$금리/NNG@$인하/NNG,-1,-0.36699429602908396,31,12,19,28,0.2606819193844677,0.5634143025409991
소비/NNG@$심리/NNG@$위축/NNG,-1,-0.3670837630697048,183,73,110,174,0.39711693544878246,0.8584698857699926
통화정책/NNG@$기준금리/NNG@$인하/NNG,-1,-0.36838156132560484,60,24,36,81,0.34636411501442077,0.7510026699171147
거시/NNG@$건전성/NNG@$정책/NNG,-1,-0.36838156132560484,60,24,36,178,0.34636411501442077,0.7510026699171147
유동성/NNG@$공급/NNG@$조치/NNG,-1,-0.3713093325290552,65,26,39,76,0.35375893727552676,0.7722508857841903
국채/NNG@$금리/NNG@$하락/NNG,-1,-0.3713093325290552,65,26,39,141,0.35375893727552676,0.7722508857841903
인플레이션/NNG@$압력/NNG@$완화/NNG,-1,-0.3716505381421924,105,42,63,102,0.3883108638688836,0.8483477806180453
달러/NNG@$가치/NNG@$하락/NNG,-1,-0.37436635033128773,75,30,45,78,0.3660903382692736,0.8048584112820679
주택/NNG@$담보대출/NNG@$금리/NNG,-1,-0.3747841541213237,85,34,51,90,0.37562372130468447,0.8266198716375154
구조적/NNG@$문제/NNG@$해결/NNG,-1,-0.3754290116248088,36,14,22,53,0.27564861704295307,0.6075187456353174
지금/NNG@$금리/NNG@$인상/NNG,-1,-0.3754290116248088,36,14,22,36,0.27564861704295307,0.6075187456353174
달러/NNG@$환율/NNG@$상승/NNG,-1,-0.3754290116248088,36,14,22,46,0.27564861704295307,0.6075187456353174
외국/NNG@$자본/NNG@$유입/NNG,-1,-0.3754290116248088,36,14,22,46,0.27564861704295307,0.6075187456353174
동결/NNG@$자산/NNG@$매입/NNG,0,-0.3786641199955796,19,7,12,65,0.20350658781845402,0.4519121263841695
완화적/NNG@$통화정책/NNG@$지속/NNG,0,-0.3786641199955796,19,7,12,20,0.20350658781845402,0.4519121263841695
경기/NNG@$둔화/NNG@$국면/NNG,0,-0.3786641199955796,19,7,12,35,0.20350658781845402,0.4519121263841695
거시/NNG@$금융/NNG@$경제/NNG,0,-0.3786641199955796,19,7,12,33,0.20350658781845402,0.4519121263841695
농산물/NNG@$가격/NNG@$급등/NNG,0,-0.3786641199955796,19,7,12,40,0.20350658781845402,0.4519121263841695
인상/NNG@$사이클/NNG@$종료/NNG,0,-0.3786641199955796,19,7,12,31,0.20350658781845402,0.4519121263841695
금리/NNG@$인상/NNG@$소수/NNG@$의견/NNG,0,-0.3786641199955796,19,7,12,31,0.20350658781845402,0.4519121263841695
경제/NNG@$불확실성/NNG@$커지/VV,0,-0.3786641199955796,19,7,12,33,0.20350658781845402,0.4519121263841695
전망/NNG@$상향/NNG@$조정/NNG,-1,-0.38080141580245896,149,59,90,219,0.3866039330824332,0.8627964772230594
인하/NNG@$소수/NNG@$의견/NNG,-1,-0.38155880066897296,98,39,59,109,0.3786586417649522,0.8465618944070881
대응/NNG@$금리/NNG@$인하/NNG,-1,-0.3822720752061399,41,16,25,25,0.28920975999867155,0.6476617361292709
예상/NNG@$기준금리/NNG@$인하/NNG,-1,-0.3822720752061399,41,16,25,44,0.28920975999867155,0.6476617361292709
내수/NNG@$경기/NNG@$활성화/NNG,-1,-0.3826515827404259,24,9,15,23,0.22439314109118375,0.5029566044386194
경기/NNG@$부양/NNG@$대책/NNG,-1,-0.3826515827404259,24,9,15,32,0.22439314109118375,0.5029566044386194
인하/NNG@$금리/NNG@$동결/NNG,-1,-0.3826515827404259,24,9,15,33,0.22439314109118375,0.5029566044386194
국내총생산/NNG@$갭/NNG@$마이너스/NNG,-1,-0.3826515827404259,24,9,15,38,0.22439314109118375,0.5029566044386194
마이너스금리/NNG@$정책/NNG@$도입/NNG,-1,-0.3826515827404259,24,9,15,30,0.22439314109118375,0.5029566044386194
기준금리/NNG@$인하/NNG@$가능성/NNG@$높/VA,-1,-0.3826515827404259,24,9,15,28,0.22439314109118375,0.5029566044386194
경제/NNG@$회복세/NNG@$예상/NNG,-1,-0.3826515827404259,24,9,15,29,0.22439314109118375,0.5029566044386194
은행/NNG@$금리/NNG@$인상/NNG@$단행/NNG,-1,-0.3826515827404259,24,9,15,30,0.22439314109118375,0.5029566044386194
경제/NNG@$전망/NNG@$국내총생산/NNG@$성장률/NNG,0,-0.3829531127611808,14,5,9,41,0.1782036952377744,0.3997091967910446
채권/NNG@$투자/NNG@$과세/NNG,0,-0.3829531127611808,14,5,9,36,0.1782036952377744,0.3997091967910446
경기/NNG@$회복/NNG@$모멘텀/NNG,-1,-0.3870957675286941,106,42,64,106,0.3774996797217599,0.8549946125270833
가능성/NNG@$크/VA@$진단/NNG,-1,-0.3875876059857605,46,18,28,67,0.3014718552076915,0.6835897812170555
경제/NNG@$혁신/NNG@$계획/NNG,-1,-0.3875876059857605,46,18,28,69,0.3014718552076915,0.6835897812170555
식료품/NNG@$에너지/NNG@$지수/NNG,-1,-0.3886448268500273,29,11,18,13,0.24267456508733581,0.5516363419338606
견조/NNG@$성장/NNG@$지속/NNG@$물가/NNG@$유지/NNG,-1,-0.3886448268500273,29,11,18,26,0.24267456508733581,0.5516363419338606
돈/NNG@$돌/VV@$않/VX,-1,-0.3886448268500273,29,11,18,21,0.24267456508733581,0.5516363419338606
국제금융시장/NNG@$불안/NNG@$완화/NNG,-1,-0.3886448268500273,29,11,18,14,0.24267456508733581,0.5516363419338606
구매/NNG@$관리/NNG@$지수/NNG,-1,-0.3886448268500273,29,11,18,40,0.24267456508733581,0.5516363419338606
물가/NNG@$상승세/NNG@$지속/NNG,-1,-0.3886448268500273,29,11,18,26,0.24267456508733581,0.5516363419338606
금융기관/NNG@$경제/NNG@$실시/NNG,-1,-0.3945435349107681,34,13,21,24,0.25902651235851276,0.5970586008253917
경영/NNG@$애로/NNG@$요인/NNG,-1,-0.3945435349107681,34,13,21,33,0.25902651235851276,0.5970586008253917
통화정책/NNG@$가늠/NNG@$볼/VX,-1,-0.3945435349107681,34,13,21,26,0.25902651235851276,0.5970586008253917
금리/NNG@$낮/VA@$유지/NNG,-1,-0.3953615762291275,81,32,49,117,0.3582323001583303,0.8273291159084583
금리/NNG@$인하/NNG@$없/VA,-1,-0.3967393326419896,66,26,40,66,0.33930682659056655,0.7861831899586526
지속/NNG@$가능성/NNG@$높/VA,-1,-0.3968258145743724,71,28,43,81,0.34638373289850566,0.8027451454043077
단행/NNG@$금리/NNG@$인하/NNG,-1,-0.3968258145743724,71,28,43,67,0.34638373289850566,0.8027451454043077
실물경제/NNG@$부정적/NNG@$영향/NNG,-1,-0.40355279049393555,44,17,27,30,0.28706587392719807,0.6760058095449784
소비/NNG@$지출/NNG@$감소/NNG,-1,-0.40355279049393555,44,17,27,39,0.28706587392719807,0.6760058095449784
경제/NNG@$성장세/NNG@$회복/NNG,-1,-0.40355279049393555,44,17,27,65,0.28706587392719807,0.6760058095449784
원자재/NNG@$가격/NNG@$상승세/NNG,-1,-0.40641072103572684,49,19,30,44,0.29906336441721887,0.7090841687498664
금리/NNG@$인하/NNG@$소수/NNG@$의견/NNG,-1,-0.4082433119613835,54,21,33,56,0.309862414478341,0.7379204046250193
금리/NNG@$인하/NNG@$전망/NNG,-1,-0.40831103898001175,180,70,110,219,0.3666836624273925,0.8733788813200724
금리/NNG@$인하/NNG@$여지/NNG,-1,-0.40930657865185927,64,25,39,45,0.3282460393831951,0.7836958830185539
금리/NNG@$올릴/VV@$예상/NNG,-1,-0.40930657865185927,64,25,39,90,0.3282460393831951,0.7836958830185539
산업/NNG@$평균/NNG@$지수/NNG@$상승/NNG@$거래/NNG,-1,-0.40930657865185927,64,25,39,89,0.3282460393831951,0.7836958830185539
실물/NNG@$경기/NNG@$회복/NNG,-1,-0.40930657865185927,64,25,39,51,0.3282460393831951,0.7836958830185539
심리/NNG@$크/VA@$위축/NNG,0,-0.41308855060221794,22,8,14,22,0.2031651829284219,0.48949235356000315
통화정책/NNG@$기준금리/NNG@$유지/NNG,0,-0.41308855060221794,22,8,14,45,0.2031651829284219,0.48949235356000315
경기/NNG@$개선/NNG@$지속/NNG,0,-0.41308855060221794,22,8,14,23,0.2031651829284219,0.48949235356000315
상승/NNG@$압력/NNG@$확대/NNG,0,-0.41308855060221794,22,8,14,33,0.2031651829284219,0.48949235356000315
원유/NNG@$가격/NNG@$하락/NNG,-1,-0.4133691883993821,27,10,17,26,0.22366271702417012,0.5392421288864966
경제/NNG@$전망/NNG@$예상/NNG,-1,-0.4133691883993821,27,10,17,22,0.22366271702417012,0.5392421288864966
인하/NNG@$나설/VV@$전망/NNG,-1,-0.4133691883993821,27,10,17,35,0.22366271702417012,0.5392421288864966
장단기/NNG@$금리/NNG@$스프레드/NNG,-1,-0.4133691883993821,27,10,17,31,0.22366271702417012,0.5392421288864966
기준금리/NNG@$금융/NNG@$위기/NNG,-1,-0.4133691883993821,27,10,17,31,0.22366271702417012,0.5392421288864966
물가/NNG@$상승률/NNG@$기준치/NNG,-1,-0.4133691883993821,27,10,17,33,0.22366271702417012,0.5392421288864966
내수/NNG@$경기/NNG@$부양/NNG,-1,-0.4133691883993821,27,10,17,31,0.22366271702417012,0.5392421288864966
경제/NNG@$성장/NNG@$고용/NNG,-1,-0.4133691883993821,27,10,17,52,0.22366271702417012,0.5392421288864966
경제/NNG@$환경/NNG@$변화/NNG,-1,-0.4157724946058823,32,12,20,42,0.24163714878620376,0.5859647863251033
예상치/NNG@$크/VA@$웃돌/VV,-1,-0.4157724946058823,32,12,20,35,0.24163714878620376,0.5859647863251033
금리/NNG@$동결/NNG@$가능성/NNG@$높/VA,-1,-0.4157724946058823,32,12,20,36,0.24163714878620376,0.5859647863251033
성장률/NNG@$전망/NNG@$낮췄/VV,-1,-0.4157724946058823,32,12,20,26,0.24163714878620376,0.5859647863251033
기준금리/NNG@$인하/NNG@$요구/NNG,-1,-0.4157724946058823,32,12,20,31,0.24163714878620376,0.5859647863251033
하향/NNG@$조정/NNG@$경기/NNG,-1,-0.41846642381916155,37,14,23,42,0.2576849192023993,0.6289644467602649
금리/NNG@$인상/NNG@$가시화/NNG,0,-0.41980302939300085,17,6,11,29,0.17874942291589793,0.4377119159061882
확대/NNG@$경기/NNG@$부양/NNG,0,-0.41980302939300085,17,6,11,32,0.17874942291589793,0.4377119159061882
수출/NNG@$부진/NNG@$경제/NNG,0,-0.41980302939300085,17,6,11,29,0.17874942291589793,0.4377119159061882
양적완화/NNG@$축소/NNG@$결정/NNG,0,-0.41980302939300085,17,6,11,40,0.17874942291589793,0.4377119159061882
채권/NNG@$자금/NNG@$유입/NNG,0,-0.41980302939300085,17,6,11,24,0.17874942291589793,0.4377119159061882
부정적/NNG@$영향/NNG@$우려/NNG,-1,-0.42029420390170213,103,40,63,95,0.35297714104433725,0.8653816645768999
에너지/NNG@$원자재/NNG@$가격/NNG,-1,-0.4222705031113605,47,18,29,60,0.2851115071714197,0.7023607735136472
물가/NNG@$상승/NNG@$영향/NNG,-1,-0.4222705031113605,47,18,29,52,0.2851115071714197,0.7023607735136472
기준금리/NNG@$올리/VV@$않/VX,-1,-0.4230496008901924,52,20,32,65,0.2968185650195836,0.7325873865348889
원/NNG@$환율/NNG@$상승/NNG,-1,-0.4293904432741158,75,29,46,79,0.32982896340002044,0.8267592256008213
에너지/NNG@$가격/NNG@$하락/NNG,-1,-0.4362877503294045,60,23,37,101,0.3049703680659028,0.7775186818544153
소비자/NNG@$물가/NNG@$상승률/NNG@$전망치/NNG,-1,-0.43776949316258396,55,21,34,62,0.2947171400101759,0.7541321596213085
채권/NNG@$시장/NNG@$영향/NNG,-1,-0.43776949316258396,55,21,34,63,0.2947171400101759,0.7541321596213085
경제/NNG@$발목/NNG@$잡/VV,-1,-0.43776949316258396,55,21,34,87,0.2947171400101759,0.7541321596213085
기준금리/NNG@$인하/NNG@$않/VX,-1,-0.4391934829988644,35,13,22,42,0.24092113939791512,0.6186518677765004
지식/NNG@$경제/NNG@$부/NNG,-1,-0.4391934829988644,35,13,22,65,0.24092113939791512,0.6186518677765004
외국인/NNG@$증권/NNG@$투자/NNG@$자금/NNG@$유입/NNG,-1,-0.43922536502239895,45,17,28,27,0.27065193146204564,0.6950512341377001
시장/NNG@$예상/NNG@$웃돌/VV,-1,-0.43922536502239895,45,17,28,67,0.27065193146204564,0.6950512341377001
시사/NNG@$금리/NNG@$인상/NNG,-1,-0.43928290274195325,40,15,25,77,0.2565825557548203,0.6590140317332661
장기/NNG@$대출/NNG@$프로그램/NNG,-1,-0.43928290274195325,40,15,25,75,0.2565825557548203,0.6590140317332661
금리/NNG@$인하/NNG@$부정적/NNG,-1,-0.43928290274195325,40,15,25,61,0.2565825557548203,0.6590140317332661
통화정책/NNG@$방향/NNG@$경제/NNG,-1,-0.43928290274195325,40,15,25,44,0.2565825557548203,0.6590140317332661
장기/NNG@$국채/NNG@$금리/NNG,-1,-0.43928290274195325,40,15,25,49,0.2565825557548203,0.6590140317332661
인하/NNG@$쉽/VA@$않/VX,-1,-0.43961815641825863,30,11,19,62,0.22338184609408077,0.5742167403296055
경기/NNG@$하방/NNG@$압력/NNG,-1,-0.43961815641825863,30,11,19,63,0.22338184609408077,0.5742167403296055
경제/NNG@$전망/NNG@$악화/NNG,-1,-0.43961815641825863,30,11,19,40,0.22338184609408077,0.5742167403296055
지수/NNG@$상승/NNG@$종합/NNG,-1,-0.43961815641825863,30,11,19,69,0.22338184609408077,0.5742167403296055
금리/NNG@$경기/NNG@$부양/NNG,-1,-0.43961815641825863,30,11,19,32,0.22338184609408077,0.5742167403296055
경제/NNG@$견조/NNG@$성장세/NNG,-1,-0.43961815641825863,30,11,19,42,0.22338184609408077,0.5742167403296055
갭/NNG@$플러스/NNG@$전환/NNG,-1,-0.4420951010253128,25,9,16,45,0.20345449461365955,0.5262139689928524
경기/NNG@$부양/NNG@$재정/NNG,-1,-0.4420951010253128,25,9,16,27,0.20345449461365955,0.5262139689928524
경제/NNG@$활력/NNG@$회복/NNG,-1,-0.4420951010253128,25,9,16,19,0.20345449461365955,0.5262139689928524
주택/NNG@$가격/NNG@$하락/NNG,-1,-0.4438692427596037,221,84,137,258,0.34086331695182565,0.8855032535216196
평균/NNG@$지수/NNG@$상승/NNG@$거래/NNG@$마쳤/VV,-1,-0.4480233477126232,63,24,39,87,0.3027149308607501,0.794587931754048
기준금리/NNG@$인하/NNG@$압박/NNG,0,-0.4503627566697366,20,7,13,45,0.18006941522575817,0.4754342777974711
결정/NNG@$기준금리/NNG@$인하/NNG,0,-0.4503627566697366,20,7,13,22,0.18006941522575817,0.4754342777974711
실업/NNG@$수당/NNG@$신청/NNG,0,-0.4503627566697366,20,7,13,46,0.18006941522575817,0.4754342777974711
경로/NNG@$하방/NNG@$리스크/NNG,0,-0.4503627566697366,20,7,13,33,0.18006941522575817,0.4754342777974711
성장률/NNG@$전망/NNG@$유지/NNG,0,-0.4503627566697366,20,7,13,37,0.18006941522575817,0.4754342777974711
물가/NNG@$상승세/NNG@$둔화/NNG,-1,-0.4532710157021258,53,20,33,67,0.28165616046008857,0.7491000059011064
금리/NNG@$인하/NNG@$여부/NNG,-1,-0.4533421955178504,84,32,52,71,0.3214950711386273,0.8552096299648787
기준금리/NNG@$동결/NNG@$결정/NNG,-1,-0.45673977387014253,143,54,89,232,0.33117565049529285,0.8885332370864834
지수/NNG@$상승/NNG@$거래/NNG@$마쳤/VV,-1,-0.4584691428915514,66,25,41,94,0.30057076396517324,0.8099525352393399
시장/NNG@$금리/NNG@$인하/NNG@$가능성/NNG,-1,-0.4594698335503662,38,14,24,49,0.24043645308944184,0.6495504608019845
전망/NNG@$경기/NNG@$둔화/NNG,-1,-0.4594698335503662,38,14,24,22,0.24043645308944184,0.6495504608019845
실시/NNG@$금리/NNG@$동결/NNG,-1,-0.46215677569632896,33,12,21,24,0.2234042526395896,0.6076637043570968
시장/NNG@$금리/NNG@$상승/NNG@$압력/NNG,-1,-0.46215677569632896,33,12,21,29,0.2234042526395896,0.6076637043570968
금리/NNG@$인상/NNG@$종료/NNG,-1,-0.46215677569632896,33,12,21,58,0.2234042526395896,0.6076637043570968
가치/NNG@$하락/NNG@$막/VV,-1,-0.46215677569632896,33,12,21,19,0.2234042526395896,0.6076637043570968
시장/NNG@$기준금리/NNG@$인하/NNG,-1,-0.46461278008099405,106,40,66,163,0.32252355101593083,0.8827676431718334
시장/NNG@$기대/NNG@$금리/NNG,-1,-0.46675828194256674,28,10,18,22,0.20413373396812984,0.5617929968079963
금융/NNG@$위기/NNG@$촉발/NNG,-1,-0.46675828194256674,28,10,18,26,0.20413373396812984,0.5617929968079963
가격/NNG@$소비자/NNG@$물가/NNG,-1,-0.46675828194256674,28,10,18,25,0.20413373396812984,0.5617929968079963
금융/NNG@$위기/NNG@$발발/NNG,-1,-0.46675828194256674,28,10,18,33,0.20413373396812984,0.5617929968079963
기업/NNG@$가격/NNG@$경쟁력/NNG,-1,-0.46675828194256674,28,10,18,29,0.20413373396812984,0.5617929968079963
엔화/NNG@$약세/NNG@$지속/NNG,-1,-0.46675828194256674,28,10,18,39,0.20413373396812984,0.5617929968079963
금리/NNG@$격차/NNG@$확대/NNG,-1,-0.46675828194256674,28,10,18,25,0.20413373396812984,0.5617929968079963
경제/NNG@$전망/NNG@$영향/NNG,-1,-0.46675828194256674,28,10,18,43,0.20413373396812984,0.5617929968079963
금리/NNG@$인하/NNG@$가능/NNG,-1,-0.4677751299599957,69,26,43,64,0.29852773510253006,0.8237107064094529
취업/NNG@$기회/NNG@$전망/NNG,-1,-0.473263910939845,46,17,29,71,0.2548812608283441,0.713252311145311
은행/NNG@$지급준비율/NNG@$인상/NNG,-1,-0.473263910939845,46,17,29,71,0.2548812608283441,0.713252311145311
자산/NNG@$매입/NNG@$규모/NNG@$유지/NNG,0,-0.47475655719186205,15,5,10,61,0.15056313712784727,0.42295484491517304
디플레이션/NNG@$우려/NNG@$제기/NNG,0,-0.47475655719186205,15,5,10,23,0.15056313712784727,0.42295484491517304
기준금리/NNG@$인하/NNG@$필요/NNG,-1,-0.4761445147171741,23,8,15,70,0.1817978806189164,0.5125306503232484
청구/NNG@$감소/NNG@$기록/NNG,-1,-0.4761445147171741,23,8,15,46,0.1817978806189164,0.5125306503232484
유로화/NNG@$달러화/NNG@$유로당/NNG,-1,-0.4761445147171741,23,8,15,30,0.1817978806189164,0.5125306503232484
자본/NNG@$유출/NNG@$막/VV,-1,-0.4761445147171741,23,8,15,29,0.1817978806189164,0.5125306503232484
확대/NNG@$가능성/NNG@$있/VA,-1,-0.4761445147171741,23,8,15,23,0.1817978806189164,0.5125306503232484
상승/NNG@$금리/NNG@$인하/NNG,-1,-0.4761445147171741,23,8,15,36,0.1817978806189164,0.5125306503232484
매입/NNG@$규모/NNG@$유지/NNG,-1,-0.4761445147171741,23,8,15,71,0.1817978806189164,0.5125306503232484
하방/NNG@$위험/NNG@$커지/VV,-1,-0.4761445147171741,23,8,15,31,0.1817978806189164,0.5125306503232484
채권/NNG@$딜러/NNG@$시장/NNG,-1,-0.4761445147171741,23,8,15,33,0.1817978806189164,0.5125306503232484
인상/NNG@$나설/VV@$전망/NNG,-1,-0.4773782681511828,59,22,37,70,0.27866066332728484,0.7881189384170546
견조/NNG@$성장세/NNG@$지속/NNG,-1,-0.4815781323346531,36,13,23,26,0.22362916827236778,0.639404111671587
부진/NNG@$모습/NNG@$보이/VV,-1,-0.4821837438713379,54,20,34,82,0.2670681212813672,0.7648094718497197
필요/NNG@$금리/NNG@$인하/NNG,-1,-0.4821837438713379,54,20,34,57,0.2670681212813672,0.7648094718497197
경제/NNG@$성장/NNG@$촉진/NNG,-1,-0.4835515729795218,83,31,52,68,0.3007147624106756,0.8642378235553851
경상수지/NNG@$흑자/NNG@$지속/NNG,-1,-0.4871019257346122,49,18,31,67,0.2542055619193455,0.7373816112094449
직접적/NNG@$영향/NNG@$않/VX,-1,-0.4878569985576995,31,11,20,29,0.20505079849018742,0.595974778465698
문제/NNG@$경기/NNG@$회복/NNG,-1,-0.4878569985576995,31,11,20,15,0.20505079849018742,0.595974778465698
물가/NNG@$상승률/NNG@$머물/VV,-1,-0.4878569985576995,31,11,20,28,0.20505079849018742,0.595974778465698
생산자/NNG@$물가/NNG@$상승률/NNG,-1,-0.4878569985576995,31,11,20,38,0.20505079849018742,0.595974778465698
유동성/NNG@$공급/NNG@$확대/NNG,-1,-0.49010542408487,78,29,49,58,0.29292133065961284,0.8564080086068192
수출/NNG@$증가율/NNG@$둔화/NNG,-1,-0.49234852394654816,44,16,28,61,0.2399152106261878,0.7055895679911975
자금/NNG@$유출/NNG@$가능성/NNG,-1,-0.49234852394654816,44,16,28,59,0.2399152106261878,0.7055895679911975
건전성/NNG@$종/NNG@$세트/NNG,0,-0.49744045049562846,18,6,12,34,0.15456856326973448,0.4607499294136287
외환시장/NNG@$원달러/NNG@$환율/NNG,0,-0.49744045049562846,18,6,12,22,0.15456856326973448,0.4607499294136287
조치/NNG@$내놓/VV@$않/VX,0,-0.49744045049562846,18,6,12,44,0.15456856326973448,0.4607499294136287
가격/NNG@$하락/NNG@$압력/NNG,0,-0.49744045049562846,18,6,12,46,0.15456856326973448,0.4607499294136287
선행/NNG@$지표/NNG@$역할/NNG,-1,-0.4981146389496015,26,9,17,33,0.18373420817949737,0.5486704787493348
규모/NNG@$유동성/NNG@$공급/NNG,-1,-0.4981146389496015,26,9,17,38,0.18373420817949737,0.5486704787493348
금리/NNG@$인하/NNG@$대응/NNG,-1,-0.4981146389496015,26,9,17,41,0.18373420817949737,0.5486704787493348
경제/NNG@$성장/NNG@$위협/NNG,-1,-0.4981146389496015,26,9,17,24,0.18373420817949737,0.5486704787493348
회복/NNG@$금리/NNG@$인하/NNG,-1,-0.4981146389496015,26,9,17,35,0.18373420817949737,0.5486704787493348
증가/NNG@$속도/NNG@$빠르/VA,-1,-0.4981146389496015,26,9,17,50,0.18373420817949737,0.5486704787493348
모습/NNG@$보이/VV@$않/VX,-1,-0.49835666816163404,39,14,25,25,0.22398612945175606,0.6693017651263619
금리/NNG@$내리/VV@$않/VX,-1,-0.4992033021473591,52,19,33,49,0.25360987440988464,0.7595294665501429
금리/NNG@$인하/NNG@$불가피/XR,-1,-0.4992033021473591,52,19,33,21,0.25360987440988464,0.7595294665501429
인상/NNG@$중단/NNG@$가능성/NNG,-1,-0.4992033021473591,52,19,33,89,0.25360987440988464,0.7595294665501429
경기/NNG@$하방/NNG@$리스크/NNG,-1,-0.5003151175113243,150,55,95,179,0.3003710479121234,0.9022399275809145
회복/NNG@$기미/NNG@$보이/VV,-1,-0.502830730533198,60,22,38,66,0.26512005789948556,0.8017190776410982
금융/NNG@$유의/NNG@$통화정책/NNG,-1,-0.5032876013603802,76,28,48,64,0.2828339767889013,0.8563312514794327
테이퍼링/NNG@$양적완화/NNG@$축소/NNG,-1,-0.5056489742906116,47,17,30,85,0.2397945026191681,0.7306291741396285
부동산/NNG@$종합/NNG@$대책/NNG,-1,-0.5056489742906116,47,17,30,57,0.2397945026191681,0.7306291741396285
대외/NNG@$위험/NNG@$요인/NNG,-1,-0.5056489742906116,47,17,30,59,0.2397945026191681,0.7306291741396285
통화/NNG@$긴축/NNG@$기조/NNG,-1,-0.5056489742906116,47,17,30,51,0.2397945026191681,0.7306291741396285
실업/NNG@$수당/NNG@$청구/NNG@$예상치/NNG,-1,-0.5056489742906116,47,17,30,32,0.2397945026191681,0.7306291741396285
증권/NNG@$투자/NNG@$자금/NNG@$유입/NNG,-1,-0.5056489742906116,47,17,30,28,0.2397945026191681,0.7306291741396285
수당/NNG@$청구/NNG@$예상치/NNG,-1,-0.5056489742906116,47,17,30,32,0.2397945026191681,0.7306291741396285
성장률/NNG@$전망치/NNG@$하향/NNG@$조정/NNG,-1,-0.5058109202981833,109,40,69,147,0.29443529119108885,0.8975040250939534
시장/NNG@$유동성/NNG@$공급/NNG,-1,-0.5059816617664068,34,12,22,35,0.20610653894861578,0.628546427704872
외국인/NNG@$자금/NNG@$유입/NNG,-1,-0.5059816617664068,34,12,22,63,0.20610653894861578,0.628546427704872
증시/NNG@$사상/NNG@$최고치/NNG,-1,-0.5059816617664068,34,12,22,29,0.20610653894861578,0.628546427704872
양적완화/NNG@$정책/NNG@$시행/NNG,-1,-0.5059816617664068,34,12,22,44,0.20610653894861578,0.628546427704872
가격/NNG@$하락/NNG@$영향/NNG,-1,-0.5059816617664068,34,12,22,30,0.20610653894861578,0.628546427704872
효과/NNG@$크/VA@$않/VX,-1,-0.5087645783186033,112,41,71,168,0.292783530844078,0.8995868562426311
확인/NNG@$필요/NNG@$있/VA,-1,-0.5097918776534534,55,20,35,55,0.25307458556176093,0.779737039582221
총액/NNG@$대출한도/NNG@$축소/NNG,-1,-0.5113274495241216,63,23,40,29,0.26423318712225397,0.8175016386012708
장기/NNG@$국채/NNG@$매입/NNG,-1,-0.5124342193827065,190,69,121,80,0.29208581198350314,0.9063848599621229
식료품/NNG@$가격/NNG@$상승/NNG,-1,-0.5128785147527731,42,15,27,32,0.22442531216295603,0.6972633075058715
금리/NNG@$인하/NNG@$정책/NNG,-1,-0.5146778560147143,132,48,84,136,0.2899760852512716,0.9053316704450138
하향/NNG@$조정/NNG@$기준금리/NNG,-1,-0.5169494850788532,29,10,19,27,0.1857610472779235,0.5835592750354053
금융/NNG@$불안/NNG@$경제/NNG,-1,-0.5169494850788532,29,10,19,19,0.1857610472779235,0.5835592750354053
금리/NNG@$인하/NNG@$단행/NNG@$전망/NNG,-1,-0.5169494850788532,29,10,19,41,0.1857610472779235,0.5835592750354053
선제적/NNG@$금리/NNG@$인하/NNG,-1,-0.5172299714220845,50,18,32,76,0.23972863539175462,0.7536719206133722
통화/NNG@$가치/NNG@$상승/NNG,-1,-0.5172299714220845,50,18,32,59,0.23972863539175462,0.7536719206133722
주택/NNG@$담보인정비율/NNG@$부채/NNG@$상환/NNG,0,-0.5174097195930412,21,7,14,35,0.1583792149836962,0.49816533003346425
적자/NNG@$국채/NNG@$발행/NNG,0,-0.5174097195930412,21,7,14,41,0.1583792149836962,0.49816533003346425
회복세/NNG@$보일/VV@$예상/NNG,0,-0.5174097195930412,21,7,14,45,0.1583792149836962,0.49816533003346425
유지/NNG@$물가/NNG@$상승률/NNG,0,-0.5174097195930412,21,7,14,28,0.1583792149836962,0.49816533003346425
심리/NNG@$회복/NNG@$지연/NNG,0,-0.5174097195930412,21,7,14,30,0.1583792149836962,0.49816533003346425
경기/NNG@$부양/NNG@$목적/NNG,0,-0.5174097195930412,21,7,14,30,0.1583792149836962,0.49816533003346425
성장률/NNG@$전망치/NNG@$유지/NNG,0,-0.5174097195930412,21,7,14,37,0.1583792149836962,0.49816533003346425
달러화/NNG@$가치/NNG@$하락/NNG,-1,-0.5190596548509367,58,21,37,64,0.2525846092082281,0.7980661483785347
은행/NNG@$금리/NNG@$인하/NNG,-1,-0.5190596548509367,58,21,37,47,0.2525846092082281,0.7980661483785347
지준율/NNG@$인상/NNG@$효과/NNG,-1,-0.521594927659565,37,13,24,18,0.20723485162729113,0.6593414607194865
인하/NNG@$단행/NNG@$전망/NNG,-1,-0.521594927659565,37,13,24,52,0.20723485162729113,0.6593414607194865
증권/NNG@$금리/NNG@$인하/NNG,-1,-0.521594927659565,37,13,24,24,0.20723485162729113,0.6593414607194865
민간/NNG@$소비/NNG@$부진/NNG,-1,-0.521594927659565,37,13,24,53,0.20723485162729113,0.6593414607194865
금리/NNG@$동결/NNG@$전망/NNG,-1,-0.5250453186175317,147,53,94,208,0.2830809156648305,0.9092428583850936
국내총생산/NNG@$성장률/NNG@$전망/NNG,-1,-0.5254621815534355,45,16,29,77,0.22491123182675238,0.7232356275281939
조치/NNG@$취하/VV@$않/VX,-1,-0.5254621815534355,45,16,29,79,0.22491123182675238,0.7232356275281939
인하/NNG@$가능성/NNG@$낮/VA,-1,-0.5271702801963123,80,29,51,88,0.2703309004713858,0.8734009364187174
효과/NNG@$나타나/VV@$않/VX,-1,-0.5271721070568341,61,22,39,74,0.2521283370409585,0.8145951425234131
동결/NNG@$소수/NNG@$의견/NNG,-1,-0.527317879932814,53,19,34,29,0.23969792265019274,0.77474637839282
금리/NNG@$인하/NNG@$시작/NNG,-1,-0.527317879932814,53,19,34,40,0.23969792265019274,0.77474637839282
가능성/NNG@$크/VA@$전망/NNG,-1,-0.5325470353794801,97,35,62,160,0.27393845037296327,0.8983701138469732
우려/NNG@$기준금리/NNG@$인하/NNG,-1,-0.5331542297401672,32,11,21,41,0.18780674344673742,0.6169486212283808
엔화/NNG@$가치/NNG@$상승/NNG,-1,-0.5331542297401672,32,11,21,32,0.18780674344673742,0.6169486212283808
결정/NNG@$열/VV@$기준금리/NNG,-1,-0.5331542297401672,32,11,21,33,0.18780674344673742,0.6169486212283808
관측/NNG@$힘/NNG@$얻/VV,-1,-0.5331542297401672,32,11,21,36,0.18780674344673742,0.6169486212283808
달러화/NNG@$강세/NNG@$보이/VV,-1,-0.5331542297401672,32,11,21,41,0.18780674344673742,0.6169486212283808
긍정적/NNG@$영향/NNG@$전망/NNG,-1,-0.5349398620723358,24,8,16,30,0.161996587687025,0.5348235696964382
경기/NNG@$활성화/NNG@$정책/NNG,-1,-0.5349398620723358,24,8,16,29,0.161996587687025,0.5348235696964382
성장/NNG@$금리/NNG@$인상/NNG,-1,-0.5349398620723358,24,8,16,34,0.161996587687025,0.5348235696964382
금리/NNG@$인상/NNG@$행보/NNG,-1,-0.5349398620723358,24,8,16,40,0.161996587687025,0.5348235696964382
미/NNG@$금리/NNG@$역전/NNG,-1,-0.5349398620723358,24,8,16,27,0.161996587687025,0.5348235696964382
성장률/NNG@$전망/NNG@$낮추/VV,-1,-0.5349398620723358,24,8,16,31,0.161996587687025,0.5348235696964382
기업/NNG@$투자/NNG@$심리/NNG,-1,-0.5349398620723358,24,8,16,65,0.161996587687025,0.5348235696964382
약세/NNG@$원화/NNG@$강세/NNG,-1,-0.5349398620723358,24,8,16,32,0.161996587687025,0.5348235696964382
물가/NNG@$상승/NNG@$압력/NNG@$가중/NNG,-1,-0.5349398620723358,24,8,16,30,0.161996587687025,0.5348235696964382
지표/NNG@$시장/NNG@$예상/NNG,-1,-0.5349398620723358,24,8,16,36,0.161996587687025,0.5348235696964382
가격/NNG@$상승/NNG@$인플레이션/NNG@$압력/NNG,-1,-0.5349398620723358,24,8,16,46,0.161996587687025,0.5348235696964382
금융/NNG@$통화정책/NNG@$금리/NNG,-1,-0.5349398620723358,24,8,16,32,0.161996587687025,0.5348235696964382
인하/NNG@$시장/NNG@$금리/NNG,-1,-0.5350683892367333,40,14,26,20,0.2083910226169363,0.6882399333576021
경기/NNG@$부양/NNG@$나서/VV,-1,-0.5437585182924156,59,21,38,75,0.2396873544848194,0.8112173402285294
결정/NNG@$금리/NNG@$인하/NNG,-1,-0.5458351137506251,51,18,33,32,0.22592914068293812,0.7691761368845617
경제/NNG@$금융/NNG@$위기/NNG,-1,-0.5458657003365389,115,41,74,135,0.2676827018807773,0.911405507328288
시장/NNG@$예상/NNG@$부합/NNG,-1,-0.5459203846446958,70,25,45,91,0.2508823874582863,0.8543367377879244
기준금리/NNG@$동결/NNG@$했/VV,-1,-0.5471236966600506,35,12,23,37,0.18982642408076572,0.6486401387968391
금융/NNG@$외환시장/NNG@$영향/NNG,-1,-0.5471236966600506,35,12,23,20,0.18982642408076572,0.6486401387968391
채권/NNG@$보유/NNG@$종사자/NNG,-1,-0.5471236966600506,35,12,23,29,0.18982642408076572,0.6486401387968391
주택/NNG@$가격/NNG@$전망/NNG,-1,-0.5502883976973096,27,9,18,50,0.16542365864499808,0.570390439440333
인하/NNG@$정책/NNG@$효과/NNG,-1,-0.5502883976973096,27,9,18,43,0.16542365864499808,0.570390439440333
기준금리/NNG@$인하/NNG@$정책/NNG,-1,-0.5502883976973096,27,9,18,39,0.16542365864499808,0.570390439440333
급등/NNG@$물가/NNG@$상승/NNG,-1,-0.5502883976973096,27,9,18,39,0.16542365864499808,0.570390439440333
경기/NNG@$회복세/NNG@$미약/XR,-1,-0.5504191579614827,62,22,40,58,0.2396887772566009,0.8267705766406263
예금/NNG@$증서/NNG@$금리/NNG,-1,-0.5504191579614827,62,22,40,45,0.2396887772566009,0.8267705766406263
양도성/NNG@$예금/NNG@$증서/NNG@$금리/NNG,-1,-0.5504191579614827,62,22,40,45,0.2396887772566009,0.8267705766406263
유로존/NNG@$경제/NNG@$성장/NNG,-1,-0.5504191579614827,62,22,40,114,0.2396887772566009,0.8267705766406263
원달러/NNG@$환율/NNG@$상승/NNG,-1,-0.5504191579614827,62,22,40,81,0.2396887772566009,0.8267705766406263
불안/NNG@$요인/NNG@$가능성/NNG,0,-0.5516182080828161,13,4,9,19,0.1177496899303776,0.4075590632386577
예상/NNG@$금리/NNG@$인하/NNG,-1,-0.5521970312592744,127,45,82,116,0.26401773046190663,0.9153471670691273
산업/NNG@$생산/NNG@$지표/NNG,-1,-0.5540372202820547,54,19,35,74,0.22643021984715483,0.7891995294186674
불안/NNG@$요인/NNG@$잠재/NNG,-1,-0.5567601317779785,46,16,30,51,0.2106748886070229,0.7400830435977336
성장/NNG@$목표/NNG@$달성/NNG,0,-0.5587951624831828,16,5,11,51,0.1260404901097154,0.44538955509615824
검토/NNG@$볼/VX@$필요/NNG@$있/VA,0,-0.5587951624831828,16,5,11,13,0.1260404901097154,0.44538955509615824
주택/NNG@$착공/NNG@$증가/NNG,0,-0.5587951624831828,16,5,11,35,0.1260404901097154,0.44538955509615824
금리/NNG@$인하/NNG@$쉽/VA@$않/VX,0,-0.5587951624831828,16,5,11,37,0.1260404901097154,0.44538955509615824
주택/NNG@$착공/NNG@$허가/NNG,0,-0.5587951624831828,16,5,11,44,0.1260404901097154,0.44538955509615824
수요/NNG@$압력/NNG@$완화/NNG,0,-0.5587951624831828,16,5,11,31,0.1260404901097154,0.44538955509615824
원화/NNG@$강세/NNG@$보이/VV,0,-0.5587951624831828,16,5,11,38,0.1260404901097154,0.44538955509615824
하방/NNG@$리스크/NNG@$확대/NNG,-1,-0.5591762676526664,38,13,25,35,0.19179173662335383,0.6784855731178436
채권/NNG@$시장/NNG@$외국인/NNG,-1,-0.5636924969825761,30,10,20,49,0.16866462812749244,0.6045817021266334
물가/NNG@$관리/NNG@$목표/NNG,-1,-0.5636924969825761,30,10,20,48,0.16866462812749244,0.6045817021266334
경제/NNG@$기준금리/NNG@$인하/NNG,-1,-0.5636924969825761,30,10,20,43,0.16866462812749244,0.6045817021266334
소수/NNG@$의견/NNG@$나올/VV,-1,-0.5636924969825761,30,10,20,36,0.16866462812749244,0.6045817021266334
금융/NNG@$외환시장/NNG@$변동성/NNG,-1,-0.5636924969825761,30,10,20,31,0.16866462812749244,0.6045817021266334
기금/NNG@$금리선물/NNG@$기준금리/NNG,-1,-0.5636924969825761,30,10,20,33,0.16866462812749244,0.6045817021266334
금리/NNG@$인하/NNG@$부작용/NNG,-1,-0.565442228321974,49,17,32,41,0.21176795948974772,0.7629900887950257
금리/NNG@$인상/NNG@$중단/NNG@$가능성/NNG,-1,-0.565442228321974,49,17,32,85,0.21176795948974772,0.7629900887950257
가능성/NNG@$크/VA@$예상/NNG,-1,-0.565442228321974,49,17,32,73,0.21176795948974772,0.7629900887950257
가계/NNG@$대출/NNG@$금리/NNG,0,-0.5685510198769357,19,6,13,26,0.13285842684159718,0.4830829503613939
금리/NNG@$변동성/NNG@$확대/NNG,0,-0.5685510198769357,19,6,13,28,0.13285842684159718,0.4830829503613939
경기/NNG@$회복/NNG@$수요/NNG@$압력/NNG,0,-0.5685510198769357,19,6,13,30,0.13285842684159718,0.4830829503613939
경기/NNG@$부양책/NNG@$내놓/VV,-1,-0.5693873237351239,74,26,48,66,0.2396200243681345,0.8734303750440854
소비/NNG@$내수/NNG@$회복세/NNG,-1,-0.5695743020326935,41,14,27,18,0.19368493115799135,0.7063842821040587
금리/NNG@$인하/NNG@$경기/NNG@$부양책/NNG,-1,-0.5695743020326935,41,14,27,27,0.19368493115799135,0.7063842821040587
생활/NNG@$형편/NNG@$전망/NNG,-1,-0.5726582577021732,77,27,50,146,0.23957176005259265,0.8817600588011176
금리/NNG@$인상/NNG@$생각/NNG,-1,-0.5753680860502548,33,11,22,32,0.1717246787022956,0.6371662719907181
만장일치/NNG@$금리/NNG@$동결/NNG,-1,-0.5753680860502548,33,11,22,72,0.1717246787022956,0.6371662719907181
경제/NNG@$나쁘/VA@$않/VX,-1,-0.5753680860502548,33,11,22,20,0.1717246787022956,0.6371662719907181
채권/NNG@$시장/NNG@$불안/NNG,-1,-0.5753680860502548,33,11,22,39,0.1717246787022956,0.6371662719907181
제조업/NNG@$지수/NNG@$예상치/NNG,-1,-0.5753680860502548,33,11,22,27,0.1717246787022956,0.6371662719907181
보험/NNG@$청구/NNG@$감소/NNG,-1,-0.5753680860502548,33,11,22,51,0.1717246787022956,0.6371662719907181
구조/NNG@$개혁/NNG@$필요/NNG,-1,-0.5753680860502548,33,11,22,35,0.1717246787022956,0.6371662719907181
실업/NNG@$보험/NNG@$청구/NNG@$감소/NNG,-1,-0.5753680860502548,33,11,22,51,0.1717246787022956,0.6371662719907181
물가/NNG@$상승률/NNG@$유지/NNG,-1,-0.5753680860502548,33,11,22,34,0.1717246787022956,0.6371662719907181
경제/NNG@$하방/NNG@$리스크/NNG,-1,-0.5771640457592456,66,23,43,88,0.228198174700383,0.8512642065156862
전망/NNG@$성장/NNG@$경로/NNG,-1,-0.5785373239934075,44,15,29,45,0.1954952712770737,0.7322790678353217
주택/NNG@$담보대출/NNG@$부실/NNG,-1,-0.5785373239934075,44,15,29,47,0.1954952712770737,0.7322790678353217
달러/NNG@$원/NNG@$환율/NNG@$원대/NNG,-1,-0.5789032439181263,22,7,15,31,0.13873053469265328,0.520223072374166
금리/NNG@$인상/NNG@$고민/NNG,-1,-0.5789032439181263,22,7,15,28,0.13873053469265328,0.520223072374166
회복/NNG@$수요/NNG@$압력/NNG,-1,-0.5789032439181263,22,7,15,35,0.13873053469265328,0.520223072374166
금융/NNG@$위기/NNG@$영향/NNG,-1,-0.5789032439181263,22,7,15,26,0.13873053469265328,0.520223072374166
금리/NNG@$인상/NNG@$달러/NNG@$강세/NNG,-1,-0.5793806613367871,55,19,36,53,0.21380936025622424,0.8029108148383056
전격적/NNG@$금리/NNG@$인하/NNG,-1,-0.5793806613367871,55,19,36,67,0.21380936025622424,0.8029108148383056
금리/NNG@$인하/NNG@$시사/NNG,-1,-0.5834149476414133,92,32,60,85,0.23911000602630716,0.9089165971117426
성장률/NNG@$마이너스/NNG@$기록/NNG,-1,-0.585510005539568,36,12,24,25,0.17460975624376626,0.6679663426820269
자산운용사/NNG@$채권/NNG@$딜러/NNG,-1,-0.5862510844276061,47,16,31,51,0.1972167632914069,0.756151077772469
시장/NNG@$부정적/NNG@$영향/NNG,-1,-0.588964890007762,25,8,17,36,0.1439324984375919,0.5564403001626834
수요/NNG@$하방/NNG@$압력/NNG,-1,-0.588964890007762,25,8,17,12,0.1439324984375919,0.5564403001626834
인상/NNG@$가능성/NNG@$강하/VA@$시사/NNG,-1,-0.588964890007762,25,8,17,38,0.1439324984375919,0.5564403001626834
경기/NNG@$부양/NNG@$규모/NNG,-1,-0.588964890007762,25,8,17,36,0.1439324984375919,0.5564403001626834
상승률/NNG@$물가/NNG@$목표/NNG@$유지/NNG@$통화정책/NNG,-1,-0.588964890007762,25,8,17,44,0.1439324984375919,0.5564403001626834
물가/NNG@$목표/NNG@$유지/NNG@$통화정책/NNG,-1,-0.588964890007762,25,8,17,46,0.1439324984375919,0.5564403001626834
엔화/NNG@$강세/NNG@$보이/VV,-1,-0.588964890007762,25,8,17,26,0.1439324984375919,0.5564403001626834
유럽연합/NNG@$탈퇴/NNG@$결정/NNG,-1,-0.588964890007762,25,8,17,38,0.1439324984375919,0.5564403001626834
소매/NNG@$판매/NNG@$증가율/NNG,-1,-0.588964890007762,25,8,17,49,0.1439324984375919,0.5564403001626834
목표/NNG@$유지/NNG@$통화정책/NNG,-1,-0.588964890007762,25,8,17,47,0.1439324984375919,0.5564403001626834
기준금리/NNG@$상향/NNG@$조정/NNG@$가능성/NNG,-1,-0.588964890007762,25,8,17,30,0.1439324984375919,0.5564403001626834
완화/NNG@$금리/NNG@$인하/NNG,-1,-0.5897815607368756,78,27,51,47,0.22946373837193873,0.8893220332002895
소비자/NNG@$물가/NNG@$동향/NNG,-1,-0.5928741235006691,50,17,33,50,0.19884666801899556,0.7780143294551823
가능성/NNG@$강하/VA@$시사/NNG,-1,-0.594292882927446,39,13,26,52,0.1773263745766237,0.6968551012706871
경기/NNG@$부양/NNG@$필요성/NNG,-1,-0.594292882927446,39,13,26,64,0.1773263745766237,0.6968551012706871
지속/NNG@$가능성/NNG@$크/VA,-1,-0.594292882927446,39,13,26,66,0.1773263745766237,0.6968551012706871
개선/NNG@$기미/NNG@$보이/VV,-1,-0.5983328269045471,28,9,19,39,0.14862339516991124,0.5914165863106438
위축/NNG@$우려/NNG@$있/VA,-1,-0.5983328269045471,28,9,19,17,0.14862339516991124,0.5914165863106438
완화/NNG@$정책/NNG@$펴/VV,-1,-0.5983328269045471,28,9,19,22,0.14862339516991124,0.5914165863106438
경로/NNG@$하방/NNG@$위험/NNG,-1,-0.5983328269045471,28,9,19,26,0.14862339516991124,0.5914165863106438
경제/NNG@$전망/NNG@$성장률/NNG@$전망치/NNG,-1,-0.5983328269045471,28,9,19,63,0.14862339516991124,0.5914165863106438
금리/NNG@$인하/NNG@$시장/NNG,-1,-0.5995870450103691,102,35,67,102,0.2305803341737458,0.9211383975058931
시작/NNG@$금리/NNG@$인하/NNG,-1,-0.6018724538943492,42,14,28,30,0.17988144434502365,0.7237527156851105
서브프라임모기지/NNG@$우량/NNG@$주택/NNG@$담보대출/NNG@$부실/NNG,-1,-0.6018724538943492,42,14,28,43,0.17988144434502365,0.7237527156851105
수입/NNG@$물가/NNG@$하락/NNG,-1,-0.6018724538943492,42,14,28,73,0.17988144434502365,0.7237527156851105
우량/NNG@$주택/NNG@$담보대출/NNG@$부실/NNG,-1,-0.6018724538943492,42,14,28,44,0.17988144434502365,0.7237527156851105
고려/NNG@$금리/NNG@$인하/NNG,-1,-0.6062155878347387,79,27,52,90,0.21977144729324025,0.8964077770797219
금리/NNG@$인하/NNG@$소비/NNG,-1,-0.6068377597844097,31,10,21,25,0.15290254025739675,0.6248886609340941
금리/NNG@$인하/NNG@$나설/VV@$가능성/NNG,-1,-0.6068377597844097,31,10,21,41,0.15290254025739675,0.6248886609340941
가능성/NNG@$높/VA@$보/VV,-1,-0.6068377597844097,31,10,21,34,0.15290254025739675,0.6248886609340941
인상/NNG@$위안화/NNG@$절상/NNG,-1,-0.6083871344878153,45,15,30,91,0.1822821256822225,0.7486212449089248
중기적/NNG@$물가/NNG@$기조/NNG@$유지/NNG@$금융/NNG,-1,-0.6139597001948649,48,16,32,34,0.18453570352425092,0.7714590268627595
경기/NNG@$둔화/NNG@$막/VV,-1,-0.6144295678722267,34,11,23,30,0.15683620472271984,0.6566487149197001
상향/NNG@$조정/NNG@$가능성/NNG,-1,-0.6162092148741203,68,23,45,87,0.20676054192207957,0.8706391524477507
자본/NNG@$유출입/NNG@$동향/NNG,-1,-0.6181696675170483,71,24,47,53,0.20779532427881317,0.8805470604460842
물가/NNG@$상승/NNG@$부담/NNG,-1,-0.6211201733196517,37,12,25,27,0.1604712494236959,0.6865427045224933
소수/NNG@$의견/NNG@$낸/VV,-1,-0.6211201733196517,37,12,25,27,0.1604712494236959,0.6865427045224933
금리/NNG@$인상/NNG@$확률/NNG,-1,-0.6232325082190273,86,29,57,97,0.2119706621258328,0.9131348152906547
지속/NNG@$경기/NNG@$회복/NNG,-1,-0.6260527600042707,57,19,38,62,0.19048649136442708,0.828197479167797
금융/NNG@$위기/NNG@$경기침체/NNG,-1,-0.6260527600042707,57,19,38,38,0.19048649136442708,0.828197479167797
금리/NNG@$인하/NNG@$조치/NNG,-1,-0.6267755911485082,249,83,166,161,0.21476894139860522,0.9359935359012869
유지/NNG@$가능성/NNG@$크/VA,-1,-0.626953374446914,40,13,27,48,0.1638425449918509,0.7144667668614295
점진적/NNG@$금리/NNG@$인상/NNG@$기조/NNG,-1,-0.626953374446914,40,13,27,29,0.1638425449918509,0.7144667668614295
상승률/NNG@$높/VA@$예상/NNG,-1,-0.6320913413412655,20,6,14,23,0.11381879609181955,0.5048354721968847
자산/NNG@$시장/NNG@$과열/NNG,-1,-0.6320913413412655,20,6,14,29,0.11381879609181955,0.5048354721968847
실제/NNG@$소비자/NNG@$물가/NNG,-1,-0.6320913413412655,20,6,14,29,0.11381879609181955,0.5048354721968847
기금/NNG@$금리/NNG@$인상/NNG,-1,-0.6329224318399654,66,22,44,85,0.19536930292939597,0.868947433527822
규모/NNG@$개방/NNG@$경제/NNG,0,-0.6330276450143613,17,5,12,30,0.10501435460653727,0.4672379139436795
양적완화/NNG@$규모/NNG@$확대/NNG,0,-0.6330276450143613,17,5,12,54,0.10501435460653727,0.4672379139436795
인상/NNG@$속도/NNG@$조절/NNG,0,-0.6330276450143613,17,5,12,39,0.10501435460653727,0.4672379139436795
인플레이션/NNG@$압력/NNG@$가중/NNG,-1,-0.6342986038476787,23,7,16,47,0.12123039641647827,0.5416796657364644
동일/NNG@$점포/NNG@$매출/NNG,-1,-0.6342986038476787,23,7,16,63,0.12123039641647827,0.5416796657364644
금리/NNG@$인하/NNG@$경기/NNG@$부양/NNG,-1,-0.6362395224414636,75,25,50,97,0.19935776883967504,0.8965739729924849
자산/NNG@$가격/NNG@$하락/NNG,-1,-0.6362901807209258,46,15,31,57,0.1698972143948051,0.7642105537048494
신중/NNG@$필요/NNG@$있/VA,-1,-0.6362901807209258,46,15,31,61,0.1698972143948051,0.7642105537048494
수출/NNG@$증가세/NNG@$둔화/NNG,-1,-0.6362901807209258,46,15,31,85,0.1698972143948051,0.7642105537048494
하향/NNG@$조정/NNG@$전망/NNG,-1,-0.6379412004023144,26,8,18,50,0.12766106082213347,0.5774244391860132
유로지역/NNG@$경제활동/NNG@$부진/NNG,-1,-0.6379412004023144,26,8,18,66,0.12766106082213347,0.5774244391860132
전미/NNG@$주택/NNG@$건설업/NNG,-1,-0.6379412004023144,26,8,18,64,0.12766106082213347,0.5774244391860132
소비자/NNG@$물가/NNG@$오름세/NNG,-1,-0.6379412004023144,26,8,18,28,0.12766106082213347,0.5774244391860132
경제/NNG@$침체/NNG@$우려/NNG,-1,-0.6379412004023144,26,8,18,30,0.12766106082213347,0.5774244391860132
물가/NNG@$기조/NNG@$유지/NNG@$금융/NNG@$유의/NNG,-1,-0.6399251396180278,49,16,33,34,0.17262082321050504,0.786026374253263
금리/NNG@$인하/NNG@$속도/NNG,-1,-0.6399251396180278,49,16,33,17,0.17262082321050504,0.786026374253263
하향/NNG@$조정/NNG@$경제/NNG,-1,-0.6399251396180278,49,16,33,51,0.17262082321050504,0.786026374253263
소비자/NNG@$물가/NNG@$근원인플레이션/NNG,0,-0.640524525238227,14,4,10,15,0.0940840456493127,0.4292800436665587
경제/NNG@$성장세/NNG@$예상/NNG,0,-0.640524525238227,14,4,10,35,0.0940840456493127,0.4292800436665587
회복/NNG@$속도/NNG@$빠르/VA,-1,-0.6421177200089887,29,9,20,33,0.13335878955389194,0.6117769297722558
단기적/NNG@$경기/NNG@$부양/NNG,-1,-0.6421177200089887,29,9,20,34,0.13335878955389194,0.6117769297722558
기준금리/NNG@$인하/NNG@$시장/NNG,-1,-0.6454478633009699,55,18,37,38,0.1775396305074436,0.8237557438762002
시장/NNG@$금리/NNG@$급등/NNG,-1,-0.6474533913891461,58,19,39,78,0.17976071452157114,0.839818596365281
인플레이션/NNG@$경제/NNG@$성장/NNG,-1,-0.6490267263546547,61,20,41,69,0.18183793174352972,0.8541384390845869
공격적/NNG@$금리/NNG@$인하/NNG@$단행/NNG,-1,-0.6503407213932597,35,11,24,22,0.14313753549177072,0.6754121862424837
위기/NNG@$경기/NNG@$둔화/NNG,-1,-0.6503407213932597,35,11,24,27,0.14313753549177072,0.6754121862424837
조정/NNG@$가능성/NNG@$있/VA,-1,-0.6503407213932597,35,11,24,20,0.14313753549177072,0.6754121862424837
달러/NNG@$약세/NNG@$지속/NNG,-1,-0.6539831331771091,38,12,26,17,0.14740033769070687,0.704384391022987
전망/NNG@$성장률/NNG@$전망치/NNG,-1,-0.6572009817274538,41,13,28,90,0.15132559540699034,0.731336143314967
채권/NNG@$딜러/NNG@$금리/NNG,-1,-0.6599718383403166,44,14,30,46,0.15495525868656448,0.7562298987812363
인위적/NNG@$경기/NNG@$부양/NNG,-1,-0.6599718383403166,44,14,30,42,0.15495525868656448,0.7562298987812363
상승/NNG@$압력/NNG@$예상/NNG,-1,-0.6599718383403166,44,14,30,41,0.15495525868656448,0.7562298987812363
경기/NNG@$부양/NNG@$금리/NNG@$인하/NNG,-1,-0.6662920823375471,80,26,54,74,0.1834441112901349,0.9156573042656782
금리/NNG@$인하/NNG@$압력/NNG,-1,-0.6676078392993102,74,24,50,80,0.18011234651484426,0.9032907782954641
중기적/NNG@$소비자/NNG@$물가/NNG@$상승률/NNG,-1,-0.6681057321932313,62,20,42,100,0.17201463336450218,0.8642288761927598
딜러/NNG@$금리/NNG@$인하/NNG,-1,-0.6816571760714253,30,9,21,25,0.11959778660464569,0.6314894935167965
여부/NNG@$결정/NNG@$예정/NNG,-1,-0.6816571760714253,30,9,21,25,0.11959778660464569,0.6314894935167965
증권/NNG@$기준금리/NNG@$인하/NNG,-1,-0.6818180049232747,27,8,19,27,0.1131498974577161,0.5978024202891247
국채/NNG@$매입/NNG@$결정/NNG,-1,-0.6818180049232747,27,8,19,25,0.1131498974577161,0.5978024202891247
금융시장/NNG@$불안/NNG@$해소/NNG,-1,-0.6818180049232747,27,8,19,24,0.1131498974577161,0.5978024202891247
시장/NNG@$불안/NNG@$요인/NNG,-1,-0.6822454461370662,33,10,23,29,0.12537148466665743,0.6634301103032626
긍정적/NNG@$효과/NNG@$있/VA,-1,-0.6822454461370662,33,10,23,22,0.12537148466665743,0.6634301103032626
인하/NNG@$나설/VV@$가능성/NNG,-1,-0.683166668917798,36,11,25,56,0.1305976114518691,0.693469819584398
기준금리/NNG@$인하/NNG@$여부/NNG,-1,-0.683166668917798,36,11,25,34,0.1305976114518691,0.693469819584398
금융시장/NNG@$불안/NNG@$실물경제/NNG,-1,-0.683166668917798,36,11,25,12,0.1305976114518691,0.693469819584398
가계부채/NNG@$증가/NNG@$우려/NNG,-1,-0.6834252379656983,24,7,17,33,0.10584481499682262,0.5625775893772338
위기/NNG@$대응/NNG@$능력/NNG,-1,-0.6834252379656983,24,7,17,30,0.10584481499682262,0.5625775893772338
가계부채/NNG@$급/NNG@$증세/NNG,-1,-0.6834252379656983,24,7,17,42,0.10584481499682262,0.5625775893772338
노력/NNG@$필요/NNG@$있/VA,-1,-0.6834252379656983,24,7,17,45,0.10584481499682262,0.5625775893772338
성장률/NNG@$전망/NNG@$낮/VA,-1,-0.6834252379656983,24,7,17,31,0.10584481499682262,0.5625775893772338
달러/NNG@$엔/NNG@$환율/NNG,-1,-0.6841707622235964,39,12,27,54,0.13536691539320223,0.7215050456632283
실물/NNG@$경기/NNG@$둔화/NNG,-1,-0.6851085955193108,42,13,29,32,0.13974659803425257,0.7474782184796919
성장/NNG@$지속/NNG@$중기적/NNG,-1,-0.6876700670319222,21,6,15,34,0.0974080049014203,0.5260790048168911
경제/NNG@$성장/NNG@$지속/NNG@$중기적/NNG,-1,-0.6876700670319222,21,6,15,34,0.0974080049014203,0.5260790048168911
서부텍사스산원유/NNG@$가격/NNG@$하락/NNG,-1,-0.6876700670319222,21,6,15,31,0.0974080049014203,0.5260790048168911
양적완화/NNG@$축소/NNG@$금리/NNG,-1,-0.6876700670319222,21,6,15,30,0.0974080049014203,0.5260790048168911
대출/NNG@$높/VA@$증가세/NNG,-1,-0.6876700670319222,21,6,15,13,0.0974080049014203,0.5260790048168911
개별소비세/NNG@$인하/NNG@$종료/NNG,-1,-0.6876700670319222,21,6,15,20,0.0974080049014203,0.5260790048168911
인하/NNG@$가능성/NNG@$시사/NNG,-1,-0.6928638543774974,117,37,80,85,0.17213662982696493,0.948266843897599
생각/NNG@$볼/VX@$필요/NNG,0,-0.6966509445565003,18,5,13,22,0.08741191442205609,0.4886237045823033
확대/NNG@$기준금리/NNG@$인하/NNG,0,-0.6966509445565003,18,5,13,33,0.08741191442205609,0.4886237045823033
국채/NNG@$금리/NNG@$오른/VV,0,-0.6966509445565003,18,5,13,40,0.08741191442205609,0.4886237045823033
성장/NNG@$전망/NNG@$경로/NNG,0,-0.6966509445565003,18,5,13,17,0.08741191442205609,0.4886237045823033
완화/NNG@$정책/NNG@$시행/NNG,0,-0.6966509445565003,18,5,13,33,0.08741191442205609,0.4886237045823033
경제/NNG@$전망/NNG@$반영/NNG,0,-0.6966509445565003,18,5,13,17,0.08741191442205609,0.4886237045823033
금리/NNG@$인하/NNG@$결정/NNG,-1,-0.7000571119699268,224,70,154,170,0.16804511993359258,0.9519053364411432
부양/NNG@$금리/NNG@$인하/NNG,-1,-0.7014514786891829,89,28,61,87,0.16458326320414876,0.9374078955368447
기준금리/NNG@$인하/NNG@$기대/NNG,-1,-0.7078489627888109,96,30,66,179,0.16170348286167438,0.9446653995536369
금리/NNG@$인하/NNG@$가능성/NNG@$열/VV,-1,-0.7078489627888109,96,30,66,74,0.16170348286167438,0.9446653995536369
인하/NNG@$단행/NNG@$금리/NNG,-1,-0.707928954964818,52,16,36,48,0.1412573401155338,0.8254839835197909
영향/NNG@$가능성/NNG@$상존/NNG,-1,-0.7098411715855587,46,14,32,40,0.13343984320030167,0.7858057221200634
서브프라임/NNG@$모기/NNG@$지발/NNG,-1,-0.7107728925143694,43,13,30,31,0.12906612440423615,0.7629077923486842
석유류/NNG@$가격/NNG@$하락/NNG,-1,-0.7107728925143694,43,13,30,37,0.12906612440423615,0.7629077923486842
소비/NNG@$지출/NNG@$전망/NNG,-1,-0.7127566915521368,90,28,62,125,0.15794729350475406,0.9411467325304602
부양/NNG@$기조/NNG@$유지/NNG,-1,-0.7130240876424476,37,11,26,76,0.11916562983846402,0.7108328379466108
제기/NNG@$금리/NNG@$인상/NNG,-1,-0.7130240876424476,37,11,26,44,0.11916562983846402,0.7108328379466108
금리/NNG@$인하/NNG@$압박/NNG,-1,-0.7139156909358053,126,39,87,147,0.15927732525495594,0.9535525414463871
하방/NNG@$리스크/NNG@$커지/VV,0,-0.7142160385040238,15,4,11,46,0.07517005446034249,0.4505746428846129
움직임/NNG@$보이/VV@$않/VX,0,-0.7142160385040238,15,4,11,26,0.07517005446034249,0.4505746428846129
경기/NNG@$전망/NNG@$하락/NNG,0,-0.7142160385040238,15,4,11,37,0.07517005446034249,0.4505746428846129
회복세/NNG@$완만/XR@$예상/NNG,0,-0.7142160385040238,15,4,11,37,0.07517005446034249,0.4505746428846129
자금조달/NNG@$어려움/NNG@$겪/VV,-1,-0.7146824103029061,34,10,24,29,0.11351122848598137,0.6816892934407786
금리/NNG@$인하/NNG@$영향/NNG,-1,-0.7170857204909231,31,9,22,39,0.10726801167371261,0.6505656388637975
부진/NNG@$경기/NNG@$회복/NNG,-1,-0.7170857204909231,31,9,22,56,0.10726801167371261,0.6505656388637975
경제/NNG@$차지/NNG@$비중/NNG,-1,-0.7170857204909231,31,9,22,31,0.10726801167371261,0.6505656388637975
가격/NNG@$하락/NNG@$경제/NNG,-1,-0.7207366249162988,28,8,20,36,0.10030648241100891,0.6175892122696551
하향/NNG@$조정/NNG@$불가피/XR,-1,-0.7207366249162988,28,8,20,31,0.10030648241100891,0.6175892122696551
물가/NNG@$상승률/NNG@$마이너스/NNG,-1,-0.7207366249162988,28,8,20,31,0.10030648241100891,0.6175892122696551
자산/NNG@$시장/NNG@$거품/NNG,-1,-0.7207366249162988,28,8,20,49,0.10030648241100891,0.6175892122696551
긍정적/NNG@$영향/NNG@$기대/NNG,-1,-0.7207366249162988,28,8,20,29,0.10030648241100891,0.6175892122696551
해외/NNG@$투자/NNG@$확대/NNG,-1,-0.7207366249162988,28,8,20,36,0.10030648241100891,0.6175892122696551
인하/NNG@$경기/NNG@$부양책/NNG,-1,-0.7233188711980182,59,18,41,44,0.13938631954005798,0.8674946320928396
인하/NNG@$가능성/NNG@$열/VV,-1,-0.724365498997114,167,51,116,132,0.15302204257384788,0.9565469448419696
물가/NNG@$금리/NNG@$인하/NNG,-1,-0.7264319131971371,25,7,18,26,0.09244664353871639,0.582939857677405
금리/NNG@$인하/NNG@$신중/NNG,-1,-0.7264319131971371,25,7,18,32,0.09244664353871639,0.582939857677405
금융시장/NNG@$불안/NNG@$지속/NNG,-1,-0.7264319131971371,25,7,18,23,0.09244664353871639,0.582939857677405
수당/NNG@$청구/NNG@$감소/NNG,-1,-0.7264319131971371,25,7,18,65,0.09244664353871639,0.582939857677405
시장/NNG@$금리/NNG@$낮/VA,-1,-0.7264319131971371,25,7,18,38,0.09244664353871639,0.582939857677405
실업/NNG@$수당/NNG@$청구/NNG@$감소/NNG,-1,-0.7264319131971371,25,7,18,65,0.09244664353871639,0.582939857677405
달러/NNG@$엔/NNG@$상승/NNG,-1,-0.7264319131971371,25,7,18,36,0.09244664353871639,0.582939857677405
가계부채/NNG@$증가세/NNG@$둔화/NNG,-1,-0.7264319131971371,25,7,18,21,0.09244664353871639,0.582939857677405
인하/NNG@$유동성/NNG@$공급/NNG,-1,-0.7313402350202072,69,21,48,56,0.1409752180116169,0.9077197558214031
금리/NNG@$인하/NNG@$유동성/NNG@$공급/NNG,-1,-0.7319134422202789,47,14,33,44,0.12387008683439506,0.7995479348265115
기조/NNG@$유지/NNG@$금융/NNG@$유의/NNG@$통화정책/NNG,-1,-0.7319134422202789,47,14,33,33,0.12387008683439506,0.7995479348265115
유지/NNG@$금융/NNG@$유의/NNG@$통화정책/NNG,-1,-0.7319134422202789,47,14,33,33,0.12387008683439506,0.7995479348265115
유로존/NNG@$물가/NNG@$상승률/NNG,-1,-0.7341201122276784,66,20,46,79,0.13793787220642256,0.8988664776286531
소비자/NNG@$물가/NNG@$영향/NNG,-1,-0.7343082854239327,44,13,31,35,0.11923752719123101,0.7776397510909958
자금/NNG@$유입/NNG@$주가/NNG,-1,-0.7354569827778301,22,6,16,19,0.08343332025223317,0.5468516990674723
기준금리/NNG@$인하/NNG@$통화/NNG@$완화/NNG,-1,-0.7354569827778301,22,6,16,35,0.08343332025223317,0.5468516990674723
하방/NNG@$리스크/NNG@$있/VA,-1,-0.7354569827778301,22,6,16,29,0.08343332025223317,0.5468516990674723
달러/NNG@$강세/NNG@$보이/VV,-1,-0.7354569827778301,22,6,16,28,0.08343332025223317,0.5468516990674723
하방/NNG@$위험/NNG@$크/VA,-1,-0.7354569827778301,22,6,16,36,0.08343332025223317,0.5468516990674723
원자재/NNG@$가격/NNG@$상승/NNG@$인플레이션/NNG,-1,-0.7354569827778301,22,6,16,46,0.08343332025223317,0.5468516990674723
국채/NNG@$모기지/NNG@$담보/NNG@$증권/NNG,-1,-0.7354569827778301,22,6,16,29,0.08343332025223317,0.5468516990674723
재정/NNG@$건전성/NNG@$악화/NNG,-1,-0.7369726574118918,41,12,29,51,0.11422530519031297,0.7536342389819156
경기/NNG@$부양책/NNG@$경제/NNG,-1,-0.7369726574118918,41,12,29,22,0.11422530519031297,0.7536342389819156
금리/NNG@$인하/NNG@$가능성/NNG@$크/VA,-1,-0.7438348486271952,35,10,25,45,0.10282352066483934,0.6992858101886391
경기/NNG@$회복/NNG@$걸림돌/NNG,-1,-0.7438348486271952,35,10,25,41,0.10282352066483934,0.6992858101886391
인하/NNG@$여부/NNG@$결정/NNG,-1,-0.7438348486271952,35,10,25,24,0.10282352066483934,0.6992858101886391
인상/NNG@$확률/NNG@$높/VA,-1,-0.7438348486271952,35,10,25,32,0.10282352066483934,0.6992858101886391
환율/NNG@$경상수지/NNG@$흑자/NNG,0,-0.7476992553153117,12,3,9,34,0.05958433570143523,0.4123254067580255
엠파이어/NNG@$스테이트/NNG@$지수/NNG,0,-0.7476992553153117,12,3,9,73,0.05958433570143523,0.4123254067580255
전미/NNG@$주택/NNG@$건설/NNG,0,-0.7476992553153117,12,3,9,50,0.05958433570143523,0.4123254067580255
수요/NNG@$상승/NNG@$압력/NNG,-1,-0.7486279011544954,32,9,23,32,0.09627160425891061,0.6690124230219978
조정/NNG@$가능성/NNG@$높/VA,-1,-0.7486279011544954,32,9,23,53,0.09627160425891061,0.6690124230219978
경기/NNG@$회복세/NNG@$지원/NNG,-1,-0.7499261023078599,19,5,14,27,0.07290179104548175,0.5096115802635091
경상수지/NNG@$흑자/NNG@$감소/NNG,-1,-0.7499261023078599,19,5,14,31,0.07290179104548175,0.5096115802635091
인하/NNG@$단행/NNG@$않/VX,-1,-0.7499261023078599,19,5,14,33,0.07290179104548175,0.5096115802635091
경기/NNG@$둔화/NNG@$수요/NNG,-1,-0.7499261023078599,19,5,14,40,0.07290179104548175,0.5096115802635091
기준금리/NNG@$인상/NNG@$인하/NNG,-1,-0.7499261023078599,19,5,14,31,0.07290179104548175,0.5096115802635091
경기/NNG@$부진/NNG@$심화/NNG,-1,-0.7499261023078599,19,5,14,23,0.07290179104548175,0.5096115802635091
경제/NNG@$소비자들/NNG@$심리/NNG,-1,-0.7499261023078599,19,5,14,35,0.07290179104548175,0.5096115802635091
금리/NNG@$인하/NNG@$요구/NNG,-1,-0.7507820342301293,87,26,61,86,0.13496740246259917,0.9471689433599926
금융/NNG@$위기/NNG@$확산/NNG,-1,-0.7522180625064985,48,14,34,30,0.11503440824443588,0.8126161818668878
부동산/NNG@$규제/NNG@$완화/NNG,-1,-0.7541122135187691,74,22,52,81,0.1300911505419857,0.9270400811618741
하향/NNG@$조정/NNG@$금리/NNG@$인하/NNG,-1,-0.7549805288955997,29,8,21,25,0.08900201134996606,0.636792246848952
금융/NNG@$위기/NNG@$해소/NNG,-1,-0.7549805288955997,29,8,21,24,0.08900201134996606,0.636792246848952
금리/NNG@$인하/NNG@$여력/NNG,-1,-0.7551910038741916,61,18,43,54,0.12367746335251491,0.8857533915474213
변화/NNG@$해외/NNG@$위험/NNG@$요인/NNG,-1,-0.7588193543701531,58,17,41,33,0.11987829993364756,0.8732269833218592
최악/NNG@$금융/NNG@$위기/NNG,-1,-0.7598699852082915,42,12,30,22,0.10500305186638552,0.7686678264127056
달성/NNG@$쉽/VA@$않/VX,-1,-0.7636989462122619,26,7,19,46,0.0808563545256895,0.6027767523519099
완화/NNG@$기조/NNG@$지속/NNG,-1,-0.7636989462122619,26,7,19,38,0.0808563545256895,0.6027767523519099
농산물/NNG@$석유류/NNG@$근원인플레이션율/NNG,-1,-0.764481129778739,39,11,28,70,0.09936170332847014,0.7435152898484497
경제/NNG@$금리/NNG@$인하/NNG,-1,-0.7663724042281748,92,27,65,77,0.1264836286224788,0.9551296056032648
물가/NNG@$목표/NNG@$통화정책/NNG,-1,-0.7699266303831407,36,10,26,61,0.09322026249092492,0.716226602578156
대외/NNG@$경제정책/NNG@$경제/NNG,0,-0.7733602001367414,16,4,12,39,0.06034434059912367,0.471552461809807
확인/NNG@$금리/NNG@$인하/NNG,-1,-0.7760134484046495,23,6,17,44,0.07162609673441353,0.5671704646110226
자본/NNG@$유출/NNG@$확대/NNG,-1,-0.7760134484046495,23,6,17,20,0.07162609673441353,0.5671704646110226
경제성장률/NNG@$전망/NNG@$상향/NNG@$조정/NNG,-1,-0.7760134484046495,23,6,17,38,0.07162609673441353,0.5671704646110226
원/NNG@$환율/NNG@$원대/NNG,-1,-0.7765675915571478,33,9,24,50,0.08649708818455176,0.686834284657404
내수/NNG@$부진/NNG@$경기/NNG,-1,-0.7765675915571478,33,9,24,23,0.08649708818455176,0.686834284657404
인하/NNG@$가능성/NNG@$크/VA,-1,-0.7793894223599191,90,26,64,100,0.11874449210384339,0.9564384225786625
경기/NNG@$부양책/NNG@$시행/NNG,-1,-0.7806422655796023,43,12,31,28,0.09659700198265868,0.7830310704697123
민간/NNG@$소비/NNG@$증가세/NNG,-1,-0.78492404758769,30,8,22,27,0.07909001817721226,0.655414166750605
기준금리/NNG@$인하/NNG@$가계부채/NNG,-1,-0.78492404758769,30,8,22,41,0.07909001817721226,0.655414166750605
국제금융시장/NNG@$불안/NNG@$경제/NNG,-1,-0.7932037191922726,37,10,27,12,0.08460908736536797,0.7325180954021062
조정/NNG@$금리/NNG@$인하/NNG,-1,-0.7932037191922726,37,10,27,36,0.08460908736536797,0.7325180954021062
정책금리/NNG@$인상/NNG@$기대/NNG,-1,-0.7938036576037709,20,5,15,20,0.06104642547436177,0.5302305174456984
가계/NNG@$수입/NNG@$전망/NNG@$소비/NNG@$지출/NNG,-1,-0.7957472576390588,27,7,20,37,0.07087261104282801,0.6220903657667819
가계/NNG@$저축/NNG@$전망/NNG,-1,-0.7957472576390588,27,7,20,50,0.07087261104282801,0.6220903657667819
경제/NNG@$보/VV@$수출/NNG,-1,-0.801970966537501,68,19,49,74,0.10173145660745538,0.9241220001222388
기업/NNG@$구조조정/NNG@$추진/NNG,-1,-0.8101183478543454,24,6,18,29,0.06169463670799238,0.5870387153625939
가계부채/NNG@$문제/NNG@$악화/NNG,-1,-0.8101183478543454,24,6,18,18,0.06169463670799238,0.5870387153625939
전망/NNG@$변화/NNG@$없/VA,-1,-0.8101183478543454,24,6,18,40,0.06169463670799238,0.5870387153625939
소수/NNG@$의견/NNG@$냈/VV,-1,-0.8109877077406578,31,8,23,28,0.0704197178761136,0.6734547691515975
유로화/NNG@$사용/NNG@$물가/NNG@$상승률/NNG,-1,-0.8109877077406578,31,8,23,24,0.0704197178761136,0.6734547691515975
유로존/NNG@$유로화/NNG@$사용/NNG@$물가/NNG@$상승률/NNG,-1,-0.8109877077406578,31,8,23,24,0.0704197178761136,0.6734547691515975
사용/NNG@$물가/NNG@$상승률/NNG,-1,-0.8109877077406578,31,8,23,24,0.0704197178761136,0.6734547691515975
부동산/NNG@$자산/NNG@$시장/NNG,0,-0.8114688426788843,13,3,10,31,0.04515377024068614,0.43303872784805525
금융/NNG@$규제/NNG@$개혁/NNG,0,-0.8114688426788843,13,3,10,41,0.04515377024068614,0.43303872784805525
둔화/NNG@$원자재/NNG@$가격/NNG,-1,-0.8164687267736833,45,12,33,58,0.08198127154868647,0.8098000284682876
금리/NNG@$인하/NNG@$기준금리/NNG,-1,-0.8180117386446952,52,14,38,27,0.08611136477428968,0.858512057947273
소비자/NNG@$물가/NNG@$근원물가/NNG,0,-0.8198686603663827,17,4,13,28,0.04882341661088331,0.49226168267134146
잠재적/NNG@$위험/NNG@$요인/NNG,0,-0.8198686603663827,17,4,13,34,0.04882341661088331,0.49226168267134146
은행/NNG@$마이너스금리/NNG@$도입/NNG,-1,-0.8229142779480476,35,9,26,19,0.07015029801828489,0.720614810474812
금리/NNG@$인하/NNG@$금융시장/NNG,-1,-0.8231614112930412,28,7,21,41,0.062292863149223554,0.6408777256397292
물가/NNG@$전망/NNG@$하향/NNG,-1,-0.8231614112930412,28,7,21,18,0.062292863149223554,0.6408777256397292
수입/NNG@$전망/NNG@$소비/NNG@$지출/NNG,-1,-0.8231614112930412,28,7,21,37,0.062292863149223554,0.6408777256397292
국채/NNG@$매입/NNG@$통한/VV,-1,-0.8231614112930412,28,7,21,44,0.062292863149223554,0.6408777256397292
회복세/NNG@$지속/NNG@$유로지역/NNG,-1,-0.8239184596918121,42,11,31,33,0.07619382195279543,0.7875778726655804
금리/NNG@$인하/NNG@$가능성/NNG@$시사/NNG,-1,-0.8288101726633827,89,24,65,63,0.09063891218452046,0.9661469819205796
대미/NNG@$무역/NNG@$흑자/NNG,-1,-0.8295576850307622,21,5,16,30,0.051398217750474665,0.5504876725123334
소비/NNG@$부정적/NNG@$영향/NNG,-1,-0.8295576850307622,21,5,16,24,0.051398217750474665,0.5504876725123334
금리/NNG@$인하/NNG@$부담/NNG,-1,-0.8311575630811355,53,14,39,44,0.08026066557130762,0.8684854788673763
경기/NNG@$하강/NNG@$막/VV,-1,-0.8336036166211018,32,8,24,17,0.06284480955756995,0.6909123877873421
산업/NNG@$통상/NNG@$자원/NNG@$부/NNG,-1,-0.8339135653705356,101,27,74,73,0.08832396023503938,0.9729985042070054
통상/NNG@$자원/NNG@$부/NNG,-1,-0.8339135653705356,101,27,74,73,0.08832396023503938,0.9729985042070054
상승률/NNG@$물가/NNG@$목표/NNG@$통화정책/NNG,-1,-0.8386286554543756,25,6,19,49,0.05335649974907875,0.6064514635855359
가능성/NNG@$낮/VA@$금리/NNG,-1,-0.8397952667596363,43,11,32,30,0.06991993634040673,0.8009843589723076
기준금리/NNG@$인하/NNG@$결정/NNG,-1,-0.8436395731752712,95,25,70,94,0.0827030009839774,0.9726524263953412
경제/NNG@$보/VV@$경기/NNG,-1,-0.8465330239592237,29,7,22,22,0.0549257913604203,0.6591329731907295
기업/NNG@$신뢰/NNG@$지수/NNG,-1,-0.8504576523887682,51,13,38,75,0.06989787805255658,0.8625559292317697
경기/NNG@$회복세/NNG@$예상/NNG,-1,-0.8531912334878528,33,8,25,48,0.05622873955304552,0.7077848755052869
소매/NNG@$판매/NNG@$감소/NNG,-1,-0.8540187545607669,44,11,33,72,0.06425695225142165,0.81376956026858
정책/NNG@$역량/NNG@$집중/NNG,-1,-0.8560436208653245,18,4,14,35,0.039882370132017536,0.5127155487525878
경제/NNG@$경기/NNG@$회복세/NNG,-1,-0.8560436208653245,18,4,14,33,0.039882370132017536,0.5127155487525878
경기/NNG@$부진/NNG@$완화/NNG,0,-0.857907577055661,14,3,11,19,0.03479451701118849,0.4536048574072565
제조업/NNG@$지수/NNG@$예상/NNG,0,-0.857907577055661,14,3,11,38,0.03479451701118849,0.4536048574072565
전망/NNG@$크/VA@$벗어나/VV@$않/VX,0,-0.857907577055661,14,3,11,24,0.03479451701118849,0.4536048574072565
금융시장/NNG@$불안/NNG@$금리/NNG,-1,-0.8585212667049849,22,5,17,26,0.043549190806425574,0.5703769074748372
경기/NNG@$부진/NNG@$장기화/NNG,-1,-0.8585212667049849,22,5,17,15,0.043549190806425574,0.5703769074748372
경기/NNG@$둔화/NNG@$원자재/NNG@$가격/NNG,-1,-0.8585212667049849,22,5,17,32,0.043549190806425574,0.5703769074748372
환율/NNG@$급/NNG@$등락/NNG,-1,-0.8585212667049849,22,5,17,29,0.043549190806425574,0.5703769074748372
인하/NNG@$경기/NNG@$회복/NNG,-1,-0.8631644391075269,41,10,31,47,0.058299215733859086,0.7913267194725478
인하/NNG@$통화/NNG@$완화/NNG@$정책/NNG,-1,-0.866424066186116,30,7,23,38,0.04859780416793832,0.6768488928906832
고용/NNG@$비용/NNG@$지수/NNG,-1,-0.866424066186116,30,7,23,26,0.04859780416793832,0.6768488928906832
시장/NNG@$금리/NNG@$크/VA,-1,-0.866424066186116,30,7,23,20,0.04859780416793832,0.6768488928906832
불안/NNG@$요인/NNG@$상존/NNG,-1,-0.8733576128613725,38,9,29,43,0.05200952938813775,0.7666683216916119
대출/NNG@$증가/NNG@$속도/NNG,-1,-0.8840725434185353,19,4,15,26,0.03291944185922029,0.5329071325012769
불안/NNG@$심리/NNG@$진정/NNG,-1,-0.8840725434185353,19,4,15,18,0.03291944185922029,0.5329071325012769
기준금리/NNG@$인하/NNG@$경제/NNG,-1,-0.8848120430876706,35,8,27,39,0.04539011198066642,0.7397674123964101
내수/NNG@$부진/NNG@$심화/NNG,-1,-0.8874495643710939,43,10,33,11,0.04892050734635877,0.817029621449741
기준금리/NNG@$인하/NNG@$통화정책/NNG,-1,-0.8874495643710939,43,10,33,39,0.04892050734635877,0.817029621449741
외국인/NNG@$자금/NNG@$유출/NNG,-1,-0.8895816753282217,67,16,51,101,0.05546752956828105,0.9452273102341835
경제/NNG@$전망/NNG@$기준금리/NNG,0,-0.8915214942480282,15,3,12,52,0.027303634317831053,0.47404307471520646
전망/NNG@$소비/NNG@$지출/NNG,-1,-0.8977525843475643,32,7,25,41,0.038466089031133514,0.7106332293660084
가계/NNG@$소비/NNG@$심리/NNG,-1,-0.8986287924830237,28,6,22,60,0.035503685022342316,0.661845505421444
성장/NNG@$경로/NNG@$하방/NNG@$위험/NNG,-1,-0.9008680931918924,24,5,19,22,0.03191346811293839,0.6089912431374684
금리/NNG@$인하/NNG@$배경/NNG,-1,-0.9022476381271745,99,23,76,54,0.050838135528013334,0.9844419588102618
기준금리/NNG@$결정/NNG@$통화정책/NNG,-1,-0.9058131631868589,20,4,16,39,0.027462124488640317,0.5528179691781904
완화/NNG@$기준금리/NNG@$인하/NNG,-1,-0.9085354832201411,37,8,29,31,0.03707053198282922,0.7693970445004437
자본/NNG@$유출/NNG@$환율/NNG,0,-0.9104575874617196,11,2,9,38,0.019540106950786174,0.4146173245520108
지표/NNG@$좋/VA@$않/VX,-1,-0.9123702986778557,29,6,23,29,0.031304375105818974,0.679317847332771
투기/NNG@$자금/NNG@$유입/NNG,-1,-0.9162218561689146,25,5,20,37,0.027606615265605802,0.6276776798824275
성장/NNG@$전망/NNG@$하향/NNG@$조정/NNG,-1,-0.9162218561689146,25,5,20,37,0.027606615265605802,0.6276776798824275
금융시장/NNG@$불안/NNG@$심리/NNG,-1,-0.9205296384879698,34,7,27,17,0.030906911200868664,0.7421792979474524
예상/NNG@$채권/NNG@$시장/NNG,-1,-0.9227500206737449,21,4,17,30,0.023149999421376976,0.5724233057040357
실적/NNG@$시장/NNG@$예상/NNG,-1,-0.9227500206737449,21,4,17,30,0.023149999421376976,0.5724233057040357
증시/NNG@$긍정적/NNG@$영향/NNG,-1,-0.9227500206737449,21,4,17,31,0.023149999421376976,0.5724233057040357
파산/NNG@$보호/NNG@$신청/NNG,-1,-0.9238676325632766,30,6,24,30,0.027738411698246403,0.6962723352221287
대출/NNG@$금리/NNG@$인하/NNG,-1,-0.9238821998142944,56,12,44,70,0.03646504054697978,0.9155034432448865
달러/NNG@$가치/NNG@$상승/NNG,-1,-0.9264400354728557,39,8,31,49,0.030633979767395902,0.7966872890025146
지속/NNG@$전망/NNG@$통화정책/NNG,-1,-0.9335202531480997,31,6,25,17,0.024697730436857232,0.7126976913949863
국책은행/NNG@$자본/NNG@$확충/NNG,-1,-0.9337110882262383,40,8,32,79,0.027968554767737182,0.8094653444735711
감소세/NNG@$지속/NNG@$소비/NNG,-1,-0.9338566717873213,17,3,14,34,0.017736330513829297,0.5144827379270154
금리/NNG@$상승/NNG@$우려/NNG,-1,-0.9338566717873213,17,3,14,36,0.017736330513829297,0.5144827379270154
인플레이션기대심리/NNG@$낮추/VV@$노력/NNG,-1,-0.9338566717873213,17,3,14,50,0.017736330513829297,0.5144827379270154
석유류/NNG@$제품/NNG@$가격/NNG,0,-0.9355300366579199,12,2,10,20,0.014601716608555377,0.43482241455000153
매입/NNG@$규모/NNG@$줄이/VV,0,-0.9355300366579199,12,2,10,47,0.014601716608555377,0.43482241455000153
금리/NNG@$인하/NNG@$가계부채/NNG,-1,-0.938447115947891,78,16,62,63,0.03135825888953672,0.9791059021738759
이유/NNG@$금리/NNG@$인하/NNG,-1,-0.9389456343361531,27,5,22,38,0.021080937584984333,0.6637065988161065
요인/NNG@$소비자/NNG@$물가/NNG,-1,-0.9389456343361531,27,5,22,21,0.021080937584984333,0.6637065988161065
가계/NNG@$기업/NNG@$대출/NNG,-1,-0.946522554382776,23,4,19,32,0.016945093980067723,0.6106056202813485
경제/NNG@$위기/NNG@$대응/NNG,-1,-0.946522554382776,23,4,19,27,0.016945093980067723,0.6106056202813485
자산/NNG@$매입/NNG@$규모/NNG@$확대/NNG,-1,-0.946522554382776,23,4,19,33,0.016945093980067723,0.6106056202813485
가격/NNG@$하락/NNG@$확대/NNG,-1,-0.947158235695821,18,3,15,17,0.01465194953378037,0.5344270025968721
통화/NNG@$금융/NNG@$대책/NNG,-1,-0.947158235695821,18,3,15,34,0.01465194953378037,0.5344270025968721
금융/NNG@$위기/NNG@$실물경제/NNG,-1,-0.9512137495038394,48,9,39,19,0.02230293564662135,0.882117223818321
조정/NNG@$가능성/NNG@$크/VA,0,-0.952180899835575,13,2,11,43,0.011273962041328241,0.455033704722672
부정적/NNG@$영향/NNG@$않/VX,-1,-0.9543131858448338,29,5,24,23,0.016509942932795268,0.6978174811378108
통화정책/NNG@$변화/NNG@$해외/NNG@$위험/NNG@$요인/NNG,-1,-0.9543935995461781,34,6,28,26,0.017918777648286935,0.7587129695055709
기준금리/NNG@$내릴/VV@$가능성/NNG,-1,-0.954652075775803,39,7,32,36,0.019046619072050467,0.811110752127188
환율/NNG@$상승/NNG@$물가/NNG,-1,-0.954652075775803,39,7,32,35,0.019046619072050467,0.811110752127188
은행/NNG@$지준율/NNG@$인상/NNG,-1,-0.9590019822101612,40,7,33,42,0.017462131653754848,0.8232054401886503
채무/NNG@$상환/NNG@$부담/NNG,-1,-0.9601033982855196,30,5,25,30,0.01473875315792315,0.7141132011462827
국면/NNG@$진입/NNG@$가능성/NNG,0,-0.9635593673543905,14,2,12,29,0.008955493569558095,0.4752162334154013
정책금리/NNG@$인상/NNG@$예상/NNG,0,-0.9635593673543905,14,2,12,27,0.008955493569558095,0.4752162334154013
채권/NNG@$시장/NNG@$기준금리/NNG@$인하/NNG,-1,-0.9649510091177028,31,5,26,66,0.013228739461775248,0.729885293934056
금리/NNG@$인하/NNG@$환율/NNG,-1,-0.9702361311984716,49,8,41,26,0.013856954280048992,0.8999956121518906
시장/NNG@$금리/NNG@$인하/NNG@$기대감/NNG,-1,-0.9753737852610984,22,3,19,53,0.007802536947747762,0.6115292957452877
경기/NNG@$과도/NNG@$위축/NNG,-1,-0.9759888534571063,46,7,39,6,0.011006907357113368,0.8845007652715282
상승률/NNG@$기록/NNG@$물가/NNG,-1,-0.9790586821578959,23,3,20,36,0.00685122710523265,0.6299584718837326
기준금리/NNG@$인하/NNG@$조치/NNG,-1,-0.9797471184580456,42,6,36,30,0.0090208386049937,0.8571200002683051
경제/NNG@$완만/XR@$회복세/NNG@$지속/NNG@$전망/NNG,-1,-0.980758157872212,30,4,26,37,0.00731411981666314,0.7307232661379409
통화/NNG@$부양/NNG@$기조/NNG,-1,-0.980758157872212,30,4,26,43,0.00731411981666314,0.7307232661379409
경기/NNG@$활성화/NNG@$대책/NNG,-1,-0.9815814393416583,17,2,15,33,0.00513230982392887,0.5351554267462978
금리/NNG@$재할인율/NNG@$인하/NNG,-1,-0.982195779619367,50,7,43,32,0.008493546615910494,0.915469898866075
회복/NNG@$지원/NNG@$중기적/NNG,-1,-0.9829060863899655,31,4,27,23,0.006650964694353837,0.7458992621387164
성장세/NNG@$회복/NNG@$지원/NNG@$중기적/NNG,-1,-0.9829060863899655,31,4,27,23,0.006650964694353837,0.7458992621387164
부채/NNG@$상환/NNG@$비율/NNG@$규제/NNG@$완화/NNG,-1,-0.9844239539077773,25,3,22,39,0.005421786803129695,0.6655811426786457
비율/NNG@$규제/NNG@$완화/NNG,-1,-0.9844239539077773,25,3,22,39,0.005421786803129695,0.6655811426786457
상환/NNG@$비율/NNG@$규제/NNG@$완화/NNG,-1,-0.9844239539077773,25,3,22,39,0.005421786803129695,0.6655811426786457
금리/NNG@$인하/NNG@$공조/NNG,-1,-0.9868158900538958,92,12,80,15,0.006913591565558947,0.9970965349212546
예상/NNG@$성장/NNG@$경로/NNG,-1,-0.9919775335074626,22,2,20,33,0.0027281241898853017,0.6303812665915808
하방/NNG@$리스크/NNG@$커졌/VV,-1,-0.992358790140282,31,3,28,25,0.003147239152953626,0.7609775395154327
물가/NNG@$상승/NNG@$확대/NNG,-1,-0.9930770000888816,32,3,29,20,0.002925343831555659,0.7750518182785688
유로지역/NNG@$경기/NNG@$부진/NNG,-1,-0.9951035588823266,26,2,24,40,0.0019283959711655465,0.6997002317444055
통화정책/NNG@$결정/NNG@$기준금리/NNG,-1,-0.997755496001603,21,1,20,30,0.0008995270573902041,0.6305653745576419
기준금리/NNG@$인하/NNG@$배경/NNG,-1,-0.9998809683976424,21,0,21,31,0.0002357853890737561,0.6486112696033672
세월/NNG@$사고/NNG@$영향/NNG,-1,-1.0,29,0,29,21,0.0002357853890737561,0.7754603040534968
