word,label,polarity,count,pos_count,neg_count,neu_count,pos_score,neg_score
통화정책/NNG@$완화/NNG@$조정/NNG@$필요/NNG,1,1.0,30,28,2,42,0.6505065950635485,2.5923358038819783e-06
완화/NNG@$조정/NNG@$필요/NNG,1,0.999897392512995,32,28,4,50,0.6505030662570883,3.594464600776342e-05
마이너스/NNG@$갭/NNG@$지속/NNG,1,0.9998515242835995,37,32,5,18,0.7034337395164476,5.4993134170684966e-05
금리/NNG@$인상/NNG@$소수/NNG@$의견/NNG,1,0.9994820719190365,42,35,7,8,0.740019436399154,0.00019450711282860438
소득/NNG@$주도/NNG@$성장/NNG,1,0.9994335801085845,36,30,6,52,0.6775118624052621,0.00019450223613212862
통화/NNG@$증가율/NNG@$높/VA,0,0.9994216577942447,19,16,3,18,0.4712836416858119,0.00013810668751873566
재정/NNG@$문제/NNG@$국제금융시장/NNG,1,0.9992603573737544,40,33,7,6,0.7159158399813758,0.00026753223530461055
보유/NNG@$자산/NNG@$축소/NNG,1,0.9989346231832543,63,51,12,244,0.8864747165972161,0.0004756786573568692
인상/NNG@$소수/NNG@$의견/NNG,1,0.998615763700565,85,68,17,28,0.963431224830386,0.0006706566937307228
중소기업/NNG@$대출/NNG@$증가/NNG,1,0.9974961411294356,25,20,5,15,0.5332643660449278,0.0006701175186123035
개인/NNG@$서비스/NNG@$요금/NNG,1,0.9960957291101638,28,22,6,10,0.5636236888509525,0.0011039190090043668
규모/NNG@$인프라/NNG@$투자/NNG,1,0.9957851012116337,32,25,7,17,0.6079499130161425,0.0012854798420991807
가격/NNG@$상승/NNG@$우려/NNG,1,0.9954204812316854,40,31,9,14,0.6904424333530282,0.0015862499502374103
정책/NNG@$일관성/NNG@$유지/NNG,1,0.9929853466343048,38,29,9,23,0.6638959033236087,0.002337751104519214
시중/NNG@$유동성/NNG@$증가세/NNG,1,0.9929853466343048,38,29,9,10,0.6638959033236087,0.002337751104519214
회복세/NNG@$지속/NNG@$경제/NNG,1,0.9928344632680743,26,20,6,26,0.5331748995774563,0.0019179309238966723
금리/NNG@$유지/NNG@$결정/NNG,1,0.9903262279895342,59,44,15,15,0.8318267282248532,0.00404356685740277
정책금리/NNG@$인상/NNG@$시장/NNG,1,0.9881334704813212,32,24,8,10,0.5931593865022478,0.0035403265927899745
금리/NNG@$상승/NNG@$가계부채/NNG,1,0.9881334704813212,32,24,8,26,0.5931593865022478,0.0035403265927899745
실업/NNG@$보험/NNG@$청구/NNG@$감소/NNG,1,0.9802821796121695,44,32,12,40,0.7025599308492047,0.006993451872998418
보험/NNG@$청구/NNG@$감소/NNG,1,0.9802821796121695,44,32,12,40,0.7025599308492047,0.006993451872998418
실적/NNG@$시장/NNG@$예상/NNG,0,0.9799704195663588,23,17,6,28,0.48659481840925944,0.004921009872621277
경기/NNG@$회복/NNG@$저해/NNG,1,0.9744193264229981,46,33,13,16,0.7147367623129107,0.009256652371877179
지준율/NNG@$인상/NNG@$조치/NNG,1,0.9743765871458856,36,26,10,17,0.6216511359484237,0.00806470957864336
부동산/NNG@$문제/NNG@$심각/XR,1,0.9730223000177056,49,35,14,23,0.7386305332382367,0.01009550881265047
대미/NNG@$무역/NNG@$흑자/NNG,0,0.970853512994484,22,16,6,29,0.47089586719403287,0.006961052319306503
개별소비세/NNG@$인하/NNG@$종료/NNG,0,0.9707658036911104,15,11,4,26,0.39324680043515314,0.00583094730484353
원유/NNG@$원자재/NNG@$가격/NNG@$상승/NNG,1,0.9706450975388401,55,39,16,9,0.7825720382484974,0.01165235810331302
개선/NNG@$추세/NNG@$이어지/VV,1,0.9664470190939718,25,18,7,14,0.5018890422435935,0.008559698041808611
국채/NNG@$매입/NNG@$계획/NNG,1,0.9642700990365809,79,55,24,19,0.9074529017428129,0.016498708490608922
자산/NNG@$가격/NNG@$급등/NNG,1,0.9636573574961631,82,57,25,38,0.9178605308085647,0.01697934795955064
기술/NNG@$지수/NNG@$내린/VV@$마감/NNG,1,0.9629916065934003,28,20,8,36,0.5325765884384228,0.010035882428736227
외국인/NNG@$증권/NNG@$자금/NNG,0,0.9628379367068525,18,13,5,9,0.42409024659189376,0.008025367954191733
경제/NNG@$전망/NNG@$개선/NNG,1,0.9582610607267341,34,24,10,11,0.5923235995103835,0.012618572450559262
물가/NNG@$목표/NNG@$하한/NNG,0,0.9569345828223055,21,15,6,19,0.45513230061026255,0.010010773094877575
소비자/NNG@$물가/NNG@$오름세/NNG,1,0.9566848945667259,37,26,11,17,0.6210689904177461,0.013741540937024873
청구/NNG@$감소/NNG@$기록/NNG,1,0.9566848945667259,37,26,11,32,0.6210689904177461,0.013741540937024873
총액/NNG@$대출한도/NNG@$축소/NNG,1,0.9510853468956946,73,50,23,19,0.8753486378528991,0.021933647322270586
매출액/NNG@$기준/NNG@$기업/NNG,1,0.949712495642276,27,19,8,25,0.5169948218884657,0.013327252927128195
국고채/NNG@$금리/NNG@$오른/VV,1,0.949712495642276,27,19,8,23,0.5169948218884657,0.013327252927128195
사드/NNG@$고고/NNG@$미사일/NNG@$방어/NNG@$체계/NNG,1,0.9476672549843239,30,21,9,60,0.5474269400260434,0.014700998955434296
회복세/NNG@$완만/XR@$예상/NNG,1,0.9462991167893056,33,23,10,19,0.5772890112061011,0.015919343791573864
통화정책/NNG@$금융완화/NNG@$기조/NNG@$유지/NNG,1,0.939289897179703,77,52,25,15,0.8872901052846275,0.027761015848409867
인상/NNG@$가능성/NNG@$커지/VV,1,0.9338032898787829,47,32,15,35,0.7003070076380712,0.023958436375775265
경제/NNG@$환경/NNG@$변화/NNG,1,0.9330244878830583,44,30,14,30,0.6746974773450981,0.023363232402106193
금리/NNG@$상승/NNG@$제한/NNG,1,0.9322611473281408,41,28,13,13,0.6479645768684814,0.022702188798635732
경제/NNG@$영향/NNG@$않/VX,1,0.9322611473281408,41,28,13,18,0.6479645768684814,0.022702188798635732
금리/NNG@$인상/NNG@$정당화/NNG,1,0.9322611473281408,41,28,13,22,0.6479645768684814,0.022702188798635732
관심/NNG@$가질/VV@$필요/NNG@$있/VA,1,0.9312078643634059,26,18,8,10,0.501254543160673,0.017844796285536955
인상/NNG@$단행/NNG@$시사/NNG,1,0.9309773760235374,35,24,11,22,0.5915041065308487,0.021130770878687418
인상/NNG@$가능성/NNG@$시장/NNG,1,0.9309773760235374,35,24,11,22,0.5915041065308487,0.021130770878687418
단기/NNG@$외화/NNG@$차입/NNG,1,0.9302949849365656,67,45,22,42,0.8355488497084717,0.030154691234422465
인상/NNG@$가능성/NNG@$커졌/VV,1,0.9258025556999083,55,37,18,22,0.758358802972121,0.02920054068886174
문제/NNG@$국제금융시장/NNG@$불안/NNG,1,0.921008513527213,46,31,15,12,0.6870359056405777,0.028233570511155274
인플레이션기대심리/NNG@$낮추/VV@$노력/NNG,1,0.921008513527213,46,31,15,21,0.6870359056405777,0.028233570511155274
금리/NNG@$인상/NNG@$고민/NNG,1,0.919101760009702,43,29,14,7,0.6608703066584211,0.02784141739744015
인플레이션/NNG@$우려/NNG@$커지/VV,1,0.9148327547818613,37,25,12,18,0.6053995102892615,0.026910081675458906
콜금리/NNG@$인상/NNG@$결정/NNG,1,0.9111076050922584,65,43,22,42,0.8166540984399182,0.03796177435770099
전망/NNG@$경기/NNG@$둔화/NNG,1,0.9087200477523212,48,32,16,12,0.6989824052101649,0.03340618619626878
소매/NNG@$판매/NNG@$증가율/NNG,1,0.9087200477523212,48,32,16,26,0.6989824052101649,0.03340618619626878
기금/NNG@$금리선물/NNG@$시장/NNG@$기준금리/NNG@$인상/NNG,1,0.9066971403194184,187,122,65,240,0.9873053386350459,0.048282645452213856
통화정책/NNG@$방향/NNG@$결정/NNG@$기준금리/NNG@$유지/NNG,0,0.9036542572755808,22,15,7,13,0.45438452382299377,0.02298225553467388
방향/NNG@$결정/NNG@$기준금리/NNG@$유지/NNG,0,0.9036542572755808,22,15,7,13,0.45438452382299377,0.02298225553467388
소비자/NNG@$물가/NNG@$석유류/NNG,0,0.902665543290947,19,13,6,14,0.4234130782406579,0.02164674298267141
금리/NNG@$격차/NNG@$확대/NNG,1,0.9021785839294951,42,28,14,11,0.6466926144008244,0.03323567002709027
지수/NNG@$높/VA@$기술/NNG,1,0.9021785839294951,42,28,14,63,0.6466926144008244,0.03323567002709027
경기/NNG@$둔화/NNG@$금리/NNG@$인하/NNG,1,0.9021785839294951,42,28,14,16,0.6466926144008244,0.03323567002709027
금리/NNG@$인상/NNG@$관측/NNG,1,0.9006278106866126,89,58,31,54,0.9154878849723153,0.047834743879686545
경상수지/NNG@$흑자/NNG@$감소/NNG,1,0.89828725364547,39,26,13,11,0.6189566535406529,0.03314328656938034
전격적/NNG@$금리/NNG@$인상/NNG,1,0.8963149559340533,50,33,17,17,0.7105303837020674,0.03882479889296268
경제/NNG@$회복세/NNG@$완만/XR,1,0.8963149559340533,50,33,17,32,0.7105303837020674,0.03882479889296268
금리선물/NNG@$시장/NNG@$기준금리/NNG@$인상/NNG@$가능성/NNG,1,0.8877982702920961,188,121,67,239,0.984502633809473,0.05847602193022619
시장/NNG@$기준금리/NNG@$인상/NNG@$가능성/NNG@$반영/NNG,1,0.8833135639278347,173,111,62,221,0.9834610234202928,0.06089335881116694
지수/NNG@$내린/VV@$마감/NNG,1,0.8816831165497125,41,27,14,46,0.6321604707496535,0.039722989325564895
경기/NNG@$저점/NNG@$통과/NNG,1,0.8816831165497125,41,27,14,24,0.6321604707496535,0.039722989325564895
감소/NNG@$금리/NNG@$인상/NNG,1,0.8771229214783656,27,18,9,26,0.5001654243664401,0.03271932488133509
경제/NNG@$수출/NNG@$내수/NNG,1,0.8771229214783656,27,18,9,15,0.5001654243664401,0.03271932488133509
물가/NNG@$수요/NNG@$압력/NNG,1,0.8752902620490093,38,25,13,8,0.6039549041238202,0.040137300602597195
금리/NNG@$인상/NNG@$검토/NNG,1,0.8716019109146123,62,40,22,62,0.785278983285024,0.053836821968561314
서브프라임/NNG@$모기/NNG@$지발/NNG,1,0.8716019109146123,62,40,22,12,0.785278983285024,0.053836821968561314
소수/NNG@$의견/NNG@$나오/VV,1,0.867878367886578,35,23,12,21,0.5748882850861307,0.040636637562230536
성장세/NNG@$갈/VX@$전망/NNG,1,0.8652241627123731,51,33,18,22,0.7086262470570864,0.05116891895622865
추이/NNG@$열/VV@$기준금리/NNG,1,0.8592177389286659,32,21,11,19,0.5450979772311009,0.041247547507561245
콜금리/NNG@$인상/NNG@$단행/NNG,1,0.8586987929852707,77,49,28,23,0.8588731076387796,0.06524865434440057
수출/NNG@$호조/NNG@$지속/NNG,1,0.8551955554394728,82,52,30,18,0.8779425228183773,0.06847984781696802
시장/NNG@$예상/NNG@$부합/NNG,1,0.8459054475024335,97,61,36,64,0.9210499759731949,0.07683559986662135
상승/NNG@$인플레/NNG@$압력/NNG,1,0.8392584567803232,42,27,15,14,0.6302250906949477,0.05504025386498082
양적완화/NNG@$정책/NNG@$유지/NNG,1,0.8392584567803232,42,27,15,14,0.6302250906949477,0.05504025386498082
모습/NNG@$보일/VV@$전망/NNG,1,0.8392584567803232,42,27,15,22,0.6302250906949477,0.05504025386498082
경기/NNG@$회복/NNG@$않/VX,1,0.8392584567803232,42,27,15,23,0.6302250906949477,0.05504025386498082
경제성장률/NNG@$상향/NNG@$조정/NNG,1,0.8392584567803232,42,27,15,32,0.6302250906949477,0.05504025386498082
기조/NNG@$유지/NNG@$경제/NNG,1,0.8381763705115057,73,46,27,33,0.8345652013359007,0.07341994654443497
인상/NNG@$가능성/NNG@$제기/NNG,1,0.8333760903585228,83,52,31,51,0.8752456859989819,0.07949014862487432
국채/NNG@$수익률/NNG@$하락/NNG,1,0.8298783993472278,52,33,19,17,0.7062835731227688,0.06561647006467916
물가/NNG@$상승/NNG@$전망/NNG,1,0.829512278465343,106,66,40,25,0.9355274500475516,0.08711856890952932
고용/NNG@$지표/NNG@$경제/NNG,1,0.8274814356781428,39,25,14,29,0.6020057937953598,0.056790978681119667
경기/NNG@$회복세/NNG@$약화/NNG,1,0.8274814356781428,39,25,14,27,0.6020057937953598,0.056790978681119667
금리/NNG@$오른/VV@$마감/NNG,1,0.8222254404587042,44,28,16,32,0.6428174147504,0.06266851901308956
전망/NNG@$소비자/NNG@$물가/NNG@$상승률/NNG,1,0.8222254404587042,44,28,16,21,0.6428174147504,0.06266851901308956
인하/NNG@$효과/NNG@$지켜보/VV,1,0.8222254404587042,44,28,16,17,0.6428174147504,0.06266851901308956
식료품/NNG@$가격/NNG@$급등/NNG,1,0.8220174607714517,31,20,11,17,0.529057797426059,0.05164427862814683
경기/NNG@$회복/NNG@$경제/NNG,0,0.8219437273330041,23,15,8,25,0.4530227027880175,0.044242177761614626
경제/NNG@$활력/NNG@$회복/NNG,0,0.8219437273330041,23,15,8,21,0.4530227027880175,0.044242177761614626
미사일/NNG@$방어/NNG@$체계/NNG,1,0.8165981651713241,54,34,20,89,0.7170178071588835,0.07233815599864195
통화정책/NNG@$기준금리/NNG@$동결/NNG,1,0.8141868458126913,97,60,37,69,0.912517673427828,0.09339588359068078
상승/NNG@$최고치/NNG@$기록/NNG,1,0.8138448051574372,64,40,24,26,0.7800718505042629,0.0800021307288597
금리/NNG@$기준금리/NNG@$인상/NNG,1,0.8134914032286766,36,23,13,24,0.5729203626638679,0.05888022022130364
금융/NNG@$규제/NNG@$개혁/NNG,1,0.8086524312597585,41,26,15,13,0.6150549030718298,0.06502377623576341
필요/NNG@$있/VA@$통화정책/NNG,1,0.8086524312597585,41,26,15,9,0.6150549030718298,0.06502377623576341
장단기/NNG@$금리차/NNG@$축소/NNG,1,0.8086524312597585,41,26,15,18,0.6150549030718298,0.06502377623576341
금리/NNG@$인상/NNG@$시그널/NNG,1,0.8074756506568588,161,99,62,56,0.9697332929470169,0.10321805274270549
수단/NNG@$금리/NNG@$인상/NNG,1,0.8059767226366321,46,29,17,12,0.6550376752999193,0.07032305078638162
위험/NNG@$선호/NNG@$심리/NNG,0,0.8053062061924419,28,18,10,17,0.4984640790011661,0.053718595851465246
성장세/NNG@$둔화/NNG@$예상/NNG,0,0.8053062061924419,28,18,10,17,0.4984640790011661,0.053718595851465246
내수/NNG@$수출/NNG@$균형/NNG,0,0.8053062061924419,28,18,10,16,0.4984640790011661,0.053718595851465246
지수/NNG@$낮/VA@$기술/NNG,0,0.8053062061924419,28,18,10,48,0.4984640790011661,0.053718595851465246
매파적/NNG@$통화/NNG@$긴축/NNG@$선호/NNG,0,0.8053062061924419,28,18,10,31,0.4984640790011661,0.053718595851465246
고고/NNG@$미사일/NNG@$방어/NNG@$체계/NNG,1,0.8045497203301692,51,32,19,87,0.6925456641694052,0.07495579317839857
수출/NNG@$부진/NNG@$지속/NNG,1,0.8038164123501106,56,35,21,75,0.7273543512587517,0.07905066463822226
기준금리/NNG@$인상/NNG@$나서/VV,1,0.7966905534450668,33,21,12,18,0.5431026778513446,0.06141202852267011
둔화/NNG@$우려/NNG@$있/VA,1,0.7966905534450668,33,21,12,16,0.5431026778513446,0.06141202852267011
기준금리/NNG@$인상/NNG@$가능성/NNG@$반영/NNG,1,0.7934913591976198,198,121,77,239,0.9692648181988353,0.11152385213394449
기조/NNG@$유지/NNG@$통화정책/NNG,1,0.7925439707547042,38,24,14,16,0.5863616537635064,0.0678122144036921
엔/NNG@$캐리/NNG@$자금/NNG,1,0.7925439707547042,38,24,14,12,0.5863616537635064,0.0678122144036921
양적완화/NNG@$정책/NNG@$종료/NNG,1,0.791537457952415,58,36,22,34,0.7372948338464345,0.08572928130491203
동결/NNG@$기조/NNG@$지속/NNG,1,0.7908740965314924,43,27,16,19,0.6277512924098267,0.07325142393992679
재정/NNG@$확대/NNG@$정책/NNG,1,0.7855471419968019,85,52,33,40,0.8689042689725965,0.1042837718323889
금리/NNG@$정상화/NNG@$의지/NNG,1,0.7849364513100061,80,49,31,30,0.8498912361792638,0.10232730185997133
증권/NNG@$투자/NNG@$자금/NNG@$유출/NNG,0,0.7797853473267158,17,11,6,18,0.3912548507469331,0.04837501430402898
사상/NNG@$최고/NNG@$기록/NNG,1,0.7778709209791261,55,34,21,17,0.7139819759719183,0.08914043099105266
동향/NNG@$기준금리/NNG@$인상/NNG@$확률/NNG,1,0.7762523487245898,30,19,11,38,0.5127033385605304,0.06453596981109284
국채/NNG@$가격/NNG@$동향/NNG@$기준금리/NNG@$인상/NNG,1,0.7762523487245898,30,19,11,38,0.5127033385605304,0.06453596981109284
가격/NNG@$동향/NNG@$기준금리/NNG@$인상/NNG@$확률/NNG,1,0.7762523487245898,30,19,11,38,0.5127033385605304,0.06453596981109284
美/NNG@$실업/NNG@$수당/NNG,1,0.7762523487245898,30,19,11,25,0.5127033385605304,0.06453596981109284
잠재적/NNG@$불안/NNG@$요인/NNG,1,0.7732393293005619,35,22,13,15,0.5568600964714883,0.07115863016448118
수출/NNG@$호조/NNG@$소비/NNG,1,0.7732393293005619,35,22,13,10,0.5568600964714883,0.07115863016448118
개선/NNG@$추세/NNG@$보이/VV,1,0.7732393293005619,35,22,13,13,0.5568600964714883,0.07115863016448118
인상/NNG@$가능성/NNG@$있/VA,1,0.7732072318932823,72,44,28,31,0.8112011969036639,0.10367627514679059
인하/NNG@$효과/NNG@$나타나/VV,1,0.7730097947934131,40,25,15,13,0.5994743325146367,0.07669156846002895
경제/NNG@$성장/NNG@$부진/NNG,1,0.7730097947934131,40,25,15,21,0.5994743325146367,0.07669156846002895
결제/NNG@$선물환/NNG@$시장/NNG,1,0.7730097947934131,40,25,15,14,0.5994743325146367,0.07669156846002895
차액/NNG@$결제/NNG@$선물환/NNG@$시장/NNG,1,0.7730097947934131,40,25,15,14,0.5994743325146367,0.07669156846002895
모습/NNG@$보이/VV@$경제/NNG,1,0.7730097947934131,40,25,15,18,0.5994743325146367,0.07669156846002895
통화/NNG@$긴축/NNG@$선호/NNG,1,0.7720674296761494,109,66,43,83,0.9263204282703703,0.1190606337418638
필요/NNG@$조치/NNG@$취할/VV,1,0.7598419665248526,86,52,34,34,0.865236685452414,0.11798752242595718
성장률/NNG@$상향/NNG@$조정/NNG,1,0.7571116515027236,103,62,41,39,0.9110862820934575,0.12584728594249497
상승/NNG@$기대/NNG@$심리/NNG,1,0.7548748353161556,42,26,16,14,0.6122492580592612,0.08545677175122447
환율/NNG@$금리/NNG@$인상/NNG,1,0.7548748353161556,42,26,16,26,0.6122492580592612,0.08545677175122447
금리/NNG@$인상/NNG@$불가피/XR,1,0.7518818616518221,88,53,35,39,0.8697474997042959,0.12308995210749067
채권/NNG@$딜러/NNG@$시장/NNG,1,0.7517003502477251,37,23,14,19,0.5703177180804778,0.08078092556244286
콜금리/NNG@$인상/NNG@$시장/NNG,0,0.7510044248323815,27,17,10,23,0.4818866691748651,0.06847385761345551
가계/NNG@$소비/NNG@$여력/NNG,1,0.7498464941253271,32,20,12,17,0.5266891655167575,0.07523782560234898
원유/NNG@$재고/NNG@$감소/NNG,1,0.749034163547889,54,33,21,23,0.700117047883016,0.10038341661660606
기준금리/NNG@$인상/NNG@$확률/NNG,1,0.749034163547889,54,33,21,67,0.700117047883016,0.10038341661660606
금리/NNG@$인상/NNG@$가능성/NNG@$제기/NNG,1,0.749034163547889,54,33,21,32,0.700117047883016,0.10038341661660606
완화/NNG@$정책/NNG@$종료/NNG,1,0.7442604207474992,179,107,72,55,0.9595488269633052,0.14058128912851658
인하/NNG@$쉽/VA@$않/VX,1,0.742369239948252,61,37,24,31,0.7432155076714348,0.10981094698921084
식품/NNG@$가격/NNG@$상승/NNG,1,0.7419771232140897,73,44,29,23,0.8073553546385744,0.11949610603057322
기준금리/NNG@$인상/NNG@$경기/NNG,1,0.7419771232140897,73,44,29,42,0.8073553546385744,0.11949610603057322
금리/NNG@$인상/NNG@$자산/NNG,1,0.738075545809866,44,27,17,38,0.6246789062967003,0.09406683544903004
유로지역/NNG@$경제활동/NNG@$부진/NNG,1,0.7366785483329195,56,34,22,36,0.7104290892963517,0.1076364799727327
농산물/NNG@$가격/NNG@$상승/NNG,1,0.733163818698183,87,52,35,23,0.8612254363818944,0.1324930311861293
인상/NNG@$시중/NNG@$유동성/NNG,1,0.732001545972959,39,24,15,22,0.583464844425941,0.09021307916911642
금리/NNG@$인하/NNG@$중단/NNG,1,0.732001545972959,39,24,15,36,0.583464844425941,0.09021307916911642
인상/NNG@$가능성/NNG@$강하/VA@$시사/NNG,1,0.732001545972959,39,24,15,24,0.583464844425941,0.09021307916911642
경제/NNG@$경착륙/NNG@$우려/NNG,1,0.732001545972959,39,24,15,30,0.583464844425941,0.09021307916911642
통화/NNG@$완화/NNG@$정책/NNG@$유지/NNG,1,0.732001545972959,39,24,15,17,0.583464844425941,0.09021307916911642
금융/NNG@$규제/NNG@$완화/NNG,1,0.732001545972959,39,24,15,28,0.583464844425941,0.09021307916911642
금융/NNG@$통화정책/NNG@$기준금리/NNG@$동결/NNG,1,0.732001545972959,39,24,15,18,0.583464844425941,0.09021307916911642
금리/NNG@$인상/NNG@$단행/NNG@$예상/NNG,1,0.731625435052822,63,38,25,32,0.7521929107194195,0.11648964992567126
실업/NNG@$수당/NNG@$청구/NNG@$감소/NNG,1,0.7300788147749266,51,31,20,39,0.6748884208226738,0.10521396525416321
수당/NNG@$청구/NNG@$감소/NNG,1,0.7300788147749266,51,31,20,39,0.6748884208226738,0.10521396525416321
금리/NNG@$동결/NNG@$시장/NNG@$예상/NNG,1,0.7300788147749266,51,31,20,17,0.6748884208226738,0.10521396525416321
경제/NNG@$성장/NNG@$기대/NNG,1,0.7260465616201472,34,21,13,22,0.5404085624252586,0.08570690428824253
원유/NNG@$가격/NNG@$상승/NNG,1,0.725462867452497,89,53,36,20,0.865644263670895,0.13762715327291924
경제/NNG@$위협/NNG@$요인/NNG,1,0.7225220568297923,46,28,18,22,0.6367572155283034,0.10249578964980746
기준금리/NNG@$인상/NNG@$적절/XR,1,0.7213719402554493,65,39,26,41,0.7607943300222408,0.12305112631276327
금리/NNG@$상승/NNG@$주가/NNG,0,0.7211412028283555,29,18,11,3,0.49600127424723994,0.08030059786234531
물가/NNG@$상방/NNG@$리스크/NNG,0,0.7192365956922946,24,15,9,17,0.4508256950409948,0.07356668493502515
경제/NNG@$전망/NNG@$예상/NNG,0,0.7192365956922946,24,15,9,25,0.4508256950409948,0.07356668493502515
금리/NNG@$인상/NNG@$걸림돌/NNG,1,0.7140140992984698,41,25,16,27,0.5962922111273007,0.09941588129674792
경제/NNG@$전망/NNG@$내놓/VV,1,0.7140140992984698,41,25,16,28,0.5962922111273007,0.09941588129674792
인플레이션/NNG@$압력/NNG@$억제/NNG,1,0.7140140992984698,41,25,16,11,0.5962922111273007,0.09941588129674792
가능성/NNG@$강하/VA@$시사/NNG,1,0.7139169612240097,60,36,24,31,0.7299105739735997,0.121741419887334
침체/NNG@$빠질/VV@$가능성/NNG,1,0.7081132029308055,48,29,19,16,0.6484794703332147,0.11072839171320799
통화/NNG@$완화/NNG@$정책/NNG@$종료/NNG,1,0.7066486356182502,175,103,72,55,0.9516551271051711,0.16345122826122518
미국채/NNG@$금리/NNG@$상승/NNG,1,0.70467387731596,36,22,14,14,0.5538497756098066,0.09587749150416629
비철/NNG@$금속/NNG@$가격/NNG,1,0.70467387731596,36,22,14,27,0.5538497756098066,0.09587749150416629
금리/NNG@$인상/NNG@$늦/VA,1,0.70467387731596,36,22,14,18,0.5538497756098066,0.09587749150416629
해소/NNG@$금리/NNG@$인상/NNG,1,0.70467387731596,36,22,14,15,0.5538497756098066,0.09587749150416629
체감/NNG@$경기/NNG@$회복/NNG,1,0.7022061796472325,69,41,28,19,0.7768925176912691,0.13580882050618334
가격/NNG@$하락/NNG@$축소/NNG,0,0.7014704537312697,11,7,4,17,0.33099101054260344,0.05802864756697039
인상/NNG@$나설/VV@$가능성/NNG,1,0.6987417874819202,109,64,45,52,0.9072525253996165,0.16076902847551358
소비자/NNG@$물가/NNG@$상승률/NNG@$상승/NNG,1,0.6975851141964713,43,26,17,25,0.6087918656212526,0.10836844523595629
상승/NNG@$압력/NNG@$우려/NNG,1,0.6975851141964713,43,26,17,10,0.6087918656212526,0.10836844523595629
자본/NNG@$유출/NNG@$압력/NNG,1,0.6948554253269812,31,19,12,51,0.5098871890891871,0.09172945774634364
기준금리/NNG@$올릴/VV@$예상/NNG,1,0.6947458145132659,50,30,20,17,0.6598422084513689,0.11875690057240881
채권/NNG@$시장/NNG@$통화정책/NNG,1,0.6937554190515043,57,34,23,32,0.7063317397905778,0.12761093774926316
매파/NNG@$통화/NNG@$긴축/NNG@$선호/NNG,1,0.6928447650273055,78,46,32,43,0.8159576357933118,0.14793455821864843
해외/NNG@$불안/NNG@$요인/NNG,1,0.6854921543503332,38,23,15,5,0.5670021309288671,0.10571798844910851
인상/NNG@$예상/NNG@$시장/NNG,1,0.6854921543503332,38,23,15,13,0.5670021309288671,0.10571798844910851
물가/NNG@$목표제/NNG@$채택/NNG,1,0.6854921543503332,38,23,15,14,0.5670021309288671,0.10571798844910851
경제/NNG@$민간/NNG@$소비/NNG,0,0.6854169790568145,26,16,10,16,0.4649569779333365,0.08671617575986068
공개/NNG@$기준금리/NNG@$인상/NNG,0,0.6854169790568145,26,16,10,28,0.4649569779333365,0.08671617575986068
물가/NNG@$상승/NNG@$억제/NNG,1,0.6849413706455594,156,91,65,61,0.9438040368243774,0.17633874008448375
금리/NNG@$인상/NNG@$소비/NNG,1,0.6825569674208498,45,27,18,23,0.6209570906335636,0.11706211037800322
물가/NNG@$상승/NNG@$압력/NNG@$가중/NNG,1,0.6825569674208498,45,27,18,9,0.6209570906335636,0.11706211037800322
상승/NNG@$금리/NNG@$인하/NNG,1,0.6825569674208498,45,27,18,14,0.6209570906335636,0.11706211037800322
시장/NNG@$예상/NNG@$일치/NNG,1,0.6825569674208498,45,27,18,10,0.6209570906335636,0.11706211037800322
제품/NNG@$가격/NNG@$인상/NNG,1,0.6825569674208498,45,27,18,17,0.6209570906335636,0.11706211037800322
물가/NNG@$상승률/NNG@$넘/VV,1,0.6823201560502778,52,31,21,21,0.6708431408916224,0.12657871281423394
가계부채/NNG@$종합/NNG@$대책/NNG,0,0.6788057855961496,16,10,6,41,0.3747929547818854,0.0716500499946396
규모/NNG@$자본/NNG@$유출/NNG,0,0.6783798267038141,21,13,8,28,0.4196935130323849,0.0803605695473031
인상/NNG@$필요/NNG@$있/VA,1,0.6749143614964888,68,40,28,46,0.7644042127695659,0.14824673016977555
기술/NNG@$지수/NNG@$오른/VV@$마감/NNG,1,0.670742862913362,54,32,22,64,0.6814810792168747,0.1341946621835083
통화정책/NNG@$기준금리/NNG@$유지/NNG,1,0.6687780205748681,47,28,19,20,0.6327823510485601,0.12549612350468056
동향/NNG@$금리/NNG@$인상/NNG,1,0.6687780205748681,47,28,19,26,0.6327823510485601,0.12549612350468056
인플레이션/NNG@$압력/NNG@$대응/NNG,1,0.6682521905662708,40,24,16,19,0.5798559748397686,0.1152183745534878
내수/NNG@$부진/NNG@$지속/NNG,1,0.6682521905662708,40,24,16,15,0.5798559748397686,0.1152183745534878
상승률/NNG@$최고치/NNG@$기록/NNG,1,0.6662838842204322,70,41,29,18,0.7721262579292654,0.1545152235446059
동행지수/NNG@$순환/NNG@$변동/NNG,1,0.6599283038884887,56,33,23,38,0.6917558664497049,0.14160781432882677
금리/NNG@$인하/NNG@$가능성/NNG@$반영/NNG,1,0.6580316171704372,72,42,30,25,0.779500379561473,0.16064315484804684
예상/NNG@$성장/NNG@$경로/NNG,0,0.6565368926154593,28,17,11,27,0.47890168856645177,0.09921509009689175
하방/NNG@$위험/NNG@$높/VA,0,0.6565368926154593,28,17,11,25,0.47890168856645177,0.09921509009689175
채권/NNG@$시장/NNG@$변동성/NNG,0,0.6565368926154593,28,17,11,21,0.47890168856645177,0.09921509009689175
경제/NNG@$성장률/NNG@$전망/NNG,1,0.6561079829615204,49,29,20,29,0.6442632509138675,0.13367465711797918
달러화/NNG@$가치/NNG@$하락/NNG,1,0.6557121981005132,88,51,37,34,0.8426106538079772,0.17507168503097337
성장률/NNG@$전망치/NNG@$낮/VA,1,0.6527150933765808,42,25,17,23,0.5924026661535007,0.12438166401026104
물가/NNG@$상승세/NNG@$확대/NNG,1,0.6527150933765808,42,25,17,19,0.5924026661535007,0.12438166401026104
경기/NNG@$상승세/NNG@$지속/NNG@$수요/NNG,1,0.6527150933765808,42,25,17,1,0.5924026661535007,0.12438166401026104
시장/NNG@$금리/NNG@$경기/NNG,1,0.6514900959261747,35,21,14,16,0.5369251121143377,0.11321501000307677
장기/NNG@$국채/NNG@$수익률/NNG,1,0.648974140267248,90,52,38,11,0.8470677491736925,0.18017475368920785
상승/NNG@$압력/NNG@$가중/NNG,1,0.645788954191576,67,39,28,21,0.7513598943569065,0.16157929402620244
증가/NNG@$금리/NNG@$인상/NNG,1,0.645788954191576,67,39,28,39,0.7513598943569065,0.16157929402620244
전망/NNG@$좋/VA@$않/VX,1,0.6444200932654935,51,30,21,31,0.6553964930097387,0.14160479259818992
시장/NNG@$금리/NNG@$기준금리/NNG,1,0.6444200932654935,51,30,21,29,0.6553964930097387,0.14160479259818992
생산자/NNG@$물가/NNG@$상승률/NNG,1,0.6444200932654935,51,30,21,18,0.6553964930097387,0.14160479259818992
자금/NNG@$단기/NNG@$부동화/NNG,1,0.6425453984556444,76,44,32,20,0.7932338466808955,0.17248593499254966
증시/NNG@$사상/NNG@$최고치/NNG,0,0.6402675056474567,23,14,9,40,0.4337154776771228,0.09504259515475239
달러/NNG@$환율/NNG@$기록/NNG,0,0.6402675056474567,23,14,9,29,0.4337154776771228,0.09504259515475239
경제/NNG@$회복/NNG@$기조/NNG,1,0.6386629247432334,44,26,18,9,0.6046345873060084,0.13321829330861848
상승세/NNG@$지속/NNG@$수요/NNG,1,0.6386629247432334,44,26,18,1,0.6046345873060084,0.13321829330861848
금리/NNG@$인상/NNG@$할/VV,1,0.6347419225985311,159,91,68,67,0.9327407157165004,0.20823732450379517
시장/NNG@$관심/NNG@$쏠리/VV,1,0.6336049678338465,37,22,15,26,0.5500544409096157,0.12326930191854
거시/NNG@$경제/NNG@$금융/NNG,1,0.6336049678338465,37,22,15,39,0.5500544409096157,0.12326930191854
유로지역/NNG@$재정/NNG@$문제/NNG,1,0.6336049678338465,37,22,15,7,0.5500544409096157,0.12326930191854
금리/NNG@$인상/NNG@$필요성/NNG@$제기/NNG,1,0.6336049678338465,37,22,15,29,0.5500544409096157,0.12326930191854
은행/NNG@$지준율/NNG@$인상/NNG,1,0.6336014901605345,53,31,22,29,0.6661798369797733,0.1492951814443988
상승률/NNG@$높/VA@$예상/NNG,0,0.6318797891522636,30,18,12,13,0.4926484097380579,0.11104138911024986
상하/NNG@$종합/NNG@$지수/NNG,0,0.6318797891522636,30,18,12,21,0.4926484097380579,0.11104138911024986
수요/NNG@$압력/NNG@$완화/NNG,0,0.6318797891522636,30,18,12,17,0.4926484097380579,0.11104138911024986
美/NNG@$국채/NNG@$수익률/NNG,1,0.6313255408761418,62,36,26,21,0.7204138133721129,0.16267866976759415
채권/NNG@$시장/NNG@$경기/NNG,1,0.6299084533181949,96,55,41,42,0.8588621177440475,0.19485664206248268
확대/NNG@$금리/NNG@$인상/NNG,1,0.6298182629199616,71,41,30,39,0.7668803926149796,0.17404006387635562
인상/NNG@$금리/NNG@$동결/NNG,1,0.6298182629199616,71,41,30,41,0.7668803926149796,0.17404006387635562
금리/NNG@$인상/NNG@$어렵/VA,1,0.6267275406722421,105,60,45,44,0.8792865712519359,0.2015981731586566
고용/NNG@$지표/NNG@$금리/NNG@$인상/NNG,1,0.6259023657499649,46,27,19,32,0.6165451581873247,0.14174253906671896
시장/NNG@$투자/NNG@$심리/NNG,1,0.6259023657499649,46,27,19,31,0.6165451581873247,0.14174253906671896
자금조달/NNG@$어려움/NNG@$겪/VV,1,0.6259023657499649,46,27,19,17,0.6165451581873247,0.14174253906671896
인플레이션/NNG@$목표/NNG@$달성/NNG,0,0.6244690196243283,18,11,7,37,0.388646802411734,0.08977055240940675
이자/NNG@$부담/NNG@$증가/NNG,1,0.6235526114391916,55,32,23,26,0.6766120542054677,0.15675517443840845
채권/NNG@$금리/NNG@$상승/NNG,1,0.6216376497003353,179,102,77,72,0.9328948425551375,0.21748561809635464
은행/NNG@$통화/NNG@$완화/NNG@$정책/NNG@$종료/NNG,1,0.6177666805645776,39,23,16,14,0.5629098936576359,0.13289061953422543
금리/NNG@$인상/NNG@$확대/NNG,1,0.6177666805645776,39,23,16,16,0.5629098936576359,0.13289061953422543
반영/NNG@$금리/NNG@$인상/NNG@$가능성/NNG,1,0.6177666805645776,39,23,16,21,0.5629098936576359,0.13289061953422543
인프라/NNG@$투자/NNG@$확대/NNG,1,0.6177666805645776,39,23,16,31,0.5629098936576359,0.13289061953422543
연속적/NNG@$금리/NNG@$인상/NNG,1,0.6155618816833641,109,62,47,27,0.8838846728108731,0.21015546362677537
외환/NNG@$위기/NNG@$발생/NNG,1,0.6142647298962369,48,28,20,20,0.6281288439545892,0.14997029368477197
예상/NNG@$금리/NNG@$인상/NNG@$가능성/NNG,1,0.6107537804398171,32,19,13,25,0.5061851961848904,0.12222096690236353
약세/NNG@$보일/VV@$전망/NNG,1,0.6107537804398171,32,19,13,19,0.5061851961848904,0.12222096690236353
사상/NNG@$최저/NNG@$동결/NNG,1,0.6107537804398171,32,19,13,27,0.5061851961848904,0.12222096690236353
인상/NNG@$가능성/NNG@$반영/NNG,1,0.6097066513359806,375,213,162,341,0.9320415434842443,0.22579818691472367
소매/NNG@$판매/NNG@$부진/NNG,0,0.6089790139598033,25,15,10,27,0.4475980672902592,0.10868721862006397
거시/NNG@$경제/NNG@$영향/NNG,0,0.6089790139598033,25,15,10,17,0.4475980672902592,0.10868721862006397
통화정책/NNG@$완화적/NNG@$기조/NNG,0,0.6089790139598033,25,15,10,22,0.4475980672902592,0.10868721862006397
경제/NNG@$금융/NNG@$기준금리/NNG,0,0.6089790139598033,25,15,10,24,0.4475980672902592,0.10868721862006397
민간/NNG@$자생력/NNG@$회복/NNG,1,0.6083931039898183,77,44,33,14,0.7876408150947188,0.19161379818225943
자산/NNG@$가격/NNG@$거품/NNG,1,0.6072481775906398,68,39,29,20,0.7458827502416083,0.18211510995972127
인상/NNG@$가능성/NNG@$크/VA@$않/VX,1,0.6054256636858104,59,34,25,31,0.696422955712351,0.17102177221396803
투기/NNG@$자금/NNG@$유입/NNG,1,0.6036042254597394,50,29,21,12,0.6393811530872391,0.15791772779516386
물가/NNG@$상승/NNG@$기대/NNG,1,0.6025778406193243,88,50,38,41,0.826893442037903,0.20489033167619902
시장/NNG@$예상/NNG@$깨/VV,1,0.5972045797328236,61,35,26,30,0.7058037842742595,0.17784660232976968
원자재/NNG@$가격/NNG@$상승세/NNG,1,0.5972045797328236,61,35,26,32,0.7058037842742595,0.17784660232976968
위험/NNG@$금리/NNG@$인상/NNG,1,0.5937955127765449,52,30,22,16,0.6502986246550466,0.16560052138959405
압력/NNG@$높/VA@$금리/NNG,1,0.5937955127765449,52,30,22,25,0.6502986246550466,0.16560052138959405
금리/NNG@$인상/NNG@$속도/NNG@$예상/NNG,1,0.5925520214523337,34,20,14,20,0.5194998808546145,0.13280071809039615
채권/NNG@$시장/NNG@$경제/NNG,1,0.5925520214523337,34,20,14,16,0.5194998808546145,0.13280071809039615
금리/NNG@$인상/NNG@$마지막/NNG,1,0.5925520214523337,34,20,14,24,0.5194998808546145,0.13280071809039615
물가/NNG@$상승/NNG@$압력/NNG@$금리/NNG,1,0.5925520214523337,34,20,14,24,0.5194998808546145,0.13280071809039615
대출/NNG@$증가/NNG@$속도/NNG,1,0.5925520214523337,34,20,14,11,0.5194998808546145,0.13280071809039615
지수/NNG@$최고치/NNG@$기록/NNG,1,0.5925520214523337,34,20,14,27,0.5194998808546145,0.13280071809039615
인상/NNG@$시기/NNG@$가늠/NNG,1,0.5925520214523337,34,20,14,16,0.5194998808546145,0.13280071809039615
훼손/NNG@$않/VX@$중기적/NNG@$소비자/NNG@$물가/NNG,1,0.5910517250840179,43,25,18,20,0.5877613316119926,0.15094583767978684
금융시장/NNG@$불안/NNG@$해소/NNG,1,0.5910517250840179,43,25,18,8,0.5877613316119926,0.15094583767978684
인상/NNG@$확률/NNG@$높/VA,1,0.5910517250840179,43,25,18,24,0.5877613316119926,0.15094583767978684
성장잠재력/NNG@$훼손/NNG@$않/VX@$중기적/NNG@$소비자/NNG,1,0.5910517250840179,43,25,18,20,0.5877613316119926,0.15094583767978684
호조/NNG@$금리/NNG@$인상/NNG,1,0.5910517250840179,43,25,18,35,0.5877613316119926,0.15094583767978684
원자재/NNG@$가격/NNG@$상승/NNG@$물가/NNG,1,0.5894647134209892,63,36,27,20,0.7148376618061901,0.1844771886145651
자산/NNG@$가격/NNG@$버블/NNG,1,0.5862150373269848,137,77,60,44,0.9097305669384016,0.23711566352958044
생산자/NNG@$물가/NNG@$상승/NNG,1,0.5853943147386651,94,53,41,35,0.8399064173182068,0.21946408641862694
인상/NNG@$필요성/NNG@$제기/NNG,1,0.5847311078915003,54,31,23,38,0.6608788052332698,0.17303345354151595
상승률/NNG@$물가/NNG@$목표/NNG@$통화정책/NNG,1,0.5847311078915003,54,31,23,20,0.6608788052332698,0.17303345354151595
지수/NNG@$내린/VV@$기술/NNG,0,0.5831922472268991,27,16,11,24,0.46133168307179195,0.12135270389530077
장단기/NNG@$시장/NNG@$금리/NNG,0,0.5831922472268991,27,16,11,7,0.46133168307179195,0.12135270389530077
외국/NNG@$자본/NNG@$유입/NNG,1,0.5821553059078683,65,37,28,17,0.7235276243138824,0.1909214274288853
한계/NNG@$대출/NNG@$금리/NNG,1,0.5801919365733512,76,43,33,33,0.7751006733125483,0.20574643589792616
국내총생산/NNG@$증가율/NNG@$기록/NNG,1,0.5796954357103863,45,26,19,16,0.5997406121005171,0.15943635089839137
압력/NNG@$선제적/NNG@$대응/NNG,1,0.5767652867180049,36,21,15,13,0.5325803874511057,0.14283406314807895
시장/NNG@$기대/NNG@$금리/NNG,1,0.5767652867180049,36,21,15,14,0.5325803874511057,0.14283406314807895
채권/NNG@$시장/NNG@$콜금리/NNG,1,0.5763189052987658,56,32,24,29,0.671120216634478,0.1802302140546907
증가/NNG@$경제/NNG@$성장/NNG,1,0.5763189052987658,56,32,24,15,0.671120216634478,0.1802302140546907
금리/NNG@$인상/NNG@$근거/NNG,1,0.5741260924962679,78,44,34,43,0.7815995646516798,0.21127958424450724
경제/NNG@$기준금리/NNG@$인상/NNG,1,0.5741260924962679,78,44,34,55,0.7815995646516798,0.21127958424450724
경제/NNG@$성장세/NNG@$지속/NNG,1,0.5741260924962679,78,44,34,37,0.7815995646516798,0.21127958424450724
정책/NNG@$금리/NNG@$인하/NNG,1,0.5722993089322048,89,50,39,24,0.8208311458525199,0.22309497776323564
하락/NNG@$거래/NNG@$마쳤/VV,1,0.5714719783971953,118,66,52,106,0.8854033012565656,0.24123745921188652
가격/NNG@$급등/NNG@$물가/NNG,1,0.5694163619203063,47,27,20,17,0.6114127375668339,0.16760397753551468
물가/NNG@$원자재/NNG@$가격/NNG,1,0.5694163619203063,47,27,20,20,0.6114127375668339,0.16760397753551468
금융정책/NNG@$열/VV@$기준금리/NNG,1,0.5694163619203063,47,27,20,18,0.6114127375668339,0.16760397753551468
예상/NNG@$깨/VV@$기준금리/NNG,1,0.5694163619203063,47,27,20,16,0.6114127375668339,0.16760397753551468
금리/NNG@$상승/NNG@$가계/NNG,1,0.5686560599165078,69,39,30,24,0.7398912872500252,0.2032797779292993
물가/NNG@$관리/NNG@$목표/NNG,1,0.5684799393357567,58,33,25,20,0.6810223159418936,0.1872033491241716
인상/NNG@$기조/NNG@$지속/NNG,1,0.5684799393357567,58,33,25,26,0.6810223159418936,0.1872033491241716
금리/NNG@$인하/NNG@$시기/NNG,1,0.5646654854475963,102,57,45,44,0.8538357391495128,0.23735871680070875
적자/NNG@$국채/NNG@$발행/NNG,1,0.5629751949198554,38,22,16,24,0.5454150049385226,0.1523736609157117
전망/NNG@$변화/NNG@$없/VA,1,0.5629751949198554,38,22,16,26,0.5454150049385226,0.1523736609157117
관리/NNG@$필요/NNG@$있/VA,1,0.5629751949198554,38,22,16,21,0.5454150049385226,0.1523736609157117
금융/NNG@$위기/NNG@$영향/NNG,1,0.5629751949198554,38,22,16,10,0.5454150049385226,0.1523736609157117
금리/NNG@$정상화/NNG@$추진/NNG,1,0.5629751949198554,38,22,16,9,0.5454150049385226,0.1523736609157117
지속/NNG@$경기/NNG@$회복/NNG,1,0.5626750024809699,82,46,36,37,0.7936802236333772,0.221926894685787
시기/NNG@$금리/NNG@$인상/NNG,1,0.5623934608208594,71,40,31,32,0.7475742228180172,0.20920707862994373
물가/NNG@$오름세/NNG@$둔화/NNG,0,0.5617806637138996,29,17,12,8,0.4749046079286749,0.13313933561652566
기업/NNG@$투자/NNG@$부진/NNG,0,0.5617806637138996,29,17,12,22,0.4749046079286749,0.13313933561652566
지표/NNG@$호조/NNG@$보이/VV,0,0.5617806637138996,29,17,12,29,0.4749046079286749,0.13313933561652566
통화정책/NNG@$방향/NNG@$전환/NNG,0,0.5617806637138996,29,17,12,19,0.4749046079286749,0.13313933561652566
부동산/NNG@$자산/NNG@$시장/NNG,0,0.5617806637138996,29,17,12,15,0.4749046079286749,0.13313933561652566
성장/NNG@$하방/NNG@$위험/NNG,1,0.5613447220675722,199,111,88,78,0.9189848568303188,0.2579653098855855
경기/NNG@$회복/NNG@$여부/NNG,1,0.5611464223183067,60,34,26,20,0.6905854494061583,0.19396428502452473
제조업/NNG@$지수/NNG@$예상치/NNG,1,0.560060590358284,49,28,21,11,0.622771824378408,0.17547223803120313
회복세/NNG@$보일/VV@$예상/NNG,1,0.560060590358284,49,28,21,17,0.622771824378408,0.17547223803120313
금리/NNG@$인상/NNG@$의견/NNG,1,0.560060590358284,49,28,21,27,0.622771824378408,0.17547223803120313
채권/NNG@$금리/NNG@$하락/NNG,1,0.5598172874252376,104,58,46,53,0.8567656749736751,0.24157350804809197
브렉시트/NNG@$유럽연합/NNG@$탈퇴/NNG,1,0.5579622477618824,124,69,55,184,0.8891055439087517,0.25204800215974654
기조/NNG@$유지/NNG@$필요/NNG@$있/VA,1,0.5572543834404602,84,47,37,44,0.7992772325046034,0.22704893753887576
인플레율/NNG@$억제/NNG@$목표치/NNG@$허용/NNG@$한도/NNG,1,0.5572543834404602,84,47,37,19,0.7992772325046034,0.22704893753887576
경기/NNG@$회복세/NNG@$뚜렷/XR,1,0.5542600562494213,62,35,27,40,0.6998108017132648,0.2005233945594197
물가/NNG@$상승/NNG@$압력/NNG@$지속/NNG,1,0.5542600562494213,62,35,27,26,0.6998108017132648,0.2005233945594197
축소/NNG@$금리/NNG@$인상/NNG,1,0.5514991625372834,51,29,22,59,0.633813017480899,0.18306220109991578
콜금리/NNG@$인상/NNG@$가능성/NNG,1,0.5513883144277913,180,100,80,75,0.9148819738120305,0.26432663064866374
외국인/NNG@$증권/NNG@$투자/NNG@$자금/NNG@$유출/NNG,0,0.551293253039105,15,9,6,18,0.35778793828065003,0.10339990744470139
기준금리/NNG@$내릴/VV@$전망/NNG,1,0.5508411871434706,40,23,17,28,0.5579926108061072,0.16146808175806018
이상/NNG@$금리/NNG@$인상/NNG,1,0.5459691442659325,139,77,62,71,0.8994069576338585,0.26391564883443297
사상/NNG@$최고치/NNG@$경신/NNG,1,0.5438643204566378,256,142,114,134,0.9151994193615803,0.27016211365465875
경기/NNG@$회복세/NNG@$가시화/NNG,0,0.5438405399816812,31,18,13,18,0.488303797803469,0.14415447740308404
수요/NNG@$물가/NNG@$상승/NNG@$압력/NNG@$크/VA,0,0.5438405399816812,31,18,13,49,0.488303797803469,0.14415447740308404
인상/NNG@$시장/NNG@$기대/NNG,0,0.5438405399816812,31,18,13,17,0.488303797803469,0.14415447740308404
변화/NNG@$금리/NNG@$인상/NNG,0,0.5438405399816812,31,18,13,26,0.488303797803469,0.14415447740308404
채권/NNG@$시장/NNG@$국고채/NNG@$금리/NNG,1,0.5436238211800399,53,30,23,18,0.6445324851986589,0.19039258857221397
상승/NNG@$압력/NNG@$금리/NNG,1,0.5436238211800399,53,30,23,34,0.6445324851986589,0.19039258857221397
성장/NNG@$둔화/NNG@$인플레이션/NNG,1,0.5436238211800399,53,30,23,31,0.6445324851986589,0.19039258857221397
콜/NNG@$목표/NNG@$금리/NNG,1,0.5436238211800399,53,30,23,25,0.6445324851986589,0.19039258857221397
이상/NNG@$금리/NNG@$인하/NNG,1,0.5416346332359945,66,37,29,30,0.7172567679096539,0.2130728897171759
증가/NNG@$경기/NNG@$회복/NNG,1,0.5400868354553081,42,24,18,11,0.570302843229436,0.17016058157478414
유로화/NNG@$달러화/NNG@$유로당/NNG,1,0.5400868354553081,42,24,18,11,0.570302843229436,0.17016058157478414
경제/NNG@$성장/NNG@$지지/NNG,1,0.5400868354553081,42,24,18,13,0.570302843229436,0.17016058157478414
기업/NNG@$구조조정/NNG@$진행/NNG,1,0.5400868354553081,42,24,18,26,0.570302843229436,0.17016058157478414
채권/NNG@$시장/NNG@$부담/NNG,1,0.5400868354553081,42,24,18,12,0.570302843229436,0.17016058157478414
환율/NNG@$상승/NNG@$요인/NNG,1,0.5400868354553081,42,24,18,9,0.570302843229436,0.17016058157478414
지수/NNG@$오른/VV@$마감/NNG,1,0.53993155503327,79,44,35,84,0.7751108859256719,0.23137030324432817
유동성/NNG@$증가/NNG@$속도/NNG,1,0.5363434434906242,55,31,24,38,0.6549274001200187,0.19747996822201735
기금/NNG@$금리/NNG@$동결/NNG,1,0.5363434434906242,55,31,24,20,0.6549274001200187,0.19747996822201735
물가/NNG@$오름세/NNG@$확대/NNG,1,0.5358145741958797,68,38,30,15,0.7254834485692487,0.21907956896922517
금리/NNG@$인상/NNG@$기조/NNG@$유지/NNG,1,0.5348537719402047,81,45,36,32,0.7812283386737616,0.23654941730170695
가계부채/NNG@$급/NNG@$증세/NNG,1,0.5304875774711708,44,25,19,22,0.5823362273699431,0.17848894115706587
예금금리/NNG@$한계/NNG@$대출/NNG,1,0.5304875774711708,44,25,19,27,0.5823362273699431,0.17848894115706587
경제/NNG@$안정적/NNG@$성장/NNG,1,0.5302777764702038,70,39,31,29,0.7333843677012691,0.22491719315820835
금리/NNG@$인상/NNG@$반영/NNG,1,0.529581089135774,57,32,25,40,0.6649959087620613,0.20433898056966418
인상/NNG@$속도/NNG@$빨라/VA,1,0.528664182780292,33,19,14,18,0.5015155474567061,0.15449786790026912
장기/NNG@$시장/NNG@$금리/NNG@$하락/NNG,1,0.528664182780292,33,19,14,18,0.5015155474567061,0.15449786790026912
금리/NNG@$인상/NNG@$물가/NNG@$상승/NNG,1,0.528664182780292,33,19,14,19,0.5015155474567061,0.15449786790026912
금리/NNG@$상승/NNG@$속도/NNG,1,0.528664182780292,33,19,14,19,0.5015155474567061,0.15449786790026912
시장/NNG@$영향/NNG@$크/VA@$않/VX,1,0.528664182780292,33,19,14,20,0.5015155474567061,0.15449786790026912
상승/NNG@$압력/NNG@$완화/NNG,1,0.5250420533329931,109,60,49,48,0.8556903970053662,0.26626173438067186
기준금리/NNG@$인상/NNG@$가능성/NNG@$높/VA,1,0.5249958253242986,72,40,32,30,0.7409640673115849,0.2305922285259193
수요/NNG@$물가/NNG@$압력/NNG,1,0.5249958253242986,72,40,32,14,0.7409640673115849,0.2305922285259193
산업/NNG@$생산/NNG@$부진/NNG,0,0.5235391625540005,24,14,10,25,0.4296950569246062,0.13426174852118264
하방/NNG@$위험/NNG@$상존/NNG,0,0.5235391625540005,24,14,10,24,0.4296950569246062,0.13426174852118264
인플레이션/NNG@$우려/NNG@$높/VA,1,0.5218604476070394,46,26,20,14,0.594084262493788,0.18648580848157703
통계/NNG@$유로/NNG@$유로존/NNG,1,0.5218604476070394,46,26,20,20,0.594084262493788,0.18648580848157703
정책/NNG@$효과/NNG@$극대화/NNG,1,0.5218604476070394,46,26,20,23,0.594084262493788,0.18648580848157703
인하/NNG@$효과/NNG@$지켜볼/VV,1,0.5218604476070394,46,26,20,21,0.594084262493788,0.18648580848157703
주택/NNG@$가격/NNG@$하락세/NNG,1,0.5218604476070394,46,26,20,16,0.594084262493788,0.18648580848157703
물가/NNG@$목표/NNG@$상한선/NNG,1,0.5218604476070394,46,26,20,4,0.594084262493788,0.18648580848157703
필요/NNG@$있/VA@$경제/NNG,1,0.5218604476070394,46,26,20,18,0.594084262493788,0.18648580848157703
금리/NNG@$인하/NNG@$시작/NNG,1,0.5199439237173114,74,41,33,19,0.7482275927481555,0.23611061099037756
불확실성/NNG@$금리/NNG@$인상/NNG,1,0.517359480680539,61,34,27,29,0.684150921441949,0.2174222023498639
금리/NNG@$인상/NNG@$인플레/NNG,1,0.517359480680539,61,34,27,19,0.684150921441949,0.2174222023498639
장기/NNG@$국채/NNG@$매입/NNG,1,0.5169940797660604,233,128,105,37,0.907594490424603,0.28872008486810324
가능성/NNG@$높/VA@$기준금리/NNG,1,0.5157016372220813,35,20,15,18,0.5145260141263505,0.16425660577543957
기준금리/NNG@$인상/NNG@$논의/NNG,1,0.5157016372220813,35,20,15,27,0.5145260141263505,0.16425660577543957
상승/NNG@$지수/NNG@$높/VA,1,0.5157016372220813,35,20,15,47,0.5145260141263505,0.16425660577543957
저금리/NNG@$기조/NNG@$장기화/NNG,1,0.514055757211159,48,27,21,14,0.6055394764927641,0.1941792458633907
금리/NNG@$인상/NNG@$가계부채/NNG,1,0.514055757211159,48,27,21,44,0.6055394764927641,0.1941792458633907
콜금리/NNG@$인하/NNG@$가능성/NNG,1,0.5117975326587481,63,35,28,15,0.6932382044255366,0.22366806778192783
금융/NNG@$위기/NNG@$겪/VV,1,0.5117975326587481,63,35,28,28,0.6932382044255366,0.22366806778192783
동결/NNG@$시장/NNG@$예상/NNG,1,0.5104461660906947,78,43,35,28,0.7618285024696971,0.24669889902771477
고려/NNG@$필요/NNG@$있/VA,1,0.5091837679219624,117,64,53,57,0.8640406534458932,0.2807536502786916
유로존/NNG@$경제/NNG@$성장/NNG,1,0.5091837679219624,117,64,53,59,0.8640406534458932,0.2807536502786916
급등/NNG@$소비자/NNG@$물가/NNG,1,0.5069504619370333,50,28,22,5,0.6166954537236657,0.2015933290820288
인플레이션/NNG@$압력/NNG@$가중/NNG,1,0.5069504619370333,50,28,22,20,0.6166954537236657,0.2015933290820288
동결/NNG@$기준금리/NNG@$인하/NNG,1,0.5069504619370333,50,28,22,23,0.6166954537236657,0.2015933290820288
인상/NNG@$시장/NNG@$금리/NNG,1,0.5059645664473713,80,44,36,64,0.7681780269238905,0.25177858241398504
매입/NNG@$프로그램/NNG@$규모/NNG,1,0.5045253228621118,37,21,16,17,0.5273216152180279,0.17350448158511178
내수/NNG@$부진/NNG@$수출/NNG,1,0.5045253228621118,37,21,16,32,0.5273216152180279,0.17350448158511178
금리/NNG@$상승/NNG@$마감/NNG,1,0.5045253228621118,37,21,16,16,0.5273216152180279,0.17350448158511178
기준금리/NNG@$유지/NNG@$경제/NNG,0,0.5028619419087024,26,15,11,9,0.44318609384172497,0.14647272199655884
콜금리/NNG@$인상/NNG@$효과/NNG,0,0.5028619419087024,26,15,11,22,0.44318609384172497,0.14647272199655884
물가/NNG@$상승/NNG@$압력/NNG@$완화/NNG,1,0.5016408509223991,82,45,37,23,0.7742355630834803,0.2567212639748074
금리/NNG@$인상/NNG@$조치/NNG,1,0.5009436204928033,165,90,75,63,0.8974914896066472,0.29814514638228334
증시/NNG@$금리/NNG@$인상/NNG,1,0.5004429125843013,52,29,23,37,0.6275468412731967,0.20874872421851115
경제/NNG@$성장률/NNG@$전망치/NNG,1,0.5004429125843013,52,29,23,31,0.6275468412731967,0.20874872421851115
회복/NNG@$발목/NNG@$잡/VV,1,0.5004429125843013,52,29,23,24,0.6275468412731967,0.20874872421851115
휘발유/NNG@$가격/NNG@$상승/NNG,1,0.5004429125843013,52,29,23,18,0.6275468412731967,0.20874872421851115
영향/NNG@$금리/NNG@$인상/NNG,1,0.4996930253985863,97,53,44,45,0.8202667693731092,0.2734016487147347
지수/NNG@$하락/NNG@$거래/NNG@$마쳤/VV,1,0.49683548067732364,69,38,31,78,0.7185602944506166,0.24132937518225034
금리/NNG@$인하/NNG@$시그널/NNG,1,0.49683548067732364,69,38,31,27,0.7185602944506166,0.24132937518225034
동향/NNG@$소비자/NNG@$물가/NNG,1,0.49683548067732364,69,38,31,16,0.7185602944506166,0.24132937518225034
국채/NNG@$수익률/NNG@$상승/NNG,1,0.4960169633794078,112,61,51,37,0.8514254407101222,0.2865740284122288
예상/NNG@$좋/VA@$실적/NNG,1,0.49480126663105994,39,22,17,20,0.5398893232631448,0.18230307800057394
둔화/NNG@$경기/NNG@$회복/NNG,1,0.49480126663105994,39,22,17,17,0.5398893232631448,0.18230307800057394
영향/NNG@$크/VA@$않/VX@$전망/NNG,1,0.49480126663105994,39,22,17,13,0.5398893232631448,0.18230307800057394
모습/NNG@$보일/VV@$예상/NNG,1,0.49480126663105994,39,22,17,29,0.5398893232631448,0.18230307800057394
금리/NNG@$인상/NNG@$필요/NNG@$있/VA,1,0.49480126663105994,39,22,17,30,0.5398893232631448,0.18230307800057394
금리/NNG@$인상/NNG@$이유/NNG,1,0.49444870984154066,54,30,24,18,0.6380893379760719,0.2156632098103638
금리/NNG@$인상/NNG@$종료/NNG,1,0.49232212901235983,71,39,32,20,0.726364326911788,0.24688228953037306
종료/NNG@$금리/NNG@$인상/NNG,1,0.49232212901235983,71,39,32,34,0.726364326911788,0.24688228953037306
완화/NNG@$정책/NNG@$유지/NNG,1,0.4888974278598719,56,31,25,24,0.6483196698240712,0.22235213367654946
유지/NNG@$필요/NNG@$있/VA,1,0.4866334863171107,164,89,75,80,0.8927553011708252,0.3080095937594264
내수/NNG@$부진/NNG@$경기/NNG,1,0.48626686848352674,41,23,18,15,0.552216879801976,0.19070344279559157
금융/NNG@$위기/NNG@$직전/NNG,1,0.48626686848352674,41,23,18,25,0.552216879801976,0.19070344279559157
금리/NNG@$인상/NNG@$경제/NNG@$성장/NNG,1,0.48626686848352674,41,23,18,27,0.552216879801976,0.19070344279559157
통화/NNG@$달러화/NNG@$가치/NNG,1,0.48626686848352674,41,23,18,25,0.552216879801976,0.19070344279559157
결정/NNG@$기준금리/NNG@$유지/NNG,0,0.48612153729650487,28,16,12,22,0.45656020289415844,0.15772922782874396
반영/NNG@$기준금리/NNG@$인상/NNG,0,0.48612153729650487,28,16,12,34,0.45656020289415844,0.15772922782874396
유동성/NNG@$증가세/NNG@$둔화/NNG,0,0.48612153729650487,28,16,12,13,0.45656020289415844,0.15772922782874396
확인/NNG@$금리/NNG@$인상/NNG,1,0.4848134821318617,105,57,48,41,0.8339998562188079,0.2891120752779303
단기/NNG@$경제/NNG@$관측/NNG,1,0.4838657396992714,75,41,34,44,0.7410414847219855,0.2575241738810652
금리/NNG@$인상/NNG@$준비/NNG,1,0.4837300174091259,58,32,26,51,0.6582355548144281,0.2288288045848583
기대/NNG@$금리/NNG@$인상/NNG,1,0.4837300174091259,58,32,26,42,0.6582355548144281,0.2288288045848583
개선/NNG@$모습/NNG@$보이/VV,1,0.4837300174091259,58,32,26,26,0.6582355548144281,0.2288288045848583
인상/NNG@$전제/NNG@$조건/NNG,1,0.4837300174091259,58,32,26,15,0.6582355548144281,0.2288288045848583
경로/NNG@$불확실성/NNG@$높/VA,1,0.4820274140602503,120,65,55,64,0.8591812365131624,0.3000144717624967
인상/NNG@$단행/NNG@$예상/NNG,1,0.4798861703018382,77,42,35,41,0.7479244099489,0.26262379586886525
채권/NNG@$시장/NNG@$불안/NNG,1,0.47889673964822177,60,33,27,12,0.667835659789207,0.23510482389601292
인상/NNG@$물가/NNG@$상승/NNG@$압력/NNG,1,0.47871408214395306,43,24,19,8,0.5642929460247055,0.19874780914883017
자산/NNG@$시장/NNG@$버블/NNG,1,0.47871408214395306,43,24,19,15,0.5642929460247055,0.19874780914883017
시중/NNG@$자금/NNG@$단기/NNG@$부동화/NNG,1,0.47871408214395306,43,24,19,7,0.5642929460247055,0.19874780914883017
유통/NNG@$구조/NNG@$개선/NNG,1,0.47871408214395306,43,24,19,14,0.5642929460247055,0.19874780914883017
금리/NNG@$상승/NNG@$채권/NNG,1,0.47871408214395306,43,24,19,20,0.5642929460247055,0.19874780914883017
인하/NNG@$금리/NNG@$인상/NNG,1,0.47871408214395306,43,24,19,21,0.5642929460247055,0.19874780914883017
인상/NNG@$단행/NNG@$가능성/NNG@$높/VA,1,0.47871408214395306,43,24,19,13,0.5642929460247055,0.19874780914883017
금리/NNG@$인상/NNG@$지지/NNG,1,0.47838115307489804,94,51,43,76,0.8048439363982912,0.28371636297589575
자본/NNG@$유출입/NNG@$변동성/NNG,1,0.4743555145909064,62,34,28,27,0.6771195513997126,0.2411903642000326
국제금융시장/NNG@$불안/NNG@$요인/NNG,0,0.47238773957121394,30,17,13,15,0.4698016325079703,0.16819433029408312
경기/NNG@$물가/NNG@$금융시장/NNG,0,0.47238773957121394,30,17,13,8,0.4698016325079703,0.16819433029408312
가계/NNG@$소비/NNG@$위축/NNG,0,0.47238773957121394,30,17,13,24,0.4698016325079703,0.16819433029408312
경제성장률/NNG@$전망치/NNG@$상향/NNG@$조정/NNG,1,0.4723496365294142,81,44,37,39,0.760806548142715,0.27240411450282775
고려/NNG@$않/VX@$없/VA,1,0.4719767874876968,45,25,20,25,0.5761072041769469,0.2064711545263404
외국인/NNG@$주식/NNG@$투자/NNG@$자금/NNG,1,0.4719767874876968,45,25,20,20,0.5761072041769469,0.2064711545263404
가계/NNG@$이자/NNG@$부담/NNG,1,0.47144702504642466,98,53,45,44,0.8130392213472993,0.29178251412736617
평균/NNG@$지수/NNG@$하락/NNG@$거래/NNG@$마쳤/VV,1,0.4700705945347736,64,35,29,72,0.686087642977773,0.24709440227718432
산업/NNG@$평균/NNG@$지수/NNG@$하락/NNG@$거래/NNG,1,0.4700705945347736,64,35,29,72,0.686087642977773,0.24709440227718432
경제성장률/NNG@$물가/NNG@$상승률/NNG,1,0.46876821318395634,83,45,38,42,0.7668178364997877,0.27709334967867094
서브프라임모기지/NNG@$우량/NNG@$주택/NNG@$담보대출/NNG@$부실/NNG,1,0.4660114930891597,66,36,30,19,0.6947411387970587,0.2528249132874734
물가/NNG@$상승/NNG@$압박/NNG,1,0.4660114930891597,66,36,30,17,0.6947411387970587,0.2528249132874734
물가/NNG@$상승률/NNG@$유지/NNG,1,0.46592131222852706,47,26,21,20,0.5876504205527757,0.21390253449512786
기조/NNG@$유지/NNG@$경기/NNG@$회복세/NNG,1,0.46592131222852706,47,26,21,5,0.5876504205527757,0.21390253449512786
농산물/NNG@$가격/NNG@$하락/NNG,1,0.46592131222852706,47,26,21,25,0.5876504205527757,0.21390253449512786
정책/NNG@$금리/NNG@$인상/NNG,1,0.46484049590224386,102,55,47,36,0.8203323228728716,0.29942269014474787
정책금리/NNG@$인상/NNG@$가능성/NNG,1,0.46164896205434736,104,56,48,49,0.8236596997442281,0.3030898181716177
시장/NNG@$예상치/NNG@$밑돌/VV,0,0.4609791676404442,32,18,14,20,0.48289397752593793,0.1779976137315418
고용/NNG@$취업자/NNG@$증가/NNG,0,0.4609791676404442,32,18,14,19,0.48289397752593793,0.1779976137315418
통화정책/NNG@$정상화/NNG@$속도/NNG,0,0.4609791676404442,32,18,14,29,0.48289397752593793,0.1779976137315418
경기/NNG@$상승세/NNG@$둔화/NNG,0,0.4609791676404442,32,18,14,13,0.48289397752593793,0.1779976137315418
개선/NNG@$금리/NNG@$인하/NNG,0,0.4609791676404442,32,18,14,22,0.48289397752593793,0.1779976137315418
금리/NNG@$인상/NNG@$여지/NNG,1,0.46043929093565295,49,27,22,32,0.5989144784298388,0.22106619081676263
인상/NNG@$속도/NNG@$예상/NNG,1,0.46043929093565295,49,27,22,31,0.5989144784298388,0.22106619081676263
요인/NNG@$금리/NNG@$인상/NNG,1,0.45865367907018073,89,48,41,48,0.7832106518177888,0.29040345120433037
경기/NNG@$둔화/NNG@$전망/NNG,1,0.45544225313461206,51,28,23,17,0.609892387441904,0.22798245761257516
경제/NNG@$성장/NNG@$뒷받침/NNG,1,0.45544225313461206,51,28,23,26,0.609892387441904,0.22798245761257516
금융/NNG@$위기/NNG@$발생/NNG,1,0.45469126873026866,164,88,76,63,0.8823575178677177,0.33045722178302267
경제/NNG@$회복세/NNG@$지속/NNG,1,0.4524784029732256,110,59,51,62,0.8324560717695793,0.31350992065998284
인플레/NNG@$압력/NNG@$가중/NNG,0,0.45139093803917096,34,19,15,17,0.4958207954640259,0.1872411851418891
부채/NNG@$상환/NNG@$능력/NNG,0,0.45139093803917096,34,19,15,18,0.4958207954640259,0.1872411851418891
인하/NNG@$기대/NNG@$높/VA,0,0.45139093803917096,34,19,15,13,0.4958207954640259,0.1872411851418891
엔화/NNG@$가치/NNG@$상승/NNG,0,0.45139093803917096,34,19,15,30,0.4958207954640259,0.1872411851418891
주택/NNG@$담보인정비율/NNG@$부채/NNG@$상환/NNG,0,0.45139093803917096,34,19,15,22,0.4958207954640259,0.1872411851418891
경기/NNG@$금리/NNG@$인상/NNG,1,0.4508574927272917,53,29,24,32,0.6205782744961635,0.23466849626785147
외환시장/NNG@$원달러/NNG@$환율/NNG,0,0.4504964728864467,21,12,9,19,0.3977919059483679,0.15055929108367402
자산/NNG@$축소/NNG@$계획/NNG,0,0.4493839471142067,12,7,5,44,0.32705299434045865,0.12413122385043003
소비자/NNG@$물가/NNG@$상승률/NNG@$전망/NNG,1,0.4483073919199765,76,41,35,38,0.733379996786147,0.2791018066271158
인플레이션/NNG@$압력/NNG@$낮/VA,1,0.4466248912311226,55,30,25,28,0.6309673603030724,0.24113888907094194
금리/NNG@$인상/NNG@$카드/NNG,1,0.4463108989472746,144,77,67,52,0.8703771529863928,0.3328958498524125
상승/NNG@$소비자/NNG@$물가/NNG,1,0.4463108989472746,144,77,67,47,0.8703771529863928,0.3328958498524125
가격/NNG@$상승/NNG@$경제/NNG,1,0.4451658341935507,78,42,36,22,0.74020831994029,0.2839198246767648
성장/NNG@$경로/NNG@$불확실성/NNG@$높/VA,1,0.44385495024556465,116,62,54,63,0.8396295315004835,0.3231082695347047
유지/NNG@$기준금리/NNG@$동결/NNG,1,0.44324406746318945,36,20,16,19,0.5085660364692941,0.1960054303509535
인하/NNG@$단행/NNG@$예상/NNG,1,0.44324406746318945,36,20,16,19,0.5085660364692941,0.1960054303509535
경제/NNG@$차지/NNG@$비중/NNG,1,0.44324406746318945,36,20,16,26,0.5085660364692941,0.1960054303509535
금리/NNG@$인하/NNG@$인상/NNG,1,0.44324406746318945,36,20,16,25,0.5085660364692941,0.1960054303509535
시장/NNG@$고용/NNG@$지표/NNG,1,0.44324406746318945,36,20,16,25,0.5085660364692941,0.1960054303509535
성장률/NNG@$전망/NNG@$낮추/VV,1,0.44324406746318945,36,20,16,19,0.5085660364692941,0.1960054303509535
자산/NNG@$매입/NNG@$프로그램/NNG@$규모/NNG,1,0.44324406746318945,36,20,16,15,0.5085660364692941,0.1960054303509535
동결/NNG@$금리/NNG@$인상/NNG@$가능성/NNG,1,0.44324406746318945,36,20,16,23,0.5085660364692941,0.1960054303509535
인상/NNG@$가능성/NNG@$금리/NNG,1,0.4426944554112162,57,31,26,39,0.6410559247994189,0.24740611806509055
해외/NNG@$경제/NNG@$포커스/NNG,1,0.4421276566300285,80,43,37,38,0.7467478693824929,0.2886027506607949
원자재/NNG@$가격/NNG@$급등/NNG,1,0.4389109006912171,191,102,89,68,0.8819018077955377,0.34356788057227666
요인/NNG@$물가/NNG@$상승/NNG,1,0.4362503278210341,38,21,17,22,0.5211143427215946,0.20435383421145445
기준금리/NNG@$인상/NNG@$관측/NNG,1,0.4362503278210341,38,21,17,27,0.5211143427215946,0.20435383421145445
충격/NNG@$크/VA@$않/VX,1,0.433543894706087,86,46,40,55,0.7646906981150097,0.3018796714637007
불안/NNG@$금리/NNG@$인상/NNG,1,0.433543894706087,86,46,40,63,0.7646906981150097,0.3018796714637007
금리/NNG@$인상/NNG@$확률/NNG,1,0.4324903638178488,107,57,50,76,0.8192777088268255,0.3242687885950263
금리/NNG@$인상/NNG@$요인/NNG,1,0.43233046430074573,63,34,29,38,0.6694962332053795,0.2650897458355402
금리/NNG@$인상/NNG@$금융/NNG,1,0.43233046430074573,63,34,29,57,0.6694962332053795,0.2650897458355402
가능성/NNG@$높/VA@$진단/NNG,1,0.43233046430074573,63,34,29,25,0.6694962332053795,0.2650897458355402
수출/NNG@$증가세/NNG@$지속/NNG,0,0.43224871689419375,23,13,10,15,0.41107733294600357,0.16280045710623636
투자/NNG@$심리/NNG@$긍정적/NNG,0,0.43224871689419375,23,13,10,33,0.41107733294600357,0.16280045710623636
경제성장률/NNG@$전망/NNG@$상향/NNG@$조정/NNG,1,0.4301877355656534,40,22,18,21,0.5334512551415317,0.21233680276494613
경제/NNG@$전망/NNG@$물가/NNG,1,0.4301877355656534,40,22,18,12,0.5334512551415317,0.21233680276494613
경제/NNG@$전망/NNG@$정책/NNG,1,0.4292518911562797,65,35,30,40,0.6783650726158079,0.27063919490575933
주택/NNG@$가격/NNG@$급등/NNG,1,0.4292518911562797,65,35,30,25,0.6783650726158079,0.27063919490575933
대응/NNG@$금리/NNG@$인상/NNG,1,0.42819252810424535,90,48,42,39,0.7753176807975759,0.3101229789308628
우량/NNG@$주택/NNG@$담보대출/NNG@$부실/NNG,1,0.4263225520260181,67,36,31,19,0.6869289914788694,0.2760275944637333
채권/NNG@$시장/NNG@$관심/NNG,1,0.4263225520260181,67,36,31,34,0.6869289914788694,0.2760275944637333
물가/NNG@$목표/NNG@$통화정책/NNG,1,0.4263225520260181,67,36,31,30,0.6869289914788694,0.2760275944637333
실업/NNG@$보험/NNG@$청구자/NNG,1,0.4248832986113289,42,23,19,16,0.5455633531031088,0.21999462257305016
소수/NNG@$의견/NNG@$낸/VV,1,0.4248832986113289,42,23,19,22,0.5455633531031088,0.21999462257305016
기록/NNG@$소비자/NNG@$물가/NNG,1,0.4248832986113289,42,23,19,16,0.5455633531031088,0.21999462257305016
금리/NNG@$인상/NNG@$기조/NNG@$지속/NNG,1,0.4248832986113289,42,23,19,24,0.5455633531031088,0.21999462257305016
수출/NNG@$차지/NNG@$비중/NNG,1,0.4248832986113289,42,23,19,26,0.5455633531031088,0.21999462257305016
금리/NNG@$인상/NNG@$가능성/NNG@$시사/NNG,1,0.4222323637897505,209,111,98,85,0.8774366711347473,0.3561129971299937
콜금리/NNG@$동결/NNG@$가능성/NNG,1,0.4202007298193313,44,24,20,16,0.557438344777441,0.22735973006008575
금리/NNG@$인하/NNG@$동결/NNG,1,0.4202007298193313,44,24,20,20,0.557438344777441,0.22735973006008575
경제/NNG@$완만/XR@$속도/NNG,1,0.4202007298193313,44,24,20,32,0.557438344777441,0.22735973006008575
경기/NNG@$회복세/NNG@$지속/NNG@$도움/NNG@$방향/NNG,1,0.4160315868168596,46,25,21,5,0.5690651204138062,0.23445844768961738
지속/NNG@$수요/NNG@$압력/NNG,1,0.4160315868168596,46,25,21,3,0.5690651204138062,0.23445844768961738
회복세/NNG@$지속/NNG@$도움/NNG@$방향/NNG,1,0.4160315868168596,46,25,21,5,0.5690651204138062,0.23445844768961738
인상/NNG@$가능성/NNG@$배제/NNG@$않/VX,1,0.4160315868168596,46,25,21,22,0.5690651204138062,0.23445844768961738
동결/NNG@$예상/NNG@$금리/NNG,1,0.4160315868168596,46,25,21,25,0.5690651204138062,0.23445844768961738
경기/NNG@$부정적/NNG@$영향/NNG,1,0.41577058334390515,75,40,35,44,0.7181767645884957,0.2960801613165653
증가/NNG@$물가/NNG@$상승/NNG,1,0.4122888009353971,48,26,22,16,0.5804337773474333,0.2413123143204514
양적완화/NNG@$규모/NNG@$확대/NNG,1,0.4122888009353971,48,26,22,23,0.5804337773474333,0.2413123143204514
인상/NNG@$가능성/NNG@$높이/VV,1,0.4122888009353971,48,26,22,15,0.5804337773474333,0.2413123143204514
회복/NNG@$속도/NNG@$완만/XR,1,0.4122888009353971,48,26,22,18,0.5804337773474333,0.2413123143204514
대출/NNG@$금리/NNG@$상승/NNG,1,0.41120070205012715,104,55,49,41,0.8049496714814212,0.33553146187999866
이유/NNG@$금리/NNG@$인상/NNG,1,0.40895221798569836,106,56,50,36,0.8083161320740149,0.3387606075238246
금리/NNG@$인상/NNG@$지급준비율/NNG,1,0.4089018918495524,50,27,23,22,0.5915356231764443,0.2479391083244242
금융/NNG@$위기/NNG@$가능성/NNG,1,0.4089018918495524,50,27,23,36,0.5915356231764443,0.2479391083244242
금융완화/NNG@$기조/NNG@$유지/NNG@$경기/NNG,1,0.4089018918495524,50,27,23,14,0.5915356231764443,0.2479391083244242
기준금리/NNG@$인하/NNG@$경제/NNG,1,0.4089018918495524,50,27,23,24,0.5915356231764443,0.2479391083244242
물가/NNG@$목표/NNG@$상한/NNG,0,0.40795268671716367,14,8,6,4,0.3397867664511307,0.1427446485996719
지수/NNG@$사상/NNG@$최고치/NNG,0,0.40697595881626514,27,15,12,41,0.4374812788388283,0.1842170469712931
금리/NNG@$인상/NNG@$나설/VV@$가능성/NNG,1,0.40653745146527553,83,44,39,37,0.7447806456115375,0.313946021176189
가능성/NNG@$높/VA@$경제/NNG,1,0.4058133861852151,52,28,24,17,0.6023631619607616,0.25435363811968364
물가/NNG@$상승률/NNG@$전망/NNG,1,0.4057115335061472,214,113,101,111,0.8718968536654221,0.36825659485740697
경로/NNG@$불확실성/NNG@$상존/NNG,1,0.40297610651355487,54,29,25,6,0.6129100671976977,0.26056835612455825
부정적/NNG@$영향/NNG@$예상/NNG,1,0.40297610651355487,54,29,25,29,0.6129100671976977,0.26056835612455825
동향/NNG@$그린북/NNG@$경제/NNG,1,0.40297610651355487,54,29,25,41,0.6129100671976977,0.26056835612455825
주택/NNG@$매매가격/NNG@$수도권/NNG,1,0.40297610651355487,54,29,25,10,0.6129100671976977,0.26056835612455825
성장/NNG@$경로/NNG@$불확실성/NNG@$상존/NNG,1,0.40297610651355487,54,29,25,6,0.6129100671976977,0.26056835612455825
인플레이션/NNG@$상승/NNG@$압력/NNG,1,0.40243007089067695,112,59,53,67,0.8172712127505369,0.3479020856556184
시장/NNG@$국고채/NNG@$금리/NNG,1,0.4003510970433597,56,30,26,19,0.6231711445514083,0.26659383804036857
콜금리/NNG@$인상/NNG@$전망/NNG,1,0.4003510970433597,56,30,26,17,0.6231711445514083,0.26659383804036857
둔화/NNG@$금리/NNG@$인하/NNG,1,0.4003259805081496,114,60,54,53,0.8198980735200248,0.3507749807590928
경기/NNG@$회복/NNG@$확신/NNG,1,0.40019357098089503,89,47,42,57,0.7618727115363989,0.32605290249224034
금리/NNG@$변동성/NNG@$확대/NNG,0,0.39807117430442873,29,16,13,18,0.4505603256481364,0.19379865551996234
마이너스금리/NNG@$정책/NNG@$도입/NNG,0,0.39807117430442873,29,16,13,25,0.4505603256481364,0.19379865551996234
부정적/NNG@$영향/NNG@$최소화/NNG,0,0.39807117430442873,29,16,13,34,0.4505603256481364,0.19379865551996234
외환시장/NNG@$달러/NNG@$환율/NNG,0,0.39807117430442873,29,16,13,25,0.4505603256481364,0.19379865551996234
금융/NNG@$위기/NNG@$대처/NNG,1,0.3979060203869018,58,31,27,9,0.6331422867465756,0.27243915886647807
가격/NNG@$상승/NNG@$압력/NNG,1,0.3979060203869018,58,31,27,34,0.6331422867465756,0.27243915886647807
인플레/NNG@$압력/NNG@$높/VA,1,0.3961723181244088,93,49,44,29,0.7719932598206369,0.3335560811752503
지표/NNG@$금리/NNG@$인상/NNG,1,0.3961723181244088,93,49,44,59,0.7719932598206369,0.3335560811752503
원자재/NNG@$가격/NNG@$오르/VV,1,0.3934521688462087,62,33,29,13,0.652203461910292,0.2836198301379817
식료품/NNG@$가격/NNG@$상승/NNG,1,0.3934521688462087,62,33,29,12,0.652203461910292,0.2836198301379817
경기/NNG@$하방/NNG@$위험/NNG,1,0.39329016732145883,196,103,93,119,0.8664380080615373,0.376927140740279
주택/NNG@$경기/NNG@$둔화/NNG,1,0.39228892881050803,97,51,46,52,0.7811544411918071,0.34063151288018256
국가신용등급/NNG@$상향/NNG@$조정/NNG,1,0.3914018213328392,64,34,30,22,0.6612902373821894,0.2889681989653919
기준금리/NNG@$인상/NNG@$검토/NNG,0,0.3908577967345854,31,17,14,25,0.4635305085049937,0.2028121512214064
금리/NNG@$인하/NNG@$쉽/VA@$않/VX,0,0.3908577967345854,31,17,14,22,0.4635305085049937,0.2028121512214064
인상/NNG@$긴축/NNG@$기조/NNG,0,0.3908577967345854,31,17,14,19,0.4635305085049937,0.2028121512214064
축소/NNG@$자본/NNG@$유출/NNG,0,0.3908577967345854,31,17,14,22,0.4635305085049937,0.2028121512214064
소비자/NNG@$물가/NNG@$급등/NNG,1,0.390393252633882,99,52,47,24,0.7853919456432156,0.3440155690829765
불안/NNG@$요인/NNG@$상존/NNG,1,0.38944685496144027,66,35,31,15,0.6700804450930733,0.29416277833457105
물가/NNG@$안정세/NNG@$유지/NNG,1,0.3875737336520224,68,36,32,22,0.6785745841309062,0.29920853461342084
금융/NNG@$위기/NNG@$통화정책/NNG,0,0.3849457263061873,33,18,15,16,0.47637209349518106,0.21135124639210603
경기/NNG@$회복/NNG@$발목/NNG@$잡/VV,0,0.3849457263061873,33,18,15,16,0.47637209349518106,0.21135124639210603
기준금리/NNG@$인상/NNG@$고려/NNG,0,0.3849457263061873,33,18,15,23,0.47637209349518106,0.21135124639210603
지속/NNG@$경제/NNG@$성장/NNG,0,0.3849457263061873,33,18,15,12,0.47637209349518106,0.21135124639210603
경기/NNG@$회복/NNG@$시작/NNG,0,0.3849457263061873,33,18,15,13,0.47637209349518106,0.21135124639210603
채권/NNG@$기준금리/NNG@$전망/NNG,0,0.3849457263061873,33,18,15,27,0.47637209349518106,0.21135124639210603
장기/NNG@$시장/NNG@$금리/NNG@$상승/NNG,0,0.3849457263061873,33,18,15,12,0.47637209349518106,0.21135124639210603
기준금리/NNG@$인하/NNG@$동결/NNG,0,0.3849457263061873,33,18,15,23,0.47637209349518106,0.21135124639210603
경제/NNG@$성장/NNG@$둔화/NNG@$인플레이션/NNG,0,0.3849457263061873,33,18,15,18,0.47637209349518106,0.21135124639210603
사태/NNG@$금융/NNG@$위기/NNG,0,0.3849457263061873,33,18,15,11,0.47637209349518106,0.21135124639210603
공격적/NNG@$금리/NNG@$인상/NNG,1,0.38180060783580205,193,101,92,67,0.8619432903134664,0.38524649923400583
인상/NNG@$전망/NNG@$힘/NNG,0,0.38004785361098237,35,19,16,25,0.48906613442458824,0.21948652675488078
인하/NNG@$가능성/NNG@$전망/NNG,0,0.38004785361098237,35,19,16,21,0.48906613442458824,0.21948652675488078
확대/NNG@$가능성/NNG@$높/VA,0,0.38004785361098237,35,19,16,15,0.48906613442458824,0.21948652675488078
경제/NNG@$보/VV@$경기/NNG,0,0.38004785361098237,35,19,16,16,0.48906613442458824,0.21948652675488078
기준금리/NNG@$결정/NNG@$통화정책/NNG,0,0.38004785361098237,35,19,16,24,0.48906613442458824,0.21948652675488078
가능성/NNG@$높/VA@$보/VX,1,0.3790895244616961,78,41,37,45,0.7166704321046609,0.32235318140334757
사상/NNG@$최고치/NNG@$기록/NNG,1,0.3784945841071421,178,93,85,82,0.8586052830591805,0.38673115963888216
억제/NNG@$목표치/NNG@$허용/NNG@$한도/NNG,1,0.3778455576742754,113,59,54,25,0.8092866215745321,0.36506951985465136
금리/NNG@$인하/NNG@$카드/NNG,1,0.3760771233559359,161,84,77,80,0.8530270142497626,0.38639001858757077
경제/NNG@$하강/NNG@$리스크/NNG,1,0.3759490521167599,37,20,17,20,0.5015946865482779,0.22727180401702987
가격/NNG@$상승/NNG@$기대/NNG,1,0.3759490521167599,37,20,17,29,0.5015946865482779,0.22727180401702987
성장/NNG@$둔화/NNG@$인플레/NNG,1,0.3759490521167599,37,20,17,15,0.5015946865482779,0.22727180401702987
인플레이션/NNG@$압력/NNG@$금리/NNG,1,0.3759490521167599,37,20,17,23,0.5015946865482779,0.22727180401702987
금리/NNG@$인상/NNG@$생각/NNG,1,0.3759490521167599,37,20,17,28,0.5015946865482779,0.22727180401702987
금리/NNG@$인상/NNG@$단행/NNG@$가능성/NNG,1,0.37446563708069247,117,61,56,65,0.81446392013151,0.3703084278793158
목표치/NNG@$허용/NNG@$한도/NNG,1,0.37446563708069247,117,61,56,26,0.81446392013151,0.3703084278793158
경제/NNG@$성장세/NNG@$유지/NNG,1,0.3724855561000653,39,21,18,19,0.5139409461733494,0.23474858608453913
소비/NNG@$내수/NNG@$회복세/NNG,1,0.3724855561000653,39,21,18,20,0.5139409461733494,0.23474858608453913
기준금리/NNG@$동결/NNG@$열/VV,1,0.3724855561000653,39,21,18,11,0.5139409461733494,0.23474858608453913
지준율/NNG@$인상/NNG@$효과/NNG,1,0.36953094383213636,41,22,19,14,0.5260893394151808,0.24194925694857686
상승/NNG@$속도/NNG@$둔화/NNG,1,0.36953094383213636,41,22,19,12,0.5260893394151808,0.24194925694857686
장단기/NNG@$금리/NNG@$격차/NNG,1,0.36953094383213636,41,22,19,24,0.5260893394151808,0.24194925694857686
경제/NNG@$성장/NNG@$제약/NNG,1,0.36953094383213636,41,22,19,14,0.5260893394151808,0.24194925694857686
경제/NNG@$불안/NNG@$요인/NNG,1,0.3686086362357417,92,48,44,54,0.7584372294350993,0.349551821373456
금리/NNG@$인하/NNG@$없/VA,1,0.3686086362357417,92,48,44,40,0.7584372294350993,0.349551821373456
경제/NNG@$회복/NNG@$속도/NNG,1,0.36761910719091717,150,78,72,67,0.84459890801193,0.3901542470085439
고용/NNG@$지표/NNG@$개선/NNG,1,0.367186230009547,94,49,45,52,0.763390523292241,0.35299382823852676
시장/NNG@$변동성/NNG@$확대/NNG,1,0.367186230009547,94,49,45,56,0.763390523292241,0.35299382823852676
경기/NNG@$부양/NNG@$필요/NNG,1,0.3669864147702331,43,23,20,31,0.5380255746532233,0.2488993656478309
확대/NNG@$필요/NNG@$있/VA,1,0.3669864147702331,43,23,20,14,0.5380255746532233,0.2488993656478309
소비자/NNG@$물가/NNG@$올랐/VV,1,0.3669864147702331,43,23,20,14,0.5380255746532233,0.2488993656478309
인하/NNG@$가능성/NNG@$반영/NNG,1,0.3663798641160039,127,66,61,51,0.8247390445431204,0.38207261635863815
주택/NNG@$착공/NNG@$허가/NNG,1,0.3647739172886715,45,24,21,15,0.5497366680997402,0.2556192936301883
압력/NNG@$기준금리/NNG@$인상/NNG,1,0.3647739172886715,45,24,21,27,0.5497366680997402,0.2556192936301883
경제/NNG@$성장/NNG@$도움/NNG,1,0.3647739172886715,45,24,21,8,0.5497366680997402,0.2556192936301883
경제/NNG@$불확실성/NNG@$높/VA,1,0.3647739172886715,45,24,21,28,0.5497366680997402,0.2556192936301883
경제/NNG@$더블딥/NNG@$이중/NNG@$침체/NNG,1,0.3647739172886715,45,24,21,8,0.5497366680997402,0.2556192936301883
목표/NNG@$금리/NNG@$인상/NNG,1,0.3647739172886715,45,24,21,36,0.5497366680997402,0.2556192936301883
기금/NNG@$금리/NNG@$인상/NNG,1,0.362995553957308,100,52,48,51,0.7768638630949183,0.36271346601128446
기업/NNG@$투자/NNG@$확대/NNG,1,0.36283120635022903,47,25,22,14,0.561210948828207,0.2621254832695104
가능성/NNG@$있/VA@$전망/NNG,1,0.36283120635022903,47,25,22,20,0.561210948828207,0.2621254832695104
지속/NNG@$도움/NNG@$방향/NNG,1,0.36283120635022903,47,25,22,5,0.561210948828207,0.2621254832695104
인상/NNG@$가능성/NNG@$배제/NNG@$없/VA,1,0.3616213388819913,102,53,49,44,0.7809143470028805,0.3657595708394227
금리/NNG@$동결/NNG@$경제/NNG,1,0.3611082320630383,49,26,23,23,0.5724380477418753,0.2684313527516116
경기/NNG@$부양/NNG@$규모/NNG,1,0.3611082320630383,49,26,23,12,0.5724380477418753,0.2684313527516116
경기/NNG@$부양/NNG@$통화정책/NNG,1,0.3611082320630383,49,26,23,22,0.5724380477418753,0.2684313527516116
예상치/NNG@$크/VA@$웃돌/VV,1,0.3611082320630383,49,26,23,18,0.5724380477418753,0.2684313527516116
선제적/NNG@$금리/NNG@$인상/NNG,1,0.3602805932921289,135,70,65,46,0.8306235981830449,0.3902430107951439
기준금리/NNG@$인상/NNG@$필요/NNG,1,0.35956446182489943,51,27,24,33,0.583408873801874,0.27454798408835074
재정/NNG@$건전성/NNG@$확보/NNG,1,0.35956446182489943,51,27,24,35,0.583408873801874,0.27454798408835074
상향/NNG@$조정/NNG@$가능성/NNG,1,0.3589036272386401,106,55,51,49,0.788393792670066,0.37157565324788766
인상/NNG@$기조/NNG@$유지/NNG,1,0.35755951825727617,108,56,52,57,0.7918359900602108,0.3743503179295524
개선/NNG@$경기/NNG@$회복/NNG,1,0.35570678637601527,57,30,27,35,0.6147112078367584,0.2918483591219663
기준금리/NNG@$인상/NNG@$시사/NNG,1,0.35570678637601527,57,30,27,42,0.6147112078367584,0.2918483591219663
금리/NNG@$인상/NNG@$원화/NNG,1,0.35570678637601527,57,30,27,18,0.6147112078367584,0.2918483591219663
시장/NNG@$금리/NNG@$인하/NNG@$가능성/NNG,1,0.3546036590500605,59,31,28,28,0.6245902476549859,0.29728803189322933
고용/NNG@$시장/NNG@$회복/NNG,1,0.3546036590500605,59,31,28,30,0.6245902476549859,0.29728803189322933
금리/NNG@$인상/NNG@$움직임/NNG,1,0.3546036590500605,59,31,28,32,0.6245902476549859,0.29728803189322933
성장/NNG@$모멘텀/NNG@$약화/NNG,1,0.35356379217443057,61,32,29,33,0.63418529439385,0.3025733967742178
경기/NNG@$회복/NNG@$둔화/NNG,1,0.35356379217443057,61,32,29,32,0.63418529439385,0.3025733967742178
유지/NNG@$경기/NNG@$회복세/NNG,1,0.35356379217443057,61,32,29,18,0.63418529439385,0.3025733967742178
지속/NNG@$금리/NNG@$인상/NNG,1,0.352990458284137,195,101,94,99,0.8511499528227702,0.4066206862067728
국채/NNG@$매입/NNG@$규모/NNG,1,0.35098331219229784,118,61,57,49,0.8063352217533372,0.3869797868304452
금리/NNG@$인상/NNG@$명분/NNG,1,0.35070773124559795,67,35,32,36,0.6612474090517406,0.31754809280676005
금리/NNG@$인상/NNG@$은행/NNG,1,0.35070773124559795,67,35,32,22,0.6612474090517406,0.31754809280676005
채권/NNG@$시장/NNG@$약세/NNG,1,0.34981415683051953,69,36,33,39,0.6696917893504508,0.32225887497821104
자산/NNG@$축소/NNG@$시작/NNG,0,0.34853750886440715,20,11,9,64,0.3784908096943307,0.1826617775942217
유럽연합/NNG@$탈퇴/NNG@$결정/NNG,0,0.34853750886440715,20,11,9,43,0.3784908096943307,0.1826617775942217
시사/NNG@$금리/NNG@$인상/NNG,1,0.34807632665101473,73,38,35,44,0.6857206525297666,0.33128006406536037
규모/NNG@$국채/NNG@$매입/NNG,1,0.34807632665101473,73,38,35,39,0.6857206525297666,0.33128006406536037
불확실성/NNG@$높/VA@$진/VX,1,0.34807632665101473,73,38,35,23,0.6857206525297666,0.33128006406536037
물가/NNG@$상승/NNG@$요인/NNG,1,0.34779017855314787,153,79,74,62,0.8382217423831477,0.4052188831676326
통화정책/NNG@$방향/NNG@$경기/NNG,1,0.3412822257977506,89,46,43,27,0.7387932731726776,0.36246465799437505
금리/NNG@$역전/NNG@$현상/NNG,1,0.34042012419056245,91,47,44,41,0.7442547718912732,0.3658569556827179
서브프라임모기지/NNG@$부실/NNG@$사태/NNG,1,0.34042012419056245,91,47,44,22,0.7442547718912732,0.3658569556827179
검토/NNG@$볼/VX@$필요/NNG@$있/VA,0,0.3389037529309762,22,12,10,7,0.3914900688219242,0.19310734872345398
주택/NNG@$가격/NNG@$상승/NNG@$기대/NNG,0,0.3389037529309762,22,12,10,17,0.3914900688219242,0.19310734872345398
전망/NNG@$금리/NNG@$인하/NNG,1,0.33512763458067996,103,53,50,51,0.7721267704471404,0.38411878429045576
경기/NNG@$부양/NNG@$조치/NNG,1,0.33294718616586017,148,76,72,77,0.8292163174773283,0.4145489443017967
내수/NNG@$수출/NNG@$부진/NNG,0,0.33181615841390744,24,13,11,17,0.40449493731429736,0.20273329975809265
시장/NNG@$금리/NNG@$하락/NNG,1,0.33094509427293284,183,94,89,76,0.8407687904265361,0.4222194284778894
제기/NNG@$금리/NNG@$인하/NNG,0,0.3265477530425229,26,14,12,25,0.4174790424805668,0.21172741717857024
발생/NNG@$가능성/NNG@$높/VA,0,0.3265477530425229,26,14,12,20,0.4174790424805668,0.21172741717857024
금융/NNG@$불안/NNG@$가능성/NNG,0,0.3265477530425229,26,14,12,16,0.4174790424805668,0.21172741717857024
선행지수/NNG@$순환/NNG@$변동/NNG,0,0.3226091145577865,28,15,13,33,0.4304168645093272,0.2202187335145505
금융/NNG@$경제/NNG@$전망/NNG,0,0.3226091145577865,28,15,13,21,0.4304168645093272,0.2202187335145505
금리/NNG@$인상/NNG@$가능성/NNG@$반영/NNG,1,0.3223153452470433,131,67,64,72,0.8106510157227067,0.4150339150466329
기대/NNG@$쉽/VA@$않/VX,0,0.31966001737400607,30,16,14,21,0.4432840144036045,0.22829801055728757
기준금리/NNG@$동결/NNG@$통화정책/NNG@$방향/NNG,0,0.31966001737400607,30,16,14,22,0.4432840144036045,0.22829801055728757
국내총생산/NNG@$증가율/NNG@$전망/NNG,0,0.31966001737400607,30,16,14,24,0.4432840144036045,0.22829801055728757
순환/NNG@$변동/NNG@$하락/NNG,0,0.31966001737400607,30,16,14,18,0.4432840144036045,0.22829801055728757
고용/NNG@$지표/NNG@$호조/NNG,1,0.3187133660754433,139,71,68,104,0.8166148817136344,0.4214562925515555
민간/NNG@$소비/NNG@$회복세/NNG,0,0.31745745920973034,32,17,15,27,0.45605738015717384,0.2360304131298637
무역수지/NNG@$흑자/NNG@$규모/NNG,0,0.31745745920973034,32,17,15,13,0.45605738015717384,0.2360304131298637
생산자/NNG@$물가/NNG@$소비자/NNG,0,0.31745745920973034,32,17,15,14,0.45605738015717384,0.2360304131298637
건강/NNG@$보험/NNG@$개혁/NNG,0,0.31745745920973034,32,17,15,26,0.45605738015717384,0.2360304131298637
점진적/NNG@$기준금리/NNG@$인상/NNG,0,0.31745745920973034,32,17,15,28,0.45605738015717384,0.2360304131298637
물가/NNG@$상승률/NNG@$마이너스/NNG,0,0.31745745920973034,32,17,15,27,0.45605738015717384,0.2360304131298637
물가/NNG@$금리/NNG@$인하/NNG,0,0.3158238518914265,34,18,16,17,0.46871520671302663,0.243463579559414
안정적/NNG@$경제/NNG@$성장/NNG,0,0.3158238518914265,34,18,16,16,0.46871520671302663,0.243463579559414
회복/NNG@$기대/NNG@$어렵/VA,0,0.3158238518914265,34,18,16,33,0.46871520671302663,0.243463579559414
영향/NNG@$않/VX@$전망/NNG,0,0.3158238518914265,34,18,16,24,0.46871520671302663,0.243463579559414
석유/NNG@$제품/NNG@$가격/NNG,0,0.3146268623339692,36,19,17,11,0.4812371403421598,0.2506329002380751
인상/NNG@$가능성/NNG@$가격/NNG@$반영/NNG,0,0.3146268623339692,36,19,17,23,0.4812371403421598,0.2506329002380751
인상/NNG@$금융/NNG@$위기/NNG,0,0.3146268623339692,36,19,17,15,0.4812371403421598,0.2506329002380751
완화적/NNG@$기조/NNG@$유지/NNG,0,0.3146268623339692,36,19,17,30,0.4812371403421598,0.2506329002380751
가능성/NNG@$높/VA@$시장/NNG,0,0.3146268623339692,36,19,17,10,0.4812371403421598,0.2506329002380751
하방/NNG@$리스크/NNG@$커지/VV,0,0.3146268623339692,36,19,17,25,0.4812371403421598,0.2506329002380751
인하/NNG@$금리/NNG@$동결/NNG,0,0.3137662379632169,38,20,18,19,0.4936042518781143,0.25756505523581075
가능성/NNG@$무게/NNG@$실리/VV,0,0.3137662379632169,38,20,18,12,0.4936042518781143,0.25756505523581075
회복/NNG@$찬물/NNG@$끼얹/VV,0,0.3137662379632169,38,20,18,16,0.4936042518781143,0.25756505523581075
상승/NNG@$압력/NNG@$전망/NNG,0,0.3137662379632169,38,20,18,10,0.4936042518781143,0.25756505523581075
통화정책/NNG@$변경/NNG@$가능성/NNG,1,0.3131649592179768,40,21,19,12,0.5057990456469755,0.2642804376315709
경기/NNG@$부양책/NNG@$경제/NNG,1,0.3131649592179768,40,21,19,23,0.5057990456469755,0.2642804376315709
금리/NNG@$인하/NNG@$여지/NNG,1,0.31305765609993497,70,36,34,39,0.6602975975519602,0.3450881324045594
소비자/NNG@$물가/NNG@$안정세/NNG,1,0.3130465504087534,68,35,33,18,0.6518830233029623,0.3406988506829703
시장/NNG@$경기/NNG@$둔화/NNG,1,0.3130465504087534,68,35,33,25,0.6518830233029623,0.3406988506829703
투자/NNG@$증권/NNG@$채권/NNG,1,0.313011090422213,66,34,32,56,0.6431872228741269,0.336180516018203
금리/NNG@$동결/NNG@$경기/NNG,1,0.31295370231431563,64,33,31,30,0.6342101741598873,0.331530566354728
경기/NNG@$회복/NNG@$수출/NNG,1,0.31295370231431563,64,33,31,26,0.6342101741598873,0.331530566354728
가능성/NNG@$높/VA@$금리/NNG@$인상/NNG,1,0.31295370231431563,64,33,31,20,0.6342101741598873,0.331530566354728
원화/NNG@$가치/NNG@$절상/NNG,1,0.31295370231431563,64,33,31,35,0.6342101741598873,0.331530566354728
민간/NNG@$소비/NNG@$투자/NNG,1,0.31282958715917486,78,40,38,32,0.6911684264271326,0.36140463877681295
경제/NNG@$성장/NNG@$둔화/NNG@$우려/NNG,1,0.3127867130198714,60,31,29,41,0.6154162539684281,0.3218252077840512
기조/NNG@$변화/NNG@$없/VA,1,0.3127867130198714,60,31,29,35,0.6154162539684281,0.3218252077840512
국채/NNG@$매입/NNG@$통한/VV,1,0.3127867130198714,60,31,29,12,0.6154162539684281,0.3218252077840512
콜금리/NNG@$목표/NNG@$동결/NNG,1,0.3127867130198714,60,31,29,24,0.6154162539684281,0.3218252077840512
회복/NNG@$국면/NNG@$접어들/VV,1,0.31276315241116426,42,22,20,11,0.5178054573893315,0.270794846246409
정책/NNG@$역량/NNG@$집중/NNG,1,0.31276315241116426,42,22,20,11,0.5178054573893315,0.270794846246409
자금/NNG@$유입/NNG@$확대/NNG,1,0.31276315241116426,42,22,20,9,0.5178054573893315,0.270794846246409
채권/NNG@$시장/NNG@$영향/NNG,1,0.312700888408741,80,41,39,38,0.6982007641768857,0.36518591078925067
상품/NNG@$수지/NNG@$흑자/NNG,1,0.312700888408741,80,41,39,38,0.6982007641768857,0.36518591078925067
서비스/NNG@$금리/NNG@$비교/NNG@$장기금리/NNG@$국채/NNG,1,0.31268632233497295,58,30,28,39,0.6056035312008544,0.3167642131216808
유지/NNG@$기준금리/NNG@$인상/NNG,1,0.31268632233497295,58,30,28,26,0.6056035312008544,0.3167642131216808
불안/NNG@$요인/NNG@$잠재/NNG,1,0.31258284127003066,56,29,27,41,0.5955179797689267,0.3115603428100164
우려/NNG@$기준금리/NNG@$인하/NNG,1,0.31258284127003066,56,29,27,17,0.5955179797689267,0.3115603428100164
소비/NNG@$회복/NNG@$조짐/NNG,1,0.31251381018321367,44,23,21,3,0.5296088428623826,0.2771206886250231
가능성/NNG@$낮/VA@$금리/NNG,1,0.31251381018321367,44,23,21,29,0.5296088428623826,0.2771206886250231
장기/NNG@$채권/NNG@$금리/NNG,1,0.31251381018321367,44,23,21,28,0.5296088428623826,0.2771206886250231
공격적/NNG@$통화/NNG@$완화/NNG,1,0.31251381018321367,44,23,21,24,0.5296088428623826,0.2771206886250231
채권/NNG@$시장/NNG@$자금/NNG,1,0.31251381018321367,44,23,21,18,0.5296088428623826,0.2771206886250231
인하/NNG@$정책/NNG@$효과/NNG,1,0.31251381018321367,44,23,21,26,0.5296088428623826,0.2771206886250231
물가/NNG@$상승률/NNG@$고려/NNG,1,0.31251381018321367,44,23,21,17,0.5296088428623826,0.2771206886250231
경제/NNG@$성장/NNG@$견인/NNG,1,0.31251381018321367,44,23,21,19,0.5296088428623826,0.2771206886250231
경기/NNG@$회복/NNG@$불씨/NNG,1,0.3124843253598528,54,28,26,25,0.5851641358955598,0.3062102992636569
추경/NNG@$금리/NNG@$인하/NNG,1,0.3124843253598528,54,28,26,35,0.5851641358955598,0.3062102992636569
시장/NNG@$예상/NNG@$웃돌/VV,1,0.3124007838810259,52,27,25,60,0.5745476279604923,0.30071044473855013
달러/NNG@$엔/NNG@$상승/NNG,1,0.3124007838810259,52,27,25,9,0.5745476279604923,0.30071044473855013
소수/NNG@$의견/NNG@$나올/VV,1,0.31237972379127554,46,24,22,20,0.5411959581275803,0.28326784900423535
국제금융시장/NNG@$불안/NNG@$경제/NNG,1,0.31237972379127554,46,24,22,3,0.5411959581275803,0.28326784900423535
기준금리/NNG@$만장일치/NNG@$동결/NNG,1,0.31237972379127554,46,24,22,26,0.5411959581275803,0.28326784900423535
인상/NNG@$강하/VA@$시사/NNG,1,0.31237972379127554,46,24,22,8,0.5411959581275803,0.28326784900423535
인도/NNG@$금리/NNG@$인상/NNG,1,0.3123446287923126,50,26,24,11,0.5636752333339747,0.2950566859868214
사회/NNG@$기반/NNG@$시설/NNG,1,0.3123446287923126,50,26,24,11,0.5636752333339747,0.2950566859868214
채권/NNG@$금리/NNG@$인상/NNG,1,0.3123446287923126,50,26,24,20,0.5636752333339747,0.2950566859868214
시장/NNG@$예상/NNG@$금리/NNG@$인상/NNG,1,0.31233124525101386,48,25,23,21,0.5525549322814763,0.2892443228494166
금리/NNG@$상승/NNG@$경제/NNG,1,0.31233124525101386,48,25,23,24,0.5525549322814763,0.2892443228494166
제기/NNG@$금리/NNG@$인상/NNG,1,0.31233124525101386,48,25,23,33,0.5525549322814763,0.2892443228494166
콜/NNG@$인상/NNG@$가능성/NNG,1,0.3121420023479835,86,44,42,38,0.7177077127717573,0.3758539000556327
사상/NNG@$최저/NNG@$기준금리/NNG,1,0.3118994917279927,88,45,43,48,0.7236944662236464,0.3791927067535088
국채/NNG@$금리/NNG@$급등/NNG,1,0.31101277948603,94,48,46,45,0.7401772643132669,0.388591305871492
인상/NNG@$가능성/NNG@$열/VV,1,0.3086988370072894,163,83,80,119,0.8261909753176687,0.4359737082939532
경기/NNG@$회복/NNG@$국면/NNG,1,0.3066266625068901,114,58,56,51,0.7808519204449599,0.4139385305108192
소매/NNG@$판매/NNG@$증가/NNG,1,0.30442967849576164,122,62,60,88,0.7919412354009967,0.4218558722042667
금리/NNG@$인상/NNG@$가능/NNG,1,0.29790125010686586,250,127,123,131,0.8306378474867702,0.4488659944064212
인상/NNG@$가능성/NNG@$시사/NNG,1,0.2973033807245833,315,160,155,144,0.83052811620286,0.4493956658189176
고려/NNG@$금리/NNG@$인상/NNG,1,0.29606156752797874,203,103,100,141,0.8284041507159695,0.44946832378122303
경제/NNG@$동향/NNG@$그린북/NNG,1,0.29482970619335247,154,78,76,110,0.8160904630475975,0.4439836666873538
가능성/NNG@$높/VA@$전망/NNG,1,0.29462742626204497,209,106,103,90,0.8281815050550915,0.4507612324032187
기준금리/NNG@$인하/NNG@$효과/NNG,1,0.2930829849771548,160,81,79,68,0.8181341079419329,0.4468000811129712
인상/NNG@$단행/NNG@$전망/NNG,1,0.2833644343713182,101,51,50,43,0.7451041712603864,0.41563156757089537
금리/NNG@$인상/NNG@$어려울/VA,1,0.28315932224888063,97,49,48,62,0.7356335879032297,0.4105317076085929
기준금리/NNG@$인상/NNG@$경제/NNG,1,0.28315932224888063,97,49,48,50,0.7356335879032297,0.4105317076085929
물가/NNG@$금리/NNG@$인상/NNG,1,0.28179804214317383,127,64,63,46,0.7880182207272232,0.4410682922975502
소비자/NNG@$물가/NNG@$상승세/NNG,1,0.28153371428644647,85,43,42,34,0.7016600891006523,0.39295754568397434
기준금리/NNG@$올릴/VV@$가능성/NNG,1,0.2810955753641271,83,42,41,34,0.6951329815867713,0.38967259162568585
금리/NNG@$인상/NNG@$기대감/NNG,1,0.2810955753641271,83,42,41,59,0.6951329815867713,0.38967259162568585
둔화/NNG@$경제/NNG@$성장/NNG,1,0.28060457536596184,81,41,40,25,0.6883467549135769,0.38627984718772373
시장/NNG@$예상/NNG@$크/VA,1,0.28005883057159964,79,40,39,36,0.6812976332323503,0.38277707371929265
금리/NNG@$인상/NNG@$단행/NNG@$전망/NNG,1,0.2780748936975508,73,37,36,32,0.6585415070218027,0.3715867522329832
금리/NNG@$인상/NNG@$하지/NNG@$않/VX,1,0.2780748936975508,73,37,36,29,0.6585415070218027,0.3715867522329832
주택/NNG@$담보대출/NNG@$부실/NNG,1,0.2772922650814329,71,36,35,20,0.6504118650010319,0.3676222713244493
민간/NNG@$소비/NNG@$증가/NNG,1,0.27644635075437307,69,35,34,34,0.6420074835356,0.3635372251163087
수입/NNG@$물가/NNG@$상승/NNG,1,0.27612315200695536,161,81,80,83,0.8108937804574737,0.4594905392342748
성장/NNG@$둔화/NNG@$경제/NNG,1,0.27553578566230263,67,34,33,25,0.6333277499224157,0.35932968453099673
금융/NNG@$통화정책/NNG@$열/VV@$기준금리/NNG,1,0.27553578566230263,67,34,33,33,0.6333277499224157,0.35932968453099673
달러/NNG@$엔/NNG@$환율/NNG,1,0.27455939980996646,65,33,32,28,0.6243727626482267,0.3549977928723609
주식/NNG@$투자/NNG@$자금/NNG,1,0.27455939980996646,65,33,32,30,0.6243727626482267,0.3549977928723609
인플레이션/NNG@$압력/NNG@$증가/NNG,1,0.27455939980996646,65,33,32,23,0.6243727626482267,0.3549977928723609
구조/NNG@$개혁/NNG@$추진/NNG,1,0.27351626770415205,63,32,31,56,0.615143388400022,0.35053976896452904
금리/NNG@$단기금리/NNG@$국채/NNG,1,0.27306962922097533,179,90,89,164,0.8149858765980208,0.46486849203719305
비교/NNG@$장기금리/NNG@$국채/NNG,1,0.2724057682496188,61,31,30,46,0.6056413199819682,0.3459539080959293
금리/NNG@$비교/NNG@$장기금리/NNG@$국채/NNG,1,0.2724057682496188,61,31,30,46,0.6056413199819682,0.3459539080959293
투자/NNG@$증권/NNG@$동결/NNG,1,0.27122765752763756,59,30,29,34,0.5958691346784801,0.3412385799600005
회복세/NNG@$보일/VV@$전망/NNG,1,0.27122765752763756,59,30,29,20,0.5958691346784801,0.3412385799600005
콜금리/NNG@$인상/NNG@$경기/NNG,1,0.27122765752763756,59,30,29,22,0.5958691346784801,0.3412385799600005
물가/NNG@$상승/NNG@$압력/NNG@$커질/VV,1,0.27122765752763756,59,30,29,9,0.5958691346784801,0.3412385799600005
국고채/NNG@$금리/NNG@$상승/NNG,1,0.26998215757000055,57,29,28,25,0.5858303525439361,0.3363922225503841
환율/NNG@$상승/NNG@$압력/NNG,1,0.26998215757000055,57,29,28,12,0.5858303525439361,0.3363922225503841
경제/NNG@$전망/NNG@$금리/NNG,1,0.26998215757000055,57,29,28,35,0.5858303525439361,0.3363922225503841
채권/NNG@$금리/NNG@$급등/NNG,1,0.26998215757000055,57,29,28,24,0.5858303525439361,0.3363922225503841
결정/NNG@$시장/NNG@$예상/NNG,1,0.2686700651562781,55,28,27,21,0.5755294940470721,0.33141333066026785
소폭/NNG@$하향/NNG@$조정/NNG,1,0.2686700651562781,55,28,27,32,0.5755294940470721,0.33141333066026785
원/NNG@$환율/NNG@$원대/NNG,1,0.2686700651562781,55,28,27,28,0.5755294940470721,0.33141333066026785
공개/NNG@$시장/NNG@$금리/NNG@$인상/NNG,1,0.2686700651562781,55,28,27,15,0.5755294940470721,0.33141333066026785
성장/NNG@$둔화/NNG@$가능성/NNG,1,0.26729288590061406,53,27,26,27,0.5649721364567846,0.3263004372248075
성장률/NNG@$전망/NNG@$제시/NNG,1,0.26729288590061406,53,27,26,33,0.5649721364567846,0.3263004372248075
경제/NNG@$수출/NNG@$부진/NNG,0,0.265278648884113,13,7,6,30,0.3199276732749911,0.18557725506045977
회복세/NNG@$갈/VX@$예상/NNG,0,0.265278648884113,13,7,6,6,0.3199276732749911,0.18557725506045977
강세/NNG@$금리/NNG@$인상/NNG,1,0.2643538730801811,49,25,24,31,0.5431158414775563,0.3156667868432571
호조/NNG@$지속/NNG@$경제/NNG,1,0.2643538730801811,49,25,24,6,0.5431158414775563,0.3156667868432571
달러/NNG@$가치/NNG@$상승/NNG,1,0.26280031235935675,47,24,23,41,0.5318338197679684,0.31014296645551626
예상/NNG@$물가/NNG@$상승률/NNG,1,0.26119880604366097,45,23,22,32,0.5203292243156998,0.30447888067495626
예상/NNG@$좋/VA@$않/VX,1,0.26119880604366097,45,23,22,14,0.5203292243156998,0.30447888067495626
기준금리/NNG@$인하/NNG@$압박/NNG,1,0.26119880604366097,45,23,22,20,0.5203292243156998,0.30447888067495626
지속적/NNG@$금리/NNG@$인상/NNG,1,0.2606592469276734,138,69,69,48,0.7893707538911094,0.4624477568412664
수출/NNG@$부정적/NNG@$영향/NNG,1,0.2605753277352818,126,63,63,61,0.7768801789405112,0.4552121630473126
경기/NNG@$상승/NNG@$기조/NNG,1,0.26048337296941604,124,62,62,24,0.7743358516930146,0.4538108093439043
금리/NNG@$인상/NNG@$반대/NNG,1,0.26046876790357554,144,72,72,74,0.7940705189933601,0.46539117612677344
동결/NNG@$경기/NNG@$둔화/NNG,1,0.25955794934255216,43,22,21,15,0.5086136746219696,0.29867250891273656
금리/NNG@$인하/NNG@$추경/NNG,1,0.25955794934255216,43,22,21,23,0.5086136746219696,0.29867250891273656
마련/NNG@$필요/NNG@$있/VA,1,0.25955794934255216,43,22,21,27,0.5086136746219696,0.29867250891273656
엔화/NNG@$강세/NNG@$보이/VV,1,0.25955794934255216,43,22,21,8,0.5086136746219696,0.29867250891273656
예상/NNG@$크/VA@$벗어나/VV@$않/VX,0,0.2578890033827197,41,21,20,21,0.49670012558079,0.29272140295917365
금리/NNG@$인상/NNG@$크/VA,0,0.2578890033827197,41,21,20,14,0.49670012558079,0.29272140295917365
과거/NNG@$금리/NNG@$인상/NNG,0,0.2578890033827197,41,21,20,26,0.49670012558079,0.29272140295917365
엔화/NNG@$약세/NNG@$지속/NNG,0,0.2578890033827197,41,21,20,26,0.49670012558079,0.29272140295917365
시장/NNG@$관심/NNG@$금리/NNG,0,0.2578890033827197,41,21,20,29,0.49670012558079,0.29272140295917365
국내총생산/NNG@$성장률/NNG@$기록/NNG,0,0.2578890033827197,41,21,20,29,0.49670012558079,0.29272140295917365
가격/NNG@$하락/NNG@$영향/NNG,0,0.2578890033827197,41,21,20,23,0.49670012558079,0.29272140295917365
제조업/NNG@$서비스업/NNG@$생산/NNG,0,0.25648130980179373,15,8,7,5,0.3323782317297758,0.19647240243401035
경제/NNG@$침체/NNG@$우려/NNG,0,0.25620663149687517,39,20,19,17,0.48460290057995403,0.2866224804923753
전망/NNG@$금리/NNG@$동결/NNG,0,0.25620663149687517,39,20,19,32,0.48460290057995403,0.2866224804923753
가격/NNG@$상승/NNG@$소비자/NNG,0,0.25620663149687517,39,20,19,9,0.48460290057995403,0.2866224804923753
콜금리/NNG@$인상/NNG@$예상/NNG,0,0.25620663149687517,39,20,19,18,0.48460290057995403,0.2866224804923753
시장/NNG@$금리/NNG@$크/VA,0,0.25620663149687517,39,20,19,11,0.48460290057995403,0.2866224804923753
동결/NNG@$결정/NNG@$내렸/VV,0,0.25620663149687517,39,20,19,11,0.48460290057995403,0.2866224804923753
국채/NNG@$금리/NNG@$상승/NNG,1,0.2556067483176341,234,117,117,133,0.8116110867312447,0.4806506664248383
금리/NNG@$올릴/VV@$전망/NNG,1,0.254806501236158,94,47,47,49,0.7152932114622595,0.42433503104152054
엔화/NNG@$달러당/NNG@$거래/NNG@$가격/NNG,0,0.2545298843899271,37,19,18,14,0.4723377214880548,0.28037174030537304
시장/NNG@$예상치/NNG@$상회/NNG,0,0.2545298843899271,37,19,18,26,0.4723377214880548,0.28037174030537304
금리/NNG@$인하/NNG@$소비/NNG,0,0.2545298843899271,37,19,18,19,0.4723377214880548,0.28037174030537304
수요/NNG@$압력/NNG@$높/VA,0,0.2545298843899271,37,19,18,7,0.4723377214880548,0.28037174030537304
개선/NNG@$기미/NNG@$보이/VV,0,0.2545298843899271,37,19,18,30,0.4723377214880548,0.28037174030537304
시장/NNG@$영향/NNG@$제한적/NNG,0,0.2545298843899271,37,19,18,26,0.4723377214880548,0.28037174030537304
물가/NNG@$압력/NNG@$높/VA,0,0.2545298843899271,37,19,18,16,0.4723377214880548,0.28037174030537304
회복세/NNG@$보이/VV@$경제/NNG,0,0.2545298843899271,37,19,18,25,0.4723377214880548,0.28037174030537304
달러당/NNG@$거래/NNG@$가격/NNG,0,0.2545298843899271,37,19,18,14,0.4723377214880548,0.28037174030537304
달러화/NNG@$엔화/NNG@$달러당/NNG@$거래/NNG@$가격/NNG,0,0.2545298843899271,37,19,18,14,0.4723377214880548,0.28037174030537304
증권/NNG@$기준금리/NNG@$인하/NNG,0,0.2545298843899271,37,19,18,17,0.4723377214880548,0.28037174030537304
인상/NNG@$압력/NNG@$높/VA,0,0.2528835396367184,35,18,17,19,0.45992173711750034,0.2739638665448836
경기/NNG@$둔화/NNG@$국면/NNG,0,0.2528835396367184,35,18,17,19,0.45992173711750034,0.2739638665448836
물가/NNG@$오르/VV@$않/VX,0,0.2528835396367184,35,18,17,39,0.45992173711750034,0.2739638665448836
금리/NNG@$인상/NNG@$강력/XR,0,0.2528835396367184,35,18,17,17,0.45992173711750034,0.2739638665448836
경기/NNG@$나쁘/VA@$않/VX,0,0.2528835396367184,35,18,17,15,0.45992173711750034,0.2739638665448836
부동산/NNG@$대책/NNG@$효과/NNG,0,0.2528835396367184,35,18,17,21,0.45992173711750034,0.2739638665448836
상향/NNG@$조정/NNG@$예상/NNG,0,0.2528835396367184,35,18,17,18,0.45992173711750034,0.2739638665448836
요인/NNG@$크/VA@$않/VX,0,0.2528835396367184,35,18,17,17,0.45992173711750034,0.2739638665448836
지수/NNG@$상승/NNG@$거래/NNG@$마쳤/VV,1,0.2513663835405764,86,43,43,74,0.6914939398117406,0.41324193481435834
상승/NNG@$물가/NNG@$불안/NNG,0,0.2512999556607689,33,17,16,21,0.4473735529234592,0.2673916726883673
확산/NNG@$금리/NNG@$인상/NNG,0,0.2512999556607689,33,17,16,19,0.4473735529234592,0.2673916726883673
상승/NNG@$환율/NNG@$하락/NNG,0,0.2512999556607689,33,17,16,16,0.4473735529234592,0.2673916726883673
소비자/NNG@$물가/NNG@$수요/NNG,0,0.2512999556607689,33,17,16,10,0.4473735529234592,0.2673916726883673
결정/NNG@$영향/NNG@$않/VX,0,0.2512999556607689,33,17,16,21,0.4473735529234592,0.2673916726883673
변화/NNG@$없/VA@$예상/NNG,0,0.2512999556607689,33,17,16,21,0.4473735529234592,0.2673916726883673
경기/NNG@$둔화/NNG@$원자재/NNG@$가격/NNG,0,0.2512999556607689,33,17,16,21,0.4473735529234592,0.2673916726883673
인상/NNG@$시기/NNG@$가능성/NNG,0,0.2512999556607689,33,17,16,16,0.4473735529234592,0.2673916726883673
인상/NNG@$단행/NNG@$금리/NNG,1,0.2503363632683915,84,42,42,41,0.6849272133830944,0.410218060049306
필요/NNG@$있/VA@$조언/NNG,1,0.2503363632683915,84,42,42,46,0.6849272133830944,0.410218060049306
시작/NNG@$금리/NNG@$인상/NNG,1,0.2503363632683915,84,42,42,46,0.6849272133830944,0.410218060049306
경제/NNG@$영향/NNG@$크/VA@$않/VX,0,0.2498216891422187,31,16,15,29,0.4347132664161346,0.2606453092836687
제시/NNG@$성장률/NNG@$전망치/NNG,0,0.2498216891422187,31,16,15,20,0.4347132664161346,0.2606453092836687
양적완화/NNG@$축소/NNG@$경제/NNG,0,0.2498216891422187,31,16,15,29,0.4347132664161346,0.2606453092836687
기준금리/NNG@$인상/NNG@$금융시장/NNG,0,0.2498216891422187,31,16,15,20,0.4347132664161346,0.2606453092836687
기준금리/NNG@$인상/NNG@$기대/NNG,1,0.2492323279211941,82,41,41,58,0.6781053361981373,0.4070894588527684
전망/NNG@$경제/NNG@$성장/NNG,1,0.2492323279211941,82,41,41,44,0.6781053361981373,0.4070894588527684
지수/NNG@$높/VA@$마감/NNG,0,0.24850527304743109,29,15,14,21,0.4219625153096486,0.2537111152611443
필요/NNG@$의견/NNG@$제시/NNG,0,0.24834483229536097,19,10,9,11,0.35773040237422243,0.21516416088741433
금리/NNG@$하락/NNG@$추세/NNG,0,0.2474268078401074,27,14,13,24,0.4091445492540867,0.24656991718985258
하방/NNG@$리스크/NNG@$높/VA,0,0.2474268078401074,27,14,13,14,0.4091445492540867,0.24656991718985258
가격/NNG@$상승/NNG@$주택/NNG,0,0.24669047422717116,25,13,12,18,0.3962843418221812,0.23919444773642268
해외/NNG@$자본/NNG@$유출/NNG,0,0.2464419229449244,23,12,11,33,0.38340876841573923,0.23154531060320688
국채/NNG@$금리/NNG@$서비스/NNG,1,0.2432534390301464,183,91,92,167,0.8018933833622846,0.48756828311509004
실제/NNG@$금리/NNG@$인상/NNG,1,0.2424881029621211,72,36,36,39,0.6400570713534119,0.38980162995527406
경기/NNG@$불확실성/NNG@$높/VA,1,0.2408704272615183,70,35,35,17,0.6316438604567318,0.3860013784506015
지속/NNG@$금리/NNG@$인하/NNG,1,0.23915471949072753,68,34,34,31,0.6229601107608843,0.38208279701295816
인상/NNG@$경기/NNG@$회복/NNG,1,0.2390149614953101,125,62,63,60,0.7652537381147918,0.46949546575639906
금리/NNG@$인상/NNG@$압력/NNG,1,0.23638826209161956,115,57,58,38,0.7497859678693908,0.46257310099368865
예정/NNG@$금리/NNG@$인상/NNG,1,0.23338119027529247,62,31,31,37,0.5952906671615403,0.3696029103491115
임금/NNG@$상승/NNG@$압력/NNG,1,0.23338119027529247,62,31,31,38,0.5952906671615403,0.3696029103491115
인상/NNG@$채권/NNG@$시장/NNG,1,0.23338119027529247,62,31,31,26,0.5952906671615403,0.3696029103491115
경제/NNG@$성장/NNG@$전망치/NNG,1,0.23338119027529247,62,31,31,28,0.5952906671615403,0.3696029103491115
제품/NNG@$가격/NNG@$상승/NNG,1,0.23338119027529247,62,31,31,18,0.5952906671615403,0.3696029103491115
기준금리/NNG@$추이/NNG@$열/VV,1,0.23338119027529247,62,31,31,22,0.5952906671615403,0.3696029103491115
인상/NNG@$가능성/NNG@$높/VA,1,0.23324304625549175,484,240,244,209,0.8014409346106975,0.4977424403009475
장기금리/NNG@$단기금리/NNG@$등락/NNG,1,0.2326118404994475,105,52,53,76,0.7299457689425954,0.4539449703747081
단기금리/NNG@$등락/NNG@$장기금리/NNG@$국채/NNG,1,0.2326118404994475,105,52,53,76,0.7299457689425954,0.4539449703747081
물가/NNG@$상승률/NNG@$기록/NNG,1,0.23198723684867018,222,110,112,72,0.8001491864852183,0.4982608950907346
경기/NNG@$회복/NNG@$지연/NNG,1,0.2316667071688998,218,108,110,86,0.7998401035748185,0.49840582065674954
조정/NNG@$가능성/NNG@$높/VA,1,0.23123475563620888,60,30,30,25,0.5855336847539727,0.3651977285871535
동결/NNG@$가능성/NNG@$크/VA,1,0.23123475563620888,60,30,30,34,0.5855336847539727,0.3651977285871535
투자/NNG@$자금/NNG@$유출/NNG,1,0.23123475563620888,60,30,30,51,0.5855336847539727,0.3651977285871535
시장/NNG@$예상/NNG@$뛰어넘/VV,1,0.23123475563620888,60,30,30,22,0.5855336847539727,0.3651977285871535
시중/NNG@$유동성/NNG@$흡수/NNG,1,0.23123475563620888,60,30,30,46,0.5855336847539727,0.3651977285871535
금리/NNG@$인상/NNG@$지연/NNG,1,0.2301900528001246,200,99,101,102,0.7979438398956018,0.49877712583147915
시장/NNG@$금리/NNG@$인하/NNG@$기대/NNG,1,0.22966159274534603,99,49,50,33,0.7156475638505202,0.4478347856953474
기조/NNG@$지속/NNG@$전망/NNG,1,0.22897062380499245,58,29,29,27,0.5755146930825239,0.36066852889085965
인플레이션/NNG@$압력/NNG@$높/VA,1,0.228958914441028,186,92,94,89,0.7955304464569367,0.4985622215864813
인상/NNG@$위안화/NNG@$절상/NNG,1,0.2285469213263127,97,48,49,39,0.7104493551467542,0.4456286804550252
기준금리/NNG@$동결/NNG@$경기/NNG,1,0.2285469213263127,97,48,49,41,0.7104493551467542,0.4456286804550252
금리/NNG@$인상/NNG@$인하/NNG,1,0.2273614146911307,95,47,48,41,0.7050262883863407,0.44333396638416456
인상/NNG@$가능성/NNG@$없/VA,1,0.22658466470239969,56,28,28,33,0.5652380206943456,0.35601481754081593
경기/NNG@$회복/NNG@$기조/NNG,1,0.22628711833398674,162,80,82,63,0.7875669113141497,0.4963596419355063
금리/NNG@$인상/NNG@$통한/VV,1,0.2240727008560892,54,27,27,18,0.5547089873193515,0.35123636591392804
금리/NNG@$인상/NNG@$의미/NNG,1,0.2240727008560892,54,27,27,16,0.5547089873193515,0.35123636591392804
투자자들/NNG@$금리/NNG@$인상/NNG,1,0.22184316533260318,87,43,44,60,0.6809873442983717,0.4332217688968988
인상/NNG@$나서/VV@$않/VX,1,0.22143051776789768,52,26,26,31,0.5439339491632724,0.34633323334920424
금리/NNG@$인하/NNG@$경기/NNG@$부양책/NNG,1,0.22143051776789768,52,26,26,16,0.5439339491632724,0.34633323334920424
부담/NNG@$크/VA@$않/VX,1,0.22143051776789768,52,26,26,28,0.5439339491632724,0.34633323334920424
소비자/NNG@$물가/NNG@$상승률/NNG@$중기/NNG,1,0.22143051776789768,52,26,26,11,0.5439339491632724,0.34633323334920424
농산물/NNG@$가격/NNG@$급등/NNG,1,0.21865387563547545,50,25,25,9,0.5329203402160361,0.3413057903608372
기조/NNG@$이어질/VV@$전망/NNG,1,0.21865387563547545,50,25,25,36,0.5329203402160361,0.3413057903608372
문제/NNG@$해결/NNG@$없/VA,1,0.21865387563547545,50,25,25,8,0.5329203402160361,0.3413057903608372
기준금리/NNG@$인상/NNG@$시작/NNG,1,0.2185670317905164,83,41,42,53,0.6674974872648313,0.4275729058349432
물가/NNG@$상승률/NNG@$높/VA,0,0.21694051573923834,485,239,246,168,0.7935049743893299,0.5100263745904027
금리/NNG@$인하/NNG@$논의/NNG,1,0.21573852245711578,48,24,24,28,0.5216767085974056,0.3361547420025279
규모/NNG@$경상수지/NNG@$흑자/NNG,1,0.21573852245711578,48,24,24,49,0.5216767085974056,0.3361547420025279
부동산/NNG@$담보대출/NNG@$모기지/NNG,1,0.21573852245711578,48,24,24,14,0.5216767085974056,0.3361547420025279
소비자/NNG@$물가/NNG@$예상/NNG,1,0.21573852245711578,48,24,24,12,0.5216767085974056,0.3361547420025279
통화정책/NNG@$기준금리/NNG@$인상/NNG,1,0.2149035499807732,79,39,40,42,0.6529867748950008,0.4215046289885011
금리/NNG@$인하/NNG@$유동성/NNG@$공급/NNG,1,0.2149035499807732,79,39,40,12,0.6529867748950008,0.4215046289885011
물가/NNG@$상승/NNG@$우려/NNG,0,0.21446721112264222,185,91,94,75,0.7881950642395593,0.5092473848596524
기준금리/NNG@$인하/NNG@$정책/NNG,1,0.2126802085316979,46,23,23,20,0.5102127469138464,0.33088115115784
조업/NNG@$일수/NNG@$감소/NNG,1,0.2126802085316979,46,23,23,39,0.5102127469138464,0.33088115115784
중기/NNG@$물가/NNG@$목표치/NNG,1,0.2126802085316979,46,23,23,20,0.5102127469138464,0.33088115115784
금리/NNG@$인하/NNG@$어렵/VA,1,0.2126802085316979,46,23,23,32,0.5102127469138464,0.33088115115784
인플레이션/NNG@$압력/NNG@$크/VA,1,0.2126802085316979,46,23,23,21,0.5102127469138464,0.33088115115784
상승/NNG@$인플레이션/NNG@$압력/NNG,1,0.21255923570618496,114,56,58,34,0.7363915150677517,0.47768268636238986
원/NNG@$환율/NNG@$상승/NNG,1,0.21148526970807469,112,55,57,42,0.7325272656991736,0.47624543226874955
동결/NNG@$금리/NNG@$인하/NNG,0,0.21137073945853757,169,83,86,71,0.7826847266084196,0.5089767870198272
확인/NNG@$금리/NNG@$인하/NNG,0,0.20947470234602372,44,22,22,23,0.49853931556818454,0.3254864615017715
하향/NNG@$조정/NNG@$성장률/NNG,0,0.20947470234602372,44,22,22,17,0.49853931556818454,0.3254864615017715
양적완화/NNG@$축소/NNG@$시작/NNG,0,0.20947470234602372,44,22,22,26,0.49853931556818454,0.3254864615017715
갭/NNG@$플러스/NNG@$전환/NNG,0,0.20947470234602372,44,22,22,26,0.49853931556818454,0.3254864615017715
금리/NNG@$상승/NNG@$우려/NNG,0,0.20947470234602372,44,22,22,9,0.49853931556818454,0.3254864615017715
실업/NNG@$수당/NNG@$신청/NNG,0,0.20947470234602372,44,22,22,22,0.49853931556818454,0.3254864615017715
지속/NNG@$물가/NNG@$상승/NNG@$압력/NNG,0,0.20947470234602372,44,22,22,11,0.49853931556818454,0.3254864615017715
상승/NNG@$가능성/NNG@$높/VA,0,0.20947470234602372,44,22,22,26,0.49853931556818454,0.3254864615017715
금리/NNG@$단기금리/NNG@$없/VA,1,0.20915267435739304,108,53,55,116,0.7242372820606744,0.47315865366425247
국채/NNG@$금리/NNG@$단기금리/NNG@$없/VA,1,0.20915267435739304,108,53,55,116,0.7242372820606744,0.47315865366425247
성장률/NNG@$기록/NNG@$전망/NNG,1,0.20860370087975544,73,36,37,39,0.6292580838966697,0.41157887291035833
가능성/NNG@$배제/NNG@$않/VX,0,0.20847735599245465,157,77,80,76,0.7763599715127162,0.5079279187198672
기준금리/NNG@$인하/NNG@$전망/NNG,0,0.20697162628997345,216,106,110,120,0.7875859195207254,0.5168959292692059
경기/NNG@$회복/NNG@$강도/NNG,1,0.2062696671233024,71,35,36,27,0.6208178459343103,0.40804304219035664
긴축/NNG@$기조/NNG@$전환/NNG,1,0.2062696671233024,71,35,36,23,0.6208178459343103,0.40804304219035664
인상/NNG@$시기/NNG@$결정/NNG,0,0.20611780781948363,42,21,21,23,0.4866684579502103,0.31997251984928193
지속/NNG@$경기/NNG@$둔화/NNG,0,0.20611780781948363,42,21,21,17,0.4866684579502103,0.31997251984928193
정책/NNG@$수단/NNG@$활용/NNG,0,0.20611780781948363,42,21,21,29,0.4866684579502103,0.31997251984928193
경기/NNG@$하방/NNG@$압력/NNG,0,0.20611780781948363,42,21,21,51,0.4866684579502103,0.31997251984928193
가능성/NNG@$적/VA@$않/VX,0,0.20611780781948363,42,21,21,13,0.4866684579502103,0.31997251984928193
금리/NNG@$인상/NNG@$멈출/VV,0,0.20611780781948363,42,21,21,8,0.4866684579502103,0.31997251984928193
금리/NNG@$인상/NNG@$긴축/NNG,1,0.2051463803996243,102,50,52,52,0.7103157888320025,0.46796306203912214
금리/NNG@$인상/NNG@$신호/NNG,1,0.2036626359755067,100,49,51,64,0.7052572370035805,0.46607091491533276
물가/NNG@$상승/NNG@$유발/NNG,0,0.2026053828510388,40,20,20,19,0.4746134064454001,0.3143415975779298
금리/NNG@$인상/NNG@$실시/NNG,0,0.2026053828510388,40,20,20,15,0.4746134064454001,0.3143415975779298
제로/NNG@$금리/NNG@$유지/NNG,0,0.2026053828510388,40,20,20,14,0.4746134064454001,0.3143415975779298
광/NNG@$통화/NNG@$증가율/NNG,0,0.2026053828510388,40,20,20,21,0.4746134064454001,0.3143415975779298
수출/NNG@$호조세/NNG@$지속/NNG,0,0.2026053828510388,40,20,20,12,0.4746134064454001,0.3143415975779298
물가/NNG@$상승/NNG@$목표/NNG,0,0.2026053828510388,40,20,20,28,0.4746134064454001,0.3143415975779298
기준금리/NNG@$인상/NNG@$않/VX,1,0.2020989492025158,98,48,50,49,0.6999809020361172,0.4640945823126335
금리/NNG@$인상/NNG@$시사/NNG,0,0.20198918002077781,398,195,203,274,0.7860326486681487,0.5212670210472686
물가/NNG@$상승/NNG@$압력/NNG@$크/VA@$않/VX,1,0.20121842339189944,67,33,34,70,0.6031371218999246,0.4006205626768768
금리/NNG@$인상/NNG@$이어질/VV,0,0.19893335908615728,38,19,19,25,0.46238857823358115,0.3085964107848796
금리/NNG@$동반/NNG@$상승/NNG,0,0.19893335908615728,38,19,19,12,0.46238857823358115,0.3085964107848796
금리/NNG@$인상/NNG@$나서/VV@$않/VX,0,0.19893335908615728,38,19,19,19,0.46238857823358115,0.3085964107848796
기준금리/NNG@$조정/NNG@$여부/NNG,0,0.19893335908615728,38,19,19,18,0.46238857823358115,0.3085964107848796
물가/NNG@$불안/NNG@$심리/NNG,0,0.19893335908615728,38,19,19,16,0.46238857823358115,0.3085964107848796
상승/NNG@$주택/NNG@$가격/NNG,0,0.19893335908615728,38,19,19,12,0.46238857823358115,0.3085964107848796
통화정책/NNG@$기조/NNG@$경기/NNG,0,0.19893335908615728,38,19,19,15,0.46238857823358115,0.3085964107848796
기준금리/NNG@$인상/NNG@$속도/NNG,1,0.19871689078639787,94,46,48,88,0.6887547607461626,0.45987950678036954
전망치/NNG@$상향/NNG@$조정/NNG,0,0.19854889916294538,327,160,167,163,0.7842857905390288,0.5238484086224737
종합/NNG@$지수/NNG@$하락/NNG,1,0.198489600123833,65,32,33,36,0.5938974723206868,0.3967311982882969
물가/NNG@$상승률/NNG@$크/VA,1,0.19561705887520486,63,31,32,26,0.584393381716115,0.3927216289195802
인상/NNG@$경제/NNG@$성장/NNG,1,0.19561705887520486,63,31,32,42,0.584393381716115,0.3927216289195802
수출/NNG@$내수/NNG@$부진/NNG,0,0.1950977627919186,36,18,18,21,0.4500095599125519,0.3027401388142448
경제/NNG@$성장/NNG@$위협/NNG,0,0.1950977627919186,36,18,18,14,0.4500095599125519,0.3027401388142448
소비/NNG@$기업/NNG@$투자/NNG,0,0.1950977627919186,36,18,18,24,0.4500095599125519,0.3027401388142448
통화정책/NNG@$방향/NNG@$금리/NNG,0,0.1950977627919186,36,18,18,14,0.4500095599125519,0.3027401388142448
하방/NNG@$위험/NNG@$커지/VV,0,0.1950977627919186,36,18,18,18,0.4500095599125519,0.3027401388142448
가계/NNG@$대출/NNG@$증가/NNG,1,0.19294727689599367,88,43,45,70,0.6701610007297942,0.4528636557571593
원유/NNG@$가격/NNG@$하락/NNG,0,0.19109473669742827,34,17,17,19,0.4374930800757175,0.29677644077006715
리스크/NNG@$금리/NNG@$인상/NNG,0,0.19109473669742827,34,17,17,24,0.4374930800757175,0.29677644077006715
시장/NNG@$인상/NNG@$가능성/NNG,0,0.19109473669742827,34,17,17,16,0.4374930800757175,0.29677644077006715
실업률/NNG@$물가/NNG@$상승률/NNG,0,0.19109473669742827,34,17,17,18,0.4374930800757175,0.29677644077006715
부정적/NNG@$영향/NNG@$전망/NNG,0,0.19109473669742827,34,17,17,21,0.4374930800757175,0.29677644077006715
경제/NNG@$회복세/NNG@$둔화/NNG,0,0.19109473669742827,34,17,17,14,0.4374930800757175,0.29677644077006715
경기/NNG@$회복세/NNG@$이어지/VV,0,0.19109473669742827,34,17,17,26,0.4374930800757175,0.29677644077006715
경기동행지수/NNG@$순환/NNG@$변동/NNG,0,0.19109473669742827,34,17,17,16,0.4374930800757175,0.29677644077006715
경제/NNG@$성장/NNG@$촉진/NNG,1,0.18977724133202978,115,56,59,36,0.7263983724269054,0.49410581393851083
내수/NNG@$경기/NNG@$회복/NNG,0,0.1894244757068686,152,74,78,65,0.763835820405863,0.5199514660932849
종합/NNG@$지수/NNG@$상승/NNG,1,0.18941396979965042,59,29,30,30,0.5646017968165902,0.38433904136157393
해외/NNG@$투자/NNG@$활성화/NNG,1,0.18941396979965042,59,29,30,53,0.5646017968165902,0.38433904136157393
시장/NNG@$예상치/NNG@$크/VA,1,0.18941396979965042,59,29,30,21,0.5646017968165902,0.38433904136157393
은행/NNG@$지급준비율/NNG@$인상/NNG,1,0.1885859235605578,84,41,43,33,0.6565455523478944,0.44769540232593513
부진/NNG@$경기/NNG@$회복세/NNG,0,0.18692056262457113,32,16,16,28,0.4248569690993103,0.2907094696142582
고용/NNG@$지표/NNG@$좋/VA,0,0.18692056262457113,32,16,16,22,0.4248569690993103,0.2907094696142582
필요/NNG@$있/VA@$주문/NNG,0,0.18692056262457113,32,16,16,21,0.4248569690993103,0.2907094696142582
증가/NNG@$민간/NNG@$소비/NNG,0,0.18692056262457113,32,16,16,15,0.4248569690993103,0.2907094696142582
대내외/NNG@$경제/NNG@$환경/NNG,0,0.18692056262457113,32,16,16,21,0.4248569690993103,0.2907094696142582
정책금리/NNG@$인상/NNG@$시기/NNG,0,0.18692056262457113,32,16,16,7,0.4248569690993103,0.2907094696142582
지수/NNG@$오른/VV@$거래/NNG,0,0.18692056262457113,32,16,16,20,0.4248569690993103,0.2907094696142582
원유/NNG@$도입/NNG@$단가/NNG,0,0.18692056262457113,32,16,16,14,0.4248569690993103,0.2907094696142582
국채/NNG@$금리/NNG@$낮/VA,0,0.18692056262457113,32,16,16,16,0.4248569690993103,0.2907094696142582
통화정책/NNG@$결정/NNG@$영향/NNG,0,0.18692056262457113,32,16,16,16,0.4248569690993103,0.2907094696142582
우려/NNG@$경기/NNG@$둔화/NNG,0,0.18692056262457113,32,16,16,25,0.4248569690993103,0.2907094696142582
가계/NNG@$대출/NNG@$금리/NNG,0,0.18692056262457113,32,16,16,13,0.4248569690993103,0.2907094696142582
경제/NNG@$성장세/NNG@$약화/NNG,0,0.18692056262457113,32,16,16,26,0.4248569690993103,0.2907094696142582
원달러/NNG@$환율/NNG@$상승/NNG,1,0.1862365787951319,82,40,42,61,0.6493607742623673,0.4449566687633698
금리/NNG@$동결/NNG@$이유/NNG,1,0.18606897500983455,57,28,29,29,0.554321352001578,0.3799653640831924
상향/NNG@$조정/NNG@$경제/NNG,1,0.18606897500983455,57,28,29,21,0.554321352001578,0.3799653640831924
자산/NNG@$시장/NNG@$거품/NNG,1,0.18606897500983455,57,28,29,20,0.554321352001578,0.3799653640831924
가격/NNG@$고공/NNG@$행진/NNG,1,0.18606897500983455,57,28,29,23,0.554321352001578,0.3799653640831924
금리/NNG@$인상/NNG@$출구전략/NNG,0,0.18581786150888902,144,70,74,39,0.7567030192420545,0.5189597648000273
금융시장/NNG@$금리/NNG@$인상/NNG,0,0.18482521809312846,142,69,73,77,0.7546651129463751,0.5186267761967901
경제/NNG@$성장/NNG@$동력/NNG,1,0.18376796864005596,80,39,41,54,0.6419204456295847,0.44211171301001484
부진/NNG@$금리/NNG@$인상/NNG,1,0.18376796864005596,80,39,41,65,0.6419204456295847,0.44211171301001484
예상/NNG@$금리/NNG@$인하/NNG,0,0.18363460397445408,179,87,92,64,0.7711534501107723,0.5312652945264499
우려/NNG@$크/VA@$않/VX,1,0.1836075168629041,107,52,55,37,0.7094353204379586,0.48877364883891683
등락/NNG@$장기금리/NNG@$국채/NNG,0,0.1829046158872436,177,86,91,164,0.77028969134889,0.5314721477521558
경기/NNG@$개선/NNG@$추세/NNG,0,0.18257168470165985,30,15,15,19,0.4121201055544072,0.28454388343868436
정책/NNG@$방향/NNG@$제시/NNG,0,0.18257168470165985,30,15,15,16,0.4121201055544072,0.28454388343868436
활용/NNG@$필요/NNG@$있/VA,0,0.18257168470165985,30,15,15,21,0.4121201055544072,0.28454388343868436
필요/NNG@$있/VA@$물가/NNG,0,0.18257168470165985,30,15,15,14,0.4121201055544072,0.28454388343868436
금리/NNG@$인상/NNG@$진행/NNG,0,0.18257168470165985,30,15,15,23,0.4121201055544072,0.28454388343868436
금리/NNG@$상승/NNG@$가능성/NNG,1,0.18255126078509853,55,27,28,29,0.5437906386543276,0.37547024139181717
금융/NNG@$위기/NNG@$기준금리/NNG,1,0.18117466873870214,78,38,40,25,0.6342219209372757,0.43915824924574
통화정책/NNG@$기조/NNG@$변경/NNG,0,0.17804473292057965,28,14,14,25,0.3993023488512777,0.2782848534973935
기준금리/NNG@$유지/NNG@$통화정책/NNG@$경제/NNG,0,0.17804473292057965,28,14,14,21,0.3993023488512777,0.2782848534973935
안정적/NNG@$모습/NNG@$보이/VV,0,0.17804473292057965,28,14,14,21,0.3993023488512777,0.2782848534973935
부정적/NNG@$영향/NNG@$않/VX,0,0.17804473292057965,28,14,14,24,0.3993023488512777,0.2782848534973935
유지/NNG@$통화정책/NNG@$경제/NNG,0,0.17804473292057965,28,14,14,21,0.3993023488512777,0.2782848534973935
상품/NNG@$가격/NNG@$상승/NNG,0,0.1766202354126163,128,62,66,43,0.7370104124354173,0.5151553182549151
금리/NNG@$인상/NNG@$재개/NNG,1,0.17615630574439156,99,48,51,35,0.6892618793945288,0.48224143976240386
금리/NNG@$올릴/VV@$예상/NNG,1,0.17615630574439156,99,48,51,55,0.6892618793945288,0.48224143976240386
경기/NNG@$회복/NNG@$전망/NNG,1,0.1755909243639795,74,36,38,26,0.6180419252749675,0.4329170774850044
금융시장/NNG@$불안/NNG@$요인/NNG,1,0.1755909243639795,74,36,38,23,0.6180419252749675,0.4329170774850044
구매/NNG@$관리/NNG@$지수/NNG,1,0.174962980188913,51,25,26,18,0.522002434302256,0.3661185639471872
역전/NNG@$자본/NNG@$유출/NNG,1,0.174962980188913,51,25,26,22,0.522002434302256,0.3661185639471872
금리/NNG@$인하/NNG@$예상/NNG,0,0.17486158250861883,229,111,118,103,0.7714952191839823,0.5412192929301199
제시/NNG@$금리/NNG@$인상/NNG,0,0.17333654676752452,26,13,13,26,0.38642445794685193,0.271938068589859
변동성/NNG@$음식/NNG@$에너지/NNG,0,0.17333654676752452,26,13,13,29,0.38642445794685193,0.271938068589859
경제/NNG@$성장/NNG@$하방/NNG@$위험/NNG,1,0.17087329979774868,49,24,25,17,0.5107593295073524,0.36126467270739027
원자재/NNG@$가격/NNG@$상승/NNG@$인플레이션/NNG,1,0.17087329979774868,49,24,25,19,0.5107593295073524,0.36126467270739027
경제/NNG@$리스크/NNG@$요인/NNG,1,0.17087329979774868,49,24,25,20,0.5107593295073524,0.36126467270739027
통화정책/NNG@$경기/NNG@$부양/NNG,1,0.17087329979774868,49,24,25,29,0.5107593295073524,0.36126467270739027
가격/NNG@$상승세/NNG@$둔화/NNG,1,0.17087329979774868,49,24,25,14,0.5107593295073524,0.36126467270739027
수출/NNG@$호조/NNG@$보이/VV,1,0.16957936385055494,93,45,48,37,0.6718273756630829,0.4764570473391213
금리/NNG@$인상/NNG@$위안화/NNG@$절상/NNG,1,0.16943609826341133,70,34,36,25,0.6008090608959976,0.4262168250667303
민간/NNG@$소비/NNG@$증가율/NNG,0,0.16909170682548624,118,57,61,73,0.7201039931295622,0.5112074118675618
경기/NNG@$회복세/NNG@$지원/NNG,0,0.16844419862947224,24,12,12,22,0.3735079961971782,0.265509735400093
결정/NNG@$금리/NNG@$인상/NNG,0,0.16780359474769568,145,70,75,66,0.7478103362271536,0.5322851316759363
서비스/NNG@$금리/NNG@$비교/NNG@$보/VV@$장기금리/NNG,1,0.16717571222983296,91,44,47,109,0.6655516495391193,0.47434625090942645
재정위기/NNG@$경기/NNG@$둔화/NNG,0,0.1665724116910996,47,23,24,11,0.49929474066864293,0.3562947842979064
원화/NNG@$강세/NNG@$기조/NNG,0,0.1665724116910996,47,23,24,16,0.49929474066864293,0.3562947842979064
물가/NNG@$상승세/NNG@$둔화/NNG,1,0.166127630677809,68,33,35,52,0.5917965265574491,0.42269004174976776
금리/NNG@$인상/NNG@$가계/NNG,1,0.166127630677809,68,33,35,28,0.5917965265574491,0.42269004174976776
자산/NNG@$가격/NNG@$하락/NNG,1,0.166127630677809,68,33,35,35,0.5917965265574491,0.42269004174976776
인하/NNG@$가능성/NNG@$낮/VA,0,0.1655988736116032,114,55,59,54,0.7121661105093482,0.5092170535795635
금리/NNG@$올릴/VV@$가능성/NNG,0,0.16452632000756173,170,82,88,86,0.7584802712368945,0.5435295416299265
금융/NNG@$불안/NNG@$요인/NNG,0,0.16336501665425796,22,11,11,12,0.36057522271103337,0.25900657442044334
금융/NNG@$외환시장/NNG@$영향/NNG,0,0.16336501665425796,22,11,11,33,0.36057522271103337,0.25900657442044334
인상/NNG@$가능성/NNG@$무게/NNG,1,0.16265531182898374,66,32,34,33,0.5825204584372274,0.41904343900454305
수출/NNG@$가격/NNG@$경쟁력/NNG,1,0.16265531182898374,66,32,34,28,0.5825204584372274,0.41904343900454305
성장/NNG@$발목/NNG@$잡/VV,0,0.16204834266810098,45,22,23,31,0.4876182365079318,0.3512117299239662
수당/NNG@$청구/NNG@$예상/NNG,0,0.16204834266810098,45,22,23,33,0.4876182365079318,0.3512117299239662
원화/NNG@$강세/NNG@$지속/NNG,0,0.16204834266810098,45,22,23,38,0.4876182365079318,0.3512117299239662
공급/NNG@$물가/NNG@$상승/NNG@$압력/NNG,0,0.16204834266810098,45,22,23,13,0.4876182365079318,0.3512117299239662
실업/NNG@$수당/NNG@$청구/NNG@$예상/NNG,0,0.16204834266810098,45,22,23,33,0.4876182365079318,0.3512117299239662
물가/NNG@$불안/NNG@$우려/NNG,1,0.16202258058804864,87,42,45,13,0.6522783187786529,0.46983458716829796
인플레이션/NNG@$경제/NNG@$성장/NNG,1,0.16202258058804864,87,42,45,43,0.6522783187786529,0.46983458716829796
경기/NNG@$둔화/NNG@$조짐/NNG,1,0.16202258058804864,87,42,45,40,0.6522783187786529,0.46983458716829796
예상/NNG@$기준금리/NNG@$인상/NNG,0,0.1617919470291238,110,53,57,62,0.7034921905059579,0.5069637868636674
지속/NNG@$가능성/NNG@$크/VA,1,0.15901120138841085,64,31,33,41,0.5729820808359065,0.4152757510031282
둔화/NNG@$원자재/NNG@$가격/NNG,1,0.15901120138841085,64,31,33,39,0.5729820808359065,0.4152757510031282
기준금리/NNG@$올릴/VV@$전망/NNG,1,0.15901120138841085,64,31,33,33,0.5729820808359065,0.4152757510031282
농산물/NNG@$석유류/NNG@$근원인플레이션율/NNG,1,0.15901120138841085,64,31,33,45,0.5729820808359065,0.4152757510031282
경기/NNG@$수출/NNG@$호조/NNG,1,0.15901120138841085,64,31,33,13,0.5729820808359065,0.4152757510031282
기준금리/NNG@$동결/NNG@$기조/NNG,1,0.15901120138841085,64,31,33,42,0.5729820808359065,0.4152757510031282
금리/NNG@$인상/NNG@$시장/NNG,0,0.15844482542923344,245,118,127,162,0.7629943761100608,0.5536321205931719
정책금리/NNG@$인상/NNG@$예상/NNG,0,0.1580966067227001,20,10,10,21,0.3476489708523323,0.25243581112355495
지속/NNG@$가능성/NNG@$높/VA,0,0.15764218938403118,106,51,55,46,0.6940397273914863,0.5044277088247764
거시/NNG@$정책/NNG@$기조/NNG@$유지/NNG,0,0.15728777250210557,43,21,22,13,0.47574029368161197,0.34601908392019004
금리/NNG@$올리/VV@$경기/NNG,0,0.15728777250210557,43,21,22,17,0.47574029368161197,0.34601908392019004
유로화/NNG@$사용/NNG@$물가/NNG@$상승률/NNG,0,0.15728777250210557,43,21,22,12,0.47574029368161197,0.34601908392019004
사용/NNG@$물가/NNG@$상승률/NNG,0,0.15728777250210557,43,21,22,12,0.47574029368161197,0.34601908392019004
경기/NNG@$상승/NNG@$국면/NNG,0,0.15728777250210557,43,21,22,25,0.47574029368161197,0.34601908392019004
유로존/NNG@$유로화/NNG@$사용/NNG@$물가/NNG@$상승률/NNG,0,0.15728777250210557,43,21,22,12,0.47574029368161197,0.34601908392019004
가계/NNG@$기업/NNG@$대출/NNG,0,0.15728777250210557,43,21,22,12,0.47574029368161197,0.34601908392019004
조치/NNG@$금리/NNG@$인하/NNG,1,0.15518682886262902,62,30,32,13,0.5631833168326958,0.41138596674378974
둔화/NNG@$가능성/NNG@$높/VA,1,0.15518682886262902,62,30,32,11,0.5631833168326958,0.41138596674378974
개선/NNG@$금리/NNG@$인상/NNG,1,0.15518682886262902,62,30,32,52,0.5631833168326958,0.41138596674378974
경제/NNG@$경기/NNG@$둔화/NNG,1,0.15334850943824518,81,39,42,38,0.6305086542187358,0.46230180468594806
우려/NNG@$기준금리/NNG@$인상/NNG,1,0.15334850943824518,81,39,42,34,0.6305086542187358,0.46230180468594806
성장/NNG@$동력/NNG@$약화/NNG,0,0.15263687317784225,18,9,9,38,0.3347525148402306,0.245805162091797
대출/NNG@$높/VA@$증가세/NNG,0,0.15263687317784225,18,9,9,16,0.3347525148402306,0.245805162091797
금리/NNG@$결정/NNG@$경제/NNG,0,0.15227572172931314,41,20,21,17,0.4636722396621485,0.3407212654488136
경기/NNG@$둔화/NNG@$기준금리/NNG,0,0.15227572172931314,41,20,21,16,0.4636722396621485,0.3407212654488136
경제지표/NNG@$호조/NNG@$보이/VV,0,0.15227572172931314,41,20,21,35,0.4636722396621485,0.3407212654488136
가능성/NNG@$높/VA@$경기/NNG,0,0.15227572172931314,41,20,21,17,0.4636722396621485,0.3407212654488136
경제/NNG@$성장/NNG@$우려/NNG,0,0.15227572172931314,41,20,21,21,0.4636722396621485,0.3407212654488136
시장/NNG@$금리/NNG@$영향/NNG,0,0.15227572172931314,41,20,21,28,0.4636722396621485,0.3407212654488136
경상수지/NNG@$흑자/NNG@$기록/NNG,0,0.15227572172931314,41,20,21,15,0.4636722396621485,0.3407212654488136
금리/NNG@$상승/NNG@$요인/NNG,1,0.15117312484051615,60,29,31,28,0.5531268168392118,0.40737336613578695
안전자산/NNG@$선호/NNG@$심리/NNG,1,0.15117312484051615,60,29,31,45,0.5531268168392118,0.40737336613578695
유로존/NNG@$물가/NNG@$상승률/NNG,0,0.15070621677205187,100,48,52,45,0.678310597497659,0.500047562463999
국채/NNG@$가격/NNG@$하락/NNG,1,0.15018218212245027,79,38,41,27,0.6227437871286086,0.45957626387584577
기준금리/NNG@$무담보/NNG@$콜론/NNG,1,0.15018218212245027,79,38,41,31,0.6227437871286086,0.45957626387584577
경제/NNG@$성장세/NNG@$둔화/NNG,0,0.14970964768060258,300,144,156,145,0.7584258693136732,0.5602488704884324
금리/NNG@$동결/NNG@$인하/NNG,0,0.14699514117052304,39,19,20,23,0.4514261653070658,0.3353236607357171
기준금리/NNG@$인하/NNG@$배경/NNG,0,0.14699514117052304,39,19,20,13,0.4514261653070658,0.3353236607357171
물가/NNG@$상승/NNG@$확대/NNG,0,0.14699514117052304,39,19,20,13,0.4514261653070658,0.3353236607357171
경제/NNG@$회복/NNG@$조짐/NNG,0,0.14699514117052304,39,19,20,29,0.4514261653070658,0.3353236607357171
기대/NNG@$심리/NNG@$확산/NNG,0,0.14699514117052304,39,19,20,19,0.4514261653070658,0.3353236607357171
소비자/NNG@$물가/NNG@$상승/NNG@$압력/NNG,0,0.14699514117052304,39,19,20,15,0.4514261653070658,0.3353236607357171
가계부채/NNG@$문제/NNG@$해결/NNG,0,0.14699514117052304,39,19,20,29,0.4514261653070658,0.3353236607357171
가능성/NNG@$높/VA@$덧붙였/VV,0,0.14699514117052304,39,19,20,17,0.4514261653070658,0.3353236607357171
인하/NNG@$나설/VV@$전망/NNG,0,0.14699514117052304,39,19,20,23,0.4514261653070658,0.3353236607357171
기준금리/NNG@$금융/NNG@$위기/NNG,0,0.14699514117052304,39,19,20,19,0.4514261653070658,0.3353236607357171
영향/NNG@$필요/NNG@$있/VA,0,0.1469840379501648,16,8,8,11,0.3219094256982402,0.23912281587061124
예상/NNG@$기준금리/NNG@$인하/NNG,1,0.14696033773672568,58,28,30,27,0.5428159813968662,0.40323755980455583
경제/NNG@$견조/NNG@$성장세/NNG,1,0.14696033773672568,58,28,30,14,0.5428159813968662,0.40323755980455583
물가/NNG@$자산/NNG@$가격/NNG,1,0.14686785306441408,77,37,40,8,0.6147206858165092,0.4567391520933857
경제/NNG@$회복세/NNG@$보이/VV,1,0.14555804966870034,96,46,50,52,0.666732934959641,0.4967115511078069
인상/NNG@$시기/NNG@$전망/NNG,1,0.14339869814031925,75,36,39,37,0.6064375415786508,0.4537880119120566
시장/NNG@$관심/NNG@$집중/NNG,0,0.14324583788729006,115,55,60,67,0.7017200692500922,0.5252503191229716
상승/NNG@$거래/NNG@$마쳤/VV,0,0.14324583788729006,115,55,60,94,0.7017200692500922,0.5252503191229716
금리/NNG@$인상/NNG@$전망/NNG,0,0.14323074130044255,777,372,405,455,0.7548520774553882,0.5650380084140784
금리/NNG@$인상/NNG@$예상/NNG,0,0.14267610601766934,656,314,342,317,0.7545439662246409,0.5654470007549725
수요/NNG@$인플레이션/NNG@$압력/NNG,1,0.14253793215912647,56,27,29,24,0.5322549763403371,0.3989785330611398
실시/NNG@$기준금리/NNG@$동결/NNG,1,0.14253793215912647,56,27,29,10,0.5322549763403371,0.3989785330611398
고려/NNG@$기준금리/NNG@$동결/NNG,1,0.14253793215912647,56,27,29,25,0.5322549763403371,0.3989785330611398
고용/NNG@$시장/NNG@$개선/NNG,0,0.14245754755018214,257,123,134,148,0.7543190333346997,0.5655305835715222
기준금리/NNG@$인하/NNG@$통화/NNG@$완화/NNG,0,0.14142636628802774,37,18,19,20,0.4390147978828286,0.3298327727622574
경기/NNG@$회복/NNG@$수요/NNG@$압력/NNG,0,0.14142636628802774,37,18,19,12,0.4390147978828286,0.3298327727622574
자금/NNG@$단기화/NNG@$현상/NNG,0,0.14142636628802774,37,18,19,4,0.4390147978828286,0.3298327727622574
금융/NNG@$통화정책/NNG@$금리/NNG,0,0.14142636628802774,37,18,19,19,0.4390147978828286,0.3298327727622574
수출/NNG@$민간/NNG@$소비/NNG,0,0.14142636628802774,37,18,19,6,0.4390147978828286,0.3298327727622574
인상/NNG@$물가/NNG@$상승률/NNG,0,0.14142636628802774,37,18,19,18,0.4390147978828286,0.3298327727622574
소비자물가지수/NNG@$상승률/NNG@$기록/NNG,0,0.14142636628802774,37,18,19,19,0.4390147978828286,0.3298327727622574
조정/NNG@$가능성/NNG@$크/VA,0,0.14142636628802774,37,18,19,19,0.4390147978828286,0.3298327727622574
기준금리/NNG@$인상/NNG@$가능성/NNG@$크/VA,1,0.13789446384652337,54,26,28,33,0.5214487380068427,0.39459669457566615
시장/NNG@$예상치/NNG@$웃돌/VV,1,0.13789446384652337,54,26,28,49,0.5214487380068427,0.39459669457566615
외국인/NNG@$자본/NNG@$유출/NNG,1,0.13789446384652337,54,26,28,22,0.5214487380068427,0.39459669457566615
체감/NNG@$경기/NNG@$악화/NNG,1,0.13789446384652337,54,26,28,15,0.5214487380068427,0.39459669457566615
동결/NNG@$경기/NNG@$회복/NNG,1,0.13789446384652337,54,26,28,12,0.5214487380068427,0.39459669457566615
고용/NNG@$지표/NNG@$예상/NNG,1,0.1369544482720535,90,43,47,49,0.6476367688990481,0.4910266784542745
가능성/NNG@$높/VA@$예상/NNG,0,0.13634105471793978,109,52,57,45,0.6881080893801785,0.522363587213508
경제/NNG@$성장/NNG@$기여/NNG,0,0.1355463829365786,35,17,18,15,0.42645132131268093,0.3242564082617572
접근/NNG@$필요/NNG@$있/VA,0,0.1355463829365786,35,17,18,8,0.42645132131268093,0.3242564082617572
물가/NNG@$경기/NNG@$회복/NNG,0,0.1355463829365786,35,17,18,15,0.42645132131268093,0.3242564082617572
농산물/NNG@$석유류/NNG@$가격/NNG,0,0.1355463829365786,35,17,18,7,0.42645132131268093,0.3242564082617572
잠재적/NNG@$위험/NNG@$요인/NNG,0,0.1355463829365786,35,17,18,16,0.42645132131268093,0.3242564082617572
고려/NNG@$기준금리/NNG@$유지/NNG,0,0.13509363876568803,12,6,6,4,0.29647818991681446,0.22563799280121868
금리/NNG@$올리/VV@$않/VX,0,0.13386542173784255,304,145,159,116,0.7496104294411642,0.5719275157534662
조치/NNG@$취하/VV@$않/VX,1,0.13383058480880483,88,42,46,36,0.6407933685198877,0.48893843070129783
압력/NNG@$금리/NNG@$인상/NNG,1,0.13383058480880483,88,42,46,57,0.6407933685198877,0.48893843070129783
경제/NNG@$성장/NNG@$저해/NNG,1,0.13301742452665088,52,25,27,26,0.5104029655922663,0.3900929304205136
성장/NNG@$목표/NNG@$달성/NNG,1,0.13301742452665088,52,25,27,15,0.5104029655922663,0.3900929304205136
금리/NNG@$인상/NNG@$강하/VA,1,0.13301742452665088,52,25,27,15,0.5104029655922663,0.3900929304205136
디플레이션/NNG@$물가/NNG@$하락/NNG,1,0.13301742452665088,52,25,27,32,0.5104029655922663,0.3900929304205136
유로화/NNG@$사용/NNG@$경제/NNG,1,0.13301742452665088,52,25,27,26,0.5104029655922663,0.3900929304205136
확대/NNG@$해석/NNG@$경계/NNG,1,0.1319879727225184,69,33,36,33,0.5800170206619163,0.44422735550682757
해외/NNG@$자금/NNG@$유입/NNG,1,0.1319879727225184,69,33,36,18,0.5800170206619163,0.44422735550682757
물가/NNG@$상승률/NNG@$상승/NNG,1,0.1319879727225184,69,33,36,47,0.5800170206619163,0.44422735550682757
금리/NNG@$재할인율/NNG@$인하/NNG,1,0.1319879727225184,69,33,36,13,0.5800170206619163,0.44422735550682757
금리/NNG@$인상/NNG@$자제/NNG,1,0.1319879727225184,69,33,36,43,0.5800170206619163,0.44422735550682757
가능성/NNG@$배제/NNG@$어렵/VA,0,0.1312520440348497,105,50,55,49,0.6780456482891354,0.5200841740647243
지수/NNG@$상승/NNG@$마감/NNG,0,0.12932782561571954,33,16,17,20,0.41374912404440495,0.31860391621494255
동결/NNG@$결정/NNG@$금리/NNG,0,0.12932782561571954,33,16,17,22,0.41374912404440495,0.31860391621494255
금리/NNG@$인하/NNG@$단행/NNG@$전망/NNG,0,0.1278930478634437,50,24,26,20,0.49912409698137994,0.38546866431408905
유로존/NNG@$유로화/NNG@$사용/NNG@$경제/NNG,0,0.1278930478634437,50,24,26,26,0.49912409698137994,0.38546866431408905
위험/NNG@$요인/NNG@$경제/NNG,0,0.1278930478634437,50,24,26,27,0.49912409698137994,0.38546866431408905
경기/NNG@$선행/NNG@$지표/NNG,0,0.1278930478634437,50,24,26,28,0.49912409698137994,0.38546866431408905
금리/NNG@$인상/NNG@$채권/NNG,0,0.1278930478634437,50,24,26,23,0.49912409698137994,0.38546866431408905
금리/NNG@$인상/NNG@$인플레이션/NNG,1,0.12716437436691197,84,40,44,36,0.6263672993923648,0.4844541235053305
가능성/NNG@$높/VA@$않/VX,0,0.12564986586645865,202,96,106,91,0.7429421357277578,0.5763876985520604
금리/NNG@$인하/NNG@$기대감/NNG,0,0.12410769855333492,261,124,137,161,0.7440002573188326,0.579018980901825
도시/NNG@$주택/NNG@$가격/NNG,1,0.12346212373855847,65,31,34,56,0.5610925779256097,0.4372435363733693
금리/NNG@$인상/NNG@$보/VV,1,0.12346212373855847,65,31,34,34,0.5610925779256097,0.4372435363733693
주식/NNG@$채권/NNG@$시장/NNG,0,0.12280344473306237,99,47,52,54,0.6613697669164148,0.5160761981251281
소매/NNG@$판매/NNG@$지표/NNG,0,0.12273758923830003,31,15,16,36,0.4009214445075143,0.312886498579166
성장/NNG@$전망치/NNG@$하향/NNG,0,0.12273758923830003,31,15,16,18,0.4009214445075143,0.312886498579166
인하/NNG@$가능성/NNG@$없/VA,0,0.12273758923830003,31,15,16,25,0.4009214445075143,0.312886498579166
대출/NNG@$금리/NNG@$예금금리/NNG,0,0.12273758923830003,31,15,16,24,0.4009214445075143,0.312886498579166
가격/NNG@$소비자/NNG@$물가/NNG,0,0.12273758923830003,31,15,16,22,0.4009214445075143,0.312886498579166
달러화/NNG@$가치/NNG@$상승/NNG,0,0.12250606464519409,48,23,25,34,0.4876192633204525,0.38072592511336917
물가/NNG@$상승세/NNG@$지속/NNG,0,0.12250606464519409,48,23,25,7,0.4876192633204525,0.38072592511336917
급등/NNG@$금리/NNG@$인상/NNG,0,0.12250606464519409,48,23,25,11,0.4876192633204525,0.38072592511336917
금리/NNG@$인상/NNG@$가능성/NNG@$낮/VA,0,0.12141049570689622,135,64,71,59,0.7138349521124716,0.5585921807141487
경제/NNG@$성장/NNG@$가능/NNG,1,0.11989794368119289,80,38,42,20,0.6109347320989321,0.4795394416727155
유지/NNG@$경기/NNG@$회복/NNG,1,0.11989794368119289,80,38,42,24,0.6109347320989321,0.4795394416727155
필요/NNG@$금리/NNG@$인상/NNG,0,0.11975097822177672,97,46,51,72,0.6553700179749481,0.5145712631273344
경기/NNG@$하강/NNG@$속도/NNG,1,0.11889580296816771,63,30,33,17,0.5512396813409416,0.43356333590560575
금리/NNG@$인하/NNG@$정책/NNG,0,0.11776163222402825,190,90,100,78,0.736926967270848,0.5809451111320411
유로존/NNG@$부채/NNG@$위기/NNG,0,0.11683939113345376,46,22,24,13,0.475896216117943,0.3758674228885992
공급/NNG@$제조업/NNG@$지수/NNG,0,0.11683939113345376,46,22,24,26,0.475896216117943,0.3758674228885992
주택/NNG@$가격/NNG@$상승률/NNG,0,0.11683939113345376,46,22,24,38,0.475896216117943,0.3758674228885992
인상/NNG@$가능성/NNG@$전망/NNG,0,0.11683939113345376,46,22,24,27,0.475896216117943,0.3758674228885992
자본/NNG@$확충/NNG@$펀드/NNG,0,0.11657189694108117,95,45,50,37,0.6491421082871957,0.5129766992873303
금리/NNG@$인하/NNG@$압력/NNG,0,0.11608257169650504,112,53,59,42,0.6820161608438401,0.5394896794731736
비교/NNG@$보/VV@$장기금리/NNG@$국고채/NNG,1,0.11602252850723804,78,37,41,100,0.6028344932046217,0.4769132684137771
금리/NNG@$비교/NNG@$보/VV@$장기금리/NNG@$국고채/NNG,1,0.11602252850723804,78,37,41,100,0.6028344932046217,0.4769132684137771
금리/NNG@$상승/NNG@$압력/NNG,0,0.11597553028090424,207,98,109,85,0.737814139732673,0.5837536937882704
가격/NNG@$변동성/NNG@$확대/NNG,0,0.11573487058019172,29,14,15,12,0.387980866586965,0.307117623995333
시장/NNG@$금리/NNG@$정책금리/NNG,0,0.11573487058019172,29,14,15,17,0.387980866586965,0.307117623995333
정책적/NNG@$노력/NNG@$필요/NNG,0,0.11573487058019172,29,14,15,11,0.387980866586965,0.307117623995333
체감/NNG@$경기/NNG@$좋/VA,0,0.11573487058019172,29,14,15,26,0.387980866586965,0.307117623995333
금리/NNG@$인상/NNG@$여부/NNG@$결정/NNG,1,0.11411325467796019,61,29,32,39,0.5411288778242141,0.4297557855477255
우려/NNG@$고개/NNG@$들/VV,1,0.11411325467796019,61,29,32,22,0.5411288778242141,0.4297557855477255
내외/NNG@$금리/NNG@$역전/NNG,1,0.11197574714011993,76,36,40,9,0.5944755681503759,0.47417062934335574
기준금리/NNG@$인상/NNG@$나설/VV,1,0.11197574714011993,76,36,40,47,0.5944755681503759,0.47417062934335574
경기/NNG@$회복/NNG@$가능성/NNG,1,0.11197574714011993,76,36,40,34,0.5944755681503759,0.47417062934335574
상승/NNG@$원자재/NNG@$가격/NNG,0,0.11087372846807608,44,21,23,17,0.46396321853654654,0.37089663528734573
금리/NNG@$인상/NNG@$시기/NNG@$예상/NNG,0,0.11087372846807608,44,21,23,20,0.46396321853654654,0.37089663528734573
상승/NNG@$크/VA@$않/VX,0,0.11087372846807608,44,21,23,29,0.46396321853654654,0.37089663528734573
경기/NNG@$회복/NNG@$걸림돌/NNG,0,0.11087372846807608,44,21,23,32,0.46396321853654654,0.37089663528734573
성장률/NNG@$전망치/NNG@$유지/NNG,0,0.11087372846807608,44,21,23,14,0.46396321853654654,0.37089663528734573
회복/NNG@$금리/NNG@$인하/NNG,0,0.11087372846807608,44,21,23,17,0.46396321853654654,0.37089663528734573
금리/NNG@$인상/NNG@$가능성/NNG@$열/VV,0,0.11047925761157718,108,51,57,75,0.6721409809550604,0.5377450328788335
경제/NNG@$침체/NNG@$가능성/NNG,1,0.10910294082487493,59,28,31,19,0.5307628457203802,0.4258198651017543
가계부채/NNG@$증가세/NNG@$통화정책/NNG,0,0.10826834749240599,27,13,14,22,0.37493858709548916,0.30131359081179215
경제/NNG@$소비/NNG@$투자/NNG,0,0.10826834749240599,27,13,14,17,0.37493858709548916,0.30131359081179215
경기/NNG@$부양/NNG@$필요성/NNG,1,0.10774962540524213,74,35,39,29,0.5858564405712697,0.47130865306506314
투자/NNG@$심리/NNG@$개선/NNG,1,0.10774962540524213,74,35,39,59,0.5858564405712697,0.47130865306506314
인하/NNG@$경기/NNG@$부양책/NNG,1,0.10774962540524213,74,35,39,29,0.5858564405712697,0.47130865306506314
물가/NNG@$상승/NNG@$압력/NNG@$높/VA,0,0.1071449670067608,176,83,93,70,0.7278665012401626,0.5862690613775386
금리/NNG@$인하/NNG@$효과/NNG,0,0.10666522975670834,549,259,290,191,0.7339929045341234,0.5917774110423952
금리/NNG@$인상/NNG@$가능성/NNG@$높/VA,0,0.10465649555996381,297,140,157,114,0.7328078813487316,0.5932259434370549
양적/NNG@$통화/NNG@$완화/NNG,0,0.10458704230510274,42,20,22,12,0.4518288894345663,0.36581790638288036
기록/NNG@$금리/NNG@$인상/NNG,0,0.10458704230510274,42,20,22,25,0.4518288894345663,0.36581790638288036
갭/NNG@$마이너스/NNG@$상태/NNG,0,0.10458704230510274,42,20,22,28,0.4518288894345663,0.36581790638288036
영향/NNG@$제한적/NNG@$전망/NNG,0,0.10458704230510274,42,20,22,23,0.4518288894345663,0.36581790638288036
투자/NNG@$증권/NNG@$금리/NNG@$인상/NNG,0,0.10458704230510274,42,20,22,18,0.4518288894345663,0.36581790638288036
시중/NNG@$자금/NNG@$단기화/NNG,0,0.10458704230510274,42,20,22,6,0.4518288894345663,0.36581790638288036
수출/NNG@$호조/NNG@$내수/NNG,1,0.10385230939541934,57,27,30,17,0.5201448711902015,0.42175487723091815
인하/NNG@$가능성/NNG@$있/VA,1,0.10333569250881447,72,34,38,36,0.576976038913901,0.46832453764944365
경기/NNG@$하방/NNG@$리스크/NNG,0,0.10084267408914727,221,104,117,108,0.7297779249079431,0.5953424453591633
영향/NNG@$경기/NNG@$회복/NNG,0,0.10027201754521942,25,12,13,15,0.36180332250343294,0.2954943105373191
경기/NNG@$개선/NNG@$지속/NNG,0,0.10027201754521942,25,12,13,20,0.36180332250343294,0.2954943105373191
물가/NNG@$상승률/NNG@$중기/NNG,1,0.09872492353986018,70,33,37,20,0.5678337566219511,0.4652155693022677
인상/NNG@$전망/NNG@$유지/NNG,0,0.09857786398120316,85,40,45,40,0.6144367225147223,0.5035459585039965
기금/NNG@$금리/NNG@$인하/NNG,1,0.09834762257692087,55,26,29,19,0.5092788232690032,0.4175604890330654
가계/NNG@$소비/NNG@$심리/NNG,1,0.09834762257692087,55,26,29,33,0.5092788232690032,0.4175604890330654
통화/NNG@$달러/NNG@$지수/NNG,0,0.09795387901595198,40,19,21,28,0.4395019840723968,0.3606365608339368
지표/NNG@$시장/NNG@$예상/NNG,0,0.09795387901595198,40,19,21,20,0.4395019840723968,0.3606365608339368
우려/NNG@$있/VA@$금리/NNG,0,0.09795387901595198,40,19,21,10,0.4395019840723968,0.3606365608339368
영향력/NNG@$크/VA@$않/VX,0,0.09795387901595198,40,19,21,19,0.4395019840723968,0.3606365608339368
달러/NNG@$강세/NNG@$지속/NNG,0,0.09795387901595198,40,19,21,19,0.4395019840723968,0.3606365608339368
우려/NNG@$커지/VV@$금리/NNG,0,0.09795387901595198,40,19,21,17,0.4395019840723968,0.3606365608339368
소비/NNG@$심리/NNG@$개선/NNG,0,0.09382170547150115,113,53,60,98,0.6710428622912085,0.5552385250060142
금리/NNG@$낮/VA@$유지/NNG,0,0.09382170547150115,113,53,60,85,0.6710428622912085,0.5552385250060142
기준금리/NNG@$인하/NNG@$기대감/NNG,0,0.09285005345270259,128,60,68,82,0.690258298924404,0.5722579902245123
금리/NNG@$인상/NNG@$않/VX,0,0.09273739365650124,275,129,146,131,0.7257267017496335,0.601799717473197
가격/NNG@$상승/NNG@$인플레이션/NNG@$압력/NNG,0,0.09257374236390192,53,25,28,17,0.49816910888242694,0.41323677694386923
물가/NNG@$상승/NNG@$가능성/NNG,0,0.09257374236390192,53,25,28,23,0.49816910888242694,0.41323677694386923
동결/NNG@$자산/NNG@$매입/NNG,0,0.09257374236390192,53,25,28,31,0.49816910888242694,0.41323677694386923
인플레이션/NNG@$우려/NNG@$금리/NNG@$인상/NNG,0,0.09257374236390192,53,25,28,11,0.49816910888242694,0.41323677694386923
물가/NNG@$상승/NNG@$영향/NNG,0,0.09257374236390192,53,25,28,46,0.49816910888242694,0.41323677694386923
유동성/NNG@$공급/NNG@$정책/NNG,0,0.09257374236390192,53,25,28,21,0.49816910888242694,0.41323677694386923
은행/NNG@$채권/NNG@$딜러/NNG,0,0.09168635655866408,143,67,76,55,0.703207469894117,0.584362818268818
투자/NNG@$심리/NNG@$부정적/NNG,0,0.09165888330637051,23,11,12,27,0.3485796197849062,0.28968442299018216
정책금리/NNG@$인상/NNG@$기대/NNG,0,0.09165888330637051,23,11,12,17,0.3485796197849062,0.28968442299018216
대응/NNG@$한계/NNG@$있/VA,0,0.09094445546093999,38,18,20,16,0.4269910883077999,0.3553590369921241
금리/NNG@$인상/NNG@$그칠/VV,0,0.09094445546093999,38,18,20,15,0.4269910883077999,0.3553590369921241
성장/NNG@$금리/NNG@$인상/NNG,0,0.09094445546093999,38,18,20,20,0.4269910883077999,0.3553590369921241
구조/NNG@$개혁/NNG@$필요/NNG,0,0.09094445546093999,38,18,20,30,0.4269910883077999,0.3553590369921241
반대/NNG@$금리/NNG@$인상/NNG,0,0.09094445546093999,38,18,20,24,0.4269910883077999,0.3553590369921241
금리/NNG@$인상/NNG@$기대/NNG,0,0.09040657916532524,303,142,161,178,0.7243614877533313,0.6034964252477467
채권/NNG@$시장/NNG@$강세/NNG,0,0.09016255747689761,126,59,67,68,0.6864421694313965,0.5721855408481658
증권/NNG@$금리/NNG@$인상/NNG,0,0.09016255747689761,126,59,67,55,0.6864421694313965,0.5721855408481658
금리/NNG@$인상/NNG@$시작/NNG,0,0.08991770851646641,318,149,169,142,0.7240718407723307,0.603849721302456
더블딥/NNG@$이중/NNG@$침체/NNG,0,0.08931882448808692,141,66,75,48,0.7002851563230658,0.5847176825205531
금리/NNG@$인상/NNG@$지속/NNG,0,0.089060192053801,205,96,109,69,0.7217907612599553,0.602988378619756
채권/NNG@$딜러/NNG@$금리/NNG,1,0.08887358336758666,66,31,35,24,0.5487635383625129,0.4586127836581498
국내총생산/NNG@$성장률/NNG@$전망/NNG,1,0.08887358336758666,66,31,35,56,0.5487635383625129,0.4586127836581498
상승/NNG@$경기/NNG@$회복/NNG,0,0.08709669568362988,94,44,50,25,0.6309041444766358,0.5291500231403877
실질/NNG@$국내총생산/NNG@$증가율/NNG,0,0.08651386065939848,51,24,27,29,0.4868206019129654,0.4087842750773983
경제/NNG@$전망/NNG@$금융시장/NNG,0,0.08651386065939848,51,24,27,8,0.4868206019129654,0.4087842750773983
급등/NNG@$물가/NNG@$상승/NNG,0,0.08651386065939848,51,24,27,15,0.4868206019129654,0.4087842750773983
인하/NNG@$단행/NNG@$전망/NNG,1,0.08361150510041293,64,30,34,25,0.5388368260831785,0.4551141722416661
성장률/NNG@$예상/NNG@$높/VA,0,0.08352342966311155,36,17,19,16,0.4143041920229064,0.3499930436083337
국채/NNG@$금리/NNG@$오른/VV,0,0.08352342966311155,36,17,19,22,0.4143041920229064,0.3499930436083337
투자/NNG@$활성화/NNG@$대책/NNG,0,0.08352342966311155,36,17,19,42,0.4143041920229064,0.3499930436083337
성장/NNG@$물가/NNG@$상승/NNG,0,0.08352342966311155,36,17,19,22,0.4143041920229064,0.3499930436083337
선제적/NNG@$대응/NNG@$필요/NNG,0,0.08352342966311155,36,17,19,22,0.4143041920229064,0.3499930436083337
가격/NNG@$상승/NNG@$물가/NNG,0,0.08163475665340858,150,70,80,47,0.7018904781015926,0.5951962942326736
가능성/NNG@$가격/NNG@$반영/NNG,1,0.08127255174086945,77,36,41,43,0.5821880911696293,0.4940497785661968
에너지/NNG@$가격/NNG@$급등/NNG,0,0.08014915627993036,49,23,26,18,0.47523853851140146,0.40420402706129943
곡물/NNG@$가격/NNG@$급등/NNG,0,0.08014915627993036,49,23,26,19,0.47523853851140146,0.40420402706129943
경기/NNG@$하강/NNG@$우려/NNG,1,0.07810935710100453,62,29,33,26,0.528650674886801,0.4514811694377087
조치/NNG@$금리/NNG@$인상/NNG,1,0.07810935710100453,62,29,33,25,0.528650674886801,0.4514811694377087
경제/NNG@$성장세/NNG@$회복/NNG,1,0.07810935710100453,62,29,33,47,0.528650674886801,0.4514811694377087
채권/NNG@$시장/NNG@$금리/NNG@$인상/NNG,0,0.0771658275179794,103,48,55,47,0.6442528282259136,0.5512533077890669
필요/NNG@$있/VA@$덧붙였/VV,0,0.07681264915918384,146,68,78,83,0.696432516407629,0.596324055658689
단행/NNG@$금리/NNG@$인상/NNG,1,0.07647910592133655,75,35,40,42,0.5734814377246761,0.4913759614623623
금리/NNG@$인상/NNG@$시기/NNG@$결정/NNG,0,0.07564821294474133,34,16,18,17,0.40144808979755403,0.3445477460167388
준비/NNG@$금리/NNG@$인상/NNG,0,0.07564821294474133,34,16,18,35,0.40144808979755403,0.3445477460167388
기조/NNG@$유지/NNG@$금리/NNG@$인상/NNG,0,0.07564821294474133,34,16,18,17,0.40144808979755403,0.3445477460167388
시장/NNG@$금리/NNG@$인상/NNG@$전망/NNG,0,0.07564821294474133,34,16,18,17,0.40144808979755403,0.3445477460167388
자산/NNG@$매입/NNG@$규모/NNG@$확대/NNG,0,0.07564821294474133,34,16,18,22,0.40144808979755403,0.3445477460167388
단행/NNG@$가능성/NNG@$크/VA,0,0.07564821294474133,34,16,18,32,0.40144808979755403,0.3445477460167388
시장/NNG@$금리/NNG@$인상/NNG@$시기/NNG,0,0.07564821294474133,34,16,18,16,0.40144808979755403,0.3445477460167388
금융시장/NNG@$기준금리/NNG@$인상/NNG,0,0.07564821294474133,34,16,18,23,0.40144808979755403,0.3445477460167388
시장/NNG@$충격/NNG@$않/VX,0,0.07345835463707928,47,22,25,27,0.4634283681566435,0.3994976413355408
물가/NNG@$상승률/NNG@$금리/NNG,0,0.07345835463707928,47,22,25,24,0.4634283681566435,0.3994976413355408
금리/NNG@$인상/NNG@$시기/NNG@$전망/NNG,0,0.07345835463707928,47,22,25,29,0.4634283681566435,0.3994976413355408
금리/NNG@$인상/NNG@$기정사실화/NNG,1,0.0723539882225086,60,28,32,28,0.5182068925728375,0.44771184413896004
필요/NNG@$있/VA@$금리/NNG@$인상/NNG,1,0.0723539882225086,60,28,32,28,0.5182068925728375,0.44771184413896004
기대/NNG@$금리/NNG@$인하/NNG,1,0.0723539882225086,60,28,32,20,0.5182068925728375,0.44771184413896004
물가/NNG@$목표/NNG@$하회/NNG,0,0.0720634968206133,19,9,10,19,0.32184603108825305,0.2782255732095452
기준금리/NNG@$인상/NNG@$전망/NNG,0,0.07170068102526406,372,173,199,155,0.7130284690905578,0.6168397384884392
악화/NNG@$금리/NNG@$인상/NNG,0,0.06726660837430165,32,15,17,19,0.3884275277431285,0.33903398905595283
경제/NNG@$성장/NNG@$하방/NNG@$리스크/NNG,0,0.06726660837430165,32,15,17,15,0.3884275277431285,0.33903398905595283
가능성/NNG@$높/VA@$내/VX,0,0.06726660837430165,32,15,17,18,0.3884275277431285,0.33903398905595283
규모/NNG@$축소/NNG@$시작/NNG,0,0.06726660837430165,32,15,17,22,0.3884275277431285,0.33903398905595283
시장/NNG@$금리/NNG@$인상/NNG@$예상/NNG,0,0.06726660837430165,32,15,17,16,0.3884275277431285,0.33903398905595283
금융/NNG@$위기/NNG@$금리/NNG@$인상/NNG,0,0.06726660837430165,32,15,17,24,0.3884275277431285,0.33903398905595283
경제/NNG@$경제정책/NNG@$방향/NNG,0,0.06726660837430165,32,15,17,22,0.3884275277431285,0.33903398905595283
물가/NNG@$상승률/NNG@$기준치/NNG,0,0.06726660837430165,32,15,17,28,0.3884275277431285,0.33903398905595283
하향/NNG@$조정/NNG@$기준금리/NNG,0,0.06726660837430165,32,15,17,24,0.3884275277431285,0.33903398905595283
양적완화/NNG@$축소/NNG@$금융시장/NNG,0,0.06726660837430165,32,15,17,24,0.3884275277431285,0.33903398905595283
필요/NNG@$있/VA@$기준금리/NNG,0,0.06641715624713718,45,21,24,27,0.4513955460849667,0.39466734973159656
수출/NNG@$호조/NNG@$힘입/VV,0,0.06641715624713718,45,21,24,17,0.4513955460849667,0.39466734973159656
불안/NNG@$요인/NNG@$남/VV,0,0.06641715624713718,45,21,24,24,0.4513955460849667,0.39466734973159656
경제/NNG@$회복/NNG@$국면/NNG,0,0.06641715624713718,45,21,24,15,0.4513955460849667,0.39466734973159656
기준금리/NNG@$결정/NNG@$전문가별/NNG,0,0.06641715624713718,45,21,24,43,0.4513955460849667,0.39466734973159656
금리/NNG@$인상/NNG@$전제/NNG,0,0.06641715624713718,45,21,24,23,0.4513955460849667,0.39466734973159656
기준금리/NNG@$인하/NNG@$여부/NNG,0,0.06641715624713718,45,21,24,25,0.4513955460849667,0.39466734973159656
이전/NNG@$금리/NNG@$인하/NNG,0,0.06641715624713718,45,21,24,13,0.4513955460849667,0.39466734973159656
유럽연합/NNG@$통계/NNG@$유로/NNG,0,0.06641715624713718,45,21,24,14,0.4513955460849667,0.39466734973159656
예상/NNG@$크/VA@$않/VX,0,0.06641715624713718,45,21,24,17,0.4513955460849667,0.39466734973159656
금리/NNG@$올릴/VV@$없/VA,0,0.06641715624713718,45,21,24,24,0.4513955460849667,0.39466734973159656
상승/NNG@$기준금리/NNG@$인상/NNG,1,0.0663309921732782,58,27,31,33,0.5075077127458391,0.4438045021615214
양적완화/NNG@$정책/NNG@$시행/NNG,1,0.0663309921732782,58,27,31,20,0.5075077127458391,0.4438045021615214
시장/NNG@$예상/NNG@$기준금리/NNG,1,0.0662687494955394,71,33,38,30,0.5552838813255639,0.48564440897428174
기준금리/NNG@$인상/NNG@$물가/NNG,0,0.06603192274912728,84,39,45,34,0.5944739031986355,0.5201667710051194
대외/NNG@$불안/NNG@$요인/NNG,0,0.06496954965134538,110,51,59,56,0.6496010617065414,0.5696167093973391
금리/NNG@$동결/NNG@$결정/NNG,0,0.06444812630516972,399,185,214,173,0.7085587570648467,0.6219656455625675
달러/NNG@$원/NNG@$환율/NNG@$상승/NNG,0,0.061433396418403285,95,44,51,37,0.6189290332310443,0.5465863337673276
수요/NNG@$압력/NNG@$증대/NNG,0,0.061433396418403285,95,44,51,11,0.6189290332310443,0.5465863337673276
물가/NNG@$고공/NNG@$행진/NNG,0,0.06129730594995397,82,38,44,15,0.5864416767892354,0.518037646593545
통화정책/NNG@$완화/NNG@$축소/NNG,0,0.06067633389082405,17,8,9,24,0.30828871403311564,0.2726686294298414
통화정책/NNG@$방향/NNG@$경제/NNG,0,0.06002447879193795,56,26,30,28,0.4965557344140519,0.4397577163905587
정책/NNG@$목표/NNG@$달성/NNG,0,0.06002447879193795,56,26,30,28,0.4965557344140519,0.4397577163905587
기준금리/NNG@$인상/NNG@$가능/NNG,0,0.06002447879193795,56,26,30,29,0.4965557344140519,0.4397577163905587
사상/NNG@$최저치/NNG@$기록/NNG,0,0.06002447879193795,56,26,30,13,0.4965557344140519,0.4397577163905587
경제/NNG@$성장/NNG@$달성/NNG,0,0.06002447879193795,56,26,30,16,0.4965557344140519,0.4397577163905587
성장률/NNG@$전망치/NNG@$제시/NNG,0,0.05899748602190469,43,20,23,33,0.43914524700106605,0.3897160688898286
동결/NNG@$통화정책/NNG@$방향/NNG,0,0.05899748602190469,43,20,23,29,0.43914524700106605,0.3897160688898286
고용/NNG@$지표/NNG@$악화/NNG,0,0.05899748602190469,43,20,23,22,0.43914524700106605,0.3897160688898286
전망/NNG@$소비/NNG@$지출/NNG,0,0.05899748602190469,43,20,23,30,0.43914524700106605,0.3897160688898286
금리/NNG@$하향/NNG@$조정/NNG,0,0.05899748602190469,43,20,23,14,0.43914524700106605,0.3897160688898286
상승/NNG@$압력/NNG@$확대/NNG,0,0.05899748602190469,43,20,23,12,0.43914524700106605,0.3897160688898286
활동/NNG@$동향/NNG@$보/VV,0,0.05899748602190469,43,20,23,30,0.43914524700106605,0.3897160688898286
단기적/NNG@$경기/NNG@$부양/NNG,0,0.05899748602190469,43,20,23,20,0.43914524700106605,0.3897160688898286
규모/NNG@$개방/NNG@$경제/NNG,0,0.05831343394132915,30,14,16,17,0.3752439662780341,0.3334645652998057
내수/NNG@$경기/NNG@$활성화/NNG,0,0.05831343394132915,30,14,16,17,0.3752439662780341,0.3334645652998057
결정/NNG@$기준금리/NNG@$인하/NNG,0,0.05831343394132915,30,14,16,12,0.3752439662780341,0.3334645652998057
금리/NNG@$인상/NNG@$많/VA,0,0.05831343394132915,30,14,16,23,0.3752439662780341,0.3334645652998057
물가/NNG@$낮/VA@$유지/NNG,0,0.05831343394132915,30,14,16,16,0.3752439662780341,0.3334645652998057
방향/NNG@$금리/NNG@$인상/NNG,0,0.05831343394132915,30,14,16,18,0.3752439662780341,0.3334645652998057
거시/NNG@$금융/NNG@$경제/NNG,0,0.05831343394132915,30,14,16,22,0.3752439662780341,0.3334645652998057
하락/NNG@$경기/NNG@$회복/NNG,0,0.05831343394132915,30,14,16,15,0.3752439662780341,0.3334645652998057
금리/NNG@$인하/NNG@$기대/NNG,0,0.05710646486320359,543,251,292,284,0.7039927256938423,0.6271268069319123
가능성/NNG@$금리/NNG@$인상/NNG,0,0.05681059760010898,158,73,85,90,0.6909979057472062,0.6159161478608023
콜금리/NNG@$목표/NNG@$인상/NNG,0,0.056370496337564635,80,37,43,64,0.5781539520041413,0.5157884562454489
지식/NNG@$경제/NNG@$부/NNG,0,0.056370496337564635,80,37,43,20,0.5781539520041413,0.5157884562454489
산업/NNG@$평균/NNG@$지수/NNG@$상승/NNG@$거래/NNG,0,0.056370496337564635,80,37,43,73,0.5781539520041413,0.5157884562454489
기준금리/NNG@$사상/NNG@$최저치/NNG,1,0.05515742928257694,67,31,36,34,0.5360361193373686,0.4793784074693656
조정/NNG@$금리/NNG@$인상/NNG,1,0.05515742928257694,67,31,36,26,0.5360361193373686,0.4793784074693656
민간/NNG@$소비/NNG@$회복/NNG,0,0.05353830617535604,104,48,56,43,0.6325636699696665,0.5675423966094868
대외/NNG@$불확실성/NNG@$높/VA,0,0.05341678592557941,54,25,29,23,0.4853538329948934,0.4355703577253454
하락/NNG@$소비자/NNG@$물가/NNG,0,0.05341678592557941,54,25,29,39,0.4853538329948934,0.4355703577253454
신용등급/NNG@$하향/NNG@$조정/NNG,0,0.05341678592557941,54,25,29,20,0.4853538329948934,0.4355703577253454
국고채/NNG@$금리/NNG@$하락/NNG,0,0.05341678592557941,54,25,29,32,0.4853538329948934,0.4355703577253454
확인/NNG@$필요/NNG@$있/VA,0,0.05341678592557941,54,25,29,56,0.4853538329948934,0.4355703577253454
금리/NNG@$인상/NNG@$부동산/NNG,0,0.05341678592557941,54,25,29,17,0.4853538329948934,0.4355703577253454
대응/NNG@$필요/NNG@$있/VA,0,0.052637191066389644,91,42,49,62,0.6048726547394119,0.5436788541108106
산업/NNG@$생산/NNG@$증가/NNG,0,0.05172524018984759,206,95,111,124,0.6989352092906405,0.6293745704978824
금리/NNG@$인상/NNG@$이뤄질/VV,0,0.05160211464053077,154,71,83,89,0.6857700299448736,0.6176720351735082
평균/NNG@$지수/NNG@$상승/NNG@$거래/NNG@$마쳤/VV,0,0.051242688828025074,78,36,42,72,0.569608403920941,0.5134151186719144
가능성/NNG@$높/VA@$관측/NNG,0,0.051242688828025074,78,36,42,24,0.569608403920941,0.5134151186719144
가능성/NNG@$없/VA@$않/VX,0,0.05116649393543593,41,19,22,14,0.42668197142667014,0.3846474636337507
기금/NNG@$금리선물/NNG@$기준금리/NNG,0,0.05116649393543593,41,19,22,22,0.42668197142667014,0.3846474636337507
경기/NNG@$부양/NNG@$기조/NNG,1,0.04923463837596653,65,30,35,17,0.5260181539185956,0.4760367666626352
기준금리/NNG@$인상/NNG@$동결/NNG,1,0.04923463837596653,65,30,35,31,0.5260181539185956,0.4760367666626352
가격/NNG@$상승/NNG@$영향/NNG,1,0.04923463837596653,65,30,35,18,0.5260181539185956,0.4760367666626352
억제/NNG@$금리/NNG@$인상/NNG,0,0.048886856607888385,152,70,82,48,0.682992270404885,0.6185263024658668
자본/NNG@$유출/NNG@$발생/NNG,0,0.0487055702716761,28,13,15,26,0.36189374302171046,0.32785453780578566
채권/NNG@$기준금리/NNG@$동결/NNG,0,0.0487055702716761,28,13,15,26,0.36189374302171046,0.32785453780578566
금융/NNG@$시스템/NNG@$불안/NNG,0,0.0487055702716761,28,13,15,20,0.36189374302171046,0.32785453780578566
양적/NNG@$질적/NNG@$금융완화/NNG,0,0.04778386512019961,15,7,8,38,0.29452395343188265,0.2673146106479252
달러/NNG@$가치/NNG@$하락/NNG,0,0.04668325499424886,113,52,61,40,0.6435185614180082,0.5853568035035334
금리/NNG@$인하/NNG@$나설/VV@$가능성/NNG,0,0.04648811306822065,52,24,28,20,0.473905034187263,0.4312416262073305
기조/NNG@$유지/NNG@$전망/NNG,0,0.04590449697128429,76,35,41,38,0.560803016271518,0.5109135049544036
소비자/NNG@$물가/NNG@$동향/NNG,0,0.04590449697128429,76,35,41,24,0.560803016271518,0.5109135049544036
경기/NNG@$회복/NNG@$도움/NNG,1,0.04304943710498055,63,29,34,23,0.5157380467703571,0.4725518233721052
인상/NNG@$소비자/NNG@$물가/NNG,1,0.04304943710498055,63,29,34,21,0.5157380467703571,0.4725518233721052
자산운용사/NNG@$채권/NNG@$딜러/NNG,1,0.04304943710498055,63,29,34,35,0.5157380467703571,0.4725518233721052
경기/NNG@$둔화/NNG@$예상/NNG,1,0.04304943710498055,63,29,34,32,0.5157380467703571,0.4725518233721052
주택/NNG@$착공/NNG@$감소/NNG,0,0.042885204852169734,39,18,21,17,0.4140090029576908,0.3794660106773344
가계/NNG@$수입/NNG@$전망/NNG@$소비/NNG@$지출/NNG,0,0.042885204852169734,39,18,21,25,0.4140090029576908,0.3794660106773344
모기지/NNG@$주택/NNG@$담보대출/NNG,0,0.042885204852169734,39,18,21,21,0.4140090029576908,0.3794660106773344
자산/NNG@$매입/NNG@$규모/NNG@$유지/NNG,0,0.042885204852169734,39,18,21,37,0.4140090029576908,0.3794660106773344
금리/NNG@$인상/NNG@$종결/NNG,0,0.042885204852169734,39,18,21,11,0.4140090029576908,0.3794660106773344
은행/NNG@$주택/NNG@$담보대출/NNG,0,0.042885204852169734,39,18,21,21,0.4140090029576908,0.3794660106773344
정책/NNG@$경기/NNG@$회복/NNG,0,0.042885204852169734,39,18,21,10,0.4140090029576908,0.3794660106773344
가능/NNG@$금리/NNG@$인상/NNG,0,0.042885204852169734,39,18,21,32,0.4140090029576908,0.3794660106773344
소비자/NNG@$물가/NNG@$상승률/NNG@$기록/NNG,0,0.04070188886586679,122,56,66,36,0.6521485737307999,0.6003550513105489
주례/NNG@$경제/NNG@$동향/NNG,0,0.040345878696852466,74,34,40,20,0.5517360856358725,0.5082794470892211
금리/NNG@$인상/NNG@$증시/NNG,0,0.0392160508421322,50,23,27,19,0.4622123392968435,0.4267710814393498
기준금리/NNG@$인상/NNG@$우려/NNG,0,0.0392160508421322,50,23,27,39,0.4622123392968435,0.4267710814393498
인플레이션/NNG@$억제/NNG@$금리/NNG@$인상/NNG,0,0.0392160508421322,50,23,27,15,0.4622123392968435,0.4267710814393498
경제/NNG@$전망/NNG@$악화/NNG,0,0.0392160508421322,50,23,27,20,0.4622123392968435,0.4267710814393498
은행/NNG@$기준금리/NNG@$인상/NNG,0,0.038788090494458194,109,50,59,32,0.6325453588284282,0.5845439544934347
확대/NNG@$기준금리/NNG@$인하/NNG,0,0.03833447944185009,26,12,14,25,0.34836526545862423,0.3222216250365272
부정적/NNG@$영향/NNG@$크/VA@$않/VX,0,0.03833447944185009,26,12,14,18,0.34836526545862423,0.3222216250365272
심리/NNG@$크/VA@$위축/NNG,0,0.03833447944185009,26,12,14,18,0.34836526545862423,0.3222216250365272
금리/NNG@$인상/NNG@$기준금리/NNG,0,0.03812663150297735,85,39,46,53,0.5819582640985365,0.5385082497161542
금융/NNG@$금리/NNG@$인상/NNG,1,0.03658699862055115,61,28,33,38,0.5051966151596948,0.468920562964293
금리/NNG@$인하/NNG@$행진/NNG,1,0.03658699862055115,61,28,33,19,0.5051966151596948,0.468920562964293
인플레/NNG@$우려/NNG@$금리/NNG,1,0.03658699862055115,61,28,33,22,0.5051966151596948,0.468920562964293
결정/NNG@$금리/NNG@$인하/NNG,1,0.03658699862055115,61,28,33,22,0.5051966151596948,0.468920562964293
경기/NNG@$부양책/NNG@$효과/NNG,0,0.03463169296262558,107,49,58,31,0.6267486850391503,0.5840253578595631
회복/NNG@$국면/NNG@$진입/NNG,0,0.03455604714536853,72,33,39,38,0.5424062193238028,0.5055087473654176
하향/NNG@$조정/NNG@$불가피/XR,0,0.03410666373145821,37,17,20,22,0.4011276542643763,0.37417705978444915
물가/NNG@$경기/NNG@$금융시장/NNG,0,0.03410666373145821,37,17,20,18,0.4011276542643763,0.37417705978444915
장단기/NNG@$금리/NNG@$스프레드/NNG,0,0.03410666373145821,37,17,20,21,0.4011276542643763,0.37417705978444915
금융/NNG@$중개/NNG@$기능/NNG,0,0.03410666373145821,37,17,20,20,0.4011276542643763,0.37417705978444915
경제/NNG@$경착륙/NNG@$가능성/NNG,0,0.03410666373145821,37,17,20,30,0.4011276542643763,0.37417705978444915
성장률/NNG@$전망치/NNG@$낮췄/VV,0,0.03410666373145821,37,17,20,20,0.4011276542643763,0.37417705978444915
금융시장/NNG@$영향/NNG@$제한적/NNG,0,0.03410666373145821,37,17,20,19,0.4011276542643763,0.37417705978444915
전망/NNG@$고개/NNG@$들/VV,0,0.03410666373145821,37,17,20,16,0.4011276542643763,0.37417705978444915
국채/NNG@$매입/NNG@$확대/NNG,0,0.03410666373145821,37,17,20,28,0.4011276542643763,0.37417705978444915
공급/NNG@$관리/NNG@$제조업/NNG@$지수/NNG,0,0.032907604899625076,83,38,45,26,0.5738188234800773,0.5365514043298119
인상/NNG@$가능성/NNG@$낮/VA,0,0.03278679738063395,212,97,115,92,0.6873266122191214,0.6428426497872608
인하/NNG@$시장/NNG@$금리/NNG,0,0.03157497019340605,48,22,26,12,0.4502784865197472,0.4221586710164221
노력/NNG@$필요/NNG@$있/VA,0,0.03157497019340605,48,22,26,21,0.4502784865197472,0.4221586710164221
시장/NNG@$콜금리/NNG@$인상/NNG,0,0.03157497019340605,48,22,26,31,0.4502784865197472,0.4221586710164221
투자/NNG@$증권/NNG@$경기/NNG,0,0.03157497019340605,48,22,26,32,0.4502784865197472,0.4221586710164221
지속/NNG@$가능/NNG@$경제/NNG@$성장/NNG,0,0.031522300697779615,94,43,51,34,0.5997571333057509,0.5623616578454519
기준금리/NNG@$인하/NNG@$필요/NNG,0,0.028523362809854902,70,32,38,23,0.5328123250244281,0.5025971884911746
은행권/NNG@$채권/NNG@$딜러/NNG,0,0.027483118348867297,81,37,44,26,0.5654238421713363,0.5344703005418787
금융/NNG@$위기/NNG@$경기침체/NNG,0,0.027483118348867297,81,37,44,14,0.5654238421713363,0.5344703005418787
기준금리/NNG@$인상/NNG@$예상/NNG,0,0.026922990811443448,241,110,131,105,0.6845306415205967,0.6477820620890481
경기/NNG@$회복/NNG@$기대/NNG,0,0.02596272440684233,320,146,174,148,0.68417178366479,0.6486871592200604
기준금리/NNG@$유지/NNG@$했/VV,0,0.025873206503756796,103,47,56,40,0.6145118485467866,0.5827444671416302
위안화/NNG@$절상/NNG@$문제/NNG,0,0.024773339292398555,35,16,19,14,0.3880362070182607,0.36878688736309223
환율/NNG@$변동/NNG@$확대/NNG,0,0.024773339292398555,35,16,19,38,0.3880362070182607,0.36878688736309223
제조업/NNG@$지수/NNG@$예상/NNG,0,0.024773339292398555,35,16,19,17,0.3880362070182607,0.36878688736309223
부양책/NNG@$내놓/VV@$않/VX,0,0.024773339292398555,35,16,19,23,0.3880362070182607,0.36878688736309223
국내총생산/NNG@$증가율/NNG@$전망치/NNG,0,0.024773339292398555,35,16,19,17,0.3880362070182607,0.36878688736309223
달러/NNG@$원/NNG@$환율/NNG@$원대/NNG,0,0.024773339292398555,35,16,19,18,0.3880362070182607,0.36878688736309223
경기/NNG@$회복/NNG@$정책/NNG,0,0.024773339292398555,35,16,19,17,0.3880362070182607,0.36878688736309223
금융/NNG@$위기/NNG@$대응/NNG,0,0.024096671001071934,136,62,74,33,0.6562570159424128,0.6245466641699357
하락/NNG@$환율/NNG@$상승/NNG,0,0.023535220196734707,46,21,25,19,0.4381056267982611,0.4174047551369067
가격/NNG@$하락/NNG@$경기/NNG,0,0.023535220196734707,46,21,25,15,0.4381056267982611,0.4174047551369067
장단기/NNG@$금리/NNG@$역전/NNG,0,0.023535220196734707,46,21,25,17,0.4381056267982611,0.4174047551369067
금리/NNG@$사상/NNG@$최저치/NNG,0,0.023535220196734707,46,21,25,14,0.4381056267982611,0.4174047551369067
은행/NNG@$금리/NNG@$인상/NNG@$가능성/NNG,0,0.023535220196734707,46,21,25,18,0.4381056267982611,0.4174047551369067
지수/NNG@$오른/VV@$종합/NNG,0,0.023535220196734707,46,21,25,36,0.4381056267982611,0.4174047551369067
소비/NNG@$심리/NNG@$악화/NNG,0,0.023535220196734707,46,21,25,35,0.4381056267982611,0.4174047551369067
금리/NNG@$인상/NNG@$부담/NNG,0,0.02278290982500364,169,77,92,54,0.6737901788263134,0.6429195153612246
개인/NNG@$소비/NNG@$지출/NNG@$가격지수/NNG,0,0.022763067234913503,57,26,31,52,0.4833340761258169,0.46120773242255386
경제/NNG@$성장/NNG@$엔진/NNG,0,0.022763067234913503,57,26,31,25,0.4833340761258169,0.46120773242255386
가격/NNG@$상승/NNG@$인플레/NNG,0,0.022763067234913503,57,26,31,18,0.4833340761258169,0.46120773242255386
부담/NNG@$금리/NNG@$인상/NNG,1,0.022235202115636232,68,31,37,26,0.5229535898209418,0.4995405443295191
콜금리/NNG@$동결/NNG@$결정/NNG,1,0.022235202115636232,68,31,37,18,0.5229535898209418,0.4995405443295191
조정/NNG@$필요/NNG@$있/VA,1,0.022235202115636232,68,31,37,38,0.5229535898209418,0.4995405443295191
금리/NNG@$인상/NNG@$확실/XR,1,0.022235202115636232,68,31,37,28,0.5229535898209418,0.4995405443295191
소비/NNG@$지출/NNG@$둔화/NNG,0,0.021843700962339785,79,36,43,27,0.5567707575410178,0.5322602175093092
회복/NNG@$조짐/NNG@$보이/VV,0,0.01692156704630099,132,60,72,63,0.6481512878542086,0.6257460009020012
금리/NNG@$인하/NNG@$가능성/NNG@$시사/NNG,0,0.01692156704630099,132,60,72,20,0.6481512878542086,0.6257460009020012
경제/NNG@$성장/NNG@$인플레이션/NNG,0,0.01681308876006571,121,55,66,48,0.6362321157759389,0.6143720777777723
통화정책/NNG@$방향/NNG@$기준금리/NNG@$유지/NNG,0,0.016667312794382827,110,50,60,58,0.6208480490535577,0.5996913346031493
기준금리/NNG@$인상/NNG@$시장/NNG,0,0.016479995991115493,99,45,54,62,0.6013869710139363,0.5811110123967264
신중/NNG@$필요/NNG@$있/VA,1,0.015677796114078824,66,30,36,41,0.5128294455512687,0.49633459103355776
인상/NNG@$예상/NNG@$금리/NNG,1,0.015677796114078824,66,30,36,43,0.5128294455512687,0.49633459103355776
경제/NNG@$완만/XR@$성장/NNG,1,0.015677796114078824,66,30,36,23,0.5128294455512687,0.49633459103355776
우려/NNG@$필요/NNG@$없/VA,0,0.015362895310286229,55,25,30,26,0.472015295683168,0.45712088687678837
인상/NNG@$원화/NNG@$강세/NNG,0,0.015362895310286229,55,25,30,16,0.472015295683168,0.45712088687678837
경기/NNG@$부양책/NNG@$시행/NNG,0,0.015362895310286229,55,25,30,16,0.472015295683168,0.45712088687678837
자금/NNG@$유입/NNG@$지속/NNG,0,0.01506206101632257,44,20,24,18,0.42569488421077056,0.41251012476832566
가계/NNG@$소비/NNG@$지출/NNG,0,0.01506206101632257,44,20,24,9,0.42569488421077056,0.41251012476832566
예상/NNG@$물가/NNG@$상승/NNG,0,0.01506206101632257,44,20,24,13,0.42569488421077056,0.41251012476832566
회복/NNG@$기조/NNG@$유지/NNG,0,0.014813411432736734,33,15,18,13,0.3747283974646569,0.3633027338225089
유로/NNG@$유로존/NNG@$재무/NNG,0,0.014813411432736734,33,15,18,19,0.3747283974646569,0.3633027338225089
긍정적/NNG@$영향/NNG@$미쳤/VV,0,0.014813411432736734,33,15,18,31,0.3747283974646569,0.3633027338225089
금리/NNG@$하락/NNG@$마감/NNG,0,0.014813411432736734,33,15,18,35,0.3747283974646569,0.3633027338225089
인상/NNG@$기대/NNG@$높/VA,0,0.014813411432736734,33,15,18,19,0.3747283974646569,0.3633027338225089
주택/NNG@$경기/NNG@$회복/NNG,0,0.014813411432736734,33,15,18,24,0.3747283974646569,0.3633027338225089
가격/NNG@$상승/NNG@$가능성/NNG,0,0.014813411432736734,33,15,18,6,0.3747283974646569,0.3633027338225089
가격/NNG@$낮/VA@$진/VX,0,0.014813411432736734,33,15,18,19,0.3747283974646569,0.3633027338225089
증가/NNG@$소매/NNG@$판매/NNG,0,0.014813411432736734,33,15,18,16,0.3747283974646569,0.3633027338225089
최대/NNG@$낙폭/NNG@$기록/NNG,0,0.014813411432736734,33,15,18,19,0.3747283974646569,0.3633027338225089
채무/NNG@$상환/NNG@$부담/NNG,0,0.014813411432736734,33,15,18,27,0.3747283974646569,0.3633027338225089
기준금리/NNG@$인하/NNG@$요구/NNG,0,0.014813411432736734,33,15,18,30,0.3747283974646569,0.3633027338225089
인상/NNG@$속도/NNG@$시장/NNG,0,0.014663764756470687,22,10,12,17,0.3206580333766531,0.31097402002163416
수출/NNG@$높/VA@$증가세/NNG,0,0.014663764756470687,22,10,12,16,0.3206580333766531,0.31097402002163416
긍정적/NNG@$효과/NNG@$있/VA,0,0.014663764756470687,22,10,12,33,0.3206580333766531,0.31097402002163416
위축/NNG@$소비/NNG@$심리/NNG,0,0.014663764756470687,22,10,12,25,0.3206580333766531,0.31097402002163416
경제/NNG@$보/VV@$회복세/NNG,0,0.014663764756470687,22,10,12,20,0.3206580333766531,0.31097402002163416
통화정책/NNG@$기준금리/NNG@$인하/NNG,0,0.011529078369388435,97,44,53,44,0.5944806558147003,0.5801510929064
위안화/NNG@$절상/NNG@$가능성/NNG,0,0.00987876955891287,75,34,41,12,0.5386812647729481,0.5274337310158348
전망/NNG@$힘/NNG@$얻/VV,0,0.009294337860258572,128,58,70,72,0.6394012974912057,0.6267825240907389
금리/NNG@$인상/NNG@$배경/NNG,1,0.008836031018364832,64,29,35,17,0.5024395166988297,0.4929751182796642
성장률/NNG@$하향/NNG@$조정/NNG,0,0.00860940632093743,170,77,93,93,0.6648980563741751,0.6526690221998086
경제/NNG@$차지/NNG@$소비/NNG,0,0.007607250603155702,53,24,29,29,0.4604395209451499,0.4528772049564442
채권/NNG@$시장/NNG@$외국인/NNG,0,0.007607250603155702,53,24,29,26,0.4604395209451499,0.4528772049564442
상승/NNG@$압력/NNG@$지속/NNG,0,0.007522676480883117,106,48,58,36,0.6087987164414901,0.598900962430985
은행/NNG@$대출/NNG@$금리/NNG,0,0.006399260383193717,95,43,52,38,0.5873395454007516,0.5790895127758313
상승/NNG@$소비/NNG@$지출/NNG,0,0.006114224592285389,42,19,23,16,0.4130457579274187,0.40747600958375607
산업/NNG@$활동/NNG@$동향/NNG@$보/VV,0,0.006114224592285389,42,19,23,30,0.4130457579274187,0.40747600958375607
물가/NNG@$상승률/NNG@$지속/NNG,0,0.006114224592285389,42,19,23,22,0.4130457579274187,0.40747600958375607
회복/NNG@$수요/NNG@$압력/NNG,0,0.006114224592285389,42,19,23,15,0.4130457579274187,0.40747600958375607
회복/NNG@$지연/NNG@$우려/NNG,0,0.006114224592285389,42,19,23,10,0.4130457579274187,0.40747600958375607
회복/NNG@$기미/NNG@$보이/VV,0,0.005080904776348261,84,38,46,42,0.5609869231772134,0.5545664163789242
경제/NNG@$성장/NNG@$전망/NNG,0,0.00480942066201262,345,156,189,176,0.6703125374888733,0.6630004518095931
가능성/NNG@$배제/NNG@$없/VA,0,0.004420892412226873,929,420,509,410,0.6700552242975604,0.6632607975601471
기술/NNG@$지수/NNG@$높/VA,0,0.004135332151215421,31,14,17,25,0.36119120941388777,0.35773280971252175
물가/NNG@$상승/NNG@$경제/NNG,0,0.004135332151215421,31,14,17,19,0.36119120941388777,0.35773280971252175
위기/NNG@$경제/NNG@$성장/NNG,0,0.004135332151215421,31,14,17,21,0.36119120941388777,0.35773280971252175
모니터링/NNG@$필요/NNG@$있/VA,0,0.004135332151215421,31,14,17,11,0.36119120941388777,0.35773280971252175
기준금리/NNG@$인상/NNG@$할/VX,0,0.004135332151215421,31,14,17,21,0.36119120941388777,0.35773280971252175
만장일치/NNG@$기준금리/NNG@$동결/NNG,0,0.003530599664355094,73,33,40,38,0.529240943295558,0.5248074007175858
만장일치/NNG@$금리/NNG@$동결/NNG,0,0.003530599664355094,73,33,40,32,0.529240943295558,0.5248074007175858
통화정책/NNG@$금리/NNG@$인상/NNG,0,0.002551119643748434,135,61,74,88,0.6417079303052345,0.6375791641188675
규모/NNG@$경기/NNG@$부양책/NNG,0,0.002551119643748434,135,61,74,64,0.6417079303052345,0.6375791641188675
통화정책/NNG@$금리/NNG@$동결/NNG,0,0.0016931996784170789,62,28,34,18,0.49178354595753604,0.48945794017808086
물가/NNG@$경제/NNG@$성장/NNG,0,0.0016931996784170789,62,28,34,23,0.49178354595753604,0.48945794017808086
인상/NNG@$쉽/VA@$않/VX,0,0.001180484235121293,124,56,68,66,0.6299686905992118,0.62763244377937
관리/NNG@$제조업/NNG@$지수/NNG,0,0.0010830471171059397,93,42,51,27,0.579959653804097,0.5779214002703543
회복/NNG@$모습/NNG@$보이/VV,0,0.0008714593943848215,20,9,11,22,0.3063597620054169,0.3054121957017264
기조/NNG@$유지/NNG@$예상/NNG,0,-0.000530415252422145,51,23,28,22,0.4486072637212233,0.44847451792608783
산업/NNG@$생산/NNG@$수출/NNG,0,-0.000530415252422145,51,23,28,27,0.4486072637212233,0.44847451792608783
경기/NNG@$회복/NNG@$진행/NNG,0,-0.000530415252422145,51,23,28,15,0.4486072637212233,0.44847451792608783
경제/NNG@$동향/NNG@$성장률/NNG,0,-0.000530415252422145,51,23,28,17,0.4486072637212233,0.44847451792608783
둔화/NNG@$인플레/NNG@$압력/NNG,0,-0.000530415252422145,51,23,28,25,0.4486072637212233,0.44847451792608783
수입/NNG@$전망/NNG@$소비/NNG@$지출/NNG,0,-0.0033580570948562594,40,18,22,25,0.4001553030776746,0.40230407017363423
금리선물/NNG@$시장/NNG@$금리/NNG@$인상/NNG@$가능성/NNG,0,-0.0033580570948562594,40,18,22,38,0.4001553030776746,0.40230407017363423
기준금리/NNG@$인상/NNG@$신중/NNG,0,-0.0033580570948562594,40,18,22,21,0.4001553030776746,0.40230407017363423
상승/NNG@$압력/NNG@$가능성/NNG,0,-0.0033580570948562594,40,18,22,13,0.4001553030776746,0.40230407017363423
인상/NNG@$시기/NNG@$지연/NNG,0,-0.0033580570948562594,40,18,22,27,0.4001553030776746,0.40230407017363423
직접적/NNG@$영향/NNG@$않/VX,0,-0.0033580570948562594,40,18,22,20,0.4001553030776746,0.40230407017363423
기준금리/NNG@$상향/NNG@$조정/NNG@$가능성/NNG,0,-0.0033580570948562594,40,18,22,15,0.4001553030776746,0.40230407017363423
경제/NNG@$회복/NNG@$기대감/NNG,0,-0.0033580570948562594,40,18,22,12,0.4001553030776746,0.40230407017363423
점진적/NNG@$금리/NNG@$인상/NNG@$기조/NNG,0,-0.0033580570948562594,40,18,22,29,0.4001553030776746,0.40230407017363423
동결/NNG@$전망/NNG@$우세/NNG,0,-0.0057693104982458054,60,27,33,34,0.4808612912411063,0.4857789052861463
금리/NNG@$인상/NNG@$가능성/NNG@$배제/NNG@$없/VA,0,-0.0057693104982458054,60,27,33,23,0.4808612912411063,0.4857789052861463
기준금리/NNG@$인상/NNG@$시기/NNG,0,-0.0064710294878719266,320,144,176,185,0.6627953271150266,0.6705132690713024
국내총생산/NNG@$성장률/NNG@$전망치/NNG,0,-0.0069623919830649195,80,36,44,71,0.5437101069075636,0.5505818107067281
소비자/NNG@$물가/NNG@$상승률/NNG@$높/VA,0,-0.007293206877249991,140,63,77,27,0.6393639077551583,0.6478727703472813
기준금리/NNG@$인하/NNG@$기조/NNG,0,-0.007380367004486965,29,13,16,32,0.3474015805184349,0.3520862446443775
가격/NNG@$상승세/NNG@$지속/NNG,0,-0.007380367004486965,29,13,16,19,0.3474015805184349,0.3520862446443775
달러화/NNG@$강세/NNG@$지속/NNG,0,-0.007380367004486965,29,13,16,13,0.3474015805184349,0.3520862446443775
증권사/NNG@$채권/NNG@$딜러/NNG,0,-0.007540457763054009,249,112,137,142,0.6619158485383633,0.6710563837250337
가능성/NNG@$크/VA@$않/VX@$전망/NNG,0,-0.009080851469093432,49,22,27,29,0.43651825127782323,0.44391085839009403
에너지/NNG@$가격/NNG@$상승/NNG,0,-0.009397557989000771,267,120,147,89,0.660779145114138,0.6723952062559753
기준금리/NNG@$인하/NNG@$필요성/NNG,0,-0.009961133782958487,69,31,38,40,0.5095609293482487,0.519103098681652
둔화/NNG@$조짐/NNG@$보이/VV,0,-0.01014073159934703,89,40,49,30,0.564468327956179,0.5752451722555316
전망/NNG@$금리/NNG@$인상/NNG,0,-0.010546646183687391,256,115,141,129,0.6599531008091678,0.6730988388079504
기준금리/NNG@$동결/NNG@$결정/NNG,0,-0.010546646183687391,256,115,141,119,0.6599531008091678,0.6730988388079504
경기/NNG@$둔화/NNG@$물가/NNG,0,-0.01274897180504353,98,44,54,37,0.5820548957267644,0.5962680623592852
고용/NNG@$지표/NNG@$시장/NNG,0,-0.013337970050004144,78,35,43,33,0.5346810263312386,0.5483826413827687
금융시장/NNG@$불안/NNG@$모습/NNG,0,-0.013415799943459428,38,17,21,23,0.3870169973160963,0.3969963664765277
시장/NNG@$금리/NNG@$상승세/NNG,0,-0.013415799943459428,38,17,21,20,0.3870169973160963,0.3969963664765277
경제/NNG@$회복세/NNG@$예상/NNG,0,-0.013415799943459428,38,17,21,15,0.3870169973160963,0.3969963664765277
수출/NNG@$기업/NNG@$채산성/NNG@$악화/NNG,0,-0.013415799943459428,38,17,21,16,0.3870169973160963,0.3969963664765277
모습/NNG@$보이/VV@$금리/NNG,0,-0.013415799943459428,38,17,21,21,0.3870169973160963,0.3969963664765277
물가/NNG@$상승/NNG@$주도/NNG,0,-0.013415799943459428,38,17,21,8,0.3870169973160963,0.3969963664765277
동향/NNG@$산업/NNG@$생산/NNG,0,-0.013415799943459428,38,17,21,19,0.3870169973160963,0.3969963664765277
소비/NNG@$지출/NNG@$가격지수/NNG,0,-0.013572412623456875,58,26,32,53,0.46967238606978323,0.48193390494904054
금리/NNG@$인상/NNG@$포함/NNG,0,-0.013572412623456875,58,26,32,20,0.46967238606978323,0.48193390494904054
정책금리/NNG@$인하/NNG@$가능성/NNG,0,-0.013572412623456875,58,26,32,24,0.46967238606978323,0.48193390494904054
전망/NNG@$물가/NNG@$상승률/NNG,0,-0.013572412623456875,58,26,32,18,0.46967238606978323,0.48193390494904054
외화/NNG@$자금/NNG@$유출입/NNG,0,-0.01476179962043811,18,8,10,4,0.29160870709361086,0.29993386821978474
물가/NNG@$목표/NNG@$근접/NNG,0,-0.01476179962043811,18,8,10,15,0.29160870709361086,0.29993386821978474
소비/NNG@$부정적/NNG@$영향/NNG,0,-0.01476179962043811,18,8,10,27,0.29160870709361086,0.29993386821978474
기업/NNG@$신뢰/NNG@$지수/NNG,0,-0.016065622847943217,87,39,48,39,0.5563496829372108,0.5737263827260731
경기/NNG@$부양적/NNG@$통화정책/NNG,0,-0.016065622847943217,87,39,48,28,0.5563496829372108,0.5737263827260731
경기/NNG@$부양/NNG@$의지/NNG,0,-0.016435062222235675,145,65,80,78,0.6368643617595462,0.657241036460132
소비/NNG@$심리/NNG@$회복/NNG,0,-0.01665869308199508,116,52,64,56,0.6089024046166938,0.628665420691054
달러/NNG@$원/NNG@$환율/NNG@$하락/NNG,-1,-0.017133929117320812,67,30,37,37,0.49931841506507424,0.5160147039322437
저금리/NNG@$기조/NNG@$유지/NNG,0,-0.017613429586352702,326,146,180,96,0.6552898867301165,0.6778510579560213
금리/NNG@$인상/NNG@$시기상조/NNG,0,-0.018080114606938702,47,21,26,22,0.42417097671322684,0.4391844558903948
금리/NNG@$인상/NNG@$부작용/NNG,0,-0.018080114606938702,47,21,26,21,0.42417097671322684,0.4391844558903948
동결/NNG@$기조/NNG@$이어질/VV,0,-0.018080114606938702,47,21,26,37,0.42417097671322684,0.4391844558903948
경기/NNG@$위축/NNG@$우려/NNG,0,-0.018080114606938702,47,21,26,27,0.42417097671322684,0.4391844558903948
투자/NNG@$증권/NNG@$기준금리/NNG,0,-0.018080114606938702,47,21,26,35,0.42417097671322684,0.4391844558903948
금리/NNG@$올릴/VV@$필요/NNG,0,-0.018080114606938702,47,21,26,19,0.42417097671322684,0.4391844558903948
국고채/NNG@$금리/NNG@$기준금리/NNG,0,-0.018080114606938702,47,21,26,9,0.42417097671322684,0.4391844558903948
통화정책/NNG@$열/VV@$기준금리/NNG@$동결/NNG,0,-0.018080114606938702,47,21,26,26,0.42417097671322684,0.4391844558903948
경제/NNG@$침체/NNG@$빠지/VV,0,-0.018080114606938702,47,21,26,16,0.42417097671322684,0.4391844558903948
통화정책/NNG@$기조/NNG@$변화/NNG,0,-0.018115073756160505,125,56,69,60,0.6187871543008098,0.6407338292674067
상승/NNG@$압력/NNG@$커질/VV,0,-0.018269826080660634,96,43,53,17,0.574792593471941,0.5953630717800482
둔화/NNG@$수출/NNG@$감소/NNG,0,-0.019893814151725753,27,12,15,17,0.333321348336775,0.3463729334597609
경기/NNG@$상승/NNG@$하강/NNG,0,-0.01996497873803571,76,34,42,17,0.5253881696793612,0.5460380416648387
경기/NNG@$회복/NNG@$예상/NNG,0,-0.01996497873803571,76,34,42,19,0.5253881696793612,0.5460380416648387
에너지/NNG@$원자재/NNG@$가격/NNG,0,-0.01996497873803571,76,34,42,31,0.5253881696793612,0.5460380416648387
자산/NNG@$매입/NNG@$축소/NNG,0,-0.020323520351883007,143,64,79,111,0.6329792676040609,0.6583296660346548
경제/NNG@$완만/XR@$성장세/NNG,0,-0.021739824748888137,56,25,31,41,0.45821615278148803,0.4779188789320567
확장/NNG@$기조/NNG@$유지/NNG,0,-0.021739824748888137,56,25,31,12,0.45821615278148803,0.4779188789320567
콜금리/NNG@$동결/NNG@$전망/NNG,0,-0.021739824748888137,56,25,31,11,0.45821615278148803,0.4779188789320567
금융시장/NNG@$가격/NNG@$변수/NNG,0,-0.021739824748888137,56,25,31,21,0.45821615278148803,0.4779188789320567
인플레이션/NNG@$금리/NNG@$인상/NNG,0,-0.021739824748888137,56,25,31,30,0.45821615278148803,0.4779188789320567
금리/NNG@$인상/NNG@$미루/VV,0,-0.024135171446481585,36,16,20,16,0.37361915143168545,0.39155529048490123
경제/NNG@$전망/NNG@$하향/NNG@$조정/NNG,0,-0.024135171446481585,36,16,20,17,0.37361915143168545,0.39155529048490123
시차/NNG@$소비자/NNG@$물가/NNG,0,-0.024135171446481585,36,16,20,10,0.37361915143168545,0.39155529048490123
경제/NNG@$성장/NNG@$주도/NNG,0,-0.024135171446481585,36,16,20,12,0.37361915143168545,0.39155529048490123
기업들/NNG@$체감/NNG@$경기/NNG,0,-0.024135171446481585,36,16,20,17,0.37361915143168545,0.39155529048490123
물가/NNG@$상승/NNG@$경기/NNG,0,-0.024135171446481585,36,16,20,17,0.37361915143168545,0.39155529048490123
고공/NNG@$행진/NNG@$지속/NNG,0,-0.026467710467182215,112,50,62,22,0.5971929045631301,0.6287883128341824
기준금리/NNG@$동결/NNG@$배경/NNG,0,-0.0273071321621422,121,54,67,38,0.6083875168408059,0.6416515219761733
금리/NNG@$상승/NNG@$경기/NNG,0,-0.02757105228247736,45,20,25,12,0.41156209571536795,0.43429371972877345
주택/NNG@$담보대출/NNG@$규제/NNG,0,-0.02757105228247736,45,20,25,29,0.41156209571536795,0.43429371972877345
기준금리/NNG@$인하/NNG@$않/VX,0,-0.02757105228247736,45,20,25,32,0.41156209571536795,0.43429371972877345
물가/NNG@$상승률/NNG@$예상/NNG,0,-0.02844046353356522,139,62,77,48,0.6247705919781587,0.6604256987868927
자산/NNG@$가격/NNG@$상승/NNG,0,-0.02853819688287973,341,152,189,95,0.6478551182643176,0.6849615242901241
속도/NNG@$금리/NNG@$인상/NNG,0,-0.02910115891185472,157,70,87,47,0.6349761199405922,0.6721012597723823
소비자들/NNG@$경제/NNG@$심리/NNG@$나타내/VV@$소비자심리지수/NNG,0,-0.030298719713253486,54,24,30,19,0.44649135460819456,0.47372981696718414
금리/NNG@$인하/NNG@$요구/NNG,0,-0.03212146263149496,119,53,66,54,0.6029049803712425,0.6420223408126435
안전자산/NNG@$선호/NNG@$현상/NNG,0,-0.03212146263149496,119,53,66,65,0.6029049803712425,0.6420223408126435
시장/NNG@$기준금리/NNG@$인하/NNG,0,-0.03286981303767067,173,77,96,96,0.6380970274336792,0.6805157971287115
소비자/NNG@$물가/NNG@$근원인플레이션/NNG,0,-0.03294105239716838,16,7,9,13,0.2761741233522208,0.2945753302586389
개선/NNG@$모습/NNG@$보였/VV,0,-0.033626347381989885,25,11,14,14,0.31888924317781076,0.3406031988802913
하방/NNG@$위험/NNG@$확대/NNG,0,-0.033626347381989885,25,11,14,16,0.31888924317781076,0.3406031988802913
양적완화/NNG@$축소/NNG@$시기/NNG,0,-0.033626347381989885,25,11,14,19,0.31888924317781076,0.3406031988802913
방향/NNG@$기준금리/NNG@$유지/NNG@$통화정책/NNG@$경제/NNG,0,-0.033626347381989885,25,11,14,20,0.31888924317781076,0.3406031988802913
금리/NNG@$인하/NNG@$고려/NNG,0,-0.034025817119799906,72,32,40,45,0.5060020229112527,0.5408890924954755
예상/NNG@$금리/NNG@$동결/NNG,0,-0.034025817119799906,72,32,40,42,0.5060020229112527,0.5408890924954755
경제/NNG@$성장/NNG@$예상/NNG,0,-0.0352088488654656,81,36,45,39,0.5304618531244463,0.5683791977597907
금리/NNG@$인상/NNG@$쉽/VA@$않/VX,0,-0.0352088488654656,81,36,45,37,0.5304618531244463,0.5683791977597907
경제/NNG@$금리/NNG@$인상/NNG,0,-0.03531636695609475,279,124,155,168,0.6431811466758974,0.6893039366175969
결정/NNG@$기준금리/NNG@$동결/NNG,0,-0.035613156428760395,34,15,19,18,0.35994264382392677,0.3859834452955902
예상/NNG@$채권/NNG@$시장/NNG,0,-0.035613156428760395,34,15,19,17,0.35994264382392677,0.3859834452955902
상승률/NNG@$중기/NNG@$물가/NNG@$목표/NNG,0,-0.035613156428760395,34,15,19,9,0.35994264382392677,0.3859834452955902
달러/NNG@$원/NNG@$상승/NNG,0,-0.035613156428760395,34,15,19,18,0.35994264382392677,0.3859834452955902
금리/NNG@$인상/NNG@$기정사실/NNG,0,-0.035613156428760395,34,15,19,22,0.35994264382392677,0.3859834452955902
매파적/NNG@$금리/NNG@$인상/NNG,0,-0.035613156428760395,34,15,19,17,0.35994264382392677,0.3859834452955902
금리/NNG@$인하/NNG@$어려울/VA,0,-0.035613156428760395,34,15,19,23,0.35994264382392677,0.3859834452955902
강세/NNG@$엔화/NNG@$약세/NNG,0,-0.035613156428760395,34,15,19,18,0.35994264382392677,0.3859834452955902
인플레이션/NNG@$물가/NNG@$상승/NNG,0,-0.035613156428760395,34,15,19,32,0.35994264382392677,0.3859834452955902
인플레율/NNG@$상승/NNG@$압력/NNG,0,-0.035613156428760395,34,15,19,35,0.35994264382392677,0.3859834452955902
원/NNG@$환율/NNG@$하락/NNG,0,-0.036599918832719514,99,44,55,53,0.569526378645172,0.6119371196981491
금융기관/NNG@$경제/NNG@$실시/NNG,0,-0.03760532025056862,43,19,24,15,0.3986856126915953,0.429237203688395
침체/NNG@$빠지/VV@$않/VX,0,-0.03760532025056862,43,19,24,32,0.3986856126915953,0.429237203688395
인상/NNG@$나설/VV@$예상/NNG,0,-0.03760532025056862,43,19,24,20,0.3986856126915953,0.429237203688395
달러화/NNG@$약세/NNG@$지속/NNG,0,-0.03760532025056862,43,19,24,7,0.3986856126915953,0.429237203688395
의견/NNG@$적/VA@$않/VX,0,-0.03760532025056862,43,19,24,17,0.3986856126915953,0.429237203688395
전망/NNG@$힘/NNG@$실리/VV,0,-0.03760532025056862,43,19,24,17,0.3986856126915953,0.429237203688395
전망/NNG@$채권/NNG@$시장/NNG,0,-0.03760532025056862,43,19,24,17,0.3986856126915953,0.429237203688395
경기/NNG@$둔화/NNG@$막/VV,0,-0.03760532025056862,43,19,24,21,0.3986856126915953,0.429237203688395
소수/NNG@$의견/NNG@$냈/VV,0,-0.03760532025056862,43,19,24,16,0.3986856126915953,0.429237203688395
인하/NNG@$단행/NNG@$않/VX,0,-0.03760532025056862,43,19,24,9,0.3986856126915953,0.429237203688395
금리/NNG@$인하/NNG@$영향/NNG,0,-0.039280570411623916,52,23,29,18,0.43449586793259526,0.46936275438817626
매입/NNG@$규모/NNG@$유지/NNG,0,-0.039280570411623916,52,23,29,42,0.43449586793259526,0.46936275438817626
경기/NNG@$완만/XR@$회복/NNG,0,-0.039280570411623916,52,23,29,42,0.43449586793259526,0.46936275438817626
경제/NNG@$전망/NNG@$경기/NNG,0,-0.039280570411623916,52,23,29,19,0.43449586793259526,0.46936275438817626
최악/NNG@$금융/NNG@$위기/NNG,0,-0.039280570411623916,52,23,29,12,0.43449586793259526,0.46936275438817626
인플레/NNG@$압력/NNG@$완화/NNG,-1,-0.041489054266130476,70,31,39,32,0.49590440689718873,0.5380726446481885
최대/NNG@$경제/NNG@$국인/NNG,-1,-0.041489054266130476,70,31,39,26,0.49590440689718873,0.5380726446481885
위안화/NNG@$절상/NNG@$속도/NNG,0,-0.04208275569835063,79,35,44,27,0.5213117067637424,0.5663131199184706
콜금리/NNG@$동결/NNG@$예상/NNG,0,-0.04208275569835063,79,35,44,34,0.5213117067637424,0.5663131199184706
기준금리/NNG@$사상/NNG@$최저/NNG,0,-0.0423356258331975,185,82,103,99,0.6342561592083972,0.6893562334220045
주시/NNG@$필요/NNG@$있/VA,0,-0.0424253799464932,106,47,59,47,0.5780540000270715,0.6283845028016879
투자/NNG@$심리/NNG@$위축/NNG,0,-0.045001436471990175,192,85,107,105,0.6334920054103474,0.6922107463981869
물가/NNG@$목표/NNG@$하단/NNG,0,-0.04797598014743443,32,14,18,22,0.34595762827890086,0.3802834432156186
경제/NNG@$회복/NNG@$기대/NNG,0,-0.04797598014743443,32,14,18,19,0.34595762827890086,0.3802834432156186
금리/NNG@$인상/NNG@$배제/NNG,0,-0.04824616635016632,41,18,23,15,0.3855317736381876,0.42401354527894314
저금리/NNG@$정책/NNG@$유지/NNG,0,-0.04824616635016632,41,18,23,10,0.3855317736381876,0.42401354527894314
상승/NNG@$경기/NNG@$둔화/NNG,0,-0.04824616635016632,41,18,23,11,0.3855317736381876,0.42401354527894314
담보대출/NNG@$모기지/NNG@$금리/NNG,0,-0.04824616635016632,41,18,23,21,0.3855317736381876,0.42401354527894314
물가/NNG@$상승률/NNG@$최고치/NNG,0,-0.04824616635016632,41,18,23,10,0.3855317736381876,0.42401354527894314
결정/NNG@$쉽/VA@$않/VX,0,-0.04824616635016632,41,18,23,17,0.3855317736381876,0.42401354527894314
조정/NNG@$여부/NNG@$결정/NNG,0,-0.04824616635016632,41,18,23,17,0.3855317736381876,0.42401354527894314
금리/NNG@$동결/NNG@$물가/NNG,0,-0.04824616635016632,41,18,23,16,0.3855317736381876,0.42401354527894314
국채/NNG@$모기지/NNG@$담보/NNG@$증권/NNG,0,-0.04824616635016632,41,18,23,10,0.3855317736381876,0.42401354527894314
외환/NNG@$위기/NNG@$이전/NNG,0,-0.048722260628816794,50,22,28,13,0.42222624940059517,0.464813759434702
불안/NNG@$요인/NNG@$가능성/NNG,0,-0.048895108205492144,23,10,13,9,0.3040077277698055,0.33478712498233354
금융/NNG@$불안/NNG@$경제/NNG,0,-0.048895108205492144,23,10,13,25,0.3040077277698055,0.33478712498233354
금리/NNG@$인상/NNG@$가시화/NNG,0,-0.048895108205492144,23,10,13,23,0.3040077277698055,0.33478712498233354
거시/NNG@$건전성/NNG@$조치/NNG,0,-0.048895108205492144,23,10,13,32,0.3040077277698055,0.33478712498233354
경제/NNG@$외환/NNG@$위기/NNG,0,-0.048895108205492144,23,10,13,25,0.3040077277698055,0.33478712498233354
위안화/NNG@$절상/NNG@$압력/NNG,0,-0.04899549907108147,86,38,48,56,0.534823571428197,0.5890904822712116
소비/NNG@$지출/NNG@$감소/NNG,-1,-0.04909228642943331,59,26,33,24,0.4556324412460113,0.501961388792328
변동성/NNG@$심한/VA@$에너지/NNG,-1,-0.04909228642943331,59,26,33,17,0.4556324412460113,0.501961388792328
금리/NNG@$인하/NNG@$있/VA,-1,-0.04909228642943331,59,26,33,19,0.4556324412460113,0.501961388792328
담보인정비율/NNG@$부채/NNG@$상환/NNG,-1,-0.04909228642943331,59,26,33,36,0.4556324412460113,0.501961388792328
금리/NNG@$인상/NNG@$고려/NNG,0,-0.04990738933801231,138,61,77,58,0.6097639854897201,0.6728629813938135
수출/NNG@$비중/NNG@$높/VA,0,-0.05296572396058352,111,49,62,72,0.5789816606539518,0.6428225986791644
경제/NNG@$부정적/NNG@$영향/NNG,0,-0.05425048445409297,245,108,137,161,0.6298726820775383,0.7011281331976611
고용/NNG@$시장/NNG@$호조/NNG,0,-0.05583181731743192,84,37,47,88,0.5260727335497591,0.5874447983373065
금리/NNG@$인상/NNG@$정책/NNG,0,-0.05589170497828877,202,89,113,60,0.6270311047164834,0.7002651211893487
경제/NNG@$회복/NNG@$지연/NNG,0,-0.05664561045853289,75,33,42,36,0.5022129235492596,0.5617171778608342
더블딥/NNG@$경기/NNG@$상승/NNG@$하강/NNG,-1,-0.05736658471598732,66,29,37,17,0.4748892695374636,0.5319244672139002
금융시장/NNG@$금리/NNG@$인하/NNG,0,-0.05801286794563232,57,25,32,32,0.4440227737716585,0.497995768333162
불안/NNG@$모습/NNG@$보이/VV,0,-0.05860433979925972,109,48,61,42,0.5724797202810726,0.6428292288833634
성장/NNG@$둔화/NNG@$금리/NNG,0,-0.05866756117597971,48,21,27,24,0.40967716311739777,0.46007890901521453
전망/NNG@$기준금리/NNG@$동결/NNG,0,-0.05957233734142453,39,17,22,22,0.37208554386075404,0.41862136920009785
달러화/NNG@$강세/NNG@$보이/VV,0,-0.05957233734142453,39,17,22,34,0.37208554386075404,0.41862136920009785
증권/NNG@$금리/NNG@$인하/NNG,0,-0.05957233734142453,39,17,22,22,0.37208554386075404,0.41862136920009785
요인/NNG@$가능성/NNG@$있/VA,0,-0.05957233734142453,39,17,22,9,0.37208554386075404,0.41862136920009785
시장/NNG@$금리/NNG@$낮/VA,0,-0.05957233734142453,39,17,22,24,0.37208554386075404,0.41862136920009785
인상/NNG@$하지/NNG@$않/VX,0,-0.060038535281029426,100,44,56,35,0.5569186099455794,0.6271571838491399
주택/NNG@$담보대출/NNG@$크/VA,0,-0.061391973934788235,30,13,17,28,0.3316186422726574,0.3744575807659232
달러화/NNG@$약세/NNG@$보이/VV,0,-0.061391973934788235,30,13,17,32,0.3316186422726574,0.3744575807659232
수출/NNG@$산업/NNG@$생산/NNG,0,-0.061391973934788235,30,13,17,23,0.3316186422726574,0.3744575807659232
금리/NNG@$내릴/VV@$가능성/NNG,0,-0.061481909931903056,91,40,51,23,0.5385371518619219,0.6082158199642871
금리/NNG@$인하/NNG@$가계부채/NNG,0,-0.061481909931903056,91,40,51,50,0.5385371518619219,0.6082158199642871
최대/NNG@$채권/NNG@$펀드/NNG,0,-0.061481909931903056,91,40,51,44,0.5385371518619219,0.6082158199642871
하락/NNG@$경기/NNG@$둔화/NNG,0,-0.06292416157823122,82,36,46,30,0.5170615847346841,0.5856537530248491
금리/NNG@$동결/NNG@$예상/NNG,0,-0.06388339596363768,303,133,170,172,0.6233146296584862,0.7073622373297728
금리/NNG@$인상/NNG@$없/VA,0,-0.06439364753497023,278,122,156,137,0.6229336548746749,0.7076541030256838
상승/NNG@$금리/NNG@$인상/NNG,0,-0.06556117011473206,196,86,110,80,0.6196701256708097,0.7055980900068296
실업/NNG@$수당/NNG@$청구/NNG@$예상치/NNG,-1,-0.06582113008793378,64,28,36,15,0.4639670113992235,0.5285797728158583
물가/NNG@$상승/NNG@$예상/NNG,-1,-0.06582113008793378,64,28,36,41,0.4639670113992235,0.5285797728158583
수당/NNG@$청구/NNG@$예상치/NNG,-1,-0.06582113008793378,64,28,36,15,0.4639670113992235,0.5285797728158583
생각/NNG@$볼/VX@$필요/NNG,0,-0.06617424260633775,21,9,12,19,0.28852043980922204,0.3289332934398283
인상/NNG@$나설/VV@$전망/NNG,0,-0.06631298397367913,98,43,55,31,0.5494098199425378,0.6265397236861602
출구전략/NNG@$시행/NNG@$시기/NNG,0,-0.06736349850217438,55,24,31,20,0.4321321002151644,0.4938380677729186
경기/NNG@$회복/NNG@$지속/NNG,0,-0.06826441806112571,89,39,50,40,0.5301735776696825,0.6069761742699562
억제/NNG@$기준금리/NNG@$인상/NNG,0,-0.06916911522305058,46,20,26,24,0.39684061953785504,0.45515424865577353
부진/NNG@$금리/NNG@$인하/NNG,0,-0.06916911522305058,46,20,26,40,0.39684061953785504,0.45515424865577353
물가/NNG@$압력/NNG@$완화/NNG,0,-0.06916911522305058,46,20,26,16,0.39684061953785504,0.45515424865577353
물가/NNG@$상승률/NNG@$억제/NNG,0,-0.06916911522305058,46,20,26,13,0.39684061953785504,0.45515424865577353
서두/NNG@$필요/NNG@$없/VA,0,-0.06916911522305058,46,20,26,38,0.39684061953785504,0.45515424865577353
경제/NNG@$동향/NNG@$인플레율/NNG,0,-0.06916911522305058,46,20,26,6,0.39684061953785504,0.45515424865577353
경기/NNG@$회복/NNG@$자신감/NNG,0,-0.07144823371679443,121,53,68,48,0.5796928911763147,0.6679259878898892
경기/NNG@$회복/NNG@$부진/NNG,0,-0.07168366322151654,37,16,21,21,0.3583244874418418,0.4130591404807631
금리/NNG@$인상/NNG@$가능성/NNG@$무게/NNG,0,-0.07168366322151654,37,16,21,19,0.3583244874418418,0.4130591404807631
결정/NNG@$중요/NNG@$변수/NNG,0,-0.07168366322151654,37,16,21,12,0.3583244874418418,0.4130591404807631
금융시장/NNG@$불안/NNG@$지속/NNG,0,-0.07168366322151654,37,16,21,11,0.3583244874418418,0.4130591404807631
민간/NNG@$소비/NNG@$증가세/NNG,0,-0.07168366322151654,37,16,21,20,0.3583244874418418,0.4130591404807631
경기/NNG@$둔화/NNG@$신호/NNG,0,-0.07168366322151654,37,16,21,17,0.3583244874418418,0.4130591404807631
환시/NNG@$달러화/NNG@$엔화/NNG@$달러당/NNG@$거래/NNG,0,-0.07168366322151654,37,16,21,13,0.3583244874418418,0.4130591404807631
금리/NNG@$인상/NNG@$성장/NNG,0,-0.07168366322151654,37,16,21,36,0.3583244874418418,0.4130591404807631
성장률/NNG@$소비자/NNG@$물가/NNG,0,-0.07168366322151654,37,16,21,13,0.3583244874418418,0.4130591404807631
기준금리/NNG@$인하/NNG@$결정/NNG,0,-0.07170379332529075,137,60,77,52,0.5943515241537252,0.6851673991191702
금리/NNG@$인하/NNG@$않/VX,0,-0.07396927472062065,112,49,63,44,0.5668965402676293,0.6564986202781637
이전/NNG@$금리/NNG@$인상/NNG,-1,-0.07465073524565813,62,27,35,43,0.4527645835927778,0.5250457918601766
금리/NNG@$인상/NNG@$나설/VV@$전망/NNG,-1,-0.07465073524565813,62,27,35,17,0.4527645835927778,0.5250457918601766
경제/NNG@$더딘/VA@$회복세/NNG,0,-0.07609183553391174,28,12,16,13,0.316857153713601,0.3685073244027156
외환/NNG@$위기/NNG@$가능성/NNG,0,-0.07609183553391174,28,12,16,24,0.316857153713601,0.3685073244027156
경기/NNG@$확장/NNG@$위축/NNG,0,-0.07609183553391174,28,12,16,27,0.316857153713601,0.3685073244027156
경제/NNG@$불확실성/NNG@$커지/VV,0,-0.07609183553391174,28,12,16,24,0.316857153713601,0.3685073244027156
부정적/NNG@$영향/NNG@$미쳤/VV,0,-0.07609183553391174,28,12,16,39,0.316857153713601,0.3685073244027156
자금/NNG@$중개/NNG@$기능/NNG,0,-0.07609183553391174,28,12,16,12,0.316857153713601,0.3685073244027156
금리/NNG@$상향/NNG@$조정/NNG,0,-0.07609183553391174,28,12,16,23,0.316857153713601,0.3685073244027156
경제/NNG@$긍정적/NNG@$영향/NNG,0,-0.077181389663593,53,23,30,41,0.4199556428866599,0.4894825737515687
금리/NNG@$인하/NNG@$속도/NNG,0,-0.077181389663593,53,23,30,13,0.4199556428866599,0.4894825737515687
주택/NNG@$판매/NNG@$감소/NNG,0,-0.077181389663593,53,23,30,35,0.4199556428866599,0.4894825737515687
기준금리/NNG@$인상/NNG@$가능성/NNG@$시사/NNG,0,-0.077181389663593,53,23,30,29,0.4199556428866599,0.4894825737515687
시장/NNG@$금리/NNG@$인하/NNG@$기대감/NNG,0,-0.08029114367715728,44,19,25,31,0.3837049577818721,0.45003573092295507
외환시장/NNG@$변동성/NNG@$확대/NNG,0,-0.08029114367715728,44,19,25,30,0.3837049577818721,0.45003573092295507
선행/NNG@$지표/NNG@$역할/NNG,0,-0.08029114367715728,44,19,25,15,0.3837049577818721,0.45003573092295507
대출/NNG@$금리/NNG@$인상/NNG,0,-0.08070793411380339,195,85,110,103,0.6088759884822617,0.714730838548383
전망/NNG@$성장률/NNG@$전망치/NNG,0,-0.08257736325407083,85,37,48,46,0.5126809623996157,0.6040796541543603
예상/NNG@$경기/NNG@$회복/NNG,0,-0.08257736325407083,85,37,48,24,0.5126809623996157,0.6040796541543603
국채/NNG@$금리/NNG@$하락/NNG,0,-0.08268535550781442,117,51,66,89,0.5676491039927485,0.6689926461927698
금융/NNG@$균형/NNG@$누적/NNG,0,-0.08295961636383553,12,5,7,30,0.24114738149455164,0.28435679407466186
상승/NNG@$기조/NNG@$유지/NNG,0,-0.08307797728963373,101,44,57,26,0.5442547882207721,0.6419286424737138
경기/NNG@$회복/NNG@$모멘텀/NNG,0,-0.08354440713443978,163,71,92,49,0.6000294532659871,0.7083774078667164
경제/NNG@$수출/NNG@$호조/NNG,-1,-0.08388295087699449,60,26,34,8,0.44127849445432243,0.5213156788626274
인상/NNG@$금리/NNG@$인하/NNG,-1,-0.08388295087699449,60,26,34,32,0.44127849445432243,0.5213156788626274
사상/NNG@$최대/NNG@$규모/NNG,-1,-0.08388295087699449,60,26,34,32,0.44127849445432243,0.5213156788626274
우려/NNG@$금리/NNG@$동결/NNG,-1,-0.08388295087699449,60,26,34,19,0.44127849445432243,0.5213156788626274
증가/NNG@$속도/NNG@$둔화/NNG,0,-0.08470920322623199,35,15,20,21,0.3442157681543563,0.40732494654577417
긍정적/NNG@$영향/NNG@$전망/NNG,0,-0.08470920322623199,35,15,20,19,0.3442157681543563,0.40732494654577417
조정/NNG@$가능성/NNG@$있/VA,0,-0.08470920322623199,35,15,20,20,0.3442157681543563,0.40732494654577417
금리/NNG@$인하/NNG@$기조/NNG,0,-0.08525416297932653,147,64,83,33,0.591635521204148,0.7008755200949185
소비/NNG@$지출/NNG@$전망/NNG,0,-0.08699523267376663,131,57,74,84,0.5791714603002546,0.6885193341286846
신중/NNG@$금리/NNG@$인상/NNG,0,-0.08751056705608351,51,22,29,34,0.4074867915429249,0.48492346848332957
전망/NNG@$밝/VA@$않/VX,0,-0.08751056705608351,51,22,29,33,0.4074867915429249,0.48492346848332957
기준금리/NNG@$인상/NNG@$출구전략/NNG,0,-0.08751056705608351,51,22,29,18,0.4074867915429249,0.48492346848332957
인상/NNG@$가능성/NNG@$희박/XR,0,-0.08751056705608351,51,22,29,13,0.4074867915429249,0.48492346848332957
소비/NNG@$지출/NNG@$증가/NNG,0,-0.08856770689134519,115,50,65,61,0.5613237611760916,0.6694185314976068
대외/NNG@$경제/NNG@$불확실성/NNG,0,-0.09211318478707897,42,18,24,29,0.37025347371054584,0.4447191246421882
채권/NNG@$시장/NNG@$투자/NNG,0,-0.09211318478707897,42,18,24,18,0.37025347371054584,0.4447191246421882
가격/NNG@$상승/NNG@$경기/NNG,0,-0.09211318478707897,42,18,24,10,0.37025347371054584,0.4447191246421882
해외/NNG@$투자/NNG@$확대/NNG,0,-0.09211318478707897,42,18,24,22,0.37025347371054584,0.4447191246421882
전망/NNG@$경기/NNG@$회복/NNG,0,-0.09211318478707897,42,18,24,18,0.37025347371054584,0.4447191246421882
견조/NNG@$성장세/NNG@$지속/NNG,0,-0.09211318478707897,42,18,24,20,0.37025347371054584,0.4447191246421882
심리/NNG@$부정적/NNG@$영향/NNG,0,-0.09211318478707897,42,18,24,34,0.37025347371054584,0.4447191246421882
호흡기/NNG@$증후군/NNG@$메르스/NNG@$사태/NNG,0,-0.09240165627691566,26,11,15,61,0.3015698817965017,0.36243250126483606
증후군/NNG@$메르스/NNG@$사태/NNG,0,-0.09240165627691566,26,11,15,61,0.3015698817965017,0.36243250126483606
기조/NNG@$유지/NNG@$바람직/XR,0,-0.09240165627691566,26,11,15,18,0.3015698817965017,0.36243250126483606
금리/NNG@$상승/NNG@$기조/NNG,0,-0.09240165627691566,26,11,15,19,0.3015698817965017,0.36243250126483606
수출/NNG@$부진/NNG@$경기/NNG,0,-0.09240165627691566,26,11,15,21,0.3015698817965017,0.36243250126483606
국제금융시장/NNG@$불안/NNG@$완화/NNG,0,-0.09240165627691566,26,11,15,17,0.3015698817965017,0.36243250126483606
하락/NNG@$크/VA@$않/VX,0,-0.09240165627691566,26,11,15,27,0.3015698817965017,0.36243250126483606
경기/NNG@$완만/XR@$회복세/NNG,-1,-0.09354956416649762,58,25,33,26,0.4295043674458306,0.5173824345546797
환율/NNG@$상승/NNG@$물가/NNG,-1,-0.09354956416649762,58,25,33,16,0.4295043674458306,0.5173824345546797
사상/NNG@$최저/NNG@$금리/NNG,-1,-0.09354956416649762,58,25,33,24,0.4295043674458306,0.5173824345546797
예상/NNG@$기준금리/NNG@$동결/NNG,0,-0.09366637066874461,90,39,51,40,0.516948247606005,0.6228642896318325
가능성/NNG@$크/VA@$예상/NNG,-1,-0.09412808198766265,74,32,42,48,0.47834967221584057,0.5768941248511825
정책/NNG@$기조/NNG@$변화/NNG,0,-0.09646075423272082,120,52,68,51,0.5620193312721171,0.6809965283496332
경제/NNG@$보/VV@$수출/NNG,0,-0.09657932757349608,97,42,55,45,0.5287526594248505,0.6408406945919852
인플레/NNG@$기대/NNG@$심리/NNG,0,-0.09814199440537008,377,163,214,151,0.5989147998387605,0.7281682318413795
금리/NNG@$인상/NNG@$행보/NNG,0,-0.09840375926523393,49,21,28,15,0.3947164223798668,0.48015479530613697
은행/NNG@$자본/NNG@$확충/NNG,0,-0.09840375926523393,49,21,28,11,0.3947164223798668,0.48015479530613697
엠파이어/NNG@$스테이트/NNG@$지수/NNG,0,-0.09840375926523393,49,21,28,36,0.3947164223798668,0.48015479530613697
공개/NNG@$금리/NNG@$인상/NNG,0,-0.09840375926523393,49,21,28,53,0.3947164223798668,0.48015479530613697
지속적/NNG@$경제/NNG@$성장/NNG,-1,-0.09857268214983994,65,28,37,30,0.4496766451439384,0.5471979291033386
물가/NNG@$목표/NNG@$크/VA,0,-0.09881939942688611,33,14,19,17,0.32971183434012097,0.40141617825794657
변화/NNG@$없/VA@$전망/NNG,0,-0.09881939942688611,33,14,19,25,0.32971183434012097,0.40141617825794657
발생/NNG@$가능성/NNG@$크/VA,0,-0.09881939942688611,33,14,19,27,0.32971183434012097,0.40141617825794657
하향/NNG@$조정/NNG@$예상/NNG,0,-0.09881939942688611,33,14,19,29,0.32971183434012097,0.40141617825794657
유로존/NNG@$산업/NNG@$생산/NNG,0,-0.09881939942688611,33,14,19,18,0.32971183434012097,0.40141617825794657
채권/NNG@$시장/NNG@$전망/NNG,0,-0.09881939942688611,33,14,19,32,0.32971183434012097,0.40141617825794657
성장세/NNG@$보일/VV@$전망/NNG,0,-0.09881939942688611,33,14,19,19,0.32971183434012097,0.40141617825794657
경제/NNG@$성장/NNG@$금리/NNG,0,-0.09881939942688611,33,14,19,19,0.32971183434012097,0.40141617825794657
성장세/NNG@$둔화/NNG@$우려/NNG,0,-0.09881939942688611,33,14,19,21,0.32971183434012097,0.40141617825794657
경기/NNG@$회복세/NNG@$이어질/VV,0,-0.09881939942688611,33,14,19,12,0.32971183434012097,0.40141617825794657
정책/NNG@$결정/NNG@$영향/NNG,0,-0.09881939942688611,33,14,19,20,0.32971183434012097,0.40141617825794657
경기/NNG@$확장/NNG@$국면/NNG,0,-0.10089375664521694,111,48,63,48,0.5480441860544437,0.6700300818463474
시장/NNG@$금리/NNG@$동결/NNG,0,-0.10089375664521694,111,48,63,56,0.5480441860544437,0.6700300818463474
인하/NNG@$가능성/NNG@$시사/NNG,0,-0.10256671633651537,169,73,96,33,0.5885015023795553,0.7219271595138855
기준금리/NNG@$내릴/VV@$가능성/NNG,-1,-0.10368762379477381,56,24,32,19,0.41743658678033174,0.5132388949916796
인플레/NNG@$상승/NNG@$압력/NNG,-1,-0.10368762379477381,56,24,32,13,0.41743658678033174,0.5132388949916796
상승/NNG@$압력/NNG@$낮/VA,-1,-0.10368762379477381,56,24,32,30,0.41743658678033174,0.5132388949916796
의미/NNG@$금리/NNG@$인상/NNG,0,-0.10473534461514311,40,17,23,18,0.35646255209307975,0.4391998845204394
은행/NNG@$가계/NNG@$대출/NNG@$주택/NNG@$담보대출/NNG,0,-0.10473534461514311,40,17,23,26,0.35646255209307975,0.4391998845204394
심리/NNG@$회복/NNG@$지연/NNG,0,-0.10473534461514311,40,17,23,11,0.35646255209307975,0.4391998845204394
인상/NNG@$가능/NNG@$전망/NNG,0,-0.10473534461514311,40,17,23,27,0.35646255209307975,0.4391998845204394
기준금리/NNG@$동결/NNG@$예상/NNG,0,-0.10507225790643149,290,125,165,159,0.5939003868783331,0.7322469289512528
매입/NNG@$규모/NNG@$확대/NNG,0,-0.10572979163753538,102,44,58,43,0.5315576968492718,0.6562531730971408
금리/NNG@$인하/NNG@$소수/NNG@$의견/NNG,-1,-0.10610751204173352,79,34,45,31,0.48447536813059194,0.5985827982429862
금리/NNG@$인하/NNG@$전망/NNG,0,-0.10732428001116501,281,121,160,118,0.5922606384965257,0.7335564519089958
기준금리/NNG@$하향/NNG@$조정/NNG,0,-0.10735201924952942,109,47,62,41,0.5410813065995301,0.6702048324891666
단행/NNG@$금리/NNG@$인하/NNG,0,-0.10735201924952942,109,47,62,29,0.5410813065995301,0.6702048324891666
임금/NNG@$인상/NNG@$요구/NNG,-1,-0.1080726714641127,63,27,36,17,0.43832263588698056,0.543715462991044
금리/NNG@$인하/NNG@$단행/NNG@$가능성/NNG,-1,-0.1088446055050204,86,37,49,34,0.4992076248248889,0.6202073272536425
경제/NNG@$전망/NNG@$밝/VA,0,-0.10992493571379391,47,20,27,19,0.3816320027946938,0.4751704080944809
기업/NNG@$투자/NNG@$위축/NNG,0,-0.10992493571379391,47,20,27,13,0.3816320027946938,0.4751704080944809
지금/NNG@$금리/NNG@$인상/NNG,0,-0.10992493571379391,47,20,27,25,0.3816320027946938,0.4751704080944809
소폭/NNG@$상향/NNG@$조정/NNG,0,-0.10992493571379391,47,20,27,29,0.3816320027946938,0.4751704080944809
민간/NNG@$소비/NNG@$설비투자/NNG,0,-0.11027485835050732,130,56,74,67,0.562497480662801,0.7008621194285986
강구/NNG@$필요/NNG@$있/VA,0,-0.11079891502302663,24,10,14,32,0.28559992313396515,0.35623002306502527
부동산/NNG@$경기/NNG@$회복/NNG,0,-0.11079891502302663,24,10,14,22,0.28559992313396515,0.35623002306502527
상승/NNG@$지수/NNG@$오른/VV,0,-0.11079891502302663,24,10,14,26,0.28559992313396515,0.35623002306502527
물가/NNG@$전망/NNG@$하향/NNG,0,-0.11079891502302663,24,10,14,22,0.28559992313396515,0.35623002306502527
회복세/NNG@$지속/NNG@$예상/NNG,0,-0.11079891502302663,24,10,14,12,0.28559992313396515,0.35623002306502527
금리/NNG@$인상/NNG@$결정/NNG,0,-0.11093917555479171,428,184,244,238,0.5896625116216534,0.7356973475073556
가능성/NNG@$크/VA@$보/VX,-1,-0.11166375322402966,70,30,40,34,0.4573475174058468,0.5714506193085811
수입/NNG@$물가/NNG@$하락/NNG,-1,-0.11166375322402966,70,30,40,45,0.4573475174058468,0.5714506193085811
주택/NNG@$담보대출/NNG@$증가/NNG,0,-0.11272269701908555,100,43,57,36,0.5238044630301998,0.6558919343043927
물가/NNG@$상승/NNG@$위험/NNG,0,-0.11272269701908555,100,43,57,38,0.5238044630301998,0.6558919343043927
경기/NNG@$둔화/NNG@$가능성/NNG,0,-0.11414114459650149,396,170,226,133,0.5873370657106388,0.7375603134176754
금리/NNG@$상승/NNG@$영향/NNG,0,-0.11424466850916215,31,13,18,14,0.3147440915484354,0.3953290661615006
우려/NNG@$경기/NNG@$회복/NNG,0,-0.11424466850916215,31,13,18,22,0.3147440915484354,0.3953290661615006
유지/NNG@$기준금리/NNG@$인하/NNG,0,-0.11424466850916215,31,13,18,17,0.3147440915484354,0.3953290661615006
환율/NNG@$경상수지/NNG@$흑자/NNG,0,-0.11424466850916215,31,13,18,15,0.3147440915484354,0.3953290661615006
축소/NNG@$기준금리/NNG@$인상/NNG,0,-0.11424466850916215,31,13,18,19,0.3147440915484354,0.3953290661615006
수출/NNG@$높/VA@$신장세/NNG,-1,-0.11434077213257476,54,23,31,15,0.40506784086506026,0.5088777145240401
조정/NNG@$금리/NNG@$인하/NNG,-1,-0.11434077213257476,54,23,31,19,0.40506784086506026,0.5088777145240401
취업/NNG@$기회/NNG@$전망/NNG,-1,-0.11455980240501895,77,33,44,40,0.47453499641948066,0.5964122020382048
금리/NNG@$인상/NNG@$할/VX,-1,-0.11455980240501895,77,33,44,26,0.47453499641948066,0.5964122020382048
경기/NNG@$회복/NNG@$추세/NNG,0,-0.1149708630974593,114,49,65,44,0.542680172655162,0.682627412705633
금리/NNG@$인상/NNG@$우려/NNG,0,-0.11529186210264009,282,121,161,177,0.5864793506614663,0.7382013137532504
양적완화/NNG@$축소/NNG@$우려/NNG,-1,-0.11800887958943818,61,26,35,43,0.42667645175940483,0.5400217144673424
해외/NNG@$위험/NNG@$요인/NNG@$영향/NNG,-1,-0.11800887958943818,61,26,35,24,0.42667645175940483,0.5400217144673424
경제/NNG@$심리/NNG@$나타내/VV@$소비자심리지수/NNG,-1,-0.11800887958943818,61,26,35,20,0.42667645175940483,0.5400217144673424
사상/NNG@$최대/NNG@$기록/NNG,-1,-0.11800887958943818,61,26,35,27,0.42667645175940483,0.5400217144673424
통화정책/NNG@$변화/NNG@$해외/NNG@$위험/NNG@$요인/NNG,0,-0.11828579555751917,38,16,22,22,0.3422990945552919,0.4334729670081095
기업/NNG@$체감/NNG@$경기/NNG,0,-0.11828579555751917,38,16,22,22,0.3422990945552919,0.4334729670081095
증시/NNG@$긍정적/NNG@$영향/NNG,0,-0.11828579555751917,38,16,22,14,0.3422990945552919,0.4334729670081095
사상/NNG@$최저/NNG@$유지/NNG,0,-0.11828579555751917,38,16,22,20,0.3422990945552919,0.4334729670081095
발생/NNG@$가능성/NNG@$낮/VA,0,-0.11828579555751917,38,16,22,13,0.3422990945552919,0.4334729670081095
경제/NNG@$비추/VV@$성장/NNG@$경로/NNG@$불확실성/NNG,0,-0.11828579555751917,38,16,22,27,0.3422990945552919,0.4334729670081095
완화/NNG@$기조/NNG@$지속/NNG,0,-0.11828579555751917,38,16,22,26,0.3422990945552919,0.4334729670081095
시장/NNG@$안정화/NNG@$조치/NNG,0,-0.11828579555751917,38,16,22,30,0.3422990945552919,0.4334729670081095
금리/NNG@$인상/NNG@$있/VA,0,-0.11995040540563595,98,42,56,40,0.5158131326071085,0.6554115066367432
금리/NNG@$올리/VV@$시작/NNG,-1,-0.12098710619897501,68,29,39,40,0.44642226150243136,0.5684345166693735
인하/NNG@$가능성/NNG@$높/VA,0,-0.12158313556794409,229,98,131,74,0.5814590522445747,0.7412739007972715
금리/NNG@$정상화/NNG@$속도/NNG,0,-0.12215275826260152,45,19,26,25,0.3682164077533183,0.4699638992097441
양적완화/NNG@$규모/NNG@$축소/NNG,0,-0.1229437969814462,297,127,170,171,0.5809158455893272,0.7426283727337692
채권/NNG@$시장/NNG@$국채/NNG@$가격/NNG,-1,-0.12515809754264007,82,35,47,22,0.4804205743190143,0.616923873241099
외국인/NNG@$자금/NNG@$이탈/NNG,-1,-0.12515809754264007,82,35,47,73,0.4804205743190143,0.616923873241099
경제/NNG@$성장/NNG@$고용/NNG,-1,-0.12556099239387541,52,22,30,27,0.3923885334106544,0.504291340496143
전망/NNG@$기준금리/NNG@$인하/NNG,-1,-0.12556099239387541,52,22,30,30,0.3923885334106544,0.504291340496143
가계/NNG@$대출/NNG@$증가세/NNG,-1,-0.12556099239387541,52,22,30,25,0.3923885334106544,0.504291340496143
필요성/NNG@$크/VA@$않/VX,-1,-0.12841774440717235,59,25,34,39,0.41473203168600625,0.5361083503706653
경제/NNG@$호조/NNG@$지속/NNG,-1,-0.12841774440717235,59,25,34,9,0.41473203168600625,0.5361083503706653
금리/NNG@$인상/NNG@$대응/NNG,-1,-0.13071548483829054,66,28,38,35,0.43520840290865964,0.5652106452110643
둔화/NNG@$물가/NNG@$상승/NNG,-1,-0.13071548483829054,66,28,38,25,0.43520840290865964,0.5652106452110643
통화정책/NNG@$파급/NNG@$경로/NNG,-1,-0.13071548483829054,66,28,38,32,0.43520840290865964,0.5652106452110643
위험/NNG@$요인/NNG@$영향/NNG,-1,-0.13071548483829054,66,28,38,28,0.43520840290865964,0.5652106452110643
소비자/NNG@$물가/NNG@$근원물가/NNG,0,-0.13130464179901835,29,12,17,16,0.2992134341266152,0.38905800715252625
성장/NNG@$경로/NNG@$하방/NNG@$위험/NNG,0,-0.13130464179901835,29,12,17,17,0.2992134341266152,0.38905800715252625
기준금리/NNG@$인상/NNG@$이뤄질/VV,0,-0.13130464179901835,29,12,17,33,0.2992134341266152,0.38905800715252625
대응/NNG@$방안/NNG@$마련/NNG,0,-0.13130464179901835,29,12,17,14,0.2992134341266152,0.38905800715252625
성장세/NNG@$둔화/NNG@$경제/NNG,0,-0.13130464179901835,29,12,17,10,0.2992134341266152,0.38905800715252625
완화/NNG@$정책/NNG@$지속/NNG,0,-0.13130464179901835,29,12,17,23,0.2992134341266152,0.38905800715252625
금융/NNG@$경제/NNG@$부장/NNG,0,-0.13130464179901835,29,12,17,25,0.2992134341266152,0.38905800715252625
외국인투자/NNG@$자금/NNG@$이탈/NNG,0,-0.13201174283196926,22,9,13,26,0.268705224476716,0.34989185834638087
금리/NNG@$인상/NNG@$의지/NNG,-1,-0.13248603751398869,73,31,42,40,0.4538244459199112,0.5915133339990767
채권/NNG@$시장/NNG@$우호적/NNG,-1,-0.13248603751398869,73,31,42,37,0.4538244459199112,0.5915133339990767
실시/NNG@$금리/NNG@$동결/NNG,0,-0.13293168675183775,36,15,21,21,0.32771693310806815,0.4275325729407306
경제/NNG@$견실/XR@$성장세/NNG,0,-0.13293168675183775,36,15,21,38,0.32771693310806815,0.4275325729407306
상승/NNG@$압력/NNG@$기준금리/NNG,0,-0.13293168675183775,36,15,21,28,0.32771693310806815,0.4275325729407306
과거/NNG@$금융/NNG@$위기/NNG,0,-0.13293168675183775,36,15,21,17,0.32771693310806815,0.4275325729407306
하방/NNG@$리스크/NNG@$우세/NNG,0,-0.13293168675183775,36,15,21,12,0.32771693310806815,0.4275325729407306
둔화/NNG@$우려/NNG@$금리/NNG,-1,-0.1337786127455457,80,34,46,36,0.4706253210877062,0.6150265955158888
금리/NNG@$인하/NNG@$경기/NNG@$부양/NNG,0,-0.1345251984585195,122,52,70,50,0.5385459219568118,0.7048571623567547
효과/NNG@$나타나/VV@$않/VX,-1,-0.1351522883616192,94,40,54,41,0.49910026002250035,0.6540642982509792
문제/NNG@$금리/NNG@$인상/NNG,-1,-0.1351522883616192,94,40,54,40,0.49910026002250035,0.6540642982509792
주택/NNG@$경기/NNG@$부진/NNG,0,-0.13518533764755258,43,18,25,24,0.3544463440111574,0.46452849900505383
동결/NNG@$기준금리/NNG@$인상/NNG,0,-0.13518533764755258,43,18,25,25,0.3544463440111574,0.46452849900505383
금융/NNG@$위기/NNG@$발발/NNG,0,-0.13518533764755258,43,18,25,18,0.3544463440111574,0.46452849900505383
경기/NNG@$부양/NNG@$양적완화/NNG,0,-0.13518533764755258,43,18,25,22,0.3544463440111574,0.46452849900505383
완화/NNG@$필요/NNG@$있/VA,0,-0.13518533764755258,43,18,25,9,0.3544463440111574,0.46452849900505383
금융/NNG@$위기/NNG@$경기/NNG,0,-0.1352719895954575,108,46,62,42,0.5214327530590818,0.6834972436995096
금리/NNG@$인상/NNG@$충격/NNG,0,-0.1353432599039731,101,43,58,63,0.5109776079811018,0.6698897484669953
성장/NNG@$둔화/NNG@$우려/NNG,0,-0.13708300620145464,148,63,85,83,0.555905060678682,0.7313754831899729
전미/NNG@$주택/NNG@$건설업/NNG,0,-0.13741092219979134,50,21,29,40,0.3793860220221861,0.4994719769323467
경기/NNG@$회복세/NNG@$예상/NNG,0,-0.13741092219979134,50,21,29,31,0.3793860220221861,0.4994719769323467
금리/NNG@$인상/NNG@$앞두/VV,0,-0.13741092219979134,50,21,29,51,0.3793860220221861,0.4994719769323467
지속/NNG@$가능/NNG@$성장/NNG,0,-0.13770536758888619,174,74,100,75,0.564539916392542,0.7436779509289418
지수/NNG@$내린/VV@$종합/NNG,-1,-0.1393419627667163,57,24,33,25,0.4024818009797068,0.5319668000230313
유로존/NNG@$소비자/NNG@$물가/NNG,-1,-0.1393419627667163,57,24,33,37,0.4024818009797068,0.5319668000230313
원자재/NNG@$가격/NNG@$급락/NNG,-1,-0.1393419627667163,57,24,33,36,0.4024818009797068,0.5319668000230313
기대/NNG@$심리/NNG@$높/VA,-1,-0.1393419627667163,57,24,33,20,0.4024818009797068,0.5319668000230313
실물경제/NNG@$부정적/NNG@$영향/NNG,-1,-0.1393419627667163,57,24,33,17,0.4024818009797068,0.5319668000230313
물가/NNG@$상승률/NNG@$목표치/NNG,0,-0.14053624602294057,330,140,190,177,0.5680225721628213,0.7525943921926481
대내외/NNG@$경제/NNG@$변화/NNG,0,-0.1405495480995882,15,6,9,2,0.23482909595555493,0.31114230602279835
물가/NNG@$보/VV@$소비자/NNG,0,-0.1405495480995882,15,6,9,2,0.23482909595555493,0.31114230602279835
가격/NNG@$변수/NNG@$변동성/NNG@$확대/NNG,0,-0.1405495480995882,15,6,9,9,0.23482909595555493,0.31114230602279835
모기지/NNG@$금리/NNG@$상승/NNG,0,-0.14104569591026805,120,51,69,45,0.5320729780001907,0.70569595582072
하방/NNG@$위험/NNG@$요인/NNG,0,-0.1418342979247602,113,48,65,31,0.5236028630090107,0.695579471706528
소비/NNG@$투자/NNG@$내수/NNG,0,-0.14244267948196798,172,73,99,70,0.5606493310575829,0.7457184548691366
가능/NNG@$경제/NNG@$성장/NNG,0,-0.14247422430339662,106,45,61,36,0.5139067270393278,0.683590198339828
기준금리/NNG@$올리/VV@$않/VX,-1,-0.1427317270701287,78,33,45,39,0.4605571281720079,0.6129472932180885
잠정/NNG@$주택/NNG@$판매/NNG,-1,-0.1430994455252026,85,36,49,45,0.4763020179855912,0.6343775470004949
압력/NNG@$높/VA@$않/VX,-1,-0.1430994455252026,85,36,49,41,0.4763020179855912,0.6343775470004949
성장률/NNG@$전망치/NNG@$하향/NNG@$조정/NNG,0,-0.14524874784787056,158,67,91,98,0.5544379986429882,0.7416911828187813
경기/NNG@$부양/NNG@$효과/NNG,0,-0.14530600617512168,300,127,173,121,0.5645014424278983,0.7552416713860558
양적완화/NNG@$종료/NNG@$금리/NNG,0,-0.1488953443213603,34,14,20,17,0.31265176231859193,0.42137179002505776
상승/NNG@$공공요금/NNG@$인상/NNG,0,-0.1488953443213603,34,14,20,9,0.31265176231859193,0.42137179002505776
금리/NNG@$인상/NNG@$요구/NNG,0,-0.1488953443213603,34,14,20,19,0.31265176231859193,0.42137179002505776
회복세/NNG@$찬물/NNG@$끼얹/VV,0,-0.1488953443213603,34,14,20,23,0.31265176231859193,0.42137179002505776
경제/NNG@$회복/NNG@$전망/NNG,0,-0.1488953443213603,34,14,20,13,0.31265176231859193,0.42137179002505776
종사자/NNG@$기준금리/NNG@$동결/NNG,0,-0.1488953443213603,34,14,20,32,0.31265176231859193,0.42137179002505776
부동산/NNG@$거품/NNG@$붕괴/NNG,0,-0.1488953443213603,34,14,20,18,0.31265176231859193,0.42137179002505776
금리/NNG@$결정/NNG@$앞두/VV,0,-0.1488953443213603,34,14,20,24,0.31265176231859193,0.42137179002505776
지표/NNG@$좋/VA@$않/VX,0,-0.14914688166147527,41,17,24,17,0.34029023590421464,0.4588569376994957
소비자/NNG@$물가/NNG@$상승률/NNG@$하락/NNG,0,-0.14914688166147527,41,17,24,14,0.34029023590421464,0.4588569376994957
하방/NNG@$위험/NNG@$크/VA,0,-0.14914688166147527,41,17,24,17,0.34029023590421464,0.4588569376994957
금융/NNG@$위기/NNG@$촉발/NNG,0,-0.14914688166147527,41,17,24,13,0.34029023590421464,0.4588569376994957
외국인/NNG@$채권/NNG@$투자/NNG@$자금/NNG,0,-0.14914688166147527,41,17,24,16,0.34029023590421464,0.4588569376994957
주식/NNG@$부동산/NNG@$자산/NNG,0,-0.14914688166147527,41,17,24,18,0.34029023590421464,0.4588569376994957
인상/NNG@$크/VA@$않/VX,0,-0.14914688166147527,41,17,24,14,0.34029023590421464,0.4588569376994957
금리/NNG@$인상/NNG@$늦출/VV,0,-0.14914688166147527,41,17,24,14,0.34029023590421464,0.4588569376994957
전망/NNG@$상향/NNG@$조정/NNG,0,-0.14989639689245204,258,109,149,110,0.5610279151692015,0.7576656156706276
인하/NNG@$유동성/NNG@$공급/NNG,0,-0.14990894474743632,104,44,60,21,0.5061521526683556,0.683573683796985
기준금리/NNG@$낮/VA@$유지/NNG,0,-0.14996694889637485,48,20,28,33,0.3660436303991477,0.4944115336984001
하강/NNG@$국면/NNG@$진입/NNG,0,-0.14996694889637485,48,20,28,13,0.3660436303991477,0.4944115336984001
석유류/NNG@$제품/NNG@$가격/NNG,0,-0.1504555847791379,27,11,16,5,0.282975776000813,0.38259458458780454
외국인/NNG@$채권/NNG@$자금/NNG,0,-0.1504555847791379,27,11,16,19,0.282975776000813,0.38259458458780454
변수/NNG@$변동성/NNG@$확대/NNG,0,-0.1504555847791379,27,11,16,18,0.282975776000813,0.38259458458780454
인플레이션/NNG@$정책/NNG@$목표/NNG,0,-0.1504555847791379,27,11,16,25,0.282975776000813,0.38259458458780454
소매/NNG@$판매/NNG@$설비투자/NNG,0,-0.1504555847791379,27,11,16,9,0.282975776000813,0.38259458458780454
악화/NNG@$금리/NNG@$인하/NNG,-1,-0.15083206971843632,55,23,32,23,0.38991617607541634,0.5275882392255734
전세/NNG@$가격/NNG@$상승/NNG,-1,-0.15083206971843632,55,23,32,26,0.38991617607541634,0.5275882392255734
기업/NNG@$투자/NNG@$활성화/NNG,-1,-0.15083206971843632,55,23,32,17,0.38991617607541634,0.5275882392255734
양적완화/NNG@$축소/NNG@$가능성/NNG,-1,-0.15142780225251207,90,38,52,42,0.48138769397247105,0.6521505844337772
청/NNG@$원유/NNG@$재고/NNG,-1,-0.15192455942349525,69,29,40,63,0.4319797811055802,0.58581104013755
금리/NNG@$인상/NNG@$경기/NNG@$회복/NNG,-1,-0.15192455942349525,69,29,40,37,0.4319797811055802,0.58581104013755
에너지/NNG@$청/NNG@$원유/NNG@$재고/NNG,-1,-0.15192455942349525,69,29,40,63,0.4319797811055802,0.58581104013755
유동성/NNG@$공급/NNG@$조치/NNG,0,-0.15468409334992406,116,49,67,25,0.5185159680291108,0.7071451591911481
경기/NNG@$하향/NNG@$리스크/NNG,0,-0.15720403532770644,20,8,12,7,0.2505041039881394,0.3434017728215747
위축/NNG@$우려/NNG@$있/VA,0,-0.15720403532770644,20,8,12,25,0.2505041039881394,0.3434017728215747
경제정책/NNG@$방향/NNG@$성장률/NNG,0,-0.15720403532770644,20,8,12,30,0.2505041039881394,0.3434017728215747
엔/NNG@$원/NNG@$환율/NNG,-1,-0.16000126538051285,88,37,51,43,0.4721468414082533,0.6509606997949857
최고/NNG@$투자/NNG@$책임자/NNG,0,-0.1607746356221602,214,90,124,112,0.5521518754074586,0.7624740346022649
인하/NNG@$단행/NNG@$금리/NNG,-1,-0.16095739718285307,81,34,47,19,0.4567339923580268,0.6309466661772039
원화/NNG@$가치/NNG@$상승/NNG,0,-0.16184149978576579,195,82,113,109,0.550084239953318,0.7612831758070969
개선/NNG@$추세/NNG@$지속/NNG,-1,-0.16227866714027983,67,28,39,36,0.42062002871217125,0.582634998888949
회복세/NNG@$갈/VX@$전망/NNG,-1,-0.16227866714027983,67,28,39,34,0.42062002871217125,0.582634998888949
문제/NNG@$해결/NNG@$않/VX,-1,-0.16266258229122244,60,25,35,21,0.3997777498672628,0.5542011470079456
정책/NNG@$경기/NNG@$부양/NNG,-1,-0.16266258229122244,60,25,35,26,0.3997777498672628,0.5542011470079456
경기/NNG@$둔화/NNG@$리스크/NNG,-1,-0.16266258229122244,60,25,35,40,0.3997777498672628,0.5542011470079456
흑자/NNG@$기조/NNG@$유지/NNG,-1,-0.16266258229122244,60,25,35,14,0.3997777498672628,0.5542011470079456
구조적/NNG@$문제/NNG@$해결/NNG,-1,-0.16266258229122244,60,25,35,29,0.3997777498672628,0.5542011470079456
경기/NNG@$둔화/NNG@$우려/NNG@$커지/VV,-1,-0.16294849970042535,53,22,31,16,0.37702293441889384,0.5229635675354756
금융정책/NNG@$결정/NNG@$열/VV,-1,-0.16294849970042535,53,22,31,39,0.37702293441889384,0.5229635675354756
파산/NNG@$보호/NNG@$신청/NNG,-1,-0.16294849970042535,53,22,31,7,0.37702293441889384,0.5229635675354756
소비자/NNG@$물가/NNG@$오르/VV,0,-0.16332339651693462,46,19,27,18,0.3523393616238442,0.48910155664486243
기준금리/NNG@$인상/NNG@$영향/NNG,0,-0.16332339651693462,46,19,27,22,0.3523393616238442,0.48910155664486243
인상/NNG@$없/VA@$전망/NNG,0,-0.16332339651693462,46,19,27,20,0.3523393616238442,0.48910155664486243
변동성/NNG@$크/VA@$확대/NNG,0,-0.16332339651693462,46,19,27,28,0.3523393616238442,0.48910155664486243
가격/NNG@$상승/NNG@$소비/NNG,0,-0.16332339651693462,46,19,27,15,0.3523393616238442,0.48910155664486243
성장률/NNG@$마이너스/NNG@$기록/NNG,0,-0.16332339651693462,46,19,27,15,0.3523393616238442,0.48910155664486243
엔화/NNG@$약세/NNG@$수출/NNG,0,-0.16332339651693462,46,19,27,33,0.3523393616238442,0.48910155664486243
중기적/NNG@$소비자/NNG@$물가/NNG@$상승률/NNG,0,-0.16369643905836595,107,45,62,55,0.5013526329070457,0.6964882384235175
금리/NNG@$동결/NNG@$배경/NNG,0,-0.16394663533239717,145,61,84,38,0.535273649808447,0.7439940287826237
물가/NNG@$상승률/NNG@$달성/NNG,0,-0.16419713020855564,39,16,23,38,0.3257053653764182,0.45294125750428565
지표/NNG@$개인/NNG@$소비/NNG@$지출/NNG@$물가지수/NNG,0,-0.16419713020855564,39,16,23,25,0.3257053653764182,0.45294125750428565
가능성/NNG@$낮/VA@$보/VX,0,-0.16419713020855564,39,16,23,29,0.3257053653764182,0.45294125750428565
경상수지/NNG@$적자/NNG@$기록/NNG,0,-0.16419713020855564,39,16,23,15,0.3257053653764182,0.45294125750428565
종합/NNG@$지수/NNG@$내린/VV,0,-0.16419713020855564,39,16,23,21,0.3257053653764182,0.45294125750428565
부동산/NNG@$자산/NNG@$가격/NNG,-1,-0.16551575046478462,100,42,58,22,0.4899415134510329,0.6831835839643519
전망/NNG@$대외/NNG@$경제/NNG,0,-0.16647886156042102,32,13,19,18,0.29701388236432646,0.4149820976411099
주가/NNG@$상승/NNG@$환율/NNG,0,-0.16647886156042102,32,13,19,14,0.29701388236432646,0.4149820976411099
확대/NNG@$경기/NNG@$부양/NNG,0,-0.16647886156042102,32,13,19,17,0.29701388236432646,0.4149820976411099
금융시장/NNG@$불안/NNG@$경제/NNG,0,-0.16647886156042102,32,13,19,18,0.29701388236432646,0.4149820976411099
외국/NNG@$자본/NNG@$유출/NNG,0,-0.16647886156042102,32,13,19,19,0.29701388236432646,0.4149820976411099
경기/NNG@$부양/NNG@$목적/NNG,0,-0.16647886156042102,32,13,19,19,0.29701388236432646,0.4149820976411099
가능성/NNG@$크/VA@$덧붙였/VV,0,-0.16647886156042102,32,13,19,20,0.29701388236432646,0.4149820976411099
경기/NNG@$모멘텀/NNG@$둔화/NNG,0,-0.16647886156042102,32,13,19,19,0.29701388236432646,0.4149820976411099
가능성/NNG@$있/VA@$덧붙였/VV,0,-0.16647886156042102,32,13,19,21,0.29701388236432646,0.4149820976411099
경제/NNG@$전망/NNG@$국내총생산/NNG@$성장률/NNG,0,-0.16647886156042102,32,13,19,23,0.29701388236432646,0.4149820976411099
금리/NNG@$인상/NNG@$가능성/NNG@$크/VA,0,-0.1668827813161633,119,50,69,46,0.5134842539332363,0.7180261548669407
수출/NNG@$증가세/NNG@$둔화/NNG,-1,-0.16725206428915995,93,39,54,38,0.47707603262853415,0.6676216037963806
시장/NNG@$국채/NNG@$가격/NNG,-1,-0.1688852482277352,86,36,50,25,0.4626444325790478,0.6496037500172325
경기/NNG@$둔화/NNG@$수출/NNG,-1,-0.1688852482277352,86,36,50,60,0.4626444325790478,0.6496037500172325
금리/NNG@$인상/NNG@$예고/NNG,0,-0.16917008834105174,112,47,65,79,0.5041172070800426,0.7082509164257852
경제성장률/NNG@$전망/NNG@$하향/NNG@$조정/NNG,-1,-0.17040139753771433,79,33,46,48,0.44654146635454484,0.628952148581698
성장/NNG@$하방/NNG@$리스크/NNG,-1,-0.1714518147620463,105,44,61,42,0.49348629913202396,0.6965781421387379
가능성/NNG@$금리/NNG@$인하/NNG,-1,-0.1714518147620463,105,44,61,38,0.49348629913202396,0.6965781421387379
증후군/NNG@$메르스/NNG@$여파/NNG,0,-0.17236993467272532,25,10,15,25,0.2658194879498525,0.37592613519160184
인하/NNG@$전망/NNG@$유지/NNG,0,-0.17236993467272532,25,10,15,29,0.2658194879498525,0.37592613519160184
호흡기/NNG@$증후군/NNG@$메르스/NNG@$여파/NNG,0,-0.17236993467272532,25,10,15,25,0.2658194879498525,0.37592613519160184
금융시장/NNG@$기준금리/NNG@$인하/NNG,0,-0.17236993467272532,25,10,15,8,0.2658194879498525,0.37592613519160184
금융/NNG@$경제/NNG@$고려/NNG,0,-0.17270870221100154,136,57,79,13,0.5237128621893117,0.7411599229953375
금리/NNG@$인상/NNG@$동결/NNG,-1,-0.17310006639160835,65,27,38,28,0.4089607674731749,0.579229144140883
경기/NNG@$부양/NNG@$노력/NNG,-1,-0.17310006639160835,65,27,38,37,0.4089607674731749,0.579229144140883
부진/NNG@$경기/NNG@$회복/NNG,-1,-0.17310006639160835,65,27,38,22,0.4089607674731749,0.579229144140883
유지/NNG@$가능성/NNG@$크/VA,-1,-0.17437130507413834,58,24,34,30,0.387345712549896,0.550053530421387
금리/NNG@$인상/NNG@$여파/NNG,-1,-0.17576430005050425,51,21,30,28,0.3637864119417032,0.5180833766320224
가능성/NNG@$높/VA@$보/VV,-1,-0.17576430005050425,51,21,30,14,0.3637864119417032,0.5180833766320224
통화/NNG@$완화/NNG@$조치/NNG,-1,-0.17576430005050425,51,21,30,32,0.3637864119417032,0.5180833766320224
상승/NNG@$인플레이션/NNG@$우려/NNG,0,-0.1775982558236321,44,18,26,10,0.33824421481122313,0.4835331329929433
확대/NNG@$경기/NNG@$회복/NNG,0,-0.1775982558236321,44,18,26,10,0.33824421481122313,0.4835331329929433
경제/NNG@$성장/NNG@$완만/XR,0,-0.1775982558236321,44,18,26,14,0.33824421481122313,0.4835331329929433
외국인투자/NNG@$자금/NNG@$유입/NNG,0,-0.1775982558236321,44,18,26,33,0.33824421481122313,0.4835331329929433
증가/NNG@$시장/NNG@$예상치/NNG,0,-0.1775982558236321,44,18,26,23,0.33824421481122313,0.4835331329929433
일본식/NNG@$장기/NNG@$불황/NNG,0,-0.1775982558236321,44,18,26,4,0.33824421481122313,0.4835331329929433
기조/NNG@$금리/NNG@$인상/NNG,0,-0.1775982558236321,44,18,26,16,0.33824421481122313,0.4835331329929433
국내총생산/NNG@$갭/NNG@$마이너스/NNG,0,-0.1775982558236321,44,18,26,18,0.33824421481122313,0.4835331329929433
금리/NNG@$인상/NNG@$신중/NNG,0,-0.1793631693941501,146,61,85,78,0.5247783937680839,0.7529284030078625
인하/NNG@$단행/NNG@$가능성/NNG,-1,-0.17945758294067338,103,43,60,54,0.4853886889955306,0.6965495838983827
경제/NNG@$성장/NNG@$모멘텀/NNG,-1,-0.18021675138841975,77,32,45,39,0.43607093482282105,0.6267585983721276
금리/NNG@$인상/NNG@$서두/NNG,0,-0.18054496516827445,37,15,22,19,0.3106339721754136,0.4467725589865647
부채/NNG@$상환/NNG@$비율/NNG@$규제/NNG@$완화/NNG,0,-0.18054496516827445,37,15,22,27,0.3106339721754136,0.4467725589865647
비율/NNG@$규제/NNG@$완화/NNG,0,-0.18054496516827445,37,15,22,27,0.3106339721754136,0.4467725589865647
환율/NNG@$등가격/NNG@$변수/NNG,0,-0.18054496516827445,37,15,22,10,0.3106339721754136,0.4467725589865647
동결/NNG@$경제/NNG@$동향/NNG,0,-0.18054496516827445,37,15,22,14,0.3106339721754136,0.4467725589865647
비용/NNG@$상승/NNG@$압력/NNG,0,-0.18054496516827445,37,15,22,18,0.3106339721754136,0.4467725589865647
상승/NNG@$종합/NNG@$지수/NNG@$오른/VV,0,-0.18054496516827445,37,15,22,33,0.3106339721754136,0.4467725589865647
기준금리/NNG@$인하/NNG@$가능성/NNG@$높/VA,0,-0.18054496516827445,37,15,22,15,0.3106339721754136,0.4467725589865647
상환/NNG@$비율/NNG@$규제/NNG@$완화/NNG,0,-0.18054496516827445,37,15,22,27,0.3106339721754136,0.4467725589865647
기준금리/NNG@$인하/NNG@$단행/NNG,-1,-0.18217955241670414,96,40,56,50,0.4727696732186738,0.6822660736402558
곡물/NNG@$가격/NNG@$상승/NNG,-1,-0.1823085666861053,70,29,41,12,0.41746932902092415,0.6026213798011087
금리/NNG@$인상/NNG@$사이클/NNG,0,-0.1823955553632941,192,80,112,96,0.5345796124173391,0.7718100555125486
생각/NNG@$금리/NNG@$인상/NNG,-1,-0.1844282898787516,63,26,37,28,0.3969947653446805,0.575583169099839
인하/NNG@$가능성/NNG@$제기/NNG,-1,-0.1844282898787516,63,26,37,24,0.3969947653446805,0.575583169099839
인하/NNG@$나설/VV@$가능성/NNG,-1,-0.1844282898787516,63,26,37,29,0.3969947653446805,0.575583169099839
자본/NNG@$유출/NNG@$우려/NNG,0,-0.1854436517246486,214,89,125,118,0.5338170288437543,0.7755824728099054
유지/NNG@$금리/NNG@$인상/NNG,0,-0.18602253314278228,243,101,142,119,0.5340487800336753,0.776849242437772
부진/NNG@$경제/NNG@$성장/NNG,0,-0.186102316774994,30,12,18,22,0.2806776809975248,0.4083526814629515
기조/NNG@$유지/NNG@$가능성/NNG,0,-0.186102316774994,30,12,18,18,0.2806776809975248,0.4083526814629515
부채/NNG@$상환/NNG@$부담/NNG,0,-0.186102316774994,30,12,18,24,0.2806776809975248,0.4083526814629515
경제/NNG@$금리/NNG@$동결/NNG,0,-0.186102316774994,30,12,18,23,0.2806776809975248,0.4083526814629515
생산/NNG@$소비/NNG@$투자/NNG,-1,-0.1866986082915325,56,23,33,33,0.37458543818200846,0.5456503819475332
경상수지/NNG@$적자/NNG@$확대/NNG,-1,-0.1866986082915325,56,23,33,28,0.37458543818200846,0.5456503819475332
경제/NNG@$성장률/NNG@$기록/NNG,-1,-0.1866986082915325,56,23,33,21,0.37458543818200846,0.5456503819475332
금리/NNG@$인상/NNG@$적절/XR,-1,-0.18772460607457175,101,42,59,86,0.47705600260048353,0.6963948569612809
흑자/NNG@$기조/NNG@$지속/NNG,0,-0.18834077453793263,18,7,11,22,0.23037820130262254,0.3367300169244763
방안/NNG@$검토/NNG@$필요/NNG@$있/VA,0,-0.18834077453793263,18,7,11,15,0.23037820130262254,0.3367300169244763
경제/NNG@$동향/NNG@$경기/NNG,-1,-0.1891180699389312,113,47,66,42,0.4918821082769,0.720113347028323
조치/NNG@$내놓/VV@$않/VX,-1,-0.1893687357582159,49,20,29,13,0.35018647965512006,0.5129379070170687
소수/NNG@$의견/NNG@$등장/NNG,-1,-0.1893687357582159,49,20,29,19,0.35018647965512006,0.5129379070170687
매입/NNG@$규모/NNG@$늘리/VV,-1,-0.1893687357582159,49,20,29,14,0.35018647965512006,0.5129379070170687
통화정책/NNG@$가늠/NNG@$볼/VX,-1,-0.1893687357582159,49,20,29,11,0.35018647965512006,0.5129379070170687
금리/NNG@$인상/NNG@$마무리/NNG,-1,-0.1893687357582159,49,20,29,13,0.35018647965512006,0.5129379070170687
경기/NNG@$회복세/NNG@$미약/XR,-1,-0.19042762129380997,75,31,44,45,0.42531779450559626,0.6243558147962985
기업/NNG@$채산성/NNG@$악화/NNG,-1,-0.19042762129380997,75,31,44,25,0.42531779450559626,0.6243558147962985
유로존/NNG@$경기/NNG@$회복/NNG,0,-0.1929411230761583,42,17,25,28,0.3237199739518203,0.4776967646533057
위기/NNG@$금리/NNG@$인하/NNG,0,-0.1929411230761583,42,17,25,14,0.3237199739518203,0.4776967646533057
경기/NNG@$부양/NNG@$기준금리/NNG@$인하/NNG,0,-0.1929411230761583,42,17,25,44,0.3237199739518203,0.4776967646533057
인상/NNG@$통화/NNG@$긴축/NNG,0,-0.1929411230761583,42,17,25,19,0.3237199739518203,0.4776967646533057
단행/NNG@$가능성/NNG@$높/VA,-1,-0.19421743753230225,87,36,51,25,0.4490068018298326,0.6643337417154712
경기/NNG@$회복/NNG@$기대감/NNG,0,-0.19599238888541182,307,127,180,132,0.5267793445797216,0.7822817799784163
금리/NNG@$인하/NNG@$가능성/NNG@$낮/VA,-1,-0.19630947774109953,61,25,36,33,0.38471336253697697,0.571686449616764
물가/NNG@$잡/VV@$금리/NNG,-1,-0.19630947774109953,61,25,36,9,0.38471336253697697,0.571686449616764
가계부채/NNG@$문제/NNG@$악화/NNG,0,-0.1980746528059577,23,9,14,19,0.24742963373320703,0.3690336400700031
금리/NNG@$하락/NNG@$압력/NNG,0,-0.19846838232213826,35,14,21,22,0.29499790030094536,0.4403406605250878
금융시장/NNG@$불안/NNG@$실물경제/NNG,0,-0.19846838232213826,35,14,21,13,0.29499790030094536,0.4403406605250878
중기적/NNG@$물가/NNG@$상승률/NNG@$목표/NNG,0,-0.19846838232213826,35,14,21,27,0.29499790030094536,0.4403406605250878
인상/NNG@$출구전략/NNG@$시행/NNG,0,-0.19846838232213826,35,14,21,14,0.29499790030094536,0.4403406605250878
주택담보대출비율/NNG@$부채/NNG@$상환/NNG,0,-0.19846838232213826,35,14,21,31,0.29499790030094536,0.4403406605250878
상승/NNG@$압력/NNG@$증대/NNG,0,-0.19846838232213826,35,14,21,10,0.29499790030094536,0.4403406605250878
장기/NNG@$국채/NNG@$금리/NNG,-1,-0.19971346211343943,54,22,32,35,0.36148260571538626,0.5409812528599487
금리/NNG@$인상/NNG@$행진/NNG@$중단/NNG,-1,-0.19971346211343943,54,22,32,18,0.36148260571538626,0.5409812528599487
외국인/NNG@$증권/NNG@$투자/NNG@$자금/NNG@$유입/NNG,-1,-0.19971346211343943,54,22,32,18,0.36148260571538626,0.5409812528599487
금리/NNG@$상승/NNG@$주택/NNG,-1,-0.19971346211343943,54,22,32,14,0.36148260571538626,0.5409812528599487
동결/NNG@$기조/NNG@$유지/NNG,0,-0.20098382664066838,145,60,85,68,0.5087752574984774,0.7634299314648852
금리/NNG@$인하/NNG@$시장/NNG,0,-0.20098382664066838,145,60,85,59,0.5087752574984774,0.7634299314648852
수출/NNG@$감소세/NNG@$지속/NNG,-1,-0.2010612635463983,73,30,43,66,0.4142770295955619,0.6217332235503646
영향/NNG@$주지/NNG@$않/VX,-1,-0.2010612635463983,73,30,43,37,0.4142770295955619,0.6217332235503646
위험/NNG@$크/VA@$않/VX,-1,-0.2038721234956169,47,19,28,11,0.3361972373300224,0.507516989616745
금리/NNG@$인하/NNG@$명분/NNG,-1,-0.2038721234956169,47,19,28,20,0.3361972373300224,0.507516989616745
인하/NNG@$통화/NNG@$완화/NNG@$정책/NNG,-1,-0.2038721234956169,47,19,28,21,0.3361972373300224,0.507516989616745
가격/NNG@$경쟁력/NNG@$약화/NNG,-1,-0.2038721234956169,47,19,28,44,0.3361972373300224,0.507516989616745
필요/NNG@$있/VA@$생각/NNG,-1,-0.2038721234956169,47,19,28,16,0.3361972373300224,0.507516989616745
시장/NNG@$불안/NNG@$요인/NNG,-1,-0.2038721234956169,47,19,28,15,0.3361972373300224,0.507516989616745
금리/NNG@$인상/NNG@$달러화/NNG@$강세/NNG,-1,-0.2038721234956169,47,19,28,17,0.3361972373300224,0.507516989616745
증권/NNG@$기준금리/NNG@$인상/NNG,-1,-0.2038721234956169,47,19,28,19,0.3361972373300224,0.507516989616745
인하/NNG@$여부/NNG@$결정/NNG,-1,-0.2038721234956169,47,19,28,12,0.3361972373300224,0.507516989616745
가능성/NNG@$낮/VA@$전망/NNG,-1,-0.2038721234956169,47,19,28,13,0.3361972373300224,0.507516989616745
금리/NNG@$인하/NNG@$할/VV,-1,-0.20474935701771035,66,27,39,34,0.3941638805250715,0.596111630012321
기미/NNG@$보이/VV@$않/VX,0,-0.2050931102768936,194,80,114,80,0.5178917716162758,0.7837925413479415
경기/NNG@$전망/NNG@$지수/NNG,-1,-0.2078916276500653,78,32,46,71,0.42193845671885716,0.6423143336771676
경기/NNG@$개선/NNG@$기대/NNG,0,-0.20836466736730774,28,11,17,32,0.2634662580424273,0.40146948456875553
내수/NNG@$회복/NNG@$지연/NNG,0,-0.20836466736730774,28,11,17,20,0.2634662580424273,0.40146948456875553
전망/NNG@$경제성장률/NNG@$전망치/NNG,0,-0.20836466736730774,28,11,17,27,0.2634662580424273,0.40146948456875553
불안/NNG@$심리/NNG@$완화/NNG,0,-0.20836466736730774,28,11,17,10,0.2634662580424273,0.40146948456875553
인플레이션/NNG@$압력/NNG@$증대/NNG,0,-0.20836466736730774,28,11,17,14,0.2634662580424273,0.40146948456875553
불안/NNG@$심리/NNG@$진정/NNG,0,-0.20836466736730774,28,11,17,9,0.2634662580424273,0.40146948456875553
실제/NNG@$소비자/NNG@$물가/NNG,0,-0.20836466736730774,28,11,17,21,0.2634662580424273,0.40146948456875553
경제/NNG@$지속/NNG@$가능/NNG,-1,-0.208797930684551,59,24,35,22,0.3721060686755614,0.5675280414150938
금리/NNG@$인상/NNG@$아니/VCN,-1,-0.20938314752050602,90,37,53,58,0.4451430589643079,0.6797530648512874
인상/NNG@$경기/NNG@$둔화/NNG,-1,-0.20938314752050602,90,37,53,78,0.4451430589643079,0.6797530648512874
경기/NNG@$하강/NNG@$가능성/NNG,0,-0.2095443403713243,40,16,24,7,0.30871629514556365,0.4715822002224031
가능/NNG@$속도/NNG@$금리/NNG@$인상/NNG,0,-0.2095443403713243,40,16,24,13,0.30871629514556365,0.4715822002224031
유로존/NNG@$국채/NNG@$금리/NNG,0,-0.2095443403713243,40,16,24,20,0.30871629514556365,0.4715822002224031
금리/NNG@$주가/NNG@$환율/NNG,0,-0.2095443403713243,40,16,24,5,0.30871629514556365,0.4715822002224031
채권/NNG@$시장/NNG@$기준금리/NNG@$인상/NNG,0,-0.2095443403713243,40,16,24,15,0.30871629514556365,0.4715822002224031
목표/NNG@$하향/NNG@$조정/NNG,0,-0.2095443403713243,40,16,24,20,0.30871629514556365,0.4715822002224031
고려/NNG@$기준금리/NNG@$인하/NNG,0,-0.2095443403713243,40,16,24,28,0.30871629514556365,0.4715822002224031
소비자/NNG@$물가/NNG@$상승률/NNG@$목표치/NNG,0,-0.2095443403713243,40,16,24,25,0.30871629514556365,0.4715822002224031
예측/NNG@$가능/NNG@$속도/NNG@$금리/NNG@$인상/NNG,0,-0.2095443403713243,40,16,24,13,0.30871629514556365,0.4715822002224031
테이퍼링/NNG@$양적완화/NNG@$축소/NNG,-1,-0.21214862298621096,71,29,42,61,0.40294307703742577,0.618879877493569
인상/NNG@$여부/NNG@$결정/NNG,-1,-0.21224573903391541,136,56,80,64,0.4957340784211274,0.7615521994854737
유로존/NNG@$국채/NNG@$매입/NNG,-1,-0.21349927178511896,52,21,31,20,0.3480192356431306,0.5360353563346588
통화정책/NNG@$방향/NNG@$논의/NNG@$기준금리/NNG,-1,-0.21349927178511896,52,21,31,8,0.3480192356431306,0.5360353563346588
민간/NNG@$소비/NNG@$위축/NNG,-1,-0.21349927178511896,52,21,31,27,0.3480192356431306,0.5360353563346588
재정/NNG@$건전성/NNG@$악화/NNG,-1,-0.21349927178511896,52,21,31,40,0.3480192356431306,0.5360353563346588
방향/NNG@$논의/NNG@$기준금리/NNG,-1,-0.21349927178511896,52,21,31,8,0.3480192356431306,0.5360353563346588
공개/NNG@$시장/NNG@$기준금리/NNG,-1,-0.21676156796233537,64,26,38,21,0.3820473517427524,0.5924822487209012
경기/NNG@$회복/NNG@$불확실성/NNG,-1,-0.21676156796233537,64,26,38,15,0.3820473517427524,0.5924822487209012
채권/NNG@$투자/NNG@$과세/NNG,0,-0.2183443237315853,33,13,20,17,0.27869122184605527,0.4336336431117115
회복/NNG@$조짐/NNG@$나타나/VV,0,-0.2183443237315853,33,13,20,15,0.27869122184605527,0.4336336431117115
주택/NNG@$담보대출/NNG@$급증/NNG,0,-0.2183443237315853,33,13,20,20,0.27869122184605527,0.4336336431117115
회복/NNG@$이어지/VV@$중기적/NNG@$물가/NNG@$상승률/NNG,0,-0.2183443237315853,33,13,20,26,0.27869122184605527,0.4336336431117115
기금/NNG@$금리선물/NNG@$시장/NNG@$금리/NNG@$인상/NNG,0,-0.2183443237315853,33,13,20,31,0.27869122184605527,0.4336336431117115
우려/NNG@$가시/VV@$않/VX,0,-0.2183443237315853,33,13,20,20,0.27869122184605527,0.4336336431117115
금융시장/NNG@$혼란/NNG@$경제/NNG,0,-0.2183443237315853,33,13,20,27,0.27869122184605527,0.4336336431117115
수출/NNG@$타격/NNG@$입/VV,0,-0.2183443237315853,33,13,20,21,0.27869122184605527,0.4336336431117115
예정/NNG@$기준금리/NNG@$인상/NNG,0,-0.2183443237315853,33,13,20,22,0.27869122184605527,0.4336336431117115
금융/NNG@$외환시장/NNG@$변동성/NNG,0,-0.2183443237315853,33,13,20,28,0.27869122184605527,0.4336336431117115
대외/NNG@$경제정책/NNG@$경제/NNG,0,-0.2183443237315853,33,13,20,22,0.27869122184605527,0.4336336431117115
구조/NNG@$개혁/NNG@$노력/NNG,0,-0.2183443237315853,33,13,20,22,0.27869122184605527,0.4336336431117115
중기/NNG@$물가/NNG@$목표/NNG,0,-0.21835062361753121,205,84,121,80,0.5087681426074453,0.7916356228893777
수출/NNG@$증가율/NNG@$둔화/NNG,-1,-0.21862080438759035,76,31,45,29,0.41106612785271657,0.6399754128834853
유지/NNG@$금리/NNG@$인하/NNG,-1,-0.21862080438759035,76,31,45,33,0.41106612785271657,0.6399754128834853
원화/NNG@$가치/NNG@$하락/NNG,-1,-0.21910075244601823,88,36,52,52,0.4354207026843739,0.6785753127866941
경제성장률/NNG@$전망치/NNG@$하향/NNG@$조정/NNG,-1,-0.2193731857738287,134,55,79,87,0.4894097472060141,0.7631500048360901
부양/NNG@$기준금리/NNG@$인하/NNG,-1,-0.21941237711520045,45,18,27,46,0.3217853462378264,0.5018099680524011
인상/NNG@$경제/NNG@$영향/NNG,-1,-0.21941237711520045,45,18,27,25,0.3217853462378264,0.5018099680524011
대외/NNG@$의존도/NNG@$높/VA@$경제/NNG,-1,-0.21941237711520045,45,18,27,19,0.3217853462378264,0.5018099680524011
통화/NNG@$완화/NNG@$기조/NNG@$유지/NNG,-1,-0.21941237711520045,45,18,27,12,0.3217853462378264,0.5018099680524011
통화/NNG@$가치/NNG@$절상/NNG,-1,-0.21941237711520045,45,18,27,17,0.3217853462378264,0.5018099680524011
정책/NNG@$여력/NNG@$확보/NNG,-1,-0.22195809266335553,57,23,34,29,0.3591600677970789,0.5630966759103395
금리/NNG@$경기/NNG@$회복/NNG,-1,-0.22195809266335553,57,23,34,18,0.3591600677970789,0.5630966759103395
사상/NNG@$최대치/NNG@$기록/NNG,-1,-0.22195809266335553,57,23,34,33,0.3591600677970789,0.5630966759103395
인상/NNG@$행진/NNG@$중단/NNG,-1,-0.22195809266335553,57,23,34,20,0.3591600677970789,0.5630966759103395
경제/NNG@$침체/NNG@$빠질/VV,-1,-0.22195809266335553,57,23,34,19,0.3591600677970789,0.5630966759103395
경기/NNG@$하강/NNG@$리스크/NNG,0,-0.22390394952769221,176,72,104,31,0.5016044450942077,0.7896468814988774
금리/NNG@$인상/NNG@$부정적/NNG,-1,-0.22426595021744122,81,33,48,51,0.41855475221354715,0.6594084711352536
부양/NNG@$금리/NNG@$인하/NNG,-1,-0.22473916847072328,127,52,75,49,0.4806774789354272,0.7580335037936451
경제성장률/NNG@$하향/NNG@$조정/NNG,-1,-0.22529693581422117,110,45,65,53,0.4640437450407234,0.732661393746536
경기/NNG@$부양/NNG@$금리/NNG@$인하/NNG,-1,-0.22529693581422117,110,45,65,44,0.4640437450407234,0.732661393746536
상승/NNG@$가능성/NNG@$크/VA,0,-0.22765883318699487,38,15,23,22,0.2931668686455245,0.4651782140665871
경기/NNG@$부양/NNG@$대책/NNG,0,-0.22765883318699487,38,15,23,18,0.2931668686455245,0.4651782140665871
금융/NNG@$경제/NNG@$검토/NNG@$기준금리/NNG@$유지/NNG,0,-0.22765883318699487,38,15,23,19,0.2931668686455245,0.4651782140665871
딜러/NNG@$금리/NNG@$인하/NNG,0,-0.22765883318699487,38,15,23,17,0.2931668686455245,0.4651782140665871
은행/NNG@$금리/NNG@$인상/NNG@$단행/NNG,0,-0.22765883318699487,38,15,23,16,0.2931668686455245,0.4651782140665871
과거/NNG@$외환/NNG@$위기/NNG,0,-0.22765883318699487,38,15,23,18,0.2931668686455245,0.4651782140665871
경기/NNG@$둔화/NNG@$인플레/NNG,-1,-0.22815788915840884,50,20,30,24,0.33417269875375516,0.5308015372101156
금리/NNG@$인상/NNG@$추세/NNG,-1,-0.22815788915840884,50,20,30,20,0.33417269875375516,0.5308015372101156
가계/NNG@$저축/NNG@$전망/NNG,-1,-0.22815788915840884,50,20,30,27,0.33417269875375516,0.5308015372101156
불안/NNG@$심리/NNG@$확산/NNG,-1,-0.22815788915840884,50,20,30,15,0.33417269875375516,0.5308015372101156
성장률/NNG@$전망치/NNG@$상향/NNG@$조정/NNG,-1,-0.2291729543270159,86,35,51,50,0.4254352225808939,0.6772109254967369
상환/NNG@$부담/NNG@$증가/NNG,0,-0.2292011082522959,21,8,13,40,0.22733097420721046,0.3618886044305645
인상/NNG@$성장/NNG@$둔화/NNG,0,-0.2292011082522959,21,8,13,30,0.22733097420721046,0.3618886044305645
유지/NNG@$물가/NNG@$상승/NNG,0,-0.2292011082522959,21,8,13,27,0.22733097420721046,0.3618886044305645
완화적/NNG@$정책/NNG@$기조/NNG@$유지/NNG,0,-0.2292011082522959,21,8,13,10,0.22733097420721046,0.3618886044305645
완화적/NNG@$통화정책/NNG@$지속/NNG,0,-0.2292011082522959,21,8,13,18,0.22733097420721046,0.3618886044305645
금리/NNG@$인상/NNG@$계획/NNG,-1,-0.22979466591700526,74,30,44,61,0.3999057051116172,0.6374080191587752
둔화/NNG@$우려/NNG@$커지/VV,-1,-0.22979466591700526,74,30,44,22,0.3999057051116172,0.6374080191587752
심리/NNG@$나타내/VV@$소비자심리지수/NNG,-1,-0.22979466591700526,74,30,44,25,0.3999057051116172,0.6374080191587752
경제/NNG@$위기/NNG@$극복/NNG,-1,-0.23043447095183722,120,49,71,34,0.47084927456306874,0.7514982763320057
추진/NNG@$필요/NNG@$있/VA,0,-0.2341432438977995,26,10,16,22,0.24512894159980533,0.3943138939358602
기준금리/NNG@$인상/NNG@$인하/NNG,0,-0.2341432438977995,26,10,16,24,0.24512894159980533,0.3943138939358602
감소세/NNG@$지속/NNG@$소비/NNG,0,-0.2341432438977995,26,10,16,25,0.24512894159980533,0.3943138939358602
물가/NNG@$안정세/NNG@$지속/NNG,0,-0.2341432438977995,26,10,16,7,0.24512894159980533,0.3943138939358602
경제/NNG@$구조/NNG@$개혁/NNG,0,-0.2341432438977995,26,10,16,19,0.24512894159980533,0.3943138939358602
지수/NNG@$상승/NNG@$기록/NNG,-1,-0.2358312674258991,67,27,40,24,0.37936960550839127,0.6124352865511501
인상/NNG@$달러화/NNG@$강세/NNG,-1,-0.23586709640091863,55,22,33,24,0.34585961283068406,0.5583807538701958
증권/NNG@$투자/NNG@$자금/NNG@$유입/NNG,-1,-0.23586709640091863,55,22,33,20,0.34585961283068406,0.5583807538701958
시장/NNG@$경기/NNG@$회복/NNG,-1,-0.23586709640091863,55,22,33,20,0.34585961283068406,0.5583807538701958
기준금리/NNG@$동결/NNG@$가능성/NNG@$높/VA,0,-0.23616395692367098,43,17,26,19,0.3069079061960445,0.49580559644938615
상승률/NNG@$목표/NNG@$달성/NNG,0,-0.23616395692367098,43,17,26,18,0.3069079061960445,0.49580559644938615
전망/NNG@$국내총생산/NNG@$성장률/NNG,0,-0.23616395692367098,43,17,26,30,0.3069079061960445,0.49580559644938615
채권/NNG@$가격/NNG@$상승/NNG,0,-0.23616395692367098,43,17,26,11,0.3069079061960445,0.49580559644938615
물가/NNG@$상승률/NNG@$목표/NNG@$달성/NNG,0,-0.23616395692367098,43,17,26,18,0.3069079061960445,0.49580559644938615
둔화/NNG@$모습/NNG@$보이/VV,0,-0.23616395692367098,43,17,26,16,0.3069079061960445,0.49580559644938615
시장/NNG@$금리/NNG@$급등/NNG,-1,-0.23708224563334224,96,39,57,40,0.43749056203991415,0.7081349431681673
금융/NNG@$위기/NNG@$여파/NNG,-1,-0.23962037112357826,84,34,50,33,0.4151826719776457,0.675649314840862
경제/NNG@$체질/NNG@$개선/NNG,-1,-0.23962037112357826,84,34,50,78,0.4151826719776457,0.675649314840862
주택/NNG@$담보대출/NNG@$금리/NNG,-1,-0.24043926626854162,123,50,73,52,0.4665256277130294,0.7605216031861751
상승세/NNG@$보일/VV@$전망/NNG,0,-0.24069402952345642,31,12,19,20,0.26157010174562934,0.42663724470992415
경제/NNG@$내수/NNG@$회복세/NNG,0,-0.24069402952345642,31,12,19,23,0.26157010174562934,0.42663724470992415
금리/NNG@$올릴/VV@$있/VA,0,-0.24069402952345642,31,12,19,21,0.26157010174562934,0.42663724470992415
긍정적/NNG@$영향/NNG@$기대/NNG,0,-0.24069402952345642,31,12,19,26,0.26157010174562934,0.42663724470992415
경로/NNG@$하방/NNG@$위험/NNG,0,-0.24069402952345642,31,12,19,23,0.26157010174562934,0.42663724470992415
통화/NNG@$긴축/NNG@$기조/NNG,-1,-0.2414463332382789,72,29,43,26,0.3884514863994163,0.6346005412549175
필요/NNG@$있/VA@$진단/NNG,-1,-0.2414463332382789,72,29,43,42,0.3884514863994163,0.6346005412549175
경제/NNG@$금융/NNG@$위기/NNG,-1,-0.2420584154181714,175,71,104,75,0.48795601434155295,0.7981937866796361
금융/NNG@$위기/NNG@$극복/NNG,-1,-0.24248178304222234,180,73,107,89,0.48841144481218873,0.7996569656185405
시작/NNG@$금리/NNG@$인하/NNG,-1,-0.24262509329365345,60,24,36,12,0.3568391989738144,0.5844166210903966
금리/NNG@$인상/NNG@$무게/NNG,-1,-0.24262509329365345,60,24,36,23,0.3568391989738144,0.5844166210903966
콜론/NNG@$금리/NNG@$동결/NNG,-1,-0.24381492743655686,48,19,29,16,0.3199144866957854,0.5252682314022148
인플레이션/NNG@$압력/NNG@$커지/VV,-1,-0.24381492743655686,48,19,29,32,0.3199144866957854,0.5252682314022148
무담보/NNG@$콜론/NNG@$금리/NNG@$동결/NNG,-1,-0.24381492743655686,48,19,29,15,0.3199144866957854,0.5252682314022148
물가/NNG@$상승/NNG@$압력/NNG@$낮/VA,-1,-0.24381492743655686,48,19,29,20,0.3199144866957854,0.5252682314022148
관심/NNG@$금리/NNG@$인상/NNG,-1,-0.24381492743655686,48,19,29,24,0.3199144866957854,0.5252682314022148
수출/NNG@$경기/NNG@$회복/NNG,-1,-0.24381492743655686,48,19,29,37,0.3199144866957854,0.5252682314022148
의심/NNG@$여지/NNG@$없/VA,-1,-0.24381492743655686,48,19,29,22,0.3199144866957854,0.5252682314022148
하향/NNG@$조정/NNG@$경기/NNG,-1,-0.24381492743655686,48,19,29,31,0.3199144866957854,0.5252682314022148
인하/NNG@$시장/NNG@$기대/NNG,-1,-0.24381492743655686,48,19,29,10,0.3199144866957854,0.5252682314022148
공급/NNG@$과잉/NNG@$우려/NNG,-1,-0.24381492743655686,48,19,29,61,0.3199144866957854,0.5252682314022148
전망/NNG@$하향/NNG@$조정/NNG,-1,-0.24462180832560187,492,199,293,254,0.49018144441838696,0.8062106994506185
시중/NNG@$유동성/NNG@$공급/NNG,-1,-0.24515476077185583,111,45,66,29,0.45178416962765316,0.7439000608747205
금리/NNG@$인상/NNG@$리스크/NNG,0,-0.24761691327124813,36,14,22,30,0.27698438630561434,0.45847231829113755
금리/NNG@$인하/NNG@$이뤄질/VV,0,-0.24761691327124813,36,14,22,18,0.27698438630561434,0.45847231829113755
경제/NNG@$전망/NNG@$영향/NNG,0,-0.24761691327124813,36,14,22,35,0.27698438630561434,0.45847231829113755
금리/NNG@$인상/NNG@$부동산시장/NNG,0,-0.24761691327124813,36,14,22,16,0.27698438630561434,0.45847231829113755
부정적/NNG@$영향/NNG@$우려/NNG,-1,-0.24863056009827622,121,49,72,77,0.45915404698604334,0.7616463885643708
지속/NNG@$물가/NNG@$기조/NNG@$유지/NNG,-1,-0.250465893072111,82,33,49,14,0.40465896555585157,0.6738794662865177
금리/NNG@$인상/NNG@$조건/NNG,-1,-0.2506180497425218,53,21,32,23,0.33218528946983894,0.5533683360146406
경제/NNG@$물가/NNG@$상승/NNG,-1,-0.2506180497425218,53,21,32,23,0.33218528946983894,0.5533683360146406
실시/NNG@$금리/NNG@$인상/NNG,-1,-0.2506180497425218,53,21,32,26,0.33218528946983894,0.5533683360146406
산업/NNG@$생산/NNG@$증가율/NNG,-1,-0.25098625979415023,131,53,78,56,0.46507259437294485,0.7753460150075834
주택/NNG@$가격/NNG@$하락/NNG,-1,-0.2520172864439214,325,131,194,154,0.48459719484020336,0.8096748033427416
지수/NNG@$오른/VV@$기록/NNG,-1,-0.25361363820012106,70,28,42,49,0.37669708210523567,0.6315409822767295
부동산/NNG@$규제/NNG@$완화/NNG,-1,-0.2540994904717062,109,44,65,46,0.4435288840431326,0.7443578057804904
고려/NNG@$금리/NNG@$동결/NNG,0,-0.25435022028553556,41,16,25,19,0.29150976991609195,0.48949190672744713
회복/NNG@$물가/NNG@$상승/NNG@$압력/NNG,0,-0.25435022028553556,41,16,25,17,0.29150976991609195,0.48949190672744713
물가/NNG@$기준금리/NNG@$인상/NNG,0,-0.25435022028553556,41,16,25,24,0.29150976991609195,0.48949190672744713
저금리/NNG@$정책/NNG@$기조/NNG,0,-0.25435022028553556,41,16,25,14,0.29150976991609195,0.48949190672744713
경제/NNG@$경기/NNG@$부양/NNG,0,-0.25435022028553556,41,16,25,21,0.29150976991609195,0.48949190672744713
지속/NNG@$소비자/NNG@$물가/NNG,0,-0.25435022028553556,41,16,25,16,0.29150976991609195,0.48949190672744713
기준금리/NNG@$유지/NNG@$결정/NNG,-1,-0.2545045416666626,191,77,114,78,0.4806701005467401,0.8073886945602342
경제/NNG@$위험/NNG@$요인/NNG,-1,-0.25456602077018686,196,79,117,80,0.4810257392841821,0.80809218218565
담보/NNG@$증권/NNG@$매입/NNG,-1,-0.25573481288742383,114,46,68,34,0.4477589630846405,0.7540871186505884
금리/NNG@$인하/NNG@$나서/VV,-1,-0.25573481288742383,114,46,68,49,0.4477589630846405,0.7540871186505884
금리/NNG@$동결/NNG@$전망/NNG,-1,-0.2559843582890894,251,101,150,104,0.4814839321173729,0.8113172339191066
반대/NNG@$움직이/VV@$수익률/NNG,-1,-0.25702622125521846,92,37,55,25,0.41843124669276427,0.7066438424688817
가격/NNG@$반대/NNG@$움직이/VV@$수익률/NNG,-1,-0.25702622125521846,92,37,55,25,0.41843124669276427,0.7066438424688817
기준금리/NNG@$인상/NNG@$단행/NNG,-1,-0.26060764772199796,154,62,92,101,0.46920326521170375,0.7984868420420447
국제금융시장/NNG@$불안/NNG@$경기/NNG,-1,-0.26062685155235776,46,18,28,7,0.30520869916407267,0.5194234123544162
위기/NNG@$발생/NNG@$가능성/NNG,-1,-0.26062685155235776,46,18,28,31,0.30520869916407267,0.5194234123544162
결정/NNG@$금리/NNG@$동결/NNG,-1,-0.26062685155235776,46,18,28,24,0.30520869916407267,0.5194234123544162
채권/NNG@$시장/NNG@$금리/NNG@$인하/NNG,-1,-0.26162547832804195,102,41,61,44,0.4300079399609633,0.7333830575253716
위험/NNG@$요인/NNG@$상존/NNG,-1,-0.26162547832804195,102,41,61,54,0.4300079399609633,0.7333830575253716
성장/NNG@$지속/NNG@$물가/NNG@$기조/NNG@$유지/NNG,-1,-0.2617350565115957,80,32,48,14,0.39385982510929585,0.671889938359866
기준금리/NNG@$인상/NNG@$통화정책/NNG,-1,-0.2618292380425946,63,25,38,23,0.3545348347397077,0.6049271657850882
완화/NNG@$기조/NNG@$유지/NNG,-1,-0.26457474967454353,227,91,136,126,0.4747320051540317,0.8148016691964265
금리/NNG@$인상/NNG@$기업/NNG,0,-0.2662530933104066,29,11,18,20,0.2434390907698972,0.4193340598219435
경기/NNG@$부진/NNG@$심화/NNG,0,-0.2662530933104066,29,11,18,13,0.2434390907698972,0.4193340598219435
기준금리/NNG@$결정/NNG@$금융/NNG,0,-0.2662530933104066,29,11,18,25,0.2434390907698972,0.4193340598219435
소비자/NNG@$물가/NNG@$상승률/NNG@$목표/NNG,-1,-0.2663243004829665,51,20,31,27,0.31811312946481773,0.5480471295278233
부진/NNG@$경기/NNG@$둔화/NNG,-1,-0.2663243004829665,51,20,31,31,0.31811312946481773,0.5480471295278233
실물/NNG@$경기/NNG@$둔화/NNG,-1,-0.2663243004829665,51,20,31,23,0.31811312946481773,0.5480471295278233
위기/NNG@$금리/NNG@$인상/NNG,-1,-0.2663243004829665,51,20,31,31,0.31811312946481773,0.5480471295278233
금리/NNG@$인하/NNG@$사이클/NNG,-1,-0.2663400524621591,68,27,41,24,0.3646352416405374,0.6282169689241236
채권/NNG@$시장/NNG@$기준금리/NNG@$인하/NNG,-1,-0.2663400524621591,68,27,41,29,0.3646352416405374,0.6282169689241236
가능성/NNG@$크/VA@$전망/NNG,-1,-0.26748267441354723,157,63,94,100,0.4651066802615053,0.8032873669677264
동결/NNG@$가능성/NNG@$높/VA,-1,-0.2676598871448751,152,61,91,65,0.4633830834925097,0.8006157585345671
성장률/NNG@$전망/NNG@$하향/NNG@$조정/NNG,-1,-0.2677955338446727,142,57,85,87,0.45924377322622734,0.793695657133204
가계부채/NNG@$증가세/NNG@$둔화/NNG,0,-0.2684522492219935,19,7,12,27,0.20479930105353122,0.3544484408545831
시장/NNG@$금리/NNG@$인상/NNG@$가능성/NNG@$반영/NNG,0,-0.26986548739579386,34,13,21,29,0.26005403867954785,0.4514503909239299
성장률/NNG@$전망/NNG@$낮/VA,0,-0.26986548739579386,34,13,21,21,0.26005403867954785,0.4514503909239299
통화/NNG@$달러/NNG@$가치/NNG,0,-0.26986548739579386,34,13,21,30,0.26005403867954785,0.4514503909239299
양적완화/NNG@$축소/NNG@$테이퍼링/NNG,0,-0.26986548739579386,34,13,21,48,0.26005403867954785,0.4514503909239299
영향/NNG@$소비자/NNG@$물가/NNG,0,-0.26986548739579386,34,13,21,17,0.26005403867954785,0.4514503909239299
성장/NNG@$둔화/NNG@$위험/NNG,0,-0.26986548739579386,34,13,21,19,0.26005403867954785,0.4514503909239299
하방/NNG@$위험/NNG@$남/VV,0,-0.26986548739579386,34,13,21,18,0.26005403867954785,0.4514503909239299
흑자/NNG@$규모/NNG@$축소/NNG,0,-0.26986548739579386,34,13,21,15,0.26005403867954785,0.4514503909239299
고용/NNG@$시장/NNG@$악화/NNG,-1,-0.2701967055474346,73,29,44,12,0.37404282189594257,0.6497970073534445
부진/NNG@$모습/NNG@$보였/VV,-1,-0.271396651905789,56,22,34,30,0.3302438045252428,0.5751941514204827
기준금리/NNG@$동결/NNG@$시장/NNG,-1,-0.271396651905789,56,22,34,29,0.3302438045252428,0.5751941514204827
금리/NNG@$동결/NNG@$반대/NNG,0,-0.2742606083704524,39,15,24,28,0.27552019334710526,0.4828560385626609
정상화/NNG@$기조/NNG@$유지/NNG,0,-0.2742606083704524,39,15,24,13,0.27552019334710526,0.4828560385626609
거시/NNG@$건전성/NNG@$규제/NNG,0,-0.2742606083704524,39,15,24,23,0.27552019334710526,0.4828560385626609
경제/NNG@$검토/NNG@$기준금리/NNG@$유지/NNG,0,-0.2742606083704524,39,15,24,19,0.27552019334710526,0.4828560385626609
예상/NNG@$소비자/NNG@$물가/NNG,-1,-0.2758403901316058,61,24,37,31,0.3416188733988807,0.6007431032681083
상승/NNG@$압력/NNG@$커지/VV,-1,-0.2761749957768441,83,33,50,22,0.39087539271566213,0.6878591059358755
예금/NNG@$증서/NNG@$금리/NNG,-1,-0.2784052298350146,88,35,53,19,0.398355725416623,0.7044143662533758
양도성/NNG@$예금/NNG@$증서/NNG@$금리/NNG,-1,-0.2784052298350146,88,35,53,19,0.398355725416623,0.7044143662533758
예상/NNG@$경기/NNG@$둔화/NNG,-1,-0.2787904950448232,44,17,27,21,0.2900102085394168,0.5132545216720554
산업/NNG@$생산/NNG@$증가세/NNG,-1,-0.2787904950448232,44,17,27,32,0.2900102085394168,0.5132545216720554
자산/NNG@$매입/NNG@$확대/NNG,-1,-0.2787904950448232,44,17,27,21,0.2900102085394168,0.5132545216720554
상승률/NNG@$기록/NNG@$물가/NNG,-1,-0.2787904950448232,44,17,27,15,0.2900102085394168,0.5132545216720554
우려/NNG@$금리/NNG@$인상/NNG@$가능성/NNG,-1,-0.2787904950448232,44,17,27,14,0.2900102085394168,0.5132545216720554
국채/NNG@$매입/NNG@$결정/NNG,-1,-0.2787904950448232,44,17,27,8,0.2900102085394168,0.5132545216720554
경제/NNG@$구조적/NNG@$문제/NNG,-1,-0.2787904950448232,44,17,27,25,0.2900102085394168,0.5132545216720554
경기/NNG@$둔화/NNG@$영향/NNG,-1,-0.2787904950448232,44,17,27,34,0.2900102085394168,0.5132545216720554
기준금리/NNG@$인상/NNG@$필요성/NNG,-1,-0.2796758244536186,66,26,40,32,0.35225765196745,0.6246157642486765
물가/NNG@$상승/NNG@$압력/NNG@$커지/VV,-1,-0.2796758244536186,66,26,40,17,0.35225765196745,0.6246157642486765
전망치/NNG@$하향/NNG@$조정/NNG,-1,-0.28018056978928574,538,214,324,340,0.463335690679687,0.8224762658487914
회복/NNG@$금리/NNG@$인상/NNG,-1,-0.28019716299661934,93,37,56,62,0.40525216007858417,0.719396928481901
인하/NNG@$소수/NNG@$의견/NNG,-1,-0.2823097530941634,148,59,89,59,0.451286667369772,0.8047961951968158
인플레이션/NNG@$압력/NNG@$완화/NNG,-1,-0.2828668631414849,143,57,86,64,0.44884508642080756,0.8014107076146512
경제/NNG@$기준금리/NNG@$동결/NNG,-1,-0.2831249956058496,49,19,30,22,0.30361355781722815,0.5424044693940766
가계부채/NNG@$증가/NNG@$우려/NNG,-1,-0.2831249956058496,49,19,30,8,0.30361355781722815,0.5424044693940766
모기지/NNG@$담보/NNG@$증권/NNG@$매입/NNG,-1,-0.2838711180624456,113,45,68,28,0.4276265301127578,0.765192298751135
하향/NNG@$조정/NNG@$가능성/NNG,-1,-0.28561796044876275,171,68,103,85,0.45494166439349987,0.817166965238174
위험/NNG@$요인/NNG@$전개/NNG,0,-0.285838868928176,14,5,9,22,0.1795130339944934,0.3225965780130522
필요/NNG@$있/VA@$의견/NNG@$제시/NNG,0,-0.285838868928176,14,5,9,10,0.1795130339944934,0.3225965780130522
경기/NNG@$둔화/NNG@$우려/NNG@$금리/NNG,-1,-0.2870960305290776,54,21,33,22,0.31638252516568616,0.5701174992567843
인플레이션/NNG@$상승/NNG@$위험/NNG,-1,-0.2870960305290776,54,21,33,6,0.31638252516568616,0.5701174992567843
실질/NNG@$국내총생산/NNG@$성장률/NNG,-1,-0.2870960305290776,54,21,33,27,0.31638252516568616,0.5701174992567843
가능성/NNG@$크/VA@$내/VX,-1,-0.2870960305290776,54,21,33,20,0.31638252516568616,0.5701174992567843
확장적/NNG@$정책/NNG@$기조/NNG,-1,-0.29062393707675815,59,23,36,22,0.328353068108908,0.5962550843795899
산업/NNG@$생산/NNG@$감소/NNG,-1,-0.29208597831300964,96,38,58,50,0.4020312564142313,0.7323805856914599
경기/NNG@$회복/NNG@$조짐/NNG,-1,-0.29303807198337584,121,48,73,56,0.4283983724322162,0.7820383949671854
환율/NNG@$변동성/NNG@$확대/NNG,-1,-0.2933480886750206,111,44,67,83,0.4192205511864287,0.7658029977106117
금리/NNG@$인하/NNG@$불가피/XR,-1,-0.2936793730769922,64,25,39,9,0.3395547074374098,0.6207242843320057
긴축/NNG@$기조/NNG@$유지/NNG,-1,-0.2936793730769922,64,25,39,18,0.3395547074374098,0.6207242843320057
성장률/NNG@$전망/NNG@$상향/NNG@$조정/NNG,-1,-0.2936793730769922,64,25,39,27,0.3395547074374098,0.6207242843320057
금리/NNG@$인상/NNG@$예측/NNG,-1,-0.2936793730769922,64,25,39,17,0.3395547074374098,0.6207242843320057
경제/NNG@$전망/NNG@$성장률/NNG@$전망치/NNG,-1,-0.2936793730769922,64,25,39,27,0.3395547074374098,0.6207242843320057
원자재/NNG@$가격/NNG@$약세/NNG,0,-0.2950148247301678,32,12,20,22,0.2422253974479229,0.44409620250742154
물가/NNG@$지표/NNG@$개인/NNG@$소비/NNG@$지출/NNG,0,-0.2950148247301678,32,12,20,44,0.2422253974479229,0.44409620250742154
성장/NNG@$모멘텀/NNG@$둔화/NNG,0,-0.2950148247301678,32,12,20,15,0.2422253974479229,0.44409620250742154
소비자/NNG@$물가/NNG@$경기/NNG,0,-0.29608091037401174,27,10,17,13,0.22403340190089827,0.4117024943778653
완화/NNG@$정책/NNG@$시행/NNG,0,-0.29608091037401174,27,10,17,24,0.22403340190089827,0.4117024943778653
완화/NNG@$금리/NNG@$인상/NNG,-1,-0.29626223674245966,69,27,42,28,0.35001521749940734,0.6434726255267086
주택/NNG@$판매/NNG@$증가/NNG,0,-0.2962747085037435,37,14,23,33,0.2588487764501636,0.47588402508168837
통화정책/NNG@$긴축/NNG@$기조/NNG,0,-0.2962747085037435,37,14,23,17,0.2588487764501636,0.47588402508168837
물가/NNG@$상승/NNG@$인플레이션/NNG,0,-0.2962747085037435,37,14,23,20,0.2588487764501636,0.47588402508168837
제품/NNG@$가격/NNG@$하락/NNG,0,-0.2962747085037435,37,14,23,10,0.2588487764501636,0.47588402508168837
경기/NNG@$부양/NNG@$재정/NNG,0,-0.2962747085037435,37,14,23,15,0.2588487764501636,0.47588402508168837
가능성/NNG@$크/VA@$금리/NNG,-1,-0.29855589004213134,42,16,26,26,0.2742624892504172,0.506748381165513
인하/NNG@$경기/NNG@$부양/NNG@$효과/NNG,-1,-0.29855589004213134,42,16,26,17,0.2742624892504172,0.506748381165513
시장/NNG@$금리/NNG@$상승/NNG@$압력/NNG,-1,-0.29855589004213134,42,16,26,20,0.2742624892504172,0.506748381165513
물가/NNG@$상승/NNG@$금리/NNG@$인상/NNG,-1,-0.29855589004213134,42,16,26,15,0.2742624892504172,0.506748381165513
반응/NNG@$보이/VV@$않/VX,-1,-0.29855589004213134,42,16,26,32,0.2742624892504172,0.506748381165513
경제/NNG@$전망/NNG@$성장/NNG,-1,-0.29855589004213134,42,16,26,20,0.2742624892504172,0.506748381165513
금리/NNG@$인하/NNG@$아니/VCN,-1,-0.29855589004213134,42,16,26,10,0.2742624892504172,0.506748381165513
경제/NNG@$성장/NNG@$경로/NNG,-1,-0.29855589004213134,42,16,26,29,0.2742624892504172,0.506748381165513
정책/NNG@$기조/NNG@$변경/NNG,-1,-0.30119235034207736,47,18,29,18,0.2886501719208778,0.5364272935660682
완화적/NNG@$통화정책/NNG@$기조/NNG@$유지/NNG,-1,-0.30119235034207736,47,18,29,33,0.2886501719208778,0.5364272935660682
경기/NNG@$회복/NNG@$신호/NNG,-1,-0.301387751833726,84,33,51,32,0.37723681573392154,0.7013576653849763
시중/NNG@$유동성/NNG@$풍부/XR,-1,-0.301387751833726,84,33,51,28,0.37723681573392154,0.7013576653849763
지수/NNG@$뛴/VV@$기록/NNG,0,-0.3022643476884497,22,8,14,29,0.2035002936867333,0.3790767677108467
경제/NNG@$전망/NNG@$반영/NNG,0,-0.3022643476884497,22,8,14,13,0.2035002936867333,0.3790767677108467
경기/NNG@$회복/NNG@$금리/NNG@$인상/NNG,-1,-0.3038279614244993,52,20,32,32,0.30211490239643984,0.5647130803289392
소비자/NNG@$물가/NNG@$낮/VA,-1,-0.3038279614244993,52,20,32,23,0.30211490239643984,0.5647130803289392
이례적/NNG@$낮/VA@$금리/NNG,-1,-0.3062703576600746,57,22,35,6,0.3147212388094092,0.5914497597238425
생활/NNG@$형편/NNG@$전망/NNG,-1,-0.3070255148271751,137,54,83,86,0.4287261812128992,0.8070396710522049
통화정책/NNG@$방향/NNG@$의결/NNG,-1,-0.3070255148271751,137,54,83,59,0.4287261812128992,0.8070396710522049
금리/NNG@$인하/NNG@$가능성/NNG@$높/VA,-1,-0.30947161243233745,127,50,77,31,0.4212782171746696,0.7973125172692873
대외/NNG@$위험/NNG@$요인/NNG,-1,-0.31022687772609236,67,26,41,39,0.3375344586000957,0.6398857529146367
신경/NNG@$쓰/VV@$않/VX,-1,-0.31022687772609236,67,26,41,19,0.3375344586000957,0.6398857529146367
경기/NNG@$부양/NNG@$정책/NNG,-1,-0.3115530897160249,227,89,138,142,0.4393489223678919,0.8353479635023077
변동성/NNG@$확대/NNG@$가능성/NNG,-1,-0.3115834466057147,117,46,71,67,0.41236384604054693,0.7840930398166813
둔화/NNG@$인플레이션/NNG@$압력/NNG,-1,-0.31167891274304105,72,28,44,27,0.3478127713324425,0.6614914914787569
외국인/NNG@$자금/NNG@$유출/NNG,-1,-0.3137187161765409,102,40,62,66,0.3957549905914431,0.7560775610325311
물가/NNG@$상승률/NNG@$전망치/NNG,-1,-0.31394762460729264,217,85,132,98,0.43735370037658644,0.8359744723752667
대책/NNG@$금리/NNG@$인상/NNG,0,-0.32024358640535,40,15,25,14,0.2578951705510931,0.4998910842880422
경상수지/NNG@$흑자/NNG@$축소/NNG,0,-0.32024358640535,40,15,25,15,0.2578951705510931,0.4998910842880422
회복/NNG@$쉽/VA@$않/VX,0,-0.32024358640535,40,15,25,26,0.2578951705510931,0.4998910842880422
전망/NNG@$통화정책/NNG@$완화/NNG@$기조/NNG@$유지/NNG,0,-0.3204924116525859,17,6,11,38,0.1787385282047704,0.34664974588818875
경기/NNG@$부진/NNG@$완화/NNG,0,-0.3204924116525859,17,6,11,16,0.1787385282047704,0.34664974588818875
회복/NNG@$지원/NNG@$중기적/NNG,-1,-0.3207411607229689,45,17,28,9,0.2731783825513669,0.5301021113835342
테이퍼링/NNG@$자산/NNG@$매입/NNG@$축소/NNG,-1,-0.3207411607229689,45,17,28,39,0.2731783825513669,0.5301021113835342
주택/NNG@$가격/NNG@$급락/NNG,-1,-0.3207411607229689,45,17,28,13,0.2731783825513669,0.5301021113835342
성장세/NNG@$회복/NNG@$지원/NNG@$중기적/NNG,-1,-0.3207411607229689,45,17,28,9,0.2731783825513669,0.5301021113835342
확대/NNG@$가능성/NNG@$크/VA,0,-0.32089599978893013,35,13,22,28,0.24138082826981067,0.468560528838182
경기/NNG@$회복세/NNG@$유지/NNG,0,-0.32089599978893013,35,13,22,32,0.24138082826981067,0.468560528838182
메르스/NNG@$호흡기/NNG@$증후군/NNG,0,-0.32089599978893013,35,13,22,47,0.24138082826981067,0.468560528838182
금리/NNG@$인하/NNG@$가능성/NNG@$배제/NNG@$없/VA,0,-0.32089599978893013,35,13,22,20,0.24138082826981067,0.468560528838182
금리/NNG@$역전/NNG@$자본/NNG,0,-0.32089599978893013,35,13,22,16,0.24138082826981067,0.468560528838182
경기/NNG@$회복/NNG@$촉진/NNG,0,-0.32089599978893013,35,13,22,13,0.24138082826981067,0.468560528838182
전망/NNG@$기준금리/NNG@$인상/NNG,-1,-0.3217423495890015,50,19,31,42,0.28741197966317744,0.5589673916293318
국채/NNG@$매입/NNG@$양적완화/NNG,-1,-0.3217423495890015,50,19,31,19,0.28741197966317744,0.5589673916293318
금리/NNG@$인하/NNG@$여부/NNG,-1,-0.32247508109531764,110,43,67,45,0.3986096496744275,0.7764948700199729
달러/NNG@$환율/NNG@$하락/NNG,0,-0.3239102881502054,30,11,19,27,0.22330306336752015,0.43639082646237703
상승률/NNG@$높/VA@$않/VX,0,-0.3239102881502054,30,11,19,27,0.22330306336752015,0.43639082646237703
금리/NNG@$인상/NNG@$통화/NNG,-1,-0.3239749733313121,60,23,37,28,0.3131263051815852,0.6120165596712731
유지/NNG@$가능성/NNG@$높/VA,-1,-0.3255783647426115,70,27,43,32,0.3355605457001226,0.6582173709197359
투자/NNG@$심리/NNG@$회복/NNG,-1,-0.3257723382965969,90,35,55,31,0.37186962684479435,0.7297554992400964
차원/NNG@$금리/NNG@$인상/NNG,-1,-0.32618049775785274,80,31,49,25,0.3550465661872596,0.6973778133635732
금리/NNG@$인하/NNG@$통화정책/NNG,-1,-0.32618049775785274,80,31,49,32,0.3550465661872596,0.6973778133635732
투자/NNG@$자금/NNG@$유입/NNG,-1,-0.3288929602608711,141,55,86,64,0.4149359294441584,0.8199727952123766
압력/NNG@$크/VA@$않/VX@$전망/NNG,0,-0.33173166427904444,25,9,16,48,0.20299861059552107,0.4037154342217241
수출/NNG@$부진/NNG@$경제/NNG,0,-0.33173166427904444,25,9,16,21,0.20299861059552107,0.4037154342217241
유지/NNG@$민간/NNG@$소비/NNG,0,-0.33173166427904444,25,9,16,22,0.20299861059552107,0.4037154342217241
금리/NNG@$인하/NNG@$결정/NNG,-1,-0.33244492676197557,299,116,183,95,0.42398626900964065,0.8445579546290368
원자재/NNG@$가격/NNG@$하락/NNG,-1,-0.33422915501105654,307,119,188,222,0.4226521214406468,0.8452823996541601
조짐/NNG@$보이/VV@$않/VX,-1,-0.3378102458369431,88,34,54,39,0.3613182433321264,0.7284676299876103
위기/NNG@$이전/NNG@$회복/NNG,-1,-0.33866316538275654,83,32,51,28,0.35275641572566807,0.7125751547424527
부동산/NNG@$종합/NNG@$대책/NNG,-1,-0.3398223640557866,73,28,45,31,0.33363411852552105,0.6757132758915748
금리/NNG@$인상/NNG@$문제/NNG,-1,-0.3398223640557866,73,28,45,40,0.33363411852552105,0.6757132758915748
광공업/NNG@$생산/NNG@$감소/NNG,-1,-0.3398223640557866,73,28,45,23,0.33363411852552105,0.6757132758915748
통화정책/NNG@$기조/NNG@$유지/NNG,-1,-0.33989123411033995,134,52,82,80,0.40390722198664736,0.8181654791723667
경기/NNG@$좋/VA@$않/VX,-1,-0.33989123411033995,134,52,82,56,0.40390722198664736,0.8181654791723667
부정적/NNG@$영향/NNG@$가능성/NNG,-1,-0.34014215871824827,68,26,42,40,0.3229989578884206,0.6546463555896123
금리/NNG@$인상/NNG@$압박/NNG,-1,-0.34014215871824827,68,26,42,31,0.3229989578884206,0.6546463555896123
해외/NNG@$위험/NNG@$요인/NNG@$상존/NNG,-1,-0.3404421184131632,58,22,36,4,0.299372770272618,0.6071726275418183
기준금리/NNG@$동결/NNG@$물가/NNG,-1,-0.34060633375441374,53,20,33,17,0.286279227374082,0.5808324155059211
순이익/NNG@$주당/NNG@$기록/NNG,-1,-0.34060633375441374,53,20,33,31,0.286279227374082,0.5808324155059211
경제/NNG@$성장/NNG@$이끌/VV,-1,-0.34060633375441374,53,20,33,33,0.286279227374082,0.5808324155059211
증가/NNG@$속도/NNG@$빠르/VA,-1,-0.34060633375441374,53,20,33,23,0.286279227374082,0.5808324155059211
경제/NNG@$기준금리/NNG@$인하/NNG,-1,-0.34060633375441374,53,20,33,20,0.286279227374082,0.5808324155059211
동결/NNG@$소수/NNG@$의견/NNG,-1,-0.34102305184069337,48,18,30,34,0.2722390434520006,0.5528666284637527
경기/NNG@$과도/NNG@$위축/NNG,-1,-0.34102305184069337,48,18,30,4,0.2722390434520006,0.5528666284637527
경제/NNG@$심리/NNG@$위축/NNG,-1,-0.34102305184069337,48,18,30,33,0.2722390434520006,0.5528666284637527
금리/NNG@$인상/NNG@$서두르/VV@$않/VX,-1,-0.34102305184069337,48,18,30,29,0.2722390434520006,0.5528666284637527
경기/NNG@$부진/NNG@$지속/NNG,-1,-0.34204121375774443,43,16,27,22,0.2571440141769824,0.5234149656758388
인상/NNG@$시장/NNG@$예상/NNG,-1,-0.34204121375774443,43,16,27,28,0.2571440141769824,0.5234149656758388
금리/NNG@$동결/NNG@$가능성/NNG@$높/VA,-1,-0.34204121375774443,43,16,27,25,0.2571440141769824,0.5234149656758388
물가/NNG@$상승률/NNG@$기준/NNG,0,-0.3442679312549035,38,14,24,23,0.2408215380367355,0.4926678671385876
성장률/NNG@$전망/NNG@$유지/NNG,0,-0.3442679312549035,38,14,24,19,0.2408215380367355,0.4926678671385876
콜금리/NNG@$동결/NNG@$경기/NNG,0,-0.3442679312549035,38,14,24,12,0.2408215380367355,0.4926678671385876
소비자/NNG@$동향/NNG@$소비자심리지수/NNG,0,-0.3442679312549035,38,14,24,32,0.2408215380367355,0.4926678671385876
금리/NNG@$인하/NNG@$필요성/NNG,-1,-0.3446519789343815,202,78,124,106,0.4139172662248317,0.8475208939206847
정책/NNG@$기조/NNG@$유지/NNG,-1,-0.34583547387047875,236,91,145,100,0.4137662629209019,0.8494882789055065
상승/NNG@$압력/NNG@$높/VA@$않/VX,0,-0.34879885607989436,33,12,21,15,0.2229727581191489,0.4608685278457701
환율/NNG@$하락/NNG@$수출/NNG,0,-0.34879885607989436,33,12,21,19,0.2229727581191489,0.4608685278457701
인상/NNG@$사이클/NNG@$종료/NNG,0,-0.34879885607989436,33,12,21,17,0.2229727581191489,0.4608685278457701
경제/NNG@$성장/NNG@$목표/NNG,0,-0.34879885607989436,33,12,21,15,0.2229727581191489,0.4608685278457701
시장/NNG@$금리/NNG@$오르/VV,0,-0.34879885607989436,33,12,21,16,0.2229727581191489,0.4608685278457701
경기/NNG@$둔화/NNG@$추세/NNG,0,-0.34879885607989436,33,12,21,16,0.2229727581191489,0.4608685278457701
고용/NNG@$시장/NNG@$부진/NNG,0,-0.34879885607989436,33,12,21,24,0.2229727581191489,0.4608685278457701
기조/NNG@$변화/NNG@$가능성/NNG,0,-0.34879885607989436,33,12,21,8,0.2229727581191489,0.4608685278457701
경기/NNG@$활성화/NNG@$정책/NNG,0,-0.34879885607989436,33,12,21,20,0.2229727581191489,0.4608685278457701
선제/NNG@$안내/NNG@$포워드가이던스/NNG,0,-0.34879885607989436,33,12,21,20,0.2229727581191489,0.4608685278457701
매입/NNG@$프로그램/NNG@$종료/NNG,0,-0.34879885607989436,33,12,21,22,0.2229727581191489,0.4608685278457701
기준금리/NNG@$인하/NNG@$기대/NNG,-1,-0.3491271144882542,158,61,97,117,0.4056904424148731,0.8391589290884227
통화정책/NNG@$완화/NNG@$기조/NNG@$유지/NNG,-1,-0.3517231131248547,81,31,50,70,0.3414741828836849,0.7105165277432187
금리/NNG@$인상/NNG@$임박/XR,-1,-0.3517231131248547,81,31,50,27,0.3414741828836849,0.7105165277432187
금리/NNG@$인상/NNG@$통화정책/NNG,-1,-0.3523484400864597,140,54,86,62,0.3977929319193341,0.8288815576497458
경제/NNG@$둔화/NNG@$가능성/NNG,-1,-0.35304099558547364,76,29,47,33,0.33175543370884725,0.6923719825469997
상승/NNG@$압력/NNG@$예상/NNG,-1,-0.3542646573989948,71,27,44,14,0.3213183680135293,0.6724655680611908
물가/NNG@$상승/NNG@$속도/NNG,-1,-0.3566158806888622,61,23,38,33,0.2981123736623126,0.6272616297142222
기준금리/NNG@$동결/NNG@$인상/NNG,-1,-0.3566158806888622,61,23,38,28,0.2981123736623126,0.6272616297142222
유럽연합/NNG@$탈퇴/NNG@$브렉시트/NNG,-1,-0.3566158806888622,61,23,38,122,0.2981123736623126,0.6272616297142222
소비자/NNG@$물가/NNG@$하락/NNG,-1,-0.3573276212147428,117,45,72,52,0.3811380240359526,0.8032643086474694
금리/NNG@$인상/NNG@$속도/NNG@$완만/XR,0,-0.3577365070550439,28,10,18,24,0.2030380165494324,0.42831193318007993
은행/NNG@$금융정책/NNG@$결정/NNG@$열/VV,0,-0.3577365070550439,28,10,18,25,0.2030380165494324,0.42831193318007993
경로/NNG@$크/VA@$벗어나/VV@$않/VX,0,-0.3577365070550439,28,10,18,33,0.2030380165494324,0.42831193318007993
경제/NNG@$성장/NNG@$부정적/NNG,0,-0.3577365070550439,28,10,18,28,0.2030380165494324,0.42831193318007993
기업/NNG@$많/VA@$의미/NNG,0,-0.3577365070550439,28,10,18,23,0.2030380165494324,0.42831193318007993
인하/NNG@$가능성/NNG@$배제/NNG@$없/VA,-1,-0.35793291532835747,56,21,35,34,0.28523717735770204,0.6019831157361705
규모/NNG@$크/VA@$않/VX,-1,-0.35793291532835747,56,21,35,40,0.28523717735770204,0.6019831157361705
산업/NNG@$생산/NNG@$지표/NNG,-1,-0.35894832515319086,94,36,58,34,0.35655875565276784,0.7542578159351393
중기적/NNG@$물가/NNG@$기조/NNG@$유지/NNG@$금융/NNG,-1,-0.3595829196275865,51,19,32,31,0.2714197314280801,0.5749924003442315
산업/NNG@$생산/NNG@$예상/NNG,-1,-0.3595829196275865,51,19,32,25,0.2714197314280801,0.5749924003442315
시장/NNG@$금리/NNG@$결정/NNG,-1,-0.3595829196275865,51,19,32,18,0.2714197314280801,0.5749924003442315
기준금리/NNG@$동결/NNG@$전망/NNG,-1,-0.3597392174069248,303,116,187,151,0.40358493360449255,0.8552859471828196
금리/NNG@$격차/NNG@$축소/NNG,-1,-0.3618967394025937,46,17,29,23,0.2565548948254238,0.5463966932356732
모습/NNG@$보이/VV@$않/VX,-1,-0.3618967394025937,46,17,29,18,0.2565548948254238,0.5463966932356732
기준금리/NNG@$동결/NNG@$했/VV,-1,-0.3618967394025937,46,17,29,26,0.2565548948254238,0.5463966932356732
체감/NNG@$경기/NNG@$개선/NNG,-1,-0.3653104067217242,79,30,49,17,0.3299241263867431,0.7081962899592608
제품/NNG@$가격/NNG@$경쟁력/NNG,-1,-0.36543331902386234,41,15,26,22,0.24048209801447887,0.5163513911231095
경제/NNG@$나쁘/VA@$않/VX,-1,-0.36543331902386234,41,15,26,12,0.24048209801447887,0.5163513911231095
가계/NNG@$실질/NNG@$구매력/NNG,-1,-0.36543331902386234,41,15,26,19,0.24048209801447887,0.5163513911231095
에너지/NNG@$가격/NNG@$하락/NNG,-1,-0.3657102820483008,102,39,63,59,0.36175887129377887,0.7772470067098564
경상수지/NNG@$흑자/NNG@$지속/NNG,-1,-0.3673450918760528,74,28,46,42,0.31968718935387597,0.6894504120146
기준금리/NNG@$인상/NNG@$결정/NNG,-1,-0.3688093992011815,149,57,92,65,0.38915162336304265,0.8421038986590703
재정/NNG@$건전성/NNG@$유지/NNG,0,-0.37116790613691797,36,13,23,20,0.22293657207083936,0.4850629642318662
인하/NNG@$필요성/NNG@$제기/NNG,0,-0.37116790613691797,36,13,23,14,0.22293657207083936,0.4850629642318662
외환시장/NNG@$달러/NNG@$원/NNG,0,-0.37116790613691797,36,13,23,16,0.22293657207083936,0.4850629642318662
금리/NNG@$인하/NNG@$가능성/NNG@$제기/NNG,0,-0.37116790613691797,36,13,23,18,0.22293657207083936,0.4850629642318662
소비자/NNG@$물가/NNG@$전망/NNG,0,-0.37116790613691797,36,13,23,22,0.22293657207083936,0.4850629642318662
기업/NNG@$경기/NNG@$전망/NNG,-1,-0.3715230307165581,64,24,40,40,0.296915340267514,0.6465568212958237
금리/NNG@$결정/NNG@$영향/NNG,-1,-0.37413866973182763,105,40,65,33,0.3593674863513789,0.7873133410129124
회복세/NNG@$나타낼/VV@$전망/NNG,0,-0.37551412515927995,23,8,15,33,0.17987571096567137,0.3953386369809798
경기/NNG@$해외/NNG@$위험/NNG@$요인/NNG@$상존/NNG,-1,-0.3765812799466419,54,20,34,4,0.2706994836737826,0.5964336343443364
금융/NNG@$유의/NNG@$통화정책/NNG,-1,-0.3767011665895147,82,31,51,58,0.32813940654320967,0.723193061593417
가능성/NNG@$크/VA@$진단/NNG,-1,-0.3794630727074203,77,29,48,36,0.31810337464029087,0.7056006823037623
이유/NNG@$금리/NNG@$인하/NNG,-1,-0.3800079018725133,49,18,31,16,0.2560948392936947,0.5687791584481154
경제/NNG@$성장/NNG@$물가/NNG,-1,-0.38048967001400713,187,71,116,73,0.38661304477655556,0.8596225475051715
개선/NNG@$기준금리/NNG@$인상/NNG,0,-0.3808924538239187,31,11,20,24,0.20344921154482165,0.4527889648509935
금리/NNG@$내린/VV@$마감/NNG,0,-0.3808924538239187,31,11,20,47,0.20344921154482165,0.4527889648509935
오름세/NNG@$지속/NNG@$예상/NNG,0,-0.3808924538239187,31,11,20,8,0.20344921154482165,0.4527889648509935
금리/NNG@$인상/NNG@$경기/NNG@$둔화/NNG,-1,-0.38229455693504644,72,27,45,63,0.3073315984480271,0.6862309118078201
금리/NNG@$인하/NNG@$검토/NNG,-1,-0.3846439213951349,44,16,28,12,0.24031140919665564,0.5395432100172692
내수/NNG@$경기/NNG@$부양/NNG,-1,-0.3846439213951349,44,16,28,14,0.24031140919665564,0.5395432100172692
금리/NNG@$사상/NNG@$최저/NNG,-1,-0.38526753033419014,67,25,42,37,0.2957747285503012,0.6650400850617514
부진/NNG@$모습/NNG@$보이/VV,-1,-0.3872786365150118,85,32,53,51,0.3264002007942176,0.7373729258650331
통화/NNG@$가치/NNG@$상승/NNG,-1,-0.388496290618239,62,23,39,47,0.2833749666473511,0.6420092428808074
인상/NNG@$서두르/VV@$않/VX,-1,-0.388496290618239,62,23,39,36,0.2833749666473511,0.6420092428808074
고려/NNG@$금리/NNG@$인하/NNG,-1,-0.38942043653626257,111,42,69,58,0.3547482136271752,0.8054606727042394
물가/NNG@$상승률/NNG@$하락/NNG,-1,-0.3894249202036675,98,37,61,58,0.34203588978913835,0.7766053636928623
금리/NNG@$인상/NNG@$점진적/NNG,-1,-0.3906920829536491,80,30,50,39,0.31656478372905633,0.7209206109141165
인상/NNG@$속도/NNG@$완만/XR,-1,-0.39134956377953245,39,14,25,41,0.22311635594659684,0.5088963756572251
엔/NNG@$원/NNG@$재정환율/NNG,-1,-0.39134956377953245,39,14,25,23,0.22311635594659684,0.5088963756572251
상품/NNG@$가격/NNG@$급등/NNG,-1,-0.3921610395624002,57,21,36,18,0.270060679156013,0.6171498531055575
금리/NNG@$인상/NNG@$늦추/VV,-1,-0.3921610395624002,57,21,36,28,0.270060679156013,0.6171498531055575
경제/NNG@$전망/NNG@$경제성장률/NNG,-1,-0.39347234710592005,106,40,66,81,0.3476600265045861,0.7969457039028446
브렉시트/NNG@$국민/NNG@$투표/NNG,0,-0.39357624046349404,15,5,10,48,0.147587173467826,0.338399099847763
물가/NNG@$기조/NNG@$유지/NNG@$금융/NNG@$유의/NNG,-1,-0.3965470362924264,52,19,33,31,0.2557370301370786,0.5905096681622197
투자/NNG@$심리/NNG@$악화/NNG,-1,-0.3965470362924264,52,19,33,23,0.2557370301370786,0.5905096681622197
지수/NNG@$상승/NNG@$종합/NNG,-1,-0.3965470362924264,52,19,33,47,0.2557370301370786,0.5905096681622197
회복/NNG@$속도/NNG@$예상/NNG,-1,-0.3965470362924264,52,19,33,21,0.2557370301370786,0.5905096681622197
국채/NNG@$가격/NNG@$상승/NNG,-1,-0.3965470362924264,52,19,33,19,0.2557370301370786,0.5905096681622197
초저/NNG@$금리/NNG@$유지/NNG,-1,-0.39665213222558393,250,94,156,107,0.37614176600640775,0.868746578087584
효과/NNG@$지켜볼/VV@$필요/NNG@$있/VA,-1,-0.39794432053751894,70,26,44,36,0.29468433475111766,0.682698959504789
전통적/NNG@$통화정책/NNG@$수단/NNG,0,-0.39816191134652423,26,9,17,23,0.1811257372975004,0.419833010447157
물가/NNG@$목표치/NNG@$달성/NNG,0,-0.39816191134652423,26,9,17,22,0.1811257372975004,0.419833010447157
인상/NNG@$속도/NNG@$조절/NNG,0,-0.40164656493110407,34,12,22,22,0.2041168691190561,0.4770594648492764
소비자/NNG@$물가/NNG@$반영/NNG,0,-0.40164656493110407,34,12,22,10,0.2041168691190561,0.4770594648492764
인상/NNG@$어려울/VA@$전망/NNG,0,-0.40164656493110407,34,12,22,16,0.2041168691190561,0.4770594648492764
금리/NNG@$상승/NNG@$예상/NNG,0,-0.40164656493110407,34,12,22,25,0.2041168691190561,0.4770594648492764
시장/NNG@$부정적/NNG@$영향/NNG,0,-0.40164656493110407,34,12,22,27,0.2041168691190561,0.4770594648492764
인하/NNG@$가능성/NNG@$무게/NNG,0,-0.40164656493110407,34,12,22,21,0.2041168691190561,0.4770594648492764
투자/NNG@$내수/NNG@$부진/NNG,0,-0.40164656493110407,34,12,22,7,0.2041168691190561,0.4770594648492764
경기/NNG@$둔화/NNG@$심화/NNG,0,-0.40164656493110407,34,12,22,24,0.2041168691190561,0.4770594648492764
주택/NNG@$착공/NNG@$증가/NNG,0,-0.40164656493110407,34,12,22,17,0.2041168691190561,0.4770594648492764
경제/NNG@$발목/NNG@$잡/VV,-1,-0.40186335738128076,96,36,60,46,0.3318479736130862,0.7759915226732234
외환/NNG@$위기/NNG@$금융/NNG,-1,-0.4019634573145452,65,24,41,34,0.28253380357471963,0.660833047570998
하방/NNG@$리스크/NNG@$확대/NNG,-1,-0.40211247990896803,47,17,30,26,0.24026945402867197,0.5621782600321441
경영/NNG@$애로/NNG@$요인/NNG,-1,-0.40211247990896803,47,17,30,20,0.24026945402867197,0.5621782600321441
금리/NNG@$인상/NNG@$환율/NNG,-1,-0.4052559216939703,78,29,49,45,0.30472972989333924,0.7183680512334403
기준치/NNG@$허용/NNG@$한도/NNG,-1,-0.4052559216939703,78,29,49,75,0.30472972989333924,0.7183680512334403
엔화/NNG@$가치/NNG@$하락/NNG,-1,-0.4052559216939703,78,29,49,41,0.30472972989333924,0.7183680512334403
기준금리/NNG@$동결/NNG@$경제/NNG,-1,-0.4062312300127303,91,34,57,60,0.32305320550828087,0.7633411795254375
기준금리/NNG@$인하/NNG@$통화정책/NNG,-1,-0.40644997348544076,60,22,38,22,0.2694885821946991,0.6371067589324564
물가/NNG@$하락/NNG@$압력/NNG,-1,-0.40644997348544076,60,22,38,44,0.2694885821946991,0.6371067589324564
성장률/NNG@$물가/NNG@$상승률/NNG,-1,-0.40644997348544076,60,22,38,38,0.2694885821946991,0.6371067589324564
석유류/NNG@$가격/NNG@$하락/NNG,-1,-0.40644997348544076,60,22,38,20,0.2694885821946991,0.6371067589324564
외국인투자/NNG@$자금/NNG@$유출/NNG,-1,-0.40961224966475285,42,15,27,34,0.22345378032558053,0.5322915516801519
걱정/NNG@$필요/NNG@$없/VA,-1,-0.40961224966475285,42,15,27,25,0.22345378032558053,0.5322915516801519
마지막/NNG@$금리/NNG@$인상/NNG,-1,-0.40961224966475285,42,15,27,26,0.22345378032558053,0.5322915516801519
가격/NNG@$하락/NNG@$압력/NNG,-1,-0.40961224966475285,42,15,27,22,0.22345378032558053,0.5322915516801519
금리/NNG@$인하/NNG@$가능성/NNG@$열/VV,-1,-0.40961416895919,128,48,80,42,0.3522733660345453,0.8391578779305137
경제/NNG@$경기/NNG@$회복/NNG,-1,-0.4099117229034235,99,37,62,32,0.33005941694649626,0.786803156684679
금리/NNG@$인하/NNG@$물가/NNG,-1,-0.4116654936298253,55,20,35,17,0.2554596882313491,0.6115414464003773
기준금리/NNG@$인상/NNG@$기조/NNG,-1,-0.4116654936298253,55,20,35,32,0.2554596882313491,0.6115414464003773
가능성/NNG@$높/VA@$진/VX,-1,-0.41391363912177537,115,43,72,53,0.3415166010996269,0.8219876052439645
채권/NNG@$투자/NNG@$자금/NNG,-1,-0.4143566775368346,68,25,43,40,0.2817410372031707,0.6788397652374129
검토/NNG@$필요/NNG@$있/VA,-1,-0.4147141678297461,94,35,59,47,0.3214426358801783,0.7751664554717533
성장세/NNG@$회복/NNG@$이어지/VV@$중기적/NNG@$물가/NNG,-1,-0.4180210866503542,50,18,32,48,0.24032478904197518,0.5841966480991195
신호/NNG@$보내/VV@$않/VX,-1,-0.4180210866503542,50,18,32,16,0.24032478904197518,0.5841966480991195
경기/NNG@$둔화/NNG@$지속/NNG,-1,-0.4180210866503542,50,18,32,29,0.24032478904197518,0.5841966480991195
경기동행지수/NNG@$순환/NNG@$변동치/NNG,0,-0.418402363383485,29,10,19,14,0.18260619639132628,0.44430040387564973
가능성/NNG@$낮/VA@$진/VX,0,-0.418402363383485,29,10,19,19,0.18260619639132628,0.44430040387564973
인하/NNG@$기조/NNG@$유지/NNG,0,-0.418402363383485,29,10,19,24,0.18260619639132628,0.44430040387564973
지속/NNG@$필요/NNG@$있/VA,-1,-0.42033773702620514,37,13,24,10,0.20496037560554395,0.5010343396338042
요인/NNG@$경기/NNG@$회복/NNG,-1,-0.42033773702620514,37,13,24,11,0.20496037560554395,0.5010343396338042
경기/NNG@$전망/NNG@$하락/NNG,-1,-0.42033773702620514,37,13,24,15,0.20496037560554395,0.5010343396338042
채권/NNG@$보유/NNG@$종사자/NNG,-1,-0.42033773702620514,37,13,24,27,0.20496037560554395,0.5010343396338042
하락/NNG@$물가/NNG@$상승률/NNG,-1,-0.42033773702620514,37,13,24,20,0.20496037560554395,0.5010343396338042
소비/NNG@$지출/NNG@$위축/NNG,-1,-0.42033773702620514,37,13,24,13,0.20496037560554395,0.5010343396338042
경제/NNG@$성장/NNG@$회복/NNG,-1,-0.42033773702620514,37,13,24,14,0.20496037560554395,0.5010343396338042
인상/NNG@$시기/NNG@$예상/NNG,-1,-0.42043427286769863,76,28,48,41,0.2926328991936087,0.7155210472278855
우려/NNG@$금리/NNG@$인하/NNG,-1,-0.42247241075440156,172,64,108,94,0.3548151909712719,0.87186758748544
금리/NNG@$인하/NNG@$압박/NNG,-1,-0.42247241075440156,172,64,108,101,0.3548151909712719,0.87186758748544
공개/NNG@$시장/NNG@$열/VV,-1,-0.4254970051531729,58,21,37,8,0.2552451373940958,0.6318344542115354
민간/NNG@$소비/NNG@$부진/NNG,-1,-0.4254970051531729,58,21,37,32,0.2552451373940958,0.6318344542115354
가격/NNG@$금리/NNG@$인상/NNG,-1,-0.4254970051531729,58,21,37,8,0.2552451373940958,0.6318344542115354
통화정책/NNG@$금리/NNG@$인하/NNG,-1,-0.4257660400555199,71,26,45,31,0.2809895695979934,0.6960187266341585
개선/NNG@$조짐/NNG@$보이/VV,-1,-0.4257660400555199,71,26,45,43,0.2809895695979934,0.6960187266341585
국내총생산/NNG@$기준/NNG@$경제성장률/NNG,-1,-0.42617744763194254,45,16,29,9,0.22390485919390193,0.5551752076547779
소비자/NNG@$물가/NNG@$상승률/NNG@$예상/NNG,-1,-0.42617744763194254,45,16,29,18,0.22390485919390193,0.5551752076547779
금융시장/NNG@$변동성/NNG@$확대/NNG,-1,-0.42922905069621653,159,59,100,112,0.3482284393381358,0.8698999160929127
경제/NNG@$금리/NNG@$인하/NNG,-1,-0.4298411817290777,132,49,83,37,0.34021025314043574,0.8511445413813128
디플레이션/NNG@$우려/NNG@$제기/NNG,0,-0.4308468892600926,21,7,14,17,0.15411891336443423,0.38652903113096226
금리/NNG@$인하/NNG@$필요/NNG,-1,-0.43177943631708704,181,67,114,80,0.3488942988724196,0.8770280227171242
투자/NNG@$채권/NNG@$시장/NNG,-1,-0.4325272385756648,53,19,34,19,0.24045262949874024,0.6055450375266542
금리/NNG@$인상/NNG@$효과/NNG,-1,-0.43378810702943826,173,64,109,84,0.34679136021075246,0.8760542145892367
종합/NNG@$지수/NNG@$오른/VV,-1,-0.436273402311675,74,27,47,58,0.28027336800550684,0.7123649504750611
주택/NNG@$가격/NNG@$상승세/NNG,-1,-0.436273402311675,74,27,47,46,0.28027336800550684,0.7123649504750611
실물/NNG@$지표/NNG@$개선/NNG,0,-0.43661751980041497,32,11,21,16,0.18422532056627028,0.468639207178903
끝/NNG@$나지/NNG@$않/VX,0,-0.43661751980041497,32,11,21,18,0.18422532056627028,0.468639207178903
통화정책/NNG@$기조/NNG@$완화/NNG,0,-0.43661751980041497,32,11,21,19,0.18422532056627028,0.468639207178903
시장/NNG@$충격/NNG@$최소화/NNG,-1,-0.43723164460453545,40,14,26,19,0.20592217445265376,0.5246268921858906
경제/NNG@$회복/NNG@$신호/NNG,-1,-0.43723164460453545,40,14,26,12,0.20592217445265376,0.5246268921858906
경기/NNG@$국면/NNG@$예고/NNG@$선행지수/NNG,-1,-0.43723164460453545,40,14,26,37,0.20592217445265376,0.5246268921858906
원유/NNG@$재고/NNG@$증가/NNG,-1,-0.43723164460453545,40,14,26,17,0.20592217445265376,0.5246268921858906
경기/NNG@$부양책/NNG@$필요/NNG,-1,-0.43723164460453545,40,14,26,16,0.20592217445265376,0.5246268921858906
국면/NNG@$예고/NNG@$선행지수/NNG,-1,-0.43723164460453545,40,14,26,37,0.20592217445265376,0.5246268921858906
내수/NNG@$부진/NNG@$심화/NNG,-1,-0.43723164460453545,40,14,26,14,0.20592217445265376,0.5246268921858906
물가/NNG@$관리/NNG@$목표치/NNG,-1,-0.4381603152810376,61,22,39,21,0.2550790365860553,0.6513557475331946
소비자/NNG@$물가/NNG@$상승률/NNG@$전망치/NNG,-1,-0.439601182558653,82,30,52,35,0.29072469660443645,0.7450283426441228
경기/NNG@$회복/NNG@$지원/NNG,-1,-0.439601182558653,82,30,52,36,0.29072469660443645,0.7450283426441228
물가/NNG@$목표/NNG@$달성/NNG,-1,-0.44060576906970916,201,74,127,124,0.34345580742918297,0.8823522917904206
금리/NNG@$인상/NNG@$점쳤/VV,-1,-0.44123109699654106,48,17,31,21,0.224436134607181,0.5774800420379926
통화정책/NNG@$기조/NNG@$전환/NNG,-1,-0.44123109699654106,48,17,31,16,0.224436134607181,0.5774800420379926
기준금리/NNG@$인하/NNG@$가계부채/NNG,-1,-0.44123109699654106,48,17,31,23,0.224436134607181,0.5774800420379926
통화/NNG@$가치/NNG@$급락/NNG,-1,-0.44123109699654106,48,17,31,58,0.224436134607181,0.5774800420379926
효과/NNG@$크/VA@$않/VX,-1,-0.44245727368254517,182,67,115,98,0.3412891528958406,0.8808212079583517
금리/NNG@$인하/NNG@$배경/NNG,-1,-0.4446058638988669,133,49,84,20,0.33047850317024147,0.8574872383036715
가능성/NNG@$열/VV@$둔/VX,-1,-0.44576833356654644,56,20,36,23,0.24063338846871063,0.6261774027553025
의존도/NNG@$높/VA@$경제/NNG,-1,-0.44576833356654644,56,20,36,28,0.24063338846871063,0.6261774027553025
저금리/NNG@$기조/NNG@$지속/NNG,-1,-0.4459532122612875,77,28,49,29,0.2795873172803746,0.7278787518877876
부양/NNG@$기조/NNG@$유지/NNG,-1,-0.4459532122612875,77,28,49,36,0.2795873172803746,0.7278787518877876
금융/NNG@$위기/NNG@$최저/NNG,0,-0.4475137009391694,24,8,16,28,0.15722737493582126,0.4109226616776879
둔화/NNG@$금리/NNG@$인상/NNG,-1,-0.44777507608694067,199,73,126,127,0.338234130816295,0.8845711540608217
물가/NNG@$안정세/NNG@$보이/VV,-1,-0.4481009159168018,85,31,54,20,0.2898153680685426,0.7585604309953276
시장/NNG@$기준금리/NNG@$동결/NNG,-1,-0.44869938406239196,136,50,86,52,0.3287869379337986,0.8618522264913339
해외/NNG@$자본/NNG@$유입/NNG,-1,-0.4497612892689846,64,23,41,21,0.2549497557263004,0.6700795151426383
금리/NNG@$인하/NNG@$기준금리/NNG,-1,-0.4497612892689846,64,23,41,15,0.2549497557263004,0.6700795151426383
외국인/NNG@$자금/NNG@$유입/NNG,-1,-0.4497612892689846,64,23,41,33,0.2549497557263004,0.6700795151426383
금리/NNG@$인상/NNG@$자금/NNG,-1,-0.4525425130831616,43,15,28,26,0.20696046925967912,0.5477555313059141
금리/NNG@$인상/NNG@$주택/NNG,-1,-0.4525425130831616,43,15,28,17,0.20696046925967912,0.5477555313059141
상승/NNG@$원화/NNG@$가치/NNG,-1,-0.4525425130831616,43,15,28,12,0.20696046925967912,0.5477555313059141
유지/NNG@$소비자/NNG@$물가/NNG,-1,-0.4525425130831616,43,15,28,23,0.20696046925967912,0.5477555313059141
하방/NNG@$리스크/NNG@$커졌/VV,0,-0.4530878764684102,35,12,23,21,0.18592240350130143,0.4927491621792762
경제/NNG@$성장/NNG@$지속/NNG@$중기적/NNG,0,-0.4530878764684102,35,12,23,20,0.18592240350130143,0.4927491621792762
영향/NNG@$금리/NNG@$인하/NNG,0,-0.4530878764684102,35,12,23,16,0.18592240350130143,0.4927491621792762
성장/NNG@$지속/NNG@$중기적/NNG,0,-0.4530878764684102,35,12,23,20,0.18592240350130143,0.4927491621792762
상회/NNG@$증가세/NNG@$갔/VV,0,-0.4530878764684102,35,12,23,25,0.18592240350130143,0.4927491621792762
상태/NNG@$금리/NNG@$인상/NNG,-1,-0.45493154718902973,51,18,33,27,0.22502198176350183,0.5991459661019297
금리/NNG@$동결/NNG@$기조/NNG@$유지/NNG,-1,-0.45493154718902973,51,18,33,12,0.22502198176350183,0.5991459661019297
경기/NNG@$회복/NNG@$물가/NNG@$상승/NNG,-1,-0.45493154718902973,51,18,33,21,0.22502198176350183,0.5991459661019297
경기/NNG@$하강/NNG@$국면/NNG,-1,-0.45617076031311443,96,35,61,22,0.2977978094211505,0.795398847385682
기준금리/NNG@$인하/NNG@$예상/NNG,-1,-0.45619773868029145,142,52,90,71,0.32552013636748356,0.8695025389249
금리/NNG@$인하/NNG@$경제/NNG,-1,-0.4575316009366307,123,45,78,39,0.31720483354449436,0.8501475524266695
인하/NNG@$경기/NNG@$회복/NNG,-1,-0.457865087138008,59,21,38,29,0.2408515591869088,0.6460553499188042
자금/NNG@$유출/NNG@$가능성/NNG,-1,-0.457865087138008,59,21,38,44,0.2408515591869088,0.6460553499188042
경기/NNG@$회복세/NNG@$둔화/NNG,-1,-0.45908634047686003,134,49,85,65,0.32094882677621783,0.8635682699315645
경기/NNG@$둔화/NNG@$금리/NNG@$인상/NNG,-1,-0.46039463301873496,67,24,43,58,0.25484787040093354,0.687986894060167
통화정책/NNG@$경기/NNG@$회복/NNG,-1,-0.46216734658736935,75,27,48,20,0.2672647951693445,0.7247583790904498
원리금/NNG@$상환/NNG@$부담/NNG,-1,-0.46216734658736935,75,27,48,69,0.2672647951693445,0.7247583790904498
달러/NNG@$원/NNG@$환율하락/NNG,-1,-0.46216734658736935,75,27,48,31,0.2672647951693445,0.7247583790904498
경제/NNG@$소비자들/NNG@$심리/NNG,0,-0.4629581970789006,27,9,18,27,0.16022987913824738,0.4353788053335297
시중/NNG@$유동성/NNG@$확대/NNG,-1,-0.46644716726568725,46,16,30,20,0.2080445099862376,0.5703454736600585
기조/NNG@$유지/NNG@$기준금리/NNG,-1,-0.46644716726568725,46,16,30,14,0.2080445099862376,0.5703454736600585
성장/NNG@$전망/NNG@$하향/NNG@$조정/NNG,-1,-0.46644716726568725,46,16,30,16,0.2080445099862376,0.5703454736600585
경기/NNG@$둔화/NNG@$속도/NNG,-1,-0.46644716726568725,46,16,30,25,0.2080445099862376,0.5703454736600585
경기/NNG@$살아나/VV@$않/VX,-1,-0.46741525344364443,54,19,35,25,0.22564267726243487,0.6201207759582609
통화/NNG@$완화/NNG@$선호/NNG,-1,-0.46741525344364443,54,19,35,53,0.22564267726243487,0.6201207759582609
경제/NNG@$전망/NNG@$불확실성/NNG,-1,-0.46741525344364443,54,19,35,32,0.22564267726243487,0.6201207759582609
하향/NNG@$조정/NNG@$전망/NNG,-1,-0.46741525344364443,54,19,35,22,0.22564267726243487,0.6201207759582609
경기/NNG@$활성화/NNG@$대책/NNG,-1,-0.46802934960750675,38,13,25,12,0.18765608666741168,0.5165343067108296
가계/NNG@$기업/NNG@$부채/NNG,-1,-0.46802934960750675,38,13,25,39,0.18765608666741168,0.5165343067108296
산업/NNG@$통상/NNG@$자원/NNG@$부/NNG,-1,-0.4685620682518328,102,37,65,72,0.29571709234792765,0.8150880379275363
통상/NNG@$자원/NNG@$부/NNG,-1,-0.4685620682518328,102,37,65,72,0.29571709234792765,0.8150880379275363
통화/NNG@$가치/NNG@$절하/NNG,-1,-0.46892418393138413,62,22,40,70,0.24109485552951432,0.6651481310157987
인하/NNG@$가능성/NNG@$열/VV,-1,-0.4699407573692439,218,79,139,81,0.3227193850841601,0.8926596667124157
기준금리/NNG@$인하/NNG@$시장/NNG,-1,-0.47014531923988556,70,25,45,23,0.25476575328265766,0.705065632317909
실물/NNG@$경기/NNG@$회복/NNG,-1,-0.4706755801722369,86,31,55,29,0.27767003414476127,0.7694986351898476
강세/NNG@$보일/VV@$전망/NNG,0,-0.4772488697224626,30,10,20,25,0.1631263774638648,0.4597827894130227
속도/NNG@$완만/XR@$예상/NNG,0,-0.4772488697224626,30,10,20,26,0.1631263774638648,0.4597827894130227
기업/NNG@$구조조정/NNG@$추진/NNG,0,-0.4772488697224626,30,10,20,23,0.1631263774638648,0.4597827894130227
원자재/NNG@$가격/NNG@$불안/NNG,0,-0.4772488697224626,30,10,20,15,0.1631263774638648,0.4597827894130227
지속/NNG@$전망/NNG@$통화정책/NNG,0,-0.4772488697224626,30,10,20,18,0.1631263774638648,0.4597827894130227
주가/NNG@$하락/NNG@$환율/NNG,0,-0.4772488697224626,30,10,20,9,0.1631263774638648,0.4597827894130227
시장/NNG@$신뢰/NNG@$회복/NNG,-1,-0.478800952831574,57,20,37,25,0.2262829940600087,0.6403604298427463
하락/NNG@$물가/NNG@$상승/NNG,-1,-0.47904037530412147,65,23,42,27,0.24135354681485055,0.6834324405977591
속도/NNG@$빠르/VA@$않/VX,-1,-0.47904037530412147,65,23,42,38,0.24135354681485055,0.6834324405977591
경기/NNG@$부양/NNG@$나설/VV,-1,-0.47904037530412147,65,23,42,40,0.24135354681485055,0.6834324405977591
달러/NNG@$환율/NNG@$상승/NNG,-1,-0.4790943859822545,49,17,32,33,0.20915145991287826,0.592329788306922
조건/NNG@$부채권/NNG@$금리/NNG,-1,-0.4790943859822545,49,17,32,22,0.20915145991287826,0.592329788306922
환매/NNG@$조건/NNG@$부채권/NNG@$금리/NNG,-1,-0.4790943859822545,49,17,32,22,0.20915145991287826,0.592329788306922
정책/NNG@$다지기/NNG@$필요/NNG,-1,-0.4816146574121757,41,14,27,26,0.1893975858125078,0.5399049286141089
물가/NNG@$상승률/NNG@$기준금리/NNG,-1,-0.4816146574121757,41,14,27,15,0.1893975858125078,0.5399049286141089
소비/NNG@$지출/NNG@$기업/NNG,-1,-0.4816146574121757,41,14,27,14,0.1893975858125078,0.5399049286141089
인상/NNG@$전망/NNG@$금리/NNG,-1,-0.4816146574121757,41,14,27,18,0.1893975858125078,0.5399049286141089
금융/NNG@$경제/NNG@$위험/NNG@$요인/NNG,-1,-0.4816146574121757,41,14,27,20,0.1893975858125078,0.5399049286141089
중소기업/NNG@$금융/NNG@$지원/NNG,-1,-0.4816146574121757,41,14,27,17,0.1893975858125078,0.5399049286141089
정상화/NNG@$금리/NNG@$인상/NNG,-1,-0.4816146574121757,41,14,27,24,0.1893975858125078,0.5399049286141089
금리/NNG@$인하/NNG@$조치/NNG,-1,-0.48192047200063526,328,118,210,82,0.3144562315739599,0.8971153727807764
장기/NNG@$대출/NNG@$프로그램/NNG,-1,-0.4872969578402454,76,27,49,39,0.25463737887057714,0.7367185441734942
금리/NNG@$인상/NNG@$자본/NNG@$유출/NNG,-1,-0.48829816810795834,68,24,44,63,0.24161993954705183,0.7008920601800992
경기/NNG@$둔화/NNG@$인플레이션/NNG,-1,-0.4900594086337652,95,34,61,47,0.27590349273221104,0.8040491541160233
약세/NNG@$원화/NNG@$강세/NNG,0,-0.49045378556904273,33,11,22,23,0.16591732527100567,0.4840243107241631
하방/NNG@$리스크/NNG@$요인/NNG,0,-0.49045378556904273,33,11,22,13,0.16591732527100567,0.4840243107241631
금리/NNG@$인상/NNG@$단행/NNG@$않/VX,-1,-0.490611316349169,52,18,34,32,0.21026425910780458,0.6136499762657119
美/NNG@$금리/NNG@$인상/NNG,-1,-0.4926166752576633,87,31,56,53,0.26586631579471254,0.7800293957405963
금리/NNG@$인하/NNG@$대응/NNG,-1,-0.493986265647685,44,15,29,23,0.19112658304333094,0.5627788826027749
경제/NNG@$회복/NNG@$수출/NNG,-1,-0.493986265647685,44,15,29,30,0.19112658304333094,0.5627788826027749
국채/NNG@$매입/NNG@$재개/NNG,-1,-0.49482911745060254,79,28,51,38,0.2545821779070273,0.7512970477679952
인상/NNG@$자본/NNG@$유출/NNG,-1,-0.49482911745060254,79,28,51,70,0.2545821779070273,0.7512970477679952
금리/NNG@$인하/NNG@$환율/NNG,-1,-0.4986827468814856,63,22,41,12,0.22757810910308676,0.6784986461637309
금리/NNG@$인상/NNG@$논의/NNG,-1,-0.498770561977367,90,32,58,61,0.26553816343076947,0.7918570166565474
국고채/NNG@$금리/NNG@$내린/VV,0,-0.4991660762669635,16,5,11,34,0.11831440303011187,0.3531944990039262
금리/NNG@$동결/NNG@$요인/NNG,-1,-0.5011079956843841,55,19,36,22,0.21137013344281363,0.6342562044625822
가계부채/NNG@$증가/NNG@$속도/NNG,-1,-0.5011079956843841,55,19,36,56,0.21137013344281363,0.6342562044625822
가격/NNG@$하락/NNG@$물가/NNG,-1,-0.5011079956843841,55,19,36,23,0.21137013344281363,0.6342562044625822
상승/NNG@$압력/NNG@$크/VA@$않/VX@$전망/NNG,0,-0.5025712532010844,19,6,13,46,0.125225841970868,0.37723360711223053
금융/NNG@$외환시장/NNG@$불안/NNG,0,-0.5025712532010844,19,6,13,26,0.125225841970868,0.37723360711223053
가능성/NNG@$유의/NNG@$필요/NNG@$있/VA,0,-0.5025712532010844,19,6,13,11,0.125225841970868,0.37723360711223053
필요/NNG@$있/VA@$경기/NNG,-1,-0.5026397991790212,36,12,24,14,0.1686036254041066,0.5079989594664759
완화적/NNG@$통화정책/NNG@$유지/NNG,-1,-0.5026397991790212,36,12,24,25,0.1686036254041066,0.5079989594664759
기준금리/NNG@$결정/NNG@$앞두/VV,-1,-0.5026397991790212,36,12,24,25,0.1686036254041066,0.5079989594664759
민간/NNG@$소비/NNG@$개선/NNG,-1,-0.5026397991790212,36,12,24,14,0.1686036254041066,0.5079989594664759
시장/NNG@$교란/NNG@$요인/NNG,-1,-0.5026397991790212,36,12,24,15,0.1686036254041066,0.5079989594664759
예금/NNG@$대출/NNG@$금리/NNG,-1,-0.5073524589750802,66,23,43,39,0.22821684439642445,0.69634886028084
유동성/NNG@$공급/NNG@$확대/NNG,-1,-0.5083118320842255,118,42,76,18,0.2811233709317975,0.859996469245094
성장/NNG@$모멘텀/NNG@$유지/NNG,0,-0.5088981371602047,22,7,15,17,0.13105341016589592,0.4015443938614376
성장/NNG@$물가/NNG@$전망/NNG,0,-0.5088981371602047,22,7,15,24,0.13105341016589592,0.4015443938614376
소비자/NNG@$물가/NNG@$농산물/NNG,0,-0.5088981371602047,22,7,15,7,0.13105341016589592,0.4015443938614376
경제/NNG@$하방/NNG@$리스크/NNG,-1,-0.5096444579791963,96,34,62,58,0.26489369529023166,0.8132616200647719
변화/NNG@$해외/NNG@$위험/NNG@$요인/NNG,-1,-0.5106806253382503,58,20,38,33,0.2124595323450883,0.654107276898119
소비/NNG@$투자/NNG@$위축/NNG,-1,-0.5138719326160909,39,13,26,15,0.1711865733838949,0.5316094788612334
유로지역/NNG@$경기/NNG@$부진/NNG,-1,-0.5138719326160909,39,13,26,27,0.1711865733838949,0.5316094788612334
경기/NNG@$회복/NNG@$속도/NNG@$둔화/NNG,-1,-0.5138719326160909,39,13,26,10,0.1711865733838949,0.5316094788612334
관측/NNG@$힘/NNG@$얻/VV,-1,-0.5138719326160909,39,13,26,29,0.1711865733838949,0.5316094788612334
금리/NNG@$인상/NNG@$불확실성/NNG,-1,-0.513913990871149,88,31,57,50,0.2544159570147399,0.7901633819320628
금리/NNG@$인하/NNG@$여력/NNG,-1,-0.513913990871149,88,31,57,27,0.2544159570147399,0.7901633819320628
완화/NNG@$금리/NNG@$인하/NNG,-1,-0.5144397619208906,99,35,64,26,0.2645748289940579,0.8228876901782863
금융/NNG@$투자/NNG@$채권/NNG@$시장/NNG,-1,-0.5155531233761144,50,17,33,17,0.194493460347925,0.6067508046404201
위기/NNG@$경기/NNG@$둔화/NNG,-1,-0.5155531233761144,50,17,33,12,0.194493460347925,0.6067508046404201
기조/NNG@$유지/NNG@$금융/NNG@$유의/NNG@$통화정책/NNG,-1,-0.5155531233761144,50,17,33,30,0.194493460347925,0.6067508046404201
금융/NNG@$위기/NNG@$이전/NNG@$회복/NNG,-1,-0.5155531233761144,50,17,33,16,0.194493460347925,0.6067508046404201
완화/NNG@$기준금리/NNG@$인하/NNG,-1,-0.5155531233761144,50,17,33,18,0.194493460347925,0.6067508046404201
유지/NNG@$금융/NNG@$유의/NNG@$통화정책/NNG,-1,-0.5155531233761144,50,17,33,30,0.194493460347925,0.6067508046404201
경기/NNG@$회복/NNG@$가시화/NNG,-1,-0.5186751559905411,144,51,93,45,0.2833095404874527,0.8913745784039718
금리/NNG@$내리/VV@$않/VX,-1,-0.5225149177452295,72,25,47,29,0.22944967650670012,0.7295444394820639
국제금융시장/NNG@$변동성/NNG@$확대/NNG,-1,-0.5225149177452295,72,25,47,57,0.22944967650670012,0.7295444394820639
경기/NNG@$둔화/NNG@$경제/NNG,-1,-0.5241675546569087,94,33,61,59,0.25428563431140344,0.8121920562236106
외환/NNG@$건전성/NNG@$부담금/NNG,-1,-0.5242129030866781,42,14,28,23,0.17366780487273292,0.5547667468916617
전세/NNG@$가격/NNG@$수도권/NNG,-1,-0.5242129030866781,42,14,28,17,0.17366780487273292,0.5547667468916617
자금/NNG@$채권/NNG@$시장/NNG,-1,-0.5242129030866781,42,14,28,7,0.17366780487273292,0.5547667468916617
물가/NNG@$오름세/NNG@$지속/NNG,-1,-0.5242129030866781,42,14,28,8,0.17366780487273292,0.5547667468916617
금리/NNG@$인하/NNG@$금융시장/NNG,-1,-0.5249424712360851,53,18,35,16,0.19611382384159748,0.6277282677182375
문제/NNG@$경기/NNG@$회복/NNG,0,-0.5249734376677873,28,9,19,18,0.1407230403310919,0.4504698573786122
경제/NNG@$성장세/NNG@$예상/NNG,0,-0.5249734376677873,28,9,19,21,0.1407230403310919,0.4504698573786122
전미/NNG@$부동산/NNG@$중개인/NNG@$주택/NNG,0,-0.5249734376677873,28,9,19,25,0.1407230403310919,0.4504698573786122
성장세/NNG@$둔화/NNG@$가능성/NNG,0,-0.5249734376677873,28,9,19,14,0.1407230403310919,0.4504698573786122
하락/NNG@$금리/NNG@$인상/NNG,-1,-0.5273833701896891,64,22,42,49,0.21456239566476287,0.6914208349424331
인상/NNG@$단행/NNG@$않/VX,-1,-0.5273833701896891,64,22,42,41,0.21456239566476287,0.6914208349424331
금리/NNG@$인하/NNG@$반대/NNG,-1,-0.5291315312426196,75,26,49,20,0.23003676236374127,0.744882255814308
소비자/NNG@$물가/NNG@$높/VA,-1,-0.5295644441680161,86,30,56,37,0.24311928767609578,0.7881902308508654
경기/NNG@$부양책/NNG@$내놓/VV,-1,-0.5295644441680161,86,30,56,54,0.24311928767609578,0.7881902308508654
자본/NNG@$유출/NNG@$가능성/NNG,-1,-0.5300860592615647,111,39,72,79,0.2633027499960635,0.8548610321314906
물가/NNG@$상승률/NNG@$낮/VA,-1,-0.5303259244477128,371,130,241,194,0.28046967873605577,0.9112031600569943
수출/NNG@$경기/NNG@$둔화/NNG,0,-0.5334504181112527,31,10,21,28,0.14489211340293234,0.4748431771150046
매입/NNG@$규모/NNG@$줄이/VV,0,-0.5334504181112527,31,10,21,28,0.14489211340293234,0.4748431771150046
하방/NNG@$리스크/NNG@$있/VA,0,-0.5334504181112527,31,10,21,20,0.14489211340293234,0.4748431771150046
경기/NNG@$부진/NNG@$우려/NNG,0,-0.5334504181112527,31,10,21,28,0.14489211340293234,0.4748431771150046
경로/NNG@$하방/NNG@$리스크/NNG,0,-0.5334504181112527,31,10,21,22,0.14489211340293234,0.4748431771150046
인상/NNG@$시기/NNG@$늦추/VV,0,-0.5334504181112527,31,10,21,20,0.14489211340293234,0.4748431771150046
검토/NNG@$기준금리/NNG@$유지/NNG,-1,-0.5337227795899937,45,15,30,21,0.17604924595174018,0.5773904803902622
모습/NNG@$보이/VV@$경기/NNG,-1,-0.5337227795899937,45,15,30,19,0.17604924595174018,0.5773904803902622
목표/NNG@$물가/NNG@$상승률/NNG,-1,-0.5337227795899937,45,15,30,24,0.17604924595174018,0.5773904803902622
채권/NNG@$시장/NNG@$기준금리/NNG@$동결/NNG,-1,-0.5346558605108749,67,23,44,31,0.21556688925087547,0.7088413529317147
신용등급/NNG@$상향/NNG@$조정/NNG,-1,-0.5351774713629279,78,27,51,24,0.23060113621959694,0.7593844050722529
기조/NNG@$갈/VX@$전망/NNG,-1,-0.5351774713629279,78,27,51,24,0.23060113621959694,0.7593844050722529
원화/NNG@$강세/NNG@$수출/NNG,-1,-0.5365886388959085,103,36,67,59,0.2540397313005628,0.8398805483576048
소비/NNG@$심리/NNG@$위축/NNG,-1,-0.5398394494856837,238,83,155,119,0.2738007835169508,0.9135170695462281
확대/NNG@$금리/NNG@$인하/NNG,-1,-0.5412916401835499,70,24,46,43,0.216536216509713,0.7254217387808217
지수/NNG@$하락/NNG@$기록/NNG,-1,-0.5412916401835499,70,24,46,30,0.216536216509713,0.7254217387808217
소비/NNG@$투자/NNG@$심리/NNG@$위축/NNG,-1,-0.5413342004517046,59,20,39,32,0.1992027878202417,0.6674328887240647
중개인/NNG@$주택/NNG@$판매/NNG,0,-0.541797386455845,34,11,23,38,0.14873938558407385,0.4990064479370989
경기/NNG@$둔화/NNG@$수요/NNG,0,-0.541797386455845,34,11,23,25,0.14873938558407385,0.4990064479370989
위안화/NNG@$가치/NNG@$하락/NNG,0,-0.541797386455845,34,11,23,48,0.14873938558407385,0.4990064479370989
상승/NNG@$기조/NNG@$갈/VX@$전망/NNG,-1,-0.5424587499438623,48,16,32,5,0.17833306659448947,0.5994096735267653
통화/NNG@$부양/NNG@$기조/NNG,-1,-0.5424587499438623,48,16,32,25,0.17833306659448947,0.5994096735267653
인하/NNG@$가능성/NNG@$크/VA,-1,-0.5456643943750606,129,45,84,61,0.26136520439614797,0.8865140966915229
경제/NNG@$둔화/NNG@$우려/NNG,-1,-0.5473448421475441,73,25,48,37,0.2174686417720462,0.7411581617448572
경제/NNG@$기초/NNG@$체력/NNG,-1,-0.5473448421475441,73,25,48,32,0.2174686417720462,0.7411581617448572
통화정책/NNG@$변화/NNG@$가능성/NNG,-1,-0.5498551363595423,37,12,25,13,0.15231965209011936,0.5228559775882129
경제/NNG@$전망/NNG@$낙관적/NNG,-1,-0.5498551363595423,37,12,25,13,0.15231965209011936,0.5228559775882129
상승/NNG@$수입/NNG@$물가/NNG,-1,-0.5504749805355171,51,17,34,22,0.18052163758848563,0.6207627920655577
동일/NNG@$점포/NNG@$매출/NNG,-1,-0.5504749805355171,51,17,34,35,0.18052163758848563,0.6207627920655577
은행/NNG@$기준금리/NNG@$인하/NNG,-1,-0.5504749805355171,51,17,34,28,0.18052163758848563,0.6207627920655577
금리/NNG@$인하/NNG@$시사/NNG,-1,-0.5510120165015515,138,48,90,39,0.26037818272459706,0.896745037722654
확장적/NNG@$거시/NNG@$정책/NNG,-1,-0.5512848585201994,118,41,77,39,0.2534724476457185,0.873644470772778
금융/NNG@$위기/NNG@$경제/NNG,-1,-0.553828272952853,173,60,113,68,0.2630253951553181,0.9132176322327802
금융시장/NNG@$불안/NNG@$경기/NNG,-1,-0.5549813419267398,65,22,43,14,0.20207314811123944,0.7039272371525049
금리/NNG@$인하/NNG@$통한/VV,-1,-0.5549813419267398,65,22,43,27,0.20207314811123944,0.7039272371525049
금리/NNG@$인상/NNG@$중단/NNG@$가능성/NNG,-1,-0.5567264285486899,107,37,70,27,0.24424754865776924,0.8551408292442338
금리/NNG@$인하/NNG@$신중/NNG,-1,-0.5575311646946111,40,13,27,17,0.15567172481332903,0.5462964002244194
양적완화/NNG@$축소/NNG@$결정/NNG,-1,-0.5575311646946111,40,13,27,17,0.15567172481332903,0.5462964002244194
요인/NNG@$소비자/NNG@$물가/NNG,-1,-0.5575311646946111,40,13,27,8,0.15567172481332903,0.5462964002244194
결정/NNG@$열/VV@$기준금리/NNG,-1,-0.5575311646946111,40,13,27,25,0.15567172481332903,0.5462964002244194
기업/NNG@$수익성/NNG@$악화/NNG,-1,-0.5575311646946111,40,13,27,29,0.15567172481332903,0.5462964002244194
지속/NNG@$기준금리/NNG@$인상/NNG,-1,-0.5578225525396128,54,18,36,25,0.18261749104092645,0.6413977514026725
기준금리/NNG@$인상/NNG@$여부/NNG@$결정/NNG,-1,-0.5578225525396128,54,18,36,17,0.18261749104092645,0.6413977514026725
견조/NNG@$성장/NNG@$지속/NNG@$물가/NNG@$기조/NNG,-1,-0.5609159350425115,68,23,45,13,0.20342393324637684,0.7209217496794837
소매/NNG@$판매/NNG@$감소/NNG,-1,-0.5609159350425115,68,23,45,48,0.20342393324637684,0.7209217496794837
금리/NNG@$인상/NNG@$경로/NNG,-1,-0.5645494599689597,57,19,38,69,0.18462328450915413,0.6612717104291811
채권/NNG@$시장/NNG@$체감/NNG@$지표/NNG,-1,-0.5647746947765544,43,14,29,33,0.15882411872115965,0.5692413428749883
경제/NNG@$전망/NNG@$불확실/NNG,-1,-0.5647746947765544,43,14,29,14,0.15882411872115965,0.5692413428749883
시장/NNG@$체감/NNG@$지표/NNG,-1,-0.5647746947765544,43,14,29,33,0.15882411872115965,0.5692413428749883
소비자/NNG@$물가/NNG@$기준/NNG,-1,-0.5647746947765544,43,14,29,11,0.15882411872115965,0.5692413428749883
채권/NNG@$가격/NNG@$하락/NNG,-1,-0.5647746947765544,43,14,29,34,0.15882411872115965,0.5692413428749883
소비/NNG@$투자/NNG@$부진/NNG,-1,-0.5647746947765544,43,14,29,30,0.15882411872115965,0.5692413428749883
이자/NNG@$상환/NNG@$부담/NNG,-1,-0.5647746947765544,43,14,29,35,0.15882411872115965,0.5692413428749883
은행/NNG@$금리/NNG@$인하/NNG,-1,-0.5666430925269239,85,29,56,20,0.22081596199919987,0.7957767689137968
금리/NNG@$동결/NNG@$인상/NNG,-1,-0.5757167358535754,77,26,51,30,0.20714176874194684,0.7668266554403617
소비자/NNG@$물가/NNG@$영향/NNG,-1,-0.5763181408414736,63,21,42,16,0.18837575876266802,0.698609224121525
자국/NNG@$통화/NNG@$가치/NNG,-1,-0.5767103576120447,143,49,94,80,0.24452167867471583,0.9078950560368773
정책/NNG@$방향/NNG@$결정/NNG,0,-0.5813824407610839,26,8,18,14,0.11703491129630629,0.44067997789937735
확장/NNG@$국면/NNG@$지속/NNG,0,-0.5813824407610839,26,8,18,13,0.11703491129630629,0.44067997789937735
둔화/NNG@$수출/NNG@$부진/NNG,0,-0.5817936952319558,23,7,16,28,0.11037781833630447,0.4161291115720645
경제/NNG@$성장세/NNG@$완만/XR,0,-0.5817936952319558,23,7,16,31,0.11037781833630447,0.4161291115720645
수출/NNG@$증가세/NNG@$유지/NNG,0,-0.5831822913226021,29,9,20,18,0.12287488013749631,0.46518980593240444
성장/NNG@$경로/NNG@$크/VA,0,-0.5831822913226021,29,9,20,27,0.12287488013749631,0.46518980593240444
자본/NNG@$유출/NNG@$확대/NNG,0,-0.5831822913226021,29,9,20,14,0.12287488013749631,0.46518980593240444
경제/NNG@$경기/NNG@$회복세/NNG,0,-0.5831822913226021,29,9,20,22,0.12287488013749631,0.46518980593240444
기업/NNG@$가격/NNG@$경쟁력/NNG,0,-0.5862868264382715,32,10,22,25,0.12809647262551163,0.48954341958615283
경기/NNG@$둔화/NNG@$대응/NNG,0,-0.5862868264382715,32,10,22,26,0.12809647262551163,0.48954341958615283
양적완화/NNG@$축소/NNG@$금리/NNG,0,-0.5862868264382715,32,10,22,19,0.12809647262551163,0.48954341958615283
금리/NNG@$통화정책/NNG@$결정/NNG,0,-0.5862868264382715,32,10,22,31,0.12809647262551163,0.48954341958615283
통화정책/NNG@$방향/NNG@$물가/NNG,-1,-0.5891683907688456,55,18,37,15,0.16980747415311467,0.6546731467132878
개인/NNG@$소비/NNG@$지출/NNG@$물가지수/NNG@$상승률/NNG,-1,-0.5901325625313465,35,11,24,20,0.13283247957553898,0.5136324668926062
소비/NNG@$지출/NNG@$물가지수/NNG@$상승률/NNG,-1,-0.5901325625313465,35,11,24,20,0.13283247957553898,0.5136324668926062
부동산/NNG@$중개인/NNG@$주택/NNG,-1,-0.5901325625313465,35,11,24,31,0.13283247957553898,0.5136324668926062
자본/NNG@$유출/NNG@$위험/NNG,-1,-0.5901325625313465,35,11,24,27,0.13283247957553898,0.5136324668926062
소비/NNG@$투자/NNG@$수출/NNG,-1,-0.5901325625313465,35,11,24,31,0.13283247957553898,0.5136324668926062
소비자/NNG@$물가/NNG@$상승률/NNG@$둔화/NNG,-1,-0.5901325625313465,35,11,24,27,0.13283247957553898,0.5136324668926062
지속/NNG@$성장잠재력/NNG@$훼손/NNG@$않/VX,-1,-0.5901325625313465,35,11,24,20,0.13283247957553898,0.5136324668926062
지출/NNG@$물가지수/NNG@$상승률/NNG,-1,-0.5901325625313465,35,11,24,21,0.13283247957553898,0.5136324668926062
부동산/NNG@$경기/NNG@$둔화/NNG,-1,-0.5901325625313465,35,11,24,22,0.13283247957553898,0.5136324668926062
인상/NNG@$중단/NNG@$가능성/NNG,-1,-0.590272650434366,112,38,74,29,0.22623955418899436,0.8751912207551334
자금/NNG@$유출/NNG@$우려/NNG,-1,-0.5903464710868417,72,24,48,46,0.19339936773703464,0.7483204602480864
필요/NNG@$금리/NNG@$인하/NNG,-1,-0.5903464710868417,72,24,48,39,0.19339936773703464,0.7483204602480864
금융/NNG@$위기/NNG@$낮/VA,-1,-0.5943591668477652,38,12,26,20,0.13717493296706942,0.5373564941938463
문제/NNG@$금리/NNG@$인하/NNG,-1,-0.5943591668477652,38,12,26,21,0.13717493296706942,0.5373564941938463
필요/NNG@$있/VA@$권고/NNG,-1,-0.5943591668477652,38,12,26,26,0.13717493296706942,0.5373564941938463
조치/NNG@$취할/VV@$준비/NNG,-1,-0.5949790123697523,95,32,63,19,0.21317554571396005,0.8366731770998469
금융시장/NNG@$불안/NNG@$가능성/NNG,0,-0.5964744502649466,17,5,12,22,0.09317552795206106,0.36739091057957746
성장/NNG@$전망/NNG@$경로/NNG,0,-0.5964744502649466,17,5,12,18,0.09317552795206106,0.36739091057957746
경제/NNG@$견조/NNG@$성장/NNG@$지속/NNG@$물가/NNG,-1,-0.5976785949264721,78,26,52,14,0.196378380968117,0.7772150102139705
금리/NNG@$경기/NNG@$부양/NNG,-1,-0.5987319384815881,41,13,28,21,0.14118972548177758,0.560623788330767
금융시장/NNG@$불안/NNG@$심리/NNG,-1,-0.5987319384815881,41,13,28,10,0.14118972548177758,0.560623788330767
국채/NNG@$매입/NNG@$방안/NNG,-1,-0.5987319384815881,41,13,28,15,0.14118972548177758,0.560623788330767
정책/NNG@$기조/NNG@$전환/NNG,-1,-0.5987327697920833,61,20,41,11,0.1744954335533787,0.6928729659322577
전격적/NNG@$금리/NNG@$인하/NNG,-1,-0.6024448065162181,107,36,71,15,0.21629475004159485,0.8688508748270418
경기/NNG@$신뢰/NNG@$지수/NNG,-1,-0.6029191548743618,64,21,43,35,0.17666905333145136,0.7107305820953947
규모/NNG@$자산/NNG@$매입/NNG@$프로그램/NNG,-1,-0.603096613098902,44,14,30,26,0.14492543374362368,0.5833519784234433
금리/NNG@$정상화/NNG@$기조/NNG,-1,-0.6084947018628464,90,30,60,39,0.20154807511837003,0.825184936020797
경기/NNG@$둔화/NNG@$위험/NNG,-1,-0.6133516754039632,73,24,49,29,0.1825841583071297,0.7591851257438338
고용/NNG@$지표/NNG@$부진/NNG,-1,-0.6139419186646906,99,33,66,66,0.2048172854974472,0.8532400022077229
경기/NNG@$회복/NNG@$뒷받침/NNG,-1,-0.6186927281689878,192,64,128,62,0.22041082474996854,0.9323361557758494
통화/NNG@$가치/NNG@$하락/NNG,-1,-0.6217552283452947,132,44,88,115,0.2133648489891688,0.9115342222521708
회복/NNG@$속도/NNG@$둔화/NNG,-1,-0.6282513965735407,65,21,44,21,0.16555257079460525,0.7224677731437158
경제/NNG@$좋/VA@$않/VX,-1,-0.6290813282502232,97,32,65,42,0.194742869627405,0.8521823126929937
금리/NNG@$인상/NNG@$금융시장/NNG,-1,-0.630121912159489,100,33,67,90,0.1959607355575619,0.8604644695506701
경제/NNG@$완만/XR@$회복세/NNG@$지속/NNG@$전망/NNG,-1,-0.635070644655576,36,11,25,31,0.11826989159193117,0.5279376809599453
주택/NNG@$판매/NNG@$지수/NNG,-1,-0.6352110017362023,33,10,23,18,0.11283848179866666,0.5039290791919566
동결/NNG@$인상/NNG@$가능성/NNG,-1,-0.6352110017362023,33,10,23,23,0.11283848179866666,0.5039290791919566
소비자/NNG@$물가/NNG@$상승률/NNG@$농산물/NNG@$가격/NNG,-1,-0.6352110017362023,33,10,23,9,0.11283848179866666,0.5039290791919566
환율/NNG@$급/NNG@$등락/NNG,-1,-0.6358725682690621,39,12,27,12,0.1232238214259803,0.5515284498738403
경기/NNG@$호전/NNG@$예상/NNG,-1,-0.6358725682690621,39,12,27,25,0.1232238214259803,0.5515284498738403
채권/NNG@$시장/NNG@$주식시장/NNG,-1,-0.6358725682690621,39,12,27,13,0.1232238214259803,0.5515284498738403
달러/NNG@$강세/NNG@$보이/VV,-1,-0.6358725682690621,39,12,27,11,0.1232238214259803,0.5515284498738403
하향/NNG@$조정/NNG@$금리/NNG@$인하/NNG,-1,-0.6358725682690621,39,12,27,15,0.1232238214259803,0.5515284498738403
하지/NNG@$않/VX@$생각/NNG,-1,-0.6358725682690621,39,12,27,19,0.1232238214259803,0.5515284498738403
원화/NNG@$강세/NNG@$보이/VV,0,-0.6368021141683184,30,9,21,24,0.10681987493339475,0.47959865160877646
물가/NNG@$하방/NNG@$압력/NNG,0,-0.6368021141683184,30,9,21,32,0.10681987493339475,0.47959865160877646
가격/NNG@$하락/NNG@$확대/NNG,0,-0.6368021141683184,30,9,21,5,0.10681987493339475,0.47959865160877646
중단/NNG@$가능성/NNG@$시사/NNG,-1,-0.6372720039316201,42,13,29,8,0.12778083161294052,0.5746142410362605
위기/NNG@$대응/NNG@$능력/NNG,-1,-0.6372720039316201,42,13,29,12,0.12778083161294052,0.5746142410362605
영향/NNG@$가능성/NNG@$상존/NNG,-1,-0.6390316601734736,45,14,31,41,0.13200138829303604,0.5971173716378425
지수/NNG@$떨어진/VV@$기록/NNG,-1,-0.6390316601734736,45,14,31,28,0.13200138829303604,0.5971173716378425
경제/NNG@$활력/NNG@$제고/NNG,0,-0.6406090273969859,27,8,19,30,0.1000612015178643,0.4550503371185929
성장/NNG@$경로/NNG@$하방/NNG@$리스크/NNG,0,-0.6406090273969859,27,8,19,17,0.1000612015178643,0.4550503371185929
물가/NNG@$상승/NNG@$부담/NNG,-1,-0.6409865628947954,48,15,33,16,0.1359318316907181,0.6189699368030772
경제지표/NNG@$금리/NNG@$인상/NNG,-1,-0.6409865628947954,48,15,33,28,0.1359318316907181,0.6189699368030772
시장/NNG@$유동성/NNG@$공급/NNG,-1,-0.6430214182982887,51,16,35,18,0.1396083814821932,0.6401138795442417
기준금리/NNG@$인상/NNG@$없/VA,-1,-0.6430214182982887,51,16,35,26,0.1396083814821932,0.6401138795442417
경제/NNG@$성장/NNG@$영향/NNG,-1,-0.6430214182982887,51,16,35,25,0.1396083814821932,0.6401138795442417
경기/NNG@$회복세/NNG@$보이/VV,-1,-0.64571954563412,101,33,68,32,0.18744355512055463,0.8673836502775789
우려/NNG@$적/VA@$않/VX,-1,-0.6470333139280031,57,18,39,23,0.14630967911864495,0.6800919012828889
결정/NNG@$금융/NNG@$통화/NNG,-1,-0.6470333139280031,57,18,39,39,0.14630967911864495,0.6800919012828889
고용/NNG@$비용/NNG@$지수/NNG,0,-0.6478120258274989,24,7,17,32,0.09234461210982477,0.43039467173980234
성장/NNG@$하향/NNG@$리스크/NNG,0,-0.6478120258274989,24,7,17,5,0.09234461210982477,0.43039467173980234
성장/NNG@$속도/NNG@$둔화/NNG,-1,-0.6489160752068814,60,19,41,45,0.1493770309611007,0.6988570255751549
전망/NNG@$힘/NNG@$실/VV,-1,-0.6523039065004945,66,21,45,23,0.1550262825870477,0.7338308485218991
주택/NNG@$담보대출/NNG@$증가세/NNG,-1,-0.6523039065004945,66,21,45,29,0.1550262825870477,0.7338308485218991
경제/NNG@$하방/NNG@$위험/NNG,-1,-0.6528320611925242,150,49,101,64,0.19650328237127035,0.9318732721668199
수요/NNG@$하방/NNG@$압력/NNG,0,-0.6602865414157701,21,6,15,16,0.0833535897859103,0.4057468920076176
물가/NNG@$농산물/NNG@$가격/NNG,0,-0.6602865414157701,21,6,15,9,0.0833535897859103,0.4057468920076176
물가/NNG@$불안/NNG@$요인/NNG,-1,-0.6605182923642767,108,35,73,28,0.1821361755052236,0.8873253954817628
금리/NNG@$인상/NNG@$영향/NNG,-1,-0.6626617816349967,151,49,102,77,0.19040953245507508,0.9347068221697997
금융/NNG@$위기/NNG@$충격/NNG,-1,-0.6726114583661037,52,16,36,26,0.1283412286324004,0.6529695726622059
금리/NNG@$인하/NNG@$가능성/NNG@$크/VA,-1,-0.6730024522165174,55,17,38,25,0.13209448265560073,0.6730227781599076
진행/NNG@$금리/NNG@$인상/NNG,-1,-0.6730024522165174,55,17,38,26,0.13209448265560073,0.6730227781599076
금리/NNG@$내릴/VV@$전망/NNG,-1,-0.6742207845120314,40,12,28,24,0.11047781446993413,0.5653933294376833
금리/NNG@$인하/NNG@$양적완화/NNG,-1,-0.6750772905943304,67,21,46,15,0.14508432766395957,0.7448293108702175
대출/NNG@$금리/NNG@$인하/NNG,-1,-0.675628236012543,100,32,68,26,0.1697280086537693,0.8731051086982042
광공업/NNG@$생산/NNG@$증가/NNG,-1,-0.6762274915155966,76,24,52,28,0.15315017349311025,0.7895606561229727
경기/NNG@$부양/NNG@$나서/VV,-1,-0.6762735847070055,94,30,64,40,0.16613900944292986,0.8566691690840061
가격/NNG@$하락/NNG@$경제/NNG,-1,-0.6763671535019427,37,11,26,27,0.10506724586321516,0.5419486364581828
제조업/NNG@$평균/NNG@$가동률/NNG,-1,-0.6763671535019427,37,11,26,36,0.10506724586321516,0.5419486364581828
금리/NNG@$인하/NNG@$가능/NNG,-1,-0.6764795877780638,91,29,62,42,0.1642189331794706,0.847409649844969
내수/NNG@$회복세/NNG@$약화/NNG,-1,-0.6798799704409613,34,10,24,15,0.09913758545220257,0.5180336265588822
수출/NNG@$부진/NNG@$내수/NNG,-1,-0.6798799704409613,34,10,24,25,0.09913758545220257,0.5180336265588822
거시/NNG@$건전성/NNG@$정책/NNG,-1,-0.6906833043460305,132,42,90,106,0.17077257108972904,0.9293232862123453
위험/NNG@$요인/NNG@$가능성/NNG,-1,-0.6907585835877189,98,31,67,6,0.16018437860173368,0.8719537382020272
경상수지/NNG@$흑자/NNG@$기조/NNG,-1,-0.6922413868156508,92,29,63,49,0.15615738723573247,0.8548595522319387
금융/NNG@$불안/NNG@$확산/NNG,0,-0.6936315962325919,28,8,20,17,0.0852469987409656,0.46916489289126895
경기/NNG@$위축/NNG@$가능성/NNG,0,-0.6936315962325919,28,8,20,26,0.0852469987409656,0.46916489289126895
미/NNG@$금리/NNG@$역전/NNG,0,-0.6936315962325919,28,8,20,23,0.0852469987409656,0.46916489289126895
자본/NNG@$유출입/NNG@$동향/NNG,-1,-0.6961107199201619,71,22,49,53,0.1387307673755714,0.7708454711785769
시장/NNG@$금리/NNG@$역전/NNG,-1,-0.6970837442220519,65,20,45,11,0.13253857708474703,0.7392179023366775
환율/NNG@$상승/NNG@$수출/NNG,-1,-0.6970837442220519,65,20,45,33,0.13253857708474703,0.7392179023366775
경기/NNG@$회복/NNG@$긍정적/NNG,-1,-0.7015864329726902,50,15,35,27,0.1136266881894109,0.644964599313999
하락/NNG@$금리/NNG@$인하/NNG,-1,-0.7059479989186277,44,13,31,24,0.10418681369444631,0.6016517023871002
선제적/NNG@$금리/NNG@$인하/NNG,-1,-0.7073057726617807,93,29,64,33,0.14846740418808904,0.8620048331316077
에너지/NNG@$상품/NNG@$가격/NNG,-1,-0.7084780013204994,90,28,62,14,0.14618865363687103,0.8527565249704043
이중/NNG@$침체/NNG@$우려/NNG,-1,-0.7093317782852447,41,12,29,13,0.09891406722750501,0.5789675905604685
소비자/NNG@$물가/NNG@$상승률/NNG@$낮/VA,-1,-0.7104835299073665,115,36,79,64,0.15531688606568683,0.9133213302340133
개인/NNG@$소비/NNG@$지출/NNG@$물가/NNG,-1,-0.7139198338990218,38,11,27,16,0.09319470203173379,0.5556851629988675
성장률/NNG@$전망/NNG@$낮췄/VV,-1,-0.7139198338990218,38,11,27,20,0.09319470203173379,0.5556851629988675
여부/NNG@$결정/NNG@$예정/NNG,-1,-0.7139198338990218,38,11,27,17,0.09319470203173379,0.5556851629988675
차지/NNG@$비중/NNG@$높/VA,-1,-0.7139198338990218,38,11,27,18,0.09319470203173379,0.5556851629988675
금리/NNG@$인하/NNG@$부정적/NNG,-1,-0.7143059128309235,75,23,52,26,0.1330926073224447,0.7948277811635676
고려/NNG@$기준금리/NNG@$인상/NNG,-1,-0.7143059128309235,75,23,52,33,0.1330926073224447,0.7948277811635676
상승/NNG@$수요/NNG@$압력/NNG,-1,-0.7197748256808223,63,19,44,12,0.12004671809015145,0.7331729925055045
금리/NNG@$인상/NNG@$유동성/NNG,-1,-0.7200540516681024,119,37,82,48,0.1507532310363881,0.9217733863575623
금리/NNG@$인상/NNG@$국제금융시장/NNG,-1,-0.7201534270247494,35,10,25,23,0.08695184061695918,0.531881458644586
서부텍사스산원유/NNG@$가격/NNG@$하락/NNG,-1,-0.7201534270247494,35,10,25,17,0.08695184061695918,0.531881458644586
인플레율/NNG@$억제/NNG@$기준치/NNG@$허용/NNG@$한도/NNG,-1,-0.7201534270247494,35,10,25,35,0.08695184061695918,0.531881458644586
경제/NNG@$전망/NNG@$기준금리/NNG,-1,-0.7201534270247494,35,10,25,32,0.08695184061695918,0.531881458644586
가계/NNG@$대출/NNG@$주택/NNG@$담보대출/NNG@$크/VA,0,-0.7242704497885941,22,6,16,22,0.06743069928687154,0.4196016012080965
대출/NNG@$주택/NNG@$담보대출/NNG@$크/VA,0,-0.7242704497885941,22,6,16,23,0.06743069928687154,0.4196016012080965
자금/NNG@$유입/NNG@$주가/NNG,0,-0.7242704497885941,22,6,16,19,0.06743069928687154,0.4196016012080965
전망/NNG@$크/VA@$벗어나/VV@$않/VX,0,-0.7242704497885941,22,6,16,16,0.06743069928687154,0.4196016012080965
경제/NNG@$영향/NNG@$제한적/NNG,-1,-0.7257890327179264,54,16,38,48,0.10821160481920919,0.6776762614832973
구조/NNG@$개혁/NNG@$경제/NNG,-1,-0.7285540421545051,51,15,36,46,0.10376668860460492,0.6574779276828985
생산/NNG@$소매/NNG@$판매/NNG,-1,-0.7285540421545051,51,15,36,40,0.10376668860460492,0.6574779276828985
삭제/NNG@$금리/NNG@$인상/NNG,-1,-0.7358828737112901,70,21,49,32,0.11863720234033377,0.7757255381883386
하방/NNG@$리스크/NNG@$크/VA,-1,-0.7360541307681153,45,13,32,20,0.09394413640601637,0.6147237037695111
금융/NNG@$시스템/NNG@$안정성/NNG,-1,-0.7360541307681153,45,13,32,24,0.09394413640601637,0.6147237037695111
확장/NNG@$국면/NNG@$진입/NNG,0,-0.7402227838867669,29,8,21,20,0.0724892184820098,0.4830624061565678
대출/NNG@$증가세/NNG@$둔화/NNG,0,-0.7402227838867669,29,8,21,7,0.0724892184820098,0.4830624061565678
경상수지/NNG@$흑자/NNG@$규모/NNG,-1,-0.7411562496408174,121,37,84,83,0.13893032499163088,0.9296403327319515
상승률/NNG@$물가/NNG@$목표치/NNG,-1,-0.7412252119484279,42,12,30,15,0.08848403906623815,0.5922637613062729
유지/NNG@$금융/NNG@$경제/NNG@$고려/NNG,-1,-0.7412252119484279,42,12,30,9,0.08848403906623815,0.5922637613062729
수출/NNG@$경제/NNG@$성장/NNG,-1,-0.7412252119484279,42,12,30,24,0.08848403906623815,0.5922637613062729
기업/NNG@$투자/NNG@$심리/NNG,-1,-0.743096486843458,61,18,43,28,0.10766973469392095,0.7266841091175934
정책/NNG@$대응/NNG@$필요/NNG,-1,-0.7460624991650311,58,17,41,21,0.10360127536985243,0.7085522316770231
통화정책/NNG@$금융/NNG@$경제/NNG,-1,-0.7494454260330977,55,16,39,13,0.0992936042469149,0.6895437256194384
시장/NNG@$불안/NNG@$심리/NNG,-1,-0.7510662202395288,74,22,52,24,0.11428274326688675,0.7995148649210785
체감/NNG@$경기/NNG@$수치화/NNG,0,-0.7560670816177303,26,7,19,24,0.06400965908964994,0.4582419003677823
예상/NNG@$벗어나/VV@$않/VX,-1,-0.7560687637476878,36,10,26,20,0.07619635570357192,0.5454901060587627
달성/NNG@$쉽/VA@$않/VX,-1,-0.7560687637476878,36,10,26,36,0.07619635570357192,0.5454901060587627
서비스수지/NNG@$적자/NNG@$확대/NNG,-1,-0.7560687637476878,36,10,26,14,0.07619635570357192,0.5454901060587627
차원/NNG@$금리/NNG@$인하/NNG,-1,-0.7579566444020696,49,14,35,38,0.08985918979001559,0.6489888249086797
상승률/NNG@$농산물/NNG@$가격/NNG,-1,-0.7634212228161452,46,13,33,15,0.0846714552291639,0.6275101772431098
목표/NNG@$소비자/NNG@$물가/NNG,-1,-0.7634212228161452,46,13,33,19,0.0846714552291639,0.6275101772431098
물가/NNG@$상승률/NNG@$농산물/NNG@$가격/NNG,-1,-0.7634212228161452,46,13,33,14,0.0846714552291639,0.6275101772431098
산업/NNG@$생산/NNG@$소매/NNG@$판매/NNG,-1,-0.766745298087816,33,9,24,22,0.06923101768542685,0.5213293990980123
주택/NNG@$가격/NNG@$전망/NNG,-1,-0.766745298087816,33,9,24,44,0.06923101768542685,0.5213293990980123
외환/NNG@$위기/NNG@$겪/VV,-1,-0.766745298087816,33,9,24,23,0.06923101768542685,0.5213293990980123
초저/NNG@$금리/NNG@$기조/NNG@$유지/NNG,-1,-0.7669760094426455,104,31,73,60,0.12026342462684902,0.9066278303121066
소비/NNG@$지출/NNG@$물가/NNG,-1,-0.7699964375130225,43,12,31,19,0.07912147040613288,0.6052912926375525
금리/NNG@$결정/NNG@$시장/NNG,-1,-0.7699964375130225,43,12,31,11,0.07912147040613288,0.6052912926375525
성장/NNG@$부정적/NNG@$영향/NNG,-1,-0.7779919676279727,40,11,29,32,0.07316653443336868,0.5823895401955362
인상/NNG@$속도/NNG@$점진적/NNG,-1,-0.7779919676279727,40,11,29,22,0.07316653443336868,0.5823895401955362
경제/NNG@$불확실성/NNG@$확대/NNG,0,-0.7805340776448646,30,8,22,24,0.06161156062247985,0.49676917330771
경제/NNG@$금융시장/NNG@$불안/NNG,-1,-0.7878030831242879,37,10,27,19,0.06675969783887126,0.5588718738575508
대내외/NNG@$위험/NNG@$요인/NNG,0,-0.7908336919948535,16,4,12,36,0.04352284985267128,0.3702183238933868
전망/NNG@$하방/NNG@$리스크/NNG,-1,-0.791230715875127,57,16,41,19,0.08356633730136472,0.7123410922817671
물가/NNG@$상승률/NNG@$둔화/NNG,-1,-0.793611144244899,120,35,85,78,0.10896298883167743,0.9407196677399335
금리/NNG@$기조/NNG@$유지/NNG,-1,-0.7938602557760804,161,47,114,78,0.11172289978252177,0.9658391206230835
경제/NNG@$둘러싼/VV@$불확실성/NNG,-1,-0.7957983767621792,44,12,32,13,0.07074922752335366,0.6180572273760625
환율/NNG@$가격/NNG@$변수/NNG,-1,-0.7957983767621792,44,12,32,3,0.07074922752335366,0.6180572273760625
주가/NNG@$환율/NNG@$등가격/NNG@$변수/NNG,0,-0.7984017572402614,27,7,20,2,0.053257900562854815,0.47190587073711493
자본/NNG@$유출/NNG@$막/VV,0,-0.7984017572402614,27,7,20,25,0.053257900562854815,0.47190587073711493
경제/NNG@$전망/NNG@$통화정책/NNG,-1,-0.7989286280084938,64,18,46,33,0.08531750964090239,0.7581682094219734
양적완화/NNG@$규모/NNG@$줄이/VV,-1,-0.7999290115091506,34,9,25,23,0.05985258068588431,0.5348145392501685
자산/NNG@$시장/NNG@$과열/NNG,-1,-0.7999290115091506,34,9,25,15,0.05985258068588431,0.5348145392501685
상승률/NNG@$물가/NNG@$목표/NNG@$유지/NNG@$통화정책/NNG,-1,-0.804838925881783,41,11,30,28,0.06482921285524376,0.5953755935103029
경제/NNG@$위기/NNG@$대응/NNG,-1,-0.804838925881783,41,11,30,9,0.06482921285524376,0.5953755935103029
인위적/NNG@$경기/NNG@$부양/NNG,-1,-0.8050477244737462,71,20,51,15,0.08684136760346958,0.7984704222125993
매입/NNG@$규모/NNG@$축소/NNG,-1,-0.8094914715710819,88,25,63,50,0.09252565260101316,0.8725807769314803
금리/NNG@$인하/NNG@$부담/NNG,-1,-0.8147816563714634,65,18,47,32,0.07896421701573136,0.7680400115131012
물가/NNG@$목표/NNG@$소비자/NNG,-1,-0.8149850618676626,31,8,23,16,0.052402469912058616,0.5103024478975671
경기/NNG@$하강/NNG@$막/VV,-1,-0.8156314857649754,38,10,28,11,0.05851715865760791,0.5720350793477593
긴급/NNG@$금리/NNG@$인하/NNG,-1,-0.8182728037097994,137,39,98,6,0.09683493839680869,0.9616638485962277
자본/NNG@$유출입/NNG@$규제/NNG,-1,-0.8182728037097994,137,39,98,15,0.09683493839680869,0.9616638485962277
경기/NNG@$하강/NNG@$위험/NNG,-1,-0.8184224294658484,250,71,179,60,0.09793759483665786,0.9734898721928474
전망/NNG@$불확실성/NNG@$높/VA,-1,-0.8188236876930914,45,12,33,15,0.06328483014738569,0.6305667298934152
금융/NNG@$위기/NNG@$실물경제/NNG,-1,-0.820267209778159,62,17,45,5,0.07476068548472144,0.7514451216863348
채권/NNG@$자금/NNG@$유입/NNG,0,-0.821521612497259,24,6,18,17,0.0441175459796944,0.4468411907591328
불안/NNG@$경기/NNG@$둔화/NNG,-1,-0.8246986718149586,86,24,62,27,0.08418662375634735,0.8695257818754527
은행/NNG@$마이너스금리/NNG@$도입/NNG,-1,-0.8285440102567081,42,11,31,12,0.05747541268789271,0.6081252326505888
물가/NNG@$목표/NNG@$유지/NNG@$통화정책/NNG,-1,-0.8285440102567081,42,11,31,29,0.05747541268789271,0.6081252326505888
하락/NNG@$종합/NNG@$지수/NNG,-1,-0.8285824156669459,35,9,26,16,0.05179036874949896,0.5481072828070906
가치/NNG@$하락/NNG@$막/VV,-1,-0.8285824156669459,35,9,26,17,0.05179036874949896,0.5481072828070906
경기/NNG@$조절적/NNG@$통화정책/NNG,-1,-0.8293836800792143,66,18,48,21,0.07310323012244403,0.7776104444897479
경제/NNG@$완만/XR@$회복/NNG,-1,-0.8293836800792143,66,18,48,38,0.07310323012244403,0.7776104444897479
주의/NNG@$필요/NNG@$있/VA,-1,-0.8304375397378367,49,13,36,17,0.062024729079290804,0.6642169366056535
억제/NNG@$기준치/NNG@$허용/NNG@$한도/NNG,-1,-0.8304375397378367,49,13,36,52,0.062024729079290804,0.6642169366056535
국면/NNG@$진입/NNG@$가능성/NNG,0,-0.8336894013993903,28,7,21,15,0.044388152765352525,0.48542816963530294
소비/NNG@$위축/NNG@$우려/NNG,-1,-0.8392888016312816,46,12,34,16,0.056644673020842896,0.6428235087692782
회복세/NNG@$지속/NNG@$전망/NNG,-1,-0.8397742322841608,84,23,61,55,0.07607441175983468,0.8661409697270206
전미/NNG@$주택/NNG@$건설/NNG,-1,-0.844152918311704,32,8,24,30,0.04464235276634275,0.5236728721569418
목표/NNG@$유지/NNG@$통화정책/NNG,-1,-0.8493841835873003,43,11,32,29,0.051003578916728194,0.6206417774122336
가격/NNG@$하락/NNG@$기록/NNG,-1,-0.8493841835873003,43,11,32,25,0.051003578916728194,0.6206417774122336
금리/NNG@$인상/NNG@$이어지/VV,-1,-0.8531637392138689,36,9,27,25,0.04488114652588784,0.5612131335331931
하향/NNG@$조정/NNG@$경제/NNG,-1,-0.8551539005643543,68,18,50,32,0.06272498340137052,0.7958700161234624
금리/NNG@$인상/NNG@$부동산가격/NNG,-1,-0.855385304994561,61,16,45,10,0.059350301145518196,0.7543390225573322
위안화/NNG@$변동/NNG@$확대/NNG,0,-0.8567767638248802,25,6,19,51,0.03584291428008914,0.4602905230832059
대응/NNG@$금리/NNG@$인하/NNG,-1,-0.8574206663167488,47,12,35,19,0.050747071464307875,0.6548301561666816
공격적/NNG@$금리/NNG@$인하/NNG@$단행/NNG,-1,-0.8574206663167488,47,12,35,10,0.050747071464307875,0.6548301561666816
출구전략/NNG@$금리/NNG@$인상/NNG,-1,-0.8624435164256374,58,15,43,13,0.05494804981458084,0.7366614904341273
내수/NNG@$경기/NNG@$부진/NNG,0,-0.8628115170193906,29,7,22,20,0.037101473351498694,0.4988208628456857
변동성/NNG@$확대/NNG@$경제/NNG,-1,-0.8642617769468538,51,13,38,17,0.05054954841897106,0.6873508865245054
금융시장/NNG@$불안/NNG@$금리/NNG,-1,-0.8686812406652354,33,8,25,15,0.03812087202883463,0.5368862363977506
달러/NNG@$약세/NNG@$지속/NNG,-1,-0.8734464455622484,48,12,36,7,0.04551431803682504,0.6665884216411333
자금/NNG@$이탈/NNG@$우려/NNG,-1,-0.8741523060861246,37,9,28,26,0.03897062645904504,0.5741347127092953
완화/NNG@$정책/NNG@$펴/VV,-1,-0.8741523060861246,37,9,28,13,0.03897062645904504,0.5741347127092953
인상/NNG@$전망/NNG@$우세/NNG,-1,-0.8741523060861246,37,9,28,17,0.03897062645904504,0.5741347127092953
상승/NNG@$경제/NNG@$성장/NNG,-1,-0.8784671064041303,52,13,39,22,0.04570046145179262,0.6985246353823908
물가/NNG@$상승률/NNG@$머물/VV,-1,-0.8791341017897228,41,10,31,18,0.03969471208873145,0.6102550950655474
수출/NNG@$견조/NNG@$증가세/NNG,0,-0.8849056163290632,26,6,20,6,0.02926430796966177,0.47364762941625155
소비자/NNG@$물가/NNG@$상승률/NNG@$석유류/NNG@$가격/NNG,-1,-0.8866883476111005,30,7,23,19,0.031125698763047136,0.5120899580953101
물가/NNG@$상승률/NNG@$석유류/NNG@$가격/NNG,-1,-0.8866883476111005,30,7,23,19,0.031125698763047136,0.5120899580953101
상승률/NNG@$석유류/NNG@$가격/NNG,-1,-0.8866883476111005,30,7,23,19,0.031125698763047136,0.5120899580953101
은행/NNG@$대출/NNG@$증가/NNG,-1,-0.8920161061710614,38,9,29,18,0.03391808570013739,0.5868724998587747
원달러/NNG@$환율/NNG@$하락/NNG,-1,-0.8920161061710614,38,9,29,33,0.03391808570013739,0.5868724998587747
기준금리/NNG@$인하/NNG@$조치/NNG,-1,-0.8941972198284212,57,14,43,15,0.04180324500492928,0.7388783608141513
전망/NNG@$성장/NNG@$경로/NNG,-1,-0.8948362567691518,42,10,32,47,0.035001430939089063,0.6225764305245902
자산/NNG@$매입/NNG@$규모/NNG@$축소/NNG,-1,-0.8972325895533219,76,19,57,43,0.04660598358884401,0.849138098244153
등가격/NNG@$변수/NNG@$변동성/NNG,0,-0.8972905251850324,14,3,11,9,0.019673861997220005,0.35865858019518293
대외/NNG@$불확실성/NNG@$확대/NNG,-1,-0.897536885888892,46,11,35,21,0.03593855216538665,0.6568070905242209
주택/NNG@$착공/NNG@$실적/NNG,-1,-0.9062160036444674,62,15,47,31,0.03871856536803557,0.7756917249018381
금리/NNG@$인상/NNG@$점치/VV,-1,-0.9071915206543953,39,9,30,21,0.029598346566059523,0.5994254039058049
금리/NNG@$인상/NNG@$대외/NNG,0,-0.9072295371689945,27,6,21,34,0.024032806650323823,0.48691841190334945
금융/NNG@$위기/NNG@$우려/NNG,-1,-0.908365538215751,43,10,33,17,0.030929783272726115,0.6346875961648938
기준금리/NNG@$인하/NNG@$추가경정예산/NNG,-1,-0.908365538215751,43,10,33,24,0.030929783272726115,0.6346875961648938
회복/NNG@$지연/NNG@$가능성/NNG,-1,-0.9200725293965554,40,9,31,15,0.025902035788288955,0.6117912067447051
금융/NNG@$위기/NNG@$해소/NNG,-1,-0.9202675851660963,48,11,37,5,0.028707904097767373,0.6797641359287697
저축/NNG@$은행/NNG@$부실/NNG,-1,-0.9202675851660963,48,11,37,2,0.028707904097767373,0.6797641359287697
통화정책/NNG@$결정/NNG@$기준금리/NNG,-1,-0.9206545754430204,36,8,28,15,0.02418770262566655,0.5755940221285106
비둘기파/NNG@$통화/NNG@$완화/NNG@$선호/NNG,-1,-0.9206545754430204,36,8,28,38,0.02418770262566655,0.5755940221285106
수요/NNG@$상승/NNG@$압력/NNG,-1,-0.9206852566770891,52,12,40,12,0.029872407452783134,0.7111544634769355
결정/NNG@$기준금리/NNG@$인상/NNG,-1,-0.9220966969118002,32,7,25,16,0.022198070144555413,0.5382610002185347
예상/NNG@$기업/NNG@$많/VA,-1,-0.9220966969118002,32,7,25,32,0.022198070144555413,0.5382610002185347
확대/NNG@$가능성/NNG@$있/VA,-1,-0.9249124733814036,28,6,22,18,0.01986272580964101,0.5001036459120984
금리/NNG@$인하/NNG@$부작용/NNG,-1,-0.929196037199217,53,12,41,37,0.0269971117122028,0.721680947088324
석유류/NNG@$가격/NNG@$상승/NNG,0,-0.929925239398842,15,3,12,21,0.013751015833982961,0.3714816090154952
구매자/NNG@$관리/NNG@$지수/NNG,-1,-0.9310066522287078,41,9,32,15,0.022734812551072694,0.623966909580573
근거/NNG@$금리/NNG@$인상/NNG,-1,-0.9310066522287078,41,9,32,18,0.022734812551072694,0.623966909580573
경제/NNG@$전망/NNG@$하방/NNG,-1,-0.9325777618953988,37,8,29,13,0.020935257953718357,0.5881789387849333
움직임/NNG@$보이/VV@$않/VX,-1,-0.9350709990698346,33,7,26,8,0.018882146831077678,0.5511579795799888
자금/NNG@$해외/NNG@$유출/NNG,-1,-0.9351382584751494,66,15,51,6,0.02773694947320079,0.8104745129648714
건전성/NNG@$종/NNG@$세트/NNG,-1,-0.9389278904922834,29,6,23,23,0.01652594106432969,0.5132005765505884
인상/NNG@$이뤄질/VV@$전망/NNG,-1,-0.9402952749339777,42,9,33,24,0.020016049105348495,0.6359490043422631
원화/NNG@$강세/NNG@$요인/NNG,-1,-0.9402952749339777,42,9,33,21,0.020016049105348495,0.6359490043422631
상승률/NNG@$낮/VA@$물가/NNG,-1,-0.9425317870941368,38,8,30,12,0.018190160112722422,0.6005984008620376
전망/NNG@$지수/NNG@$하락/NNG,0,-0.9447625396512771,25,5,20,25,0.013814526121210403,0.4746454854685952
세월/NNG@$사고/NNG@$영향/NNG,-1,-0.9456702140009177,34,7,27,16,0.01614221123723668,0.5639230059011203
국책은행/NNG@$자본/NNG@$확충/NNG,-1,-0.9472091974343109,81,18,63,38,0.024716358743280632,0.8886980128912233
식료품/NNG@$에너지/NNG@$지수/NNG,0,-0.9533602300979874,21,4,17,21,0.010711553891170985,0.4358655706038481
규모/NNG@$유동성/NNG@$공급/NNG,-1,-0.9549296881253989,44,9,35,20,0.01566063488241714,0.6593170237740805
정책/NNG@$공조/NNG@$차원/NNG,-1,-0.9581758795202713,49,10,39,39,0.015501319613029172,0.7028265886105992
경제/NNG@$성장/NNG@$속도/NNG@$둔화/NNG,-1,-0.9589451708847628,31,6,25,20,0.011673998096528035,0.5391072423969752
경기/NNG@$상승/NNG@$수요/NNG@$압력/NNG,-1,-0.9606795521399873,45,9,36,7,0.01391731338506447,0.670695084424481
은행권/NNG@$가계/NNG@$대출/NNG,-1,-0.9606795521399873,45,9,36,17,0.01391731338506447,0.670695084424481
경제/NNG@$혁신/NNG@$계획/NNG,-1,-0.9637008742617315,41,8,33,74,0.012214106593667472,0.6368122048442029
회복/NNG@$속도/NNG@$빠르/VA,-1,-0.9656014653481964,46,9,37,16,0.012406249293748855,0.6818640422705522
인상/NNG@$지연/NNG@$가능성/NNG,-1,-0.9660614655306321,32,6,26,19,0.009910169696563392,0.5519023633431905
역할/NNG@$할/VV@$기대/NNG,-1,-0.966505160656442,60,12,48,8,0.013977610666125075,0.7885058388711573
구조/NNG@$개혁/NNG@$정책/NNG,-1,-0.9672114100621749,51,10,41,30,0.01256540730875075,0.7237582388883046
돈/NNG@$돌/VV@$않/VX,-1,-0.9673640445497224,37,7,30,13,0.010392994478957418,0.6013628318186687
단기/NNG@$시장/NNG@$금리/NNG,-1,-0.9686467666135893,42,8,34,22,0.010778074233550212,0.6485170796997869
경기/NNG@$부진/NNG@$장기화/NNG,-1,-0.9717460527425362,28,5,23,9,0.007718514209881792,0.5138275890011735
유지/NNG@$물가/NNG@$상승률/NNG,-1,-0.9717934065897943,33,6,27,16,0.00846714855274794,0.5645809412961841
정책/NNG@$수단/NNG@$개발/NNG,0,-0.9725469972631454,23,4,19,19,0.006750602310471581,0.46207063544652704
경제/NNG@$완만/XR@$회복세/NNG@$갈/VX,0,-0.9725469972631454,23,4,19,21,0.006750602310471581,0.46207063544652704
상품/NNG@$가격/NNG@$하락/NNG,-1,-0.9742648535878193,141,28,113,30,0.013630689899083412,0.9930109027740089
요인/NNG@$자본/NNG@$유출입/NNG,0,-0.9750678089028612,18,3,15,33,0.005461789752734185,0.41021359368811616
가계부채/NNG@$상환/NNG@$부담/NNG,0,-0.9750678089028612,18,3,15,25,0.005461789752734185,0.41021359368811616
금융/NNG@$위기/NNG@$확산/NNG,-1,-0.9750757502441544,63,12,51,15,0.010828158329719782,0.8135094148078608
기준금리/NNG@$인상/NNG@$지연/NNG,-1,-0.9763819360179783,44,8,36,26,0.008486295359013808,0.671345023422097
지준/NNG@$금리/NNG@$인하/NNG,-1,-0.9794069575587779,45,8,37,21,0.007570628998707138,0.6824580889833632
기준금리/NNG@$인상/NNG@$어려울/VA,-1,-0.9802185389123472,35,6,29,18,0.006295714665191623,0.5895532538138748
자본/NNG@$유출/NNG@$환율/NNG,-1,-0.9825038116283794,41,7,34,8,0.006174674659476671,0.6490254638650436
가계부채/NNG@$구조/NNG@$개선/NNG,0,-0.986349580361901,20,3,17,36,0.0032976155413331075,0.43623563910259977
채무/NNG@$상환/NNG@$능력/NNG,-1,-0.9872848533358127,32,5,27,22,0.004002717528044242,0.5649511235830372
금리/NNG@$인하/NNG@$공조/NNG,-1,-0.9877317829241042,104,18,86,3,0.006654145170868853,0.9701853980373301
견조/NNG@$성장/NNG@$지속/NNG@$물가/NNG@$유지/NNG,-1,-0.9877709639942549,49,8,41,6,0.004956775108936345,0.7248033230295683
완화/NNG@$정책/NNG@$필요/NNG,-1,-0.987990642419989,38,6,32,16,0.004210883719364096,0.6259183865607238
기준금리/NNG@$인하/NNG@$경기/NNG@$부양/NNG,-1,-0.987990642419989,38,6,32,26,0.004210883719364096,0.6259183865607238
지속/NNG@$물가/NNG@$유지/NNG,-1,-0.9892013460097532,50,8,42,6,0.0044934297692725686,0.7348451457615227
성장/NNG@$지속/NNG@$물가/NNG@$유지/NNG,-1,-0.9892013460097532,50,8,42,6,0.0044934297692725686,0.7348451457615227
회복세/NNG@$지속/NNG@$유로지역/NNG,-1,-0.990110522568845,45,7,38,30,0.0039230866090833386,0.6937181510420003
금리/NNG@$인상/NNG@$달러/NNG@$강세/NNG,-1,-0.9905866049706974,74,12,62,34,0.004805572395216804,0.8875145342666687
인상/NNG@$달러/NNG@$강세/NNG,-1,-0.9950040576222107,82,12,70,43,0.002951344089888723,0.9256496983397076
초과/NNG@$지준/NNG@$금리/NNG@$인하/NNG,-1,-0.9956378631555377,38,5,33,19,0.0018306736489410056,0.6379107286169714
금리/NNG@$인상/NNG@$인내심/NNG,-1,-0.9970538418232264,68,9,59,29,0.0018796921471165603,0.8707397087859089
통화/NNG@$금융/NNG@$대책/NNG,-1,-0.998414658648581,28,3,25,24,0.0007971080174381031,0.5399309235999473
소비/NNG@$설비투자/NNG@$내수/NNG,-1,-0.9997058179296425,41,4,37,12,0.0005669219646325807,0.6832940851203743
결정적/NNG@$역할/NNG@$할/VV,-1,-1.0,43,4,39,7,0.0004809883720460958,0.7047685499264619
