word,label,polarity,count,pos_count,neg_count,neu_count,pos_score,neg_score
증권/NNG@$투자/NNG@$자금/NNG@$유출/NNG,0,1.0,16,15,1,19,0.4194016825033851,1.0687500014682286e-06
외국인/NNG@$증권/NNG@$투자/NNG@$자금/NNG@$유출/NNG,0,0.9999963422183511,14,13,1,19,0.39175131974965527,1.7146405442596954e-06
마이너스/NNG@$갭/NNG@$지속/NNG,1,0.9999659641117542,44,39,5,11,0.7295548930885526,1.427275279981815e-05
회복세/NNG@$완만/XR@$예상/NNG,1,0.9995994399801857,37,31,6,15,0.6361567469316863,0.00012903466853406612
정책/NNG@$일관성/NNG@$유지/NNG,1,0.9987398329247454,37,30,7,24,0.6234936642633502,0.0003946234629123744
금리/NNG@$인상/NNG@$소수/NNG@$의견/NNG,1,0.9974447450487822,43,34,9,7,0.6727790397541473,0.0008622300912180914
경제/NNG@$회복세/NNG@$완만/XR,1,0.9958043377622194,49,38,11,33,0.7185045901930956,0.0015120463908665685
지속/NNG@$도움/NNG@$방향/NNG,1,0.9951742579996341,40,31,9,12,0.6360133304540142,0.0015396913154571885
경기/NNG@$회복세/NNG@$지속/NNG@$도움/NNG@$방향/NNG,1,0.9951742579996341,40,31,9,11,0.6360133304540142,0.0015396913154571885
회복세/NNG@$지속/NNG@$도움/NNG@$방향/NNG,1,0.9951742579996341,40,31,9,11,0.6360133304540142,0.0015396913154571885
인상/NNG@$소수/NNG@$의견/NNG,1,0.9929353969169217,97,73,24,16,0.9520969671749193,0.0033768717483089136
물가/NNG@$상방/NNG@$리스크/NNG,0,0.9925648315429112,22,17,5,19,0.4471734276452841,0.0016694659242473034
지준율/NNG@$인상/NNG@$조치/NNG,1,0.9922251596918923,30,23,7,23,0.5304347246219095,0.002071072064816025
경제/NNG@$하강/NNG@$리스크/NNG,1,0.9889496529715138,44,33,11,13,0.6604466481430423,0.003670418608624296
사상/NNG@$최저/NNG@$동결/NNG,1,0.9831026599654968,42,31,11,17,0.6356137043911416,0.00541654822206825
금융/NNG@$균형/NNG@$누적/NNG,0,0.9826878430292283,20,15,5,22,0.4192386895718693,0.003661097149263501
인플레이션기대심리/NNG@$낮추/VV@$노력/NNG,1,0.9811247428422951,52,38,14,15,0.7178027263059611,0.006839566461267761
대미/NNG@$무역/NNG@$흑자/NNG,0,0.9798948368461802,27,20,7,24,0.48879806683034627,0.004963981500269039
경제/NNG@$전망/NNG@$개선/NNG,1,0.9789989477134275,34,25,9,11,0.557343000022491,0.005914915026350823
경기/NNG@$회복/NNG@$저해/NNG,1,0.97893695431777,41,30,11,21,0.6228759689548345,0.006630113154409291
은행/NNG@$지준율/NNG@$인상/NNG,1,0.9743668533939147,57,41,16,25,0.7491173169657207,0.009726019866632199
기준금리/NNG@$인상/NNG@$나서/VV,1,0.9736082934711086,40,29,11,11,0.6099323363223756,0.008156369751982816
성장세/NNG@$둔화/NNG@$예상/NNG,1,0.9693960169319353,36,26,10,9,0.570510284559137,0.008865544348032614
인상/NNG@$시중/NNG@$유동성/NNG,1,0.9693409598694311,46,33,13,15,0.6597006046243045,0.010270259597662501
장단기/NNG@$시장/NNG@$금리/NNG,1,0.9673009268996511,29,21,8,5,0.5024482068689936,0.008351188049361634
물가/NNG@$목표/NNG@$하회/NNG,0,0.9656054095040676,22,16,6,16,0.43294861148956215,0.007575635499027764
물가/NNG@$상승세/NNG@$확대/NNG,1,0.9645125372191972,42,30,12,19,0.6224065214863964,0.011242973081235164
훼손/NNG@$않/VX@$중기적/NNG@$소비자/NNG@$물가/NNG,1,0.962575114195287,45,32,13,18,0.6472734051445503,0.012342568527057061
성장잠재력/NNG@$훼손/NNG@$않/VX@$중기적/NNG@$소비자/NNG,1,0.962575114195287,45,32,13,18,0.6472734051445503,0.012342568527057061
경제/NNG@$불확실성/NNG@$높/VA,1,0.962575114195287,45,32,13,28,0.6472734051445503,0.012342568527057061
엔/NNG@$캐리/NNG@$자금/NNG,1,0.9605048086630039,35,25,10,15,0.5569101931590479,0.01121868320840866
내수/NNG@$수출/NNG@$균형/NNG,0,0.9598110528326353,25,18,7,19,0.46069755400880674,0.009446865805356724
성장/NNG@$모멘텀/NNG@$유지/NNG,0,0.9598110528326353,25,18,7,14,0.46069755400880674,0.009446865805356724
경제/NNG@$경제정책/NNG@$방향/NNG,0,0.9598110528326353,25,18,7,29,0.46069755400880674,0.009446865805356724
유로지역/NNG@$경제활동/NNG@$부진/NNG,1,0.9593224632076385,70,49,21,22,0.8210326321532294,0.017044641863809214
상승률/NNG@$물가/NNG@$목표/NNG@$통화정책/NNG,1,0.9571176832842407,57,40,17,17,0.7378690847059282,0.01616651700891753
금리/NNG@$격차/NNG@$확대/NNG,1,0.9541728947767825,44,31,13,9,0.6346060642132891,0.014881135675090048
유럽연합/NNG@$탈퇴/NNG@$결정/NNG,1,0.9515816527998271,31,22,9,32,0.515935174976008,0.012799355584127163
서브프라임/NNG@$모기/NNG@$지발/NNG,1,0.9484701643714912,62,43,19,12,0.7673148069403233,0.020291092328737236
외국인/NNG@$증권/NNG@$자금/NNG,0,0.9480910011727663,21,15,6,6,0.4188922073583479,0.011160977079064728
개선/NNG@$금리/NNG@$인하/NNG,1,0.944985593557329,40,28,12,14,0.5961395700889796,0.016860559677965636
금리/NNG@$상승/NNG@$가계부채/NNG,1,0.943732761863477,43,30,13,15,0.6217005481370154,0.017995476167467567
자산/NNG@$가격/NNG@$급등/NNG,1,0.9393151186074336,88,60,28,32,0.8926851347407143,0.027931254266371053
양적완화/NNG@$축소/NNG@$금융시장/NNG,0,0.9381964428291445,27,19,8,29,0.47427420680858967,0.015121834935186408
증가/NNG@$경기/NNG@$회복/NNG,1,0.9320261570283499,36,25,11,17,0.5562042512707002,0.019566760863880688
경상수지/NNG@$흑자/NNG@$감소/NNG,1,0.9307673338829892,42,29,13,8,0.6085578889203466,0.021819167671584636
갭/NNG@$플러스/NNG@$전환/NNG,1,0.9305498960367111,48,33,15,22,0.6581159504046864,0.023672784605566943
민간/NNG@$자생력/NNG@$회복/NNG,1,0.9258680168598821,83,56,27,8,0.8680963698313079,0.03341180192940253
자본/NNG@$유출/NNG@$압력/NNG,1,0.9166590025781551,47,32,15,35,0.6454546312779464,0.02806265472263223
물가/NNG@$목표/NNG@$통화정책/NNG,1,0.9161571508289461,76,51,25,21,0.8329539258298149,0.036442225845169006
기업/NNG@$구조조정/NNG@$진행/NNG,1,0.9156477560451939,44,30,14,24,0.6206880482426007,0.027327707445330154
수요/NNG@$압력/NNG@$완화/NNG,1,0.9138685512612301,38,26,12,9,0.5690139772243133,0.025604765239167004
상하/NNG@$종합/NNG@$지수/NNG,1,0.9138685512612301,38,26,12,13,0.5690139772243133,0.025604765239167004
경제/NNG@$전망/NNG@$예상/NNG,1,0.9138685512612301,38,26,12,11,0.5690139772243133,0.025604765239167004
경기/NNG@$회복/NNG@$않/VX,1,0.9063594332512532,55,37,18,10,0.702938954583958,0.03452412724205839
가격/NNG@$동향/NNG@$기준금리/NNG@$인상/NNG@$확률/NNG,1,0.8999413021745464,46,31,15,22,0.6325157668384173,0.03330658387136095
국채/NNG@$가격/NNG@$동향/NNG@$기준금리/NNG@$인상/NNG,1,0.8999413021745464,46,31,15,22,0.6325157668384173,0.03330658387136095
동향/NNG@$기준금리/NNG@$인상/NNG@$확률/NNG,1,0.8999413021745464,46,31,15,22,0.6325157668384173,0.03330658387136095
가격/NNG@$상승/NNG@$우려/NNG,1,0.8974710565048036,43,29,14,11,0.6073861745907616,0.032815548092872286
인상/NNG@$가능성/NNG@$커졌/VV,1,0.8937747081962686,57,38,19,20,0.7130775564686568,0.039992533963862036
재정/NNG@$문제/NNG@$국제금융시장/NNG,1,0.8920939426008525,37,25,12,9,0.555127527689965,0.03165468769334619
정책금리/NNG@$인상/NNG@$시장/NNG,1,0.8864010220996859,31,21,10,11,0.5009057771722736,0.03016041525892211
중소기업/NNG@$대출/NNG@$증가/NNG,1,0.8864010220996859,31,21,10,9,0.5009057771722736,0.03016041525892211
시중/NNG@$유동성/NNG@$증가세/NNG,1,0.8864010220996859,31,21,10,17,0.5009057771722736,0.03016041525892211
소비자/NNG@$물가/NNG@$상승률/NNG@$상승/NNG,1,0.8839248348936384,48,32,16,20,0.6440294304822436,0.039675445235636285
경제/NNG@$환경/NNG@$변화/NNG,1,0.8839248348936384,48,32,16,26,0.6440294304822436,0.039675445235636285
거시/NNG@$경제/NNG@$금융/NNG,1,0.8839248348936384,48,32,16,28,0.6440294304822436,0.039675445235636285
경제/NNG@$수출/NNG@$부진/NNG,0,0.8812286917816035,25,17,8,18,0.44571861324508616,0.02813652944359917
규모/NNG@$자본/NNG@$유출/NNG,0,0.8812286917816035,25,17,8,24,0.44571861324508616,0.02813652944359917
인상/NNG@$단행/NNG@$시사/NNG,1,0.879900892585072,45,30,15,12,0.6192951929223284,0.039558706585152835
콜금리/NNG@$인상/NNG@$단행/NNG,1,0.8793348445338358,81,53,28,19,0.8437578845074979,0.054167026233061945
콜금리/NNG@$인하/NNG@$가능성/NNG,1,0.8765312555635043,67,44,23,11,0.7715362158839034,0.05075705902517242
전미/NNG@$주택/NNG@$건설업/NNG,1,0.8727570255840005,53,35,18,37,0.6786950065365678,0.0461068279370622
기대/NNG@$심리/NNG@$높/VA,1,0.8726636711382809,64,42,22,13,0.7524383413483839,0.051156597743218
인하/NNG@$정책/NNG@$효과/NNG,1,0.8704710386818089,39,26,13,31,0.567693719529535,0.03930680947510077
금융시장/NNG@$가격/NNG@$변수/NNG,1,0.868335169201875,61,40,21,16,0.7323198531671683,0.05160042110424729
외국인/NNG@$주식/NNG@$투자/NNG@$자금/NNG,1,0.8678292568324408,50,33,17,15,0.6552198332949914,0.04635777131354781
성장/NNG@$둔화/NNG@$인플레/NNG,1,0.8649535155806098,36,24,12,16,0.5410186334429151,0.03917097405513339
채권/NNG@$시장/NNG@$경제/NNG,1,0.8649535155806098,36,24,12,14,0.5410186334429151,0.03917097405513339
성장/NNG@$동력/NNG@$약화/NNG,1,0.8649535155806098,36,24,12,20,0.5410186334429151,0.03917097405513339
물가/NNG@$상승/NNG@$전망/NNG,1,0.8603443976563074,104,67,37,27,0.9154228461766106,0.06871046647692633
기술/NNG@$지수/NNG@$내린/VV@$마감/NNG,1,0.8588141813902224,33,22,11,31,0.51390878185888,0.0390280667728541
인상/NNG@$시기/NNG@$가늠/NNG,1,0.8588141813902224,33,22,11,17,0.51390878185888,0.0390280667728541
금리/NNG@$상승/NNG@$마감/NNG,1,0.8588141813902224,33,22,11,20,0.51390878185888,0.0390280667728541
금리/NNG@$상승/NNG@$제한/NNG,1,0.856009758550802,44,29,15,10,0.6057868442367101,0.04699028915345591
가능성/NNG@$강하/VA@$시사/NNG,1,0.8556653565937464,63,41,22,28,0.7414209897993849,0.05765954674869529
총액/NNG@$대출한도/NNG@$축소/NNG,1,0.8499167140921382,60,39,21,32,0.7207922715755516,0.0584688918246631
증시/NNG@$금리/NNG@$인상/NNG,1,0.8499167140921382,60,39,21,29,0.7207922715755516,0.0584688918246631
기조/NNG@$이어질/VV@$전망/NNG,1,0.8489785570686714,68,44,24,18,0.7692937458519046,0.06282513032985781
필요/NNG@$있/VA@$통화정책/NNG,1,0.8488937382379016,41,27,14,9,0.5799827306233198,0.04739363462800764
통화/NNG@$완화/NNG@$정책/NNG@$유지/NNG,1,0.8488937382379016,41,27,14,15,0.5799827306233198,0.04739363462800764
변동성/NNG@$크/VA@$확대/NNG,1,0.8448387974606513,49,32,17,25,0.6421725247238489,0.05400205893099618
금리/NNG@$정상화/NNG@$추진/NNG,1,0.8407772747327391,38,25,13,9,0.5535768685367114,0.047875694484044426
시장/NNG@$금리/NNG@$상승세/NNG,1,0.8407772747327391,38,25,13,20,0.5535768685367114,0.047875694484044426
금리/NNG@$인상/NNG@$단행/NNG@$예상/NNG,1,0.8373072038178726,70,45,25,25,0.7772085631071854,0.06881086497339665
통화/NNG@$긴축/NNG@$선호/NNG,1,0.8360119808908286,126,80,46,66,0.9485545836664177,0.08470941181991486
기준금리/NNG@$인상/NNG@$적절/XR,1,0.8322273567801901,75,48,27,31,0.8018876772918729,0.07341546977256067
부정적/NNG@$영향/NNG@$최소화/NNG,1,0.8314624537548914,35,23,12,28,0.5266768229869092,0.04845906377067967
인상/NNG@$시장/NNG@$기대/NNG,1,0.8314624537548914,35,23,12,13,0.5266768229869092,0.04845906377067967
금융/NNG@$규제/NNG@$개혁/NNG,1,0.8314624537548914,35,23,12,19,0.5266768229869092,0.04845906377067967
기준금리/NNG@$인상/NNG@$관측/NNG,1,0.8277459314637206,51,33,18,14,0.6531251952024826,0.0615434470464741
경기/NNG@$나쁘/VA@$않/VX,1,0.8277361034698465,43,28,15,7,0.5919821971415983,0.05578547536940763
원유/NNG@$원자재/NNG@$가격/NNG@$상승/NNG,1,0.8206929768362394,56,36,20,8,0.6867903039271226,0.06762630146094654
금융/NNG@$경제/NNG@$전망/NNG,0,0.8206904369835215,32,21,11,17,0.49940120085469836,0.04917539085878346
증시/NNG@$사상/NNG@$최고치/NNG,0,0.8206904369835215,32,21,11,31,0.49940120085469836,0.04917539085878346
인플레이션/NNG@$목표/NNG@$달성/NNG,0,0.8206904369835215,32,21,11,23,0.49940120085469836,0.04917539085878346
소비자/NNG@$물가/NNG@$상승률/NNG@$전망/NNG,1,0.8198051233858576,90,57,33,24,0.8623234869074979,0.08537261166038215
소비자/NNG@$물가/NNG@$오름세/NNG,1,0.8172155877944547,40,26,14,14,0.5658642801001962,0.05690828396222708
금리/NNG@$상승/NNG@$속도/NNG,1,0.8172155877944547,40,26,14,12,0.5658642801001962,0.05690828396222708
거시/NNG@$건전성/NNG@$규제/NNG,1,0.8172155877944547,40,26,14,22,0.5658642801001962,0.05690828396222708
성장세/NNG@$갈/VX@$전망/NNG,1,0.8111202709443639,53,34,19,20,0.6637466569515568,0.06921022284737897
금리/NNG@$상승/NNG@$가계/NNG,1,0.8067075015186749,71,45,26,22,0.7743876571030892,0.08283520433318402
규모/NNG@$축소/NNG@$시작/NNG,1,0.8050025820737801,37,24,13,17,0.5391947663196073,0.05824060762023483
장단기/NNG@$금리차/NNG@$축소/NNG,1,0.8050025820737801,37,24,13,22,0.5391947663196073,0.05824060762023483
모습/NNG@$보일/VV@$전망/NNG,1,0.8001792539147701,50,32,18,14,0.6398206395947865,0.07100873425900223
전격적/NNG@$금리/NNG@$인상/NNG,1,0.7950388508388453,55,35,20,12,0.6740335703513034,0.07694978488864243
잠재적/NNG@$불안/NNG@$요인/NNG,0,0.7932422926726168,26,17,9,24,0.4442441701079621,0.051212088063967584
통화정책/NNG@$금융완화/NNG@$기조/NNG@$유지/NNG,1,0.7925050282618253,78,49,29,14,0.8055457773675995,0.093232076954285
목표/NNG@$금리/NNG@$인상/NNG,1,0.7911904369867313,60,38,22,21,0.7061386778271325,0.08230504075699054
매파적/NNG@$통화/NNG@$긴축/NNG@$선호/NNG,1,0.7906987125455867,34,22,12,25,0.5120854805215147,0.059843860875110656
채권/NNG@$시장/NNG@$변동성/NNG,1,0.7906987125455867,34,22,12,15,0.5120854805215147,0.059843860875110656
매파/NNG@$통화/NNG@$긴축/NNG@$선호/NNG,1,0.7901818300503824,83,52,31,38,0.8270387773987266,0.09691690502865019
외국/NNG@$자본/NNG@$유입/NNG,1,0.7881994995076909,65,41,24,17,0.7360141302002147,0.0871614986039723
확대/NNG@$해석/NNG@$경계/NNG,1,0.7837036731312084,75,47,28,27,0.788856673548717,0.09564265839215673
인프라/NNG@$투자/NNG@$확대/NNG,1,0.7828570004306334,52,33,19,18,0.6505212455552727,0.07921689667135184
원유/NNG@$재고/NNG@$감소/NNG,1,0.7828570004306334,52,33,19,25,0.6505212455552727,0.07921689667135184
장기/NNG@$국채/NNG@$수익률/NNG,1,0.7818604498310318,80,50,30,21,0.8118272451760087,0.09936908068109067
지표/NNG@$호조/NNG@$보이/VV,1,0.779836198433822,39,25,14,19,0.5514502957701872,0.0682022953587498
상승/NNG@$환율/NNG@$하락/NNG,1,0.779836198433822,39,25,14,10,0.5514502957701872,0.0682022953587498
인상/NNG@$나서/VV@$않/VX,1,0.7795463422081506,57,36,21,26,0.6839840173632311,0.08471897069252167
금리/NNG@$인상/NNG@$출구전략/NNG,1,0.7769724302629104,144,89,55,39,0.952120464229581,0.11948028101708995
금리/NNG@$인상/NNG@$인플레/NNG,1,0.7753463384575783,67,42,25,13,0.7443698466025281,0.09417714268880904
해외/NNG@$불안/NNG@$요인/NNG,0,0.7737654034165435,31,20,11,12,0.4846580561279069,0.06180512050931151
경제/NNG@$성장세/NNG@$지속/NNG,1,0.7703174294074606,87,54,33,28,0.8377907807271608,0.10867717585249838
사상/NNG@$최고치/NNG@$기록/NNG,1,0.7694587867421125,185,114,71,75,0.9634518988326719,0.12550584592515843
물가/NNG@$상승/NNG@$기대/NNG,1,0.76916866240728,92,57,35,37,0.855665719928893,0.11162344795552576
기조/NNG@$유지/NNG@$경기/NNG@$회복세/NNG,1,0.768883397815292,49,31,18,3,0.6261540120084893,0.08179727772610948
금리/NNG@$인상/NNG@$생각/NNG,1,0.768883397815292,49,31,18,16,0.6261540120084893,0.08179727772610948
금리/NNG@$오른/VV@$마감/NNG,1,0.7662845697633864,54,34,20,22,0.6608931658766327,0.08743463204408858
지수/NNG@$높/VA@$기술/NNG,1,0.7646630347876671,59,37,22,46,0.6935973364036712,0.09248283816675376
환율/NNG@$상승/NNG@$요인/NNG,1,0.7625112150511095,36,23,13,15,0.5245289229891595,0.07066524050033551
채권/NNG@$시장/NNG@$약세/NNG,1,0.7618232337634407,79,49,30,29,0.8020373960072751,0.10840686978847987
기조/NNG@$유지/NNG@$통화정책/NNG,1,0.7561704938822191,41,26,15,13,0.5634333375004489,0.07821440773950056
경제/NNG@$성장/NNG@$부진/NNG,1,0.7561704938822191,41,26,15,20,0.5634333375004489,0.07821440773950056
개선/NNG@$추세/NNG@$보이/VV,1,0.7561704938822191,41,26,15,7,0.5634333375004489,0.07821440773950056
관심/NNG@$가질/VV@$필요/NNG@$있/VA,0,0.7534536858386072,28,18,10,8,0.45704195090924776,0.06425170951069768
동결/NNG@$기조/NNG@$지속/NNG,1,0.7527687745766083,46,29,17,16,0.600999224833107,0.08475726907902105
부동산/NNG@$문제/NNG@$심각/XR,1,0.7511138130539052,51,32,19,21,0.6369152363798679,0.09050910461815614
투기/NNG@$자금/NNG@$유입/NNG,1,0.7511138130539052,51,32,19,11,0.6369152363798679,0.09050910461815614
회복세/NNG@$보일/VV@$예상/NNG,1,0.7504733646607178,56,35,21,10,0.6709344769119532,0.09562372754135952
인상/NNG@$가능성/NNG@$제기/NNG,1,0.7422247931529542,98,60,38,36,0.8676834779299014,0.12835764881492148
부채/NNG@$상환/NNG@$능력/NNG,0,0.7419632374923852,33,21,12,19,0.49721983349545135,0.07364012083463756
금융/NNG@$위기/NNG@$통화정책/NNG,0,0.7419632374923852,33,21,12,16,0.49721983349545135,0.07364012083463756
서비스/NNG@$금리/NNG@$비교/NNG@$장기금리/NNG@$국채/NNG,1,0.738030113502268,68,42,26,29,0.7407641889359031,0.1116341788751057
금리/NNG@$인상/NNG@$정당화/NNG,1,0.73635214646115,38,24,14,25,0.5367209519846318,0.0814813044168099
기준금리/NNG@$인상/NNG@$우려/NNG,1,0.734295295149094,53,33,20,36,0.6473553060999457,0.09916119149726307
정책/NNG@$효과/NNG@$극대화/NNG,1,0.7340768975822309,43,27,16,26,0.5751356369760212,0.08818217434782483
인플레이션/NNG@$우려/NNG@$높/VA,1,0.7340768975822309,43,27,16,17,0.5751356369760212,0.08818217434782483
결제/NNG@$선물환/NNG@$시장/NNG,1,0.7340768975822309,43,27,16,11,0.5751356369760212,0.08818217434782483
상승/NNG@$압력/NNG@$우려/NNG,1,0.7340768975822309,43,27,16,10,0.5751356369760212,0.08818217434782483
지수/NNG@$내린/VV@$마감/NNG,1,0.7340768975822309,43,27,16,44,0.5751356369760212,0.08818217434782483
차액/NNG@$결제/NNG@$선물환/NNG@$시장/NNG,1,0.7340768975822309,43,27,16,11,0.5751356369760212,0.08818217434782483
경기/NNG@$둔화/NNG@$원자재/NNG@$가격/NNG,1,0.7340768975822309,43,27,16,11,0.5751356369760212,0.08818217434782483
경기/NNG@$회복세/NNG@$약화/NNG,1,0.7340768975822309,43,27,16,23,0.5751356369760212,0.08818217434782483
연속적/NNG@$금리/NNG@$인상/NNG,1,0.7340119550221218,110,67,43,26,0.8963508800703661,0.1374709336388308
소비자/NNG@$물가/NNG@$예상/NNG,1,0.733677789424946,48,30,18,12,0.6121105392367072,0.094013806011109
부진/NNG@$경기/NNG@$회복세/NNG,1,0.733677789424946,48,30,18,12,0.6121105392367072,0.094013806011109
성장/NNG@$경로/NNG@$불확실성/NNG@$높/VA,1,0.7332482850888147,125,76,49,54,0.9227600142188954,0.1419900622078668
단기금리/NNG@$등락/NNG@$장기금리/NNG@$국채/NNG,1,0.7327148068321638,130,79,51,51,0.9290890579464771,0.14329395115619065
경로/NNG@$불확실성/NNG@$높/VA,1,0.7327148068321638,130,79,51,54,0.9290890579464771,0.14329395115619065
장기금리/NNG@$단기금리/NNG@$등락/NNG,1,0.7327148068321638,130,79,51,51,0.9290890579464771,0.14329395115619065
방향/NNG@$결정/NNG@$기준금리/NNG@$유지/NNG,0,0.7286870874627784,25,16,9,10,0.4293715880170895,0.06737670293237757
통화정책/NNG@$방향/NNG@$결정/NNG@$기준금리/NNG@$유지/NNG,0,0.7286870874627784,25,16,9,10,0.4293715880170895,0.06737670293237757
자금/NNG@$중개/NNG@$기능/NNG,0,0.7286870874627784,25,16,9,15,0.4293715880170895,0.06737670293237757
경기/NNG@$회복/NNG@$여부/NNG,1,0.7259519790822762,70,43,27,10,0.7485878858739421,0.11884007453247267
시장/NNG@$변동성/NNG@$확대/NNG,1,0.7251367621852896,102,62,40,48,0.8744782355718496,0.13930420541267255
자금조달/NNG@$어려움/NNG@$겪/VV,1,0.7183998459129215,55,34,21,8,0.6574722407800973,0.10772280383729778
기조/NNG@$유지/NNG@$경제/NNG,1,0.7171104608755698,77,47,30,29,0.7812040353963531,0.1286780870985765
금리/NNG@$비교/NNG@$장기금리/NNG@$국채/NNG,1,0.7171104608755698,77,47,30,30,0.7812040353963531,0.1286780870985765
비교/NNG@$장기금리/NNG@$국채/NNG,1,0.7171104608755698,77,47,30,30,0.7812040353963531,0.1286780870985765
반영/NNG@$금리/NNG@$인상/NNG@$가능성/NNG,1,0.7157754351155261,50,31,19,10,0.6229132268171563,0.10316920342764413
제품/NNG@$가격/NNG@$인상/NNG,1,0.7157754351155261,50,31,19,12,0.6229132268171563,0.10316920342764413
가계부채/NNG@$급/NNG@$증세/NNG,1,0.7135388057821144,45,28,17,21,0.5865504541576135,0.09803889683646752
위축/NNG@$소비/NNG@$심리/NNG,1,0.7129270071102403,35,22,13,12,0.5095532288657064,0.08538157804323815
경기/NNG@$둔화/NNG@$기준금리/NNG,1,0.7129270071102403,35,22,13,22,0.5095532288657064,0.08538157804323815
채권/NNG@$금리/NNG@$상승/NNG,1,0.7127444562877496,194,117,77,57,0.9530175821122853,0.1598077681496707
시장/NNG@$인상/NNG@$가능성/NNG,1,0.7122589243950805,40,25,15,10,0.5486527326196325,0.09218304681486775
수출/NNG@$산업/NNG@$생산/NNG,1,0.7122589243950805,40,25,15,13,0.5486527326196325,0.09218304681486775
경기/NNG@$둔화/NNG@$국면/NNG,1,0.7122589243950805,40,25,15,14,0.5486527326196325,0.09218304681486775
인플레이션/NNG@$우려/NNG@$커지/VV,1,0.7122589243950805,40,25,15,15,0.5486527326196325,0.09218304681486775
불확실성/NNG@$금리/NNG@$인상/NNG,1,0.7111074492147693,67,41,26,23,0.7287024864868151,0.12300713729920934
재정/NNG@$건전성/NNG@$확보/NNG,1,0.7074474768579375,62,38,24,24,0.6990723001062347,0.11975655818524009
자금/NNG@$단기/NNG@$부동화/NNG,1,0.7066020616993378,79,48,31,17,0.7876196666943713,0.1353823335497002
침체/NNG@$빠질/VV@$가능성/NNG,1,0.7033845946309396,57,35,22,7,0.667265130664001,0.11617156090561172
자산/NNG@$시장/NNG@$거품/NNG,1,0.7033845946309396,57,35,22,20,0.667265130664001,0.11617156090561172
채권/NNG@$시장/NNG@$영향/NNG,1,0.7027877735096173,91,55,36,27,0.8343928772672687,0.1456119764100829
증가/NNG@$물가/NNG@$상승/NNG,1,0.6990057426145273,52,32,20,12,0.6334041042822558,0.11219262497689032
예상/NNG@$깨/VV@$기준금리/NNG,1,0.6944868046945638,47,29,18,16,0.5976723447644536,0.10773943000909293
국채/NNG@$금리/NNG@$오른/VV,1,0.6944868046945638,47,29,18,11,0.5976723447644536,0.10773943000909293
전망/NNG@$경기/NNG@$둔화/NNG,1,0.6944868046945638,47,29,18,13,0.5976723447644536,0.10773943000909293
활동/NNG@$동향/NNG@$보/VV,1,0.6944868046945638,47,29,18,26,0.5976723447644536,0.10773943000909293
고려/NNG@$않/VX@$없/VA,1,0.6944868046945638,47,29,18,23,0.5976723447644536,0.10773943000909293
경제/NNG@$성장/NNG@$지지/NNG,1,0.6944868046945638,47,29,18,8,0.5976723447644536,0.10773943000909293
금리/NNG@$인상/NNG@$의견/NNG,1,0.6944713247034036,64,39,25,12,0.7077934828915282,0.12759805172439348
규모/NNG@$인프라/NNG@$투자/NNG,1,0.6901573714007061,42,26,16,7,0.5603168171573978,0.10269920652437971
완화/NNG@$정책/NNG@$유지/NNG,1,0.6891984206453154,59,36,23,21,0.6767340262165136,0.1244915568336844
경제/NNG@$성장률/NNG@$전망/NNG,1,0.6891984206453154,59,36,23,19,0.6767340262165136,0.1244915568336844
금리/NNG@$인하/NNG@$없/VA,1,0.6882348757711152,100,60,40,32,0.8589420162574068,0.15859072073799052
소수/NNG@$의견/NNG@$나오/VV,1,0.6866198812209565,37,23,14,19,0.5216493969062567,0.09690631443333395
지수/NNG@$내린/VV@$기술/NNG,1,0.6866198812209565,37,23,14,14,0.5216493969062567,0.09690631443333395
회복/NNG@$기대/NNG@$어렵/VA,1,0.6866198812209565,37,23,14,30,0.5216493969062567,0.09690631443333395
주택/NNG@$착공/NNG@$허가/NNG,1,0.6866198812209565,37,23,14,23,0.5216493969062567,0.09690631443333395
증가/NNG@$민간/NNG@$소비/NNG,1,0.6866198812209565,37,23,14,10,0.5216493969062567,0.09690631443333395
인상/NNG@$긴축/NNG@$기조/NNG,1,0.6866198812209565,37,23,14,13,0.5216493969062567,0.09690631443333395
경제/NNG@$수출/NNG@$내수/NNG,0,0.6849812378597779,32,20,12,10,0.4820442793006889,0.09010467068266097
기준금리/NNG@$결정/NNG@$금융/NNG,0,0.6849812378597779,32,20,12,22,0.4820442793006889,0.09010467068266097
미국채/NNG@$금리/NNG@$상승/NNG,0,0.6849812378597779,32,20,12,18,0.4820442793006889,0.09010467068266097
경제/NNG@$외환/NNG@$위기/NNG,0,0.6849812378597779,32,20,12,16,0.4820442793006889,0.09010467068266097
고용/NNG@$지표/NNG@$경제/NNG,1,0.6832979863234312,54,33,21,14,0.6435810565286147,0.12106314926359499
기준금리/NNG@$인상/NNG@$확률/NNG,1,0.6819959928514152,78,47,31,43,0.7766896521771041,0.14681619080907296
기금/NNG@$금리선물/NNG@$시장/NNG@$기준금리/NNG@$인상/NNG,1,0.6814151371490735,248,148,100,179,0.9479348982574236,0.17957565130818964
시중/NNG@$유동성/NNG@$흡수/NNG,1,0.6770947272696886,85,51,34,21,0.8050804498658363,0.15497985763366157
경제/NNG@$회복/NNG@$지연/NNG,1,0.6770947272696886,85,51,34,26,0.8050804498658363,0.15497985763366157
금융/NNG@$규제/NNG@$완화/NNG,1,0.6768230202929428,49,30,19,18,0.6084970018395368,0.11725464248138733
시기/NNG@$금리/NNG@$인상/NNG,1,0.6766040012290635,73,44,29,30,0.7516000202868132,0.1449470312537891
수출/NNG@$부진/NNG@$지속/NNG,1,0.6719920051554225,80,48,32,51,0.7829461292153123,0.15356780315582144
동행지수/NNG@$순환/NNG@$변동/NNG,1,0.6703380139087451,68,41,27,26,0.7242641658889114,0.14291553512864763
금융/NNG@$경제/NNG@$검토/NNG@$기준금리/NNG@$유지/NNG,1,0.6628676180939577,39,24,15,18,0.5335006244660095,0.10814217823153649
주택/NNG@$담보인정비율/NNG@$부채/NNG@$상환/NNG,1,0.6628676180939577,39,24,15,17,0.5335006244660095,0.10814217823153649
경제/NNG@$검토/NNG@$기준금리/NNG@$유지/NNG,1,0.6628676180939577,39,24,15,19,0.5335006244660095,0.10814217823153649
가계부채/NNG@$증가세/NNG@$통화정책/NNG,1,0.6628676180939577,39,24,15,10,0.5335006244660095,0.10814217823153649
시장/NNG@$예상/NNG@$금리/NNG@$인상/NNG,1,0.6604371125468478,51,31,20,18,0.6190211383325578,0.12656699711602504
거시/NNG@$정책/NNG@$기조/NNG@$유지/NNG,1,0.6604371125468478,51,31,20,5,0.6190211383325578,0.12656699711602504
금리/NNG@$인상/NNG@$긴축/NNG,1,0.6602308753790445,113,67,46,41,0.8828953619259405,0.18065161813117617
금융/NNG@$불안/NNG@$요인/NNG,0,0.6584577940479441,19,12,7,15,0.37440236349127065,0.07708956646758368
부동산/NNG@$자산/NNG@$시장/NNG,0,0.6562757212135402,34,21,13,10,0.4942316289533079,0.10254748557572803
유로지역/NNG@$재정/NNG@$문제/NNG,0,0.6562757212135402,34,21,13,10,0.4942316289533079,0.10254748557572803
통화정책/NNG@$완화적/NNG@$기조/NNG,0,0.6562757212135402,34,21,13,13,0.4942316289533079,0.10254748557572803
가계부채/NNG@$구조/NNG@$개선/NNG,0,0.6562757212135402,34,21,13,22,0.4942316289533079,0.10254748557572803
금리/NNG@$인상/NNG@$가능성/NNG@$제기/NNG,1,0.6547583232865521,58,35,23,28,0.6629894601948808,0.13829677862715317
정책/NNG@$금리/NNG@$인하/NNG,1,0.6530214203742204,84,50,34,29,0.7945822573448466,0.16675532741173135
상승/NNG@$소비자/NNG@$물가/NNG,1,0.6528354680925528,144,85,59,47,0.9228083846047338,0.1937911385404771
산업/NNG@$활동/NNG@$동향/NNG@$보/VV,1,0.6513676836474467,46,28,18,26,0.5828177397830672,0.12301927772781363
금리/NNG@$유지/NNG@$결정/NNG,1,0.6513676836474467,46,28,18,28,0.5828177397830672,0.12301927772781363
지속/NNG@$물가/NNG@$상승/NNG@$압력/NNG,1,0.6513676836474467,46,28,18,9,0.5828177397830672,0.12301927772781363
경제/NNG@$회복/NNG@$국면/NNG,1,0.6513676836474467,46,28,18,14,0.5828177397830672,0.12301927772781363
경제/NNG@$더블딥/NNG@$이중/NNG@$침체/NNG,1,0.6513676836474467,46,28,18,7,0.5828177397830672,0.12301927772781363
상승/NNG@$기대/NNG@$심리/NNG,1,0.6513676836474467,46,28,18,10,0.5828177397830672,0.12301927772781363
경제/NNG@$경착륙/NNG@$우려/NNG,1,0.6513676836474467,46,28,18,23,0.5828177397830672,0.12301927772781363
채권/NNG@$시장/NNG@$부담/NNG,1,0.6513676836474467,46,28,18,8,0.5828177397830672,0.12301927772781363
지수/NNG@$최고치/NNG@$기록/NNG,1,0.6513676836474467,46,28,18,15,0.5828177397830672,0.12301927772781363
금융/NNG@$불안/NNG@$가능성/NNG,0,0.65130086189809,29,18,11,13,0.4543120310862268,0.09591696976823089
시장/NNG@$예상치/NNG@$밑돌/VV,0,0.65130086189809,29,18,11,23,0.4543120310862268,0.09591696976823089
담보인정비율/NNG@$부채/NNG@$상환/NNG,1,0.6510651283689195,65,39,26,30,0.7032097237677385,0.1485872568213986
건강/NNG@$보험/NNG@$개혁/NNG,0,0.6503071653010226,24,15,9,34,0.4142032148364745,0.08775096219466498
기술/NNG@$지수/NNG@$오른/VV@$마감/NNG,1,0.6483691210436493,72,43,29,46,0.7394650906356155,0.15771265586381553
수당/NNG@$청구/NNG@$예상/NNG,1,0.6452162919191835,53,32,21,25,0.6292423968985434,0.1356671645839809
증가/NNG@$경제/NNG@$성장/NNG,1,0.6452162919191835,53,32,21,18,0.6292423968985434,0.1356671645839809
국고채/NNG@$금리/NNG@$상승/NNG,1,0.6452162919191835,53,32,21,29,0.6292423968985434,0.1356671645839809
실업/NNG@$수당/NNG@$청구/NNG@$예상/NNG,1,0.6452162919191835,53,32,21,25,0.6292423968985434,0.1356671645839809
사드/NNG@$고고/NNG@$미사일/NNG@$방어/NNG@$체계/NNG,1,0.6452162919191835,53,32,21,37,0.6292423968985434,0.1356671645839809
물가/NNG@$목표제/NNG@$채택/NNG,1,0.6343533045095022,48,29,19,4,0.5936449184774323,0.13278767974744124
급등/NNG@$물가/NNG@$상승/NNG,1,0.6343533045095022,48,29,19,18,0.5936449184774323,0.13278767974744124
금리/NNG@$올리/VV@$경기/NNG,1,0.6308493022535671,36,22,14,24,0.5061997357269682,0.11455837471529946
엔화/NNG@$강세/NNG@$보이/VV,1,0.6308493022535671,36,22,14,15,0.5061997357269682,0.11455837471529946
압력/NNG@$선제적/NNG@$대응/NNG,1,0.6308493022535671,36,22,14,13,0.5061997357269682,0.11455837471529946
시장/NNG@$투자/NNG@$심리/NNG,1,0.629543747993146,62,37,25,15,0.681139312023485,0.15481813251221418
축소/NNG@$금리/NNG@$인상/NNG,1,0.629543747993146,62,37,25,48,0.681139312023485,0.15481813251221418
기준금리/NNG@$인하/NNG@$필요성/NNG,1,0.6276798802959436,83,49,34,26,0.7836200664069815,0.1792123351562876
경제/NNG@$기준금리/NNG@$인상/NNG,1,0.6268777742943894,90,53,37,43,0.809951790225731,0.18572490510016315
우려/NNG@$경기/NNG@$둔화/NNG,1,0.6220704139891087,43,26,17,14,0.5564417761479727,0.12962099579171957
인상/NNG@$가능성/NNG@$강하/VA@$시사/NNG,1,0.6220704139891087,43,26,17,20,0.5564417761479727,0.12962099579171957
인하/NNG@$효과/NNG@$지켜보/VV,1,0.6220704139891087,43,26,17,18,0.5564417761479727,0.12962099579171957
금리선물/NNG@$시장/NNG@$기준금리/NNG@$인상/NNG@$가능성/NNG,1,0.62094861130441,248,145,103,179,0.9344400342775746,0.21847142328232816
가계/NNG@$소비/NNG@$위축/NNG,0,0.6201007917141701,31,19,12,23,0.46650876746841835,0.10937056596463944
영향/NNG@$경기/NNG@$회복/NNG,0,0.6201007917141701,31,19,12,9,0.46650876746841835,0.10937056596463944
원유/NNG@$가격/NNG@$상승/NNG,1,0.6189534291278691,85,50,35,24,0.7891587403373224,0.18570443906869552
모습/NNG@$보이/VV@$경제/NNG,1,0.6187097497408123,50,30,20,8,0.6041849179113161,0.14228882493169187
금융/NNG@$위기/NNG@$직전/NNG,1,0.6187097497408123,50,30,20,16,0.6041849179113161,0.14228882493169187
하향/NNG@$조정/NNG@$성장률/NNG,1,0.6187097497408123,50,30,20,11,0.6041849179113161,0.14228882493169187
유동성/NNG@$공급/NNG@$정책/NNG,1,0.6178394609555742,57,34,23,17,0.6487710752715847,0.15322020125697486
금리/NNG@$역전/NNG@$현상/NNG,1,0.6106096296390477,101,59,42,31,0.8398562885321154,0.20300816607900202
인상/NNG@$단행/NNG@$예상/NNG,1,0.6105290182599308,87,51,36,31,0.7944249919083333,0.19207597975284652
하방/NNG@$리스크/NNG@$우세/NNG,0,0.6102614513515303,26,16,10,22,0.4264723381863893,0.10320041011660555
국채/NNG@$매입/NNG@$계획/NNG,1,0.6097941943316341,80,47,33,18,0.7662167329781613,0.18569001751649802
금리/NNG@$인상/NNG@$움직임/NNG,1,0.6086169131427484,73,43,30,18,0.7341106312324491,0.17857654153312202
경제/NNG@$영향/NNG@$크/VA@$않/VX,1,0.6083087885777856,38,23,15,22,0.5179417062415733,0.1261155748353241
물가/NNG@$상승률/NNG@$최고치/NNG,1,0.6083087885777856,38,23,15,13,0.5179417062415733,0.1261155748353241
호흡기/NNG@$증후군/NNG@$메르스/NNG@$사태/NNG,1,0.6042875378543997,52,31,21,35,0.6144349999564401,0.1515258134732744
증후군/NNG@$메르스/NNG@$사태/NNG,1,0.6042875378543997,52,31,21,35,0.6144349999564401,0.1515258134732744
필요/NNG@$조치/NNG@$취할/VV,1,0.6031147138511626,96,56,40,24,0.8229987653253573,0.20371014497412313
농산물/NNG@$가격/NNG@$상승/NNG,1,0.6023879576366478,89,52,37,21,0.799426015935765,0.19832760076280578
수출/NNG@$호조/NNG@$지속/NNG,1,0.6010909142175889,82,48,34,18,0.7721781225823666,0.19234830289399305
시장/NNG@$기준금리/NNG@$인상/NNG@$가능성/NNG@$반영/NNG,1,0.5974425158428507,231,134,97,163,0.9285547675243815,0.2339498975442247
상승률/NNG@$최고치/NNG@$기록/NNG,1,0.5967665330698944,68,40,28,20,0.7060347382170086,0.17825997377423866
채권/NNG@$시장/NNG@$경기/NNG,1,0.5956569734012991,98,57,41,40,0.8268671594526065,0.20948778617694544
약세/NNG@$보일/VV@$전망/NNG,0,0.5930996471497592,33,20,13,18,0.47851501260053314,0.12219489141050144
변동성/NNG@$음식/NNG@$에너지/NNG,0,0.5930996471497592,33,20,13,22,0.47851501260053314,0.12219489141050144
사상/NNG@$최고치/NNG@$경신/NNG,1,0.5930075825952972,252,146,106,138,0.9277227220682611,0.23697308326106573
물가/NNG@$자산/NNG@$가격/NNG,1,0.5902006619309657,77,45,32,8,0.7477506347724557,0.19265853878295994
인상/NNG@$가능성/NNG@$배제/NNG@$않/VX,1,0.588589674664082,47,28,19,21,0.5783311374203309,0.14974490699114132
기준금리/NNG@$인하/NNG@$압박/NNG,1,0.588589674664082,47,28,19,18,0.5783311374203309,0.14974490699114132
상승/NNG@$경기/NNG@$회복/NNG,1,0.5884106186232456,100,58,42,19,0.8305079900022782,0.21515785976391236
성장/NNG@$경로/NNG@$하방/NNG@$위험/NNG,1,0.5882700144058923,40,24,16,6,0.5294510454161084,0.13722270649485274
인상/NNG@$가능성/NNG@$높이/VV,1,0.5882700144058923,40,24,16,23,0.5294510454161084,0.13722270649485274
인하/NNG@$효과/NNG@$나타나/VV,1,0.5882700144058923,40,24,16,13,0.5294510454161084,0.13722270649485274
지표/NNG@$시장/NNG@$예상/NNG,1,0.5882700144058923,40,24,16,20,0.5294510454161084,0.13722270649485274
상승/NNG@$압력/NNG@$전망/NNG,1,0.5882700144058923,40,24,16,8,0.5294510454161084,0.13722270649485274
인하/NNG@$금리/NNG@$동결/NNG,1,0.5882700144058923,40,24,16,17,0.5294510454161084,0.13722270649485274
회복/NNG@$지연/NNG@$우려/NNG,1,0.5882700144058923,40,24,16,12,0.5294510454161084,0.13722270649485274
물가/NNG@$상승/NNG@$압력/NNG@$가중/NNG,1,0.5882700144058923,40,24,16,14,0.5294510454161084,0.13722270649485274
금리/NNG@$인상/NNG@$종료/NNG,1,0.5869566471008656,70,41,29,21,0.7137238498539769,0.18572599774312298
유동성/NNG@$증가/NNG@$속도/NNG,1,0.5869566471008656,70,41,29,23,0.7137238498539769,0.18572599774312298
순이익/NNG@$주당/NNG@$기록/NNG,1,0.578578941922498,56,33,23,28,0.6340582044553396,0.16923507109396735
기준금리/NNG@$인상/NNG@$않/VX,1,0.5768147149542262,118,68,50,29,0.8684926513243898,0.23303825977558398
축소/NNG@$기준금리/NNG@$인상/NNG,0,0.5766701206244169,28,17,11,22,0.43858715591055536,0.11773488684358727
달러/NNG@$환율/NNG@$기록/NNG,0,0.5766701206244169,28,17,11,24,0.43858715591055536,0.11773488684358727
외환시장/NNG@$변동성/NNG@$확대/NNG,1,0.5740484852354724,49,29,20,25,0.588870220825059,0.15932085969965334
외환/NNG@$건전성/NNG@$부담금/NNG,1,0.5740484852354724,49,29,20,16,0.588870220825059,0.15932085969965334
소수/NNG@$의견/NNG@$낸/VV,1,0.5740484852354724,49,29,20,15,0.588870220825059,0.15932085969965334
경제/NNG@$영향/NNG@$않/VX,1,0.5740484852354724,49,29,20,10,0.588870220825059,0.15932085969965334
외환/NNG@$위기/NNG@$발생/NNG,1,0.5740484852354724,49,29,20,19,0.588870220825059,0.15932085969965334
우려/NNG@$고개/NNG@$들/VV,1,0.5727703066794931,65,38,27,18,0.6841782659409411,0.1858130865120296
경제/NNG@$성장/NNG@$동력/NNG,1,0.5723316129037987,97,56,41,37,0.8169246754425697,0.22215489156489257
성장률/NNG@$예상/NNG@$높/VA,1,0.5703831822023178,42,25,17,10,0.54072166371513,0.14789726102139236
내수/NNG@$부진/NNG@$경기/NNG,1,0.5703831822023178,42,25,17,14,0.54072166371513,0.14789726102139236
경제/NNG@$성장세/NNG@$유지/NNG,1,0.5703831822023178,42,25,17,16,0.54072166371513,0.14789726102139236
유지/NNG@$민간/NNG@$소비/NNG,1,0.5703831822023178,42,25,17,5,0.54072166371513,0.14789726102139236
경기/NNG@$둔화/NNG@$금리/NNG@$인하/NNG,1,0.5703831822023178,42,25,17,16,0.54072166371513,0.14789726102139236
금융시장/NNG@$불안/NNG@$해소/NNG,1,0.5703831822023178,42,25,17,9,0.54072166371513,0.14789726102139236
최대/NNG@$낙폭/NNG@$기록/NNG,1,0.5703831822023178,42,25,17,10,0.54072166371513,0.14789726102139236
경제/NNG@$성장세/NNG@$완만/XR,0,0.5696618026691114,35,21,14,19,0.49032435883266395,0.1343995908338448
경기/NNG@$회복세/NNG@$지원/NNG,0,0.5696618026691114,35,21,14,11,0.49032435883266395,0.1343995908338448
주택/NNG@$경기/NNG@$회복/NNG,0,0.5696618026691114,35,21,14,22,0.49032435883266395,0.1343995908338448
상환/NNG@$부담/NNG@$증가/NNG,0,0.5696618026691114,35,21,14,26,0.49032435883266395,0.1343995908338448
콜/NNG@$목표/NNG@$금리/NNG,1,0.5670640011790842,58,34,24,20,0.6434294953853148,0.17772495550172127
예상/NNG@$물가/NNG@$상승률/NNG,1,0.5670640011790842,58,34,24,19,0.6434294953853148,0.17772495550172127
인상/NNG@$나설/VV@$가능성/NNG,1,0.5645739479541536,122,70,52,39,0.8717033999460099,0.24254781079218177
조정/NNG@$금리/NNG@$인상/NNG,1,0.5630829227530427,67,39,28,26,0.6922783262745446,0.19346746118214656
시장/NNG@$예상/NNG@$부합/NNG,1,0.5613338514773645,108,62,46,53,0.8429468737623951,0.23678196464514845
금리/NNG@$동결/NNG@$시장/NNG@$예상/NNG,1,0.5607303743602321,51,30,21,17,0.5991342976738061,0.1685922081984319
경기/NNG@$회복세/NNG@$뚜렷/XR,1,0.5602334157317816,76,44,32,26,0.735019839124382,0.20712937882076474
주택/NNG@$가격/NNG@$상승/NNG@$기대/NNG,0,0.5596904353992385,23,14,9,16,0.3986284957748647,0.11251178170549732
금리/NNG@$상승/NNG@$주가/NNG,0,0.5596904353992385,23,14,9,9,0.3986284957748647,0.11251178170549732
지수/NNG@$오른/VV@$마감/NNG,1,0.5586144077835031,101,58,43,62,0.8242745455098336,0.23337870604558372
경기/NNG@$회복/NNG@$걸림돌/NNG,1,0.5563117680146248,60,35,25,16,0.6525071408296436,0.18598429957096468
검토/NNG@$기준금리/NNG@$유지/NNG,1,0.5543414310193089,44,26,18,22,0.5517479163042894,0.15816344031455842
증가/NNG@$속도/NNG@$둔화/NNG,1,0.5543414310193089,44,26,18,12,0.5517479163042894,0.15816344031455842
경제지표/NNG@$호조/NNG@$보이/VV,1,0.5543414310193089,44,26,18,32,0.5517479163042894,0.15816344031455842
인상/NNG@$속도/NNG@$빨라/VA,1,0.5543414310193089,44,26,18,7,0.5517479163042894,0.15816344031455842
물가/NNG@$오름세/NNG@$확대/NNG,1,0.5539084057463353,69,40,29,14,0.7000829650334405,0.2009359598812247
생산자/NNG@$물가/NNG@$상승/NNG,1,0.5520425391170445,103,59,44,26,0.8276255371468527,0.2388231559334007
은행/NNG@$지급준비율/NNG@$인상/NNG,1,0.5502711805967111,87,50,37,30,0.7769247262599286,0.2253363505625521
경제/NNG@$성장/NNG@$기대/NNG,1,0.5492150114654597,37,22,15,19,0.5019302137341376,0.1460193055561814
물가/NNG@$목표/NNG@$상한선/NNG,1,0.5492150114654597,37,22,15,13,0.5019302137341376,0.1460193055561814
성장률/NNG@$전망/NNG@$낮추/VV,1,0.5492150114654597,37,22,15,18,0.5019302137341376,0.1460193055561814
결정/NNG@$영향/NNG@$않/VX,1,0.5492150114654597,37,22,15,17,0.5019302137341376,0.1460193055561814
휘발유/NNG@$가격/NNG@$상승/NNG,1,0.5484822115189953,53,31,22,17,0.6091207486775019,0.1775747350214627
환율/NNG@$금리/NNG@$인상/NNG,1,0.5484822115189953,53,31,22,15,0.6091207486775019,0.1775747350214627
물가/NNG@$목표/NNG@$하한/NNG,0,0.5484137750589739,30,18,12,10,0.4505437881372415,0.1313710885904043
양적완화/NNG@$정책/NNG@$유지/NNG,1,0.5398810523459738,46,27,19,10,0.5625246516214883,0.16804787043710373
주택/NNG@$가격/NNG@$하락세/NNG,1,0.5398810523459738,46,27,19,16,0.5625246516214883,0.16804787043710373
물가/NNG@$상승률/NNG@$상승/NNG,1,0.5368327057979192,82,47,35,34,0.7537638812872459,0.2271197504356314
상승/NNG@$압력/NNG@$가중/NNG,1,0.5367745938333117,64,37,27,24,0.6697849195689023,0.2018486495255912
경제성장률/NNG@$전망/NNG@$하향/NNG@$조정/NNG,1,0.5362486620808684,91,52,39,36,0.7867567936432404,0.23745012664656906
공개/NNG@$기준금리/NNG@$인상/NNG,1,0.531269023000561,39,23,16,15,0.5133259319775472,0.15709893624239138
추이/NNG@$열/VV@$기준금리/NNG,1,0.531269023000561,39,23,16,12,0.5133259319775472,0.15709893624239138
요인/NNG@$크/VA@$않/VX,1,0.531269023000561,39,23,16,13,0.5133259319775472,0.15709893624239138
구조/NNG@$개혁/NNG@$추진/NNG,1,0.5290079275691846,75,43,32,44,0.72176141544478,0.22228248180954
유지/NNG@$경기/NNG@$회복세/NNG,1,0.5278538150011414,66,38,28,13,0.6779882001113697,0.20947126143026124
원자재/NNG@$가격/NNG@$상승/NNG@$물가/NNG,1,0.5278538150011414,66,38,28,17,0.6779882001113697,0.20947126143026124
금리/NNG@$인상/NNG@$시그널/NNG,1,0.5271793511092764,173,98,75,44,0.9032618601844979,0.2795938698833249
금리/NNG@$상승/NNG@$채권/NNG,1,0.5267779625105757,48,28,20,15,0.5730472575182848,0.1775771446592115
가계/NNG@$기업/NNG@$부채/NNG,1,0.5267779625105757,48,28,20,29,0.5730472575182848,0.1775771446592115
국채/NNG@$수익률/NNG@$하락/NNG,1,0.5266848379220064,57,33,24,12,0.6282535928351916,0.1947347915681826
투자/NNG@$자금/NNG@$유출/NNG,1,0.5266848379220064,57,33,24,54,0.6282535928351916,0.1947347915681826
유로/NNG@$유로존/NNG@$재무/NNG,0,0.5244940546796049,32,19,13,20,0.46233695774897954,0.14417707517023542
기준금리/NNG@$인상/NNG@$경제/NNG,1,0.5216846116893297,113,64,49,34,0.8414313416259865,0.26443294745002016
경제/NNG@$완만/XR@$성장세/NNG,1,0.5194216645665517,68,39,29,29,0.685904056839125,0.21689835377311315
소비/NNG@$심리/NNG@$악화/NNG,1,0.516923597722809,59,34,25,22,0.6373980049739263,0.20294092755324286
기준금리/NNG@$인상/NNG@$필요/NNG,1,0.516923597722809,59,34,25,25,0.6373980049739263,0.20294092755324286
추경/NNG@$금리/NNG@$인하/NNG,1,0.516923597722809,59,34,25,30,0.6373980049739263,0.20294092755324286
콜금리/NNG@$목표/NNG@$인상/NNG,1,0.5160599805079069,115,65,50,29,0.8436521398767808,0.26924356216925294
영향력/NNG@$크/VA@$않/VX,1,0.5154141799683216,41,24,17,18,0.5245049629607487,0.16768556194607842
금리/NNG@$인상/NNG@$필요성/NNG@$제기/NNG,1,0.5154141799683216,41,24,17,25,0.5245049629607487,0.16768556194607842
금융/NNG@$통화정책/NNG@$기준금리/NNG@$동결/NNG,1,0.5154141799683216,41,24,17,16,0.5245049629607487,0.16768556194607842
전망/NNG@$금리/NNG@$동결/NNG,1,0.5154141799683216,41,24,17,30,0.5245049629607487,0.16768556194607842
사상/NNG@$최저치/NNG@$기록/NNG,1,0.5148428326360286,50,29,21,19,0.5833116992546661,0.1867765003566771
기준금리/NNG@$인상/NNG@$가능성/NNG@$반영/NNG,1,0.5138289912647436,262,148,114,175,0.9066896018767124,0.29112363880380354
자본/NNG@$유출입/NNG@$규제/NNG,1,0.5106888636993667,142,80,62,10,0.8801069765968974,0.2850046196263013
금리/NNG@$인상/NNG@$근거/NNG,1,0.5095756903678499,90,51,39,31,0.7750540910691177,0.2517418328518163
경제/NNG@$위기/NNG@$극복/NNG,1,0.5094426019694214,126,71,55,28,0.8604812978511369,0.2795895486945815
시장/NNG@$경기/NNG@$둔화/NNG,1,0.5078035775708811,61,35,26,32,0.6462607921569605,0.21091508440543374
신중/NNG@$금리/NNG@$인상/NNG,1,0.5078035775708811,61,35,26,24,0.6462607921569605,0.21091508440543374
양적완화/NNG@$규모/NNG@$축소/NNG,1,0.5063437405195519,330,186,144,138,0.9046985262414255,0.29642203504050085
금리/NNG@$단기금리/NNG@$국채/NNG,1,0.5049792155509598,222,125,97,121,0.9033750374370725,0.2970755820091607
국채/NNG@$매입/NNG@$규모/NNG,1,0.5043108082399035,128,72,56,39,0.8616946939176953,0.2838776370003768
확대/NNG@$기준금리/NNG@$인하/NNG,0,0.5040817817344618,34,20,14,17,0.47396032582554165,0.15623792903224662
상승/NNG@$주택/NNG@$가격/NNG,0,0.5040817817344618,34,20,14,16,0.47396032582554165,0.15623792903224662
금리/NNG@$인하/NNG@$추경/NNG,1,0.5039160577397368,52,30,22,14,0.5933145470827811,0.19566918206872932
성장/NNG@$둔화/NNG@$가능성/NNG,1,0.5039160577397368,52,30,22,28,0.5933145470827811,0.19566918206872932
통화/NNG@$달러화/NNG@$가치/NNG,1,0.5039160577397368,52,30,22,14,0.5933145470827811,0.19566918206872932
실시/NNG@$기준금리/NNG@$동결/NNG,1,0.5039160577397368,52,30,22,14,0.5933145470827811,0.19566918206872932
콜금리/NNG@$동결/NNG@$결정/NNG,1,0.5038350041563664,72,41,31,14,0.7008853139131181,0.23119516428837358
기준금리/NNG@$결정/NNG@$앞두/VV,1,0.5013123135416568,43,25,18,18,0.5354609890811716,0.17782429662609106
결정/NNG@$기준금리/NNG@$동결/NNG,1,0.5013123135416568,43,25,18,9,0.5354609890811716,0.17782429662609106
예상/NNG@$경기/NNG@$회복/NNG,1,0.5006213782595357,83,47,36,26,0.7467859765414726,0.24846234799727698
인상/NNG@$기조/NNG@$지속/NNG,1,0.4992520728108627,63,36,27,21,0.6548424821469702,0.21866881921703765
가계부채/NNG@$종합/NNG@$대책/NNG,0,0.495393622831231,27,16,11,30,0.42236829069582144,0.14249306861179756
경제/NNG@$활력/NNG@$회복/NNG,0,0.495393622831231,27,16,11,17,0.42236829069582144,0.14249306861179756
경제/NNG@$더딘/VA@$회복세/NNG,0,0.495393622831231,27,16,11,14,0.42236829069582144,0.14249306861179756
물가/NNG@$상승/NNG@$압력/NNG@$완화/NNG,1,0.4942052357528621,85,48,37,20,0.7523839077529025,0.2546294940331917
고용/NNG@$지표/NNG@$개선/NNG,1,0.49357526342565716,105,59,46,41,0.8138966574232925,0.27590663823681494
이유/NNG@$금리/NNG@$인상/NNG,1,0.49357526342565716,105,59,46,37,0.8138966574232925,0.27590663823681494
조업/NNG@$일수/NNG@$감소/NNG,1,0.4912063406052132,65,37,28,20,0.6631441627365329,0.22621260865892767
경제/NNG@$회복세/NNG@$지속/NNG,1,0.48984020802434225,125,70,55,47,0.8524248156523343,0.2918283136316294
둔화/NNG@$원자재/NNG@$가격/NNG,1,0.4896932631925417,76,43,33,27,0.7147565025098573,0.24479207693706598
적자/NNG@$국채/NNG@$발행/NNG,1,0.48868566954668347,45,26,19,17,0.5461880442202597,0.1875563898104994
경제/NNG@$성장/NNG@$제약/NNG,1,0.48868566954668347,45,26,19,10,0.5461880442202597,0.1875563898104994
금리/NNG@$인상/NNG@$지급준비율/NNG,1,0.48868566954668347,45,26,19,27,0.5461880442202597,0.1875563898104994
국채/NNG@$금리/NNG@$상승/NNG,1,0.48827913127390365,257,144,113,110,0.8991472855041,0.3090895067278916
가계/NNG@$소비/NNG@$여력/NNG,0,0.4865096199402412,36,21,15,13,0.48540685124915867,0.16763899308435612
가격/NNG@$상승세/NNG@$지속/NNG,0,0.4865096199402412,36,21,15,12,0.48540685124915867,0.16763899308435612
금리/NNG@$하락/NNG@$추세/NNG,0,0.4865096199402412,36,21,15,15,0.48540685124915867,0.16763899308435612
지수/NNG@$낮/VA@$기술/NNG,0,0.4865096199402412,36,21,15,40,0.48540685124915867,0.16763899308435612
매출액/NNG@$기준/NNG@$기업/NNG,0,0.4865096199402412,36,21,15,16,0.48540685124915867,0.16763899308435612
금리/NNG@$인상/NNG@$통한/VV,1,0.484570382954046,56,32,24,16,0.6125248576085314,0.2126163720150308
인상/NNG@$속도/NNG@$예상/NNG,1,0.484570382954046,56,32,24,24,0.6125248576085314,0.2126163720150308
위안화/NNG@$절상/NNG@$압력/NNG,1,0.482851980116374,109,61,48,33,0.8198003520848098,0.2858442383480068
우려/NNG@$크/VA@$않/VX,1,0.482851980116374,109,61,48,35,0.8198003520848098,0.2858442383480068
엔/NNG@$원/NNG@$환율/NNG,1,0.4820490612824264,89,50,39,42,0.7628301307170419,0.2665373646250408
가격/NNG@$급등/NNG@$물가/NNG,1,0.4773063098884962,47,27,20,17,0.556680609374153,0.19691856183943826
채권/NNG@$시장/NNG@$자금/NNG,1,0.4773063098884962,47,27,20,15,0.556680609374153,0.19691856183943826
중기적/NNG@$소비자/NNG@$물가/NNG@$상승률/NNG,1,0.47266289412616946,113,63,50,49,0.8249808183162823,0.2953468484140234
회복세/NNG@$지속/NNG@$경제/NNG,0,0.4712474175960084,38,22,16,14,0.49666911619753096,0.17845854114099302
금리/NNG@$인상/NNG@$속도/NNG@$예상/NNG,0,0.4712474175960084,38,22,16,16,0.49666911619753096,0.17845854114099302
금리/NNG@$인상/NNG@$확대/NNG,0,0.4712474175960084,38,22,16,17,0.49666911619753096,0.17845854114099302
우려/NNG@$있/VA@$금리/NNG,0,0.4712474175960084,38,22,16,12,0.49666911619753096,0.17845854114099302
기대/NNG@$쉽/VA@$않/VX,0,0.4712474175960084,38,22,16,13,0.49666911619753096,0.17845854114099302
가능성/NNG@$무게/NNG@$실리/VV,0,0.4712474175960084,38,22,16,12,0.49666911619753096,0.17845854114099302
사상/NNG@$최저/NNG@$기준금리/NNG,1,0.47069047114645546,93,52,41,43,0.7723173176000145,0.27789936810652127
경기/NNG@$상승/NNG@$기조/NNG,1,0.4697657471475263,124,69,55,24,0.8439709588091501,0.3044040609352028
국채/NNG@$수익률/NNG@$상승/NNG,1,0.4696742672811689,104,58,46,45,0.803278375705899,0.2897950486949326
등락/NNG@$장기금리/NNG@$국채/NNG,1,0.46839237535340716,221,123,98,120,0.8922025576521341,0.3229354491348841
국채/NNG@$매입/NNG@$통한/VV,1,0.4678959354188301,60,34,26,12,0.6306632439840454,0.22856091566955086
인플레이션/NNG@$압력/NNG@$가중/NNG,1,0.4678959354188301,60,34,26,10,0.6306632439840454,0.22856091566955086
금리/NNG@$인하/NNG@$논의/NNG,1,0.4678959354188301,60,34,26,16,0.6306632439840454,0.22856091566955086
전망/NNG@$좋/VA@$않/VX,1,0.4678959354188301,60,34,26,22,0.6306632439840454,0.22856091566955086
동결/NNG@$경기/NNG@$둔화/NNG,1,0.4669868711499412,49,28,21,9,0.5669336859102756,0.20594298848105783
하락/NNG@$거래/NNG@$마쳤/VV,1,0.46695861412827044,144,80,64,80,0.8674100589314556,0.3151160967956347
위험/NNG@$요인/NNG@$전개/NNG,0,0.4656387681650658,15,9,6,21,0.3319108633198372,0.12098525116139214
경기/NNG@$회복/NNG@$둔화/NNG,1,0.463098093016135,73,41,32,20,0.6935903699784595,0.25446457255622024
검토/NNG@$필요/NNG@$있/VA,1,0.46002589376090675,97,54,43,44,0.7808952924877727,0.2887405066766427
가계/NNG@$대출/NNG@$증가/NNG,1,0.46002589376090675,97,54,43,61,0.7808952924877727,0.2887405066766427
상승/NNG@$압력/NNG@$완화/NNG,1,0.45965568667479895,108,60,48,49,0.8094880518274796,0.299593998499582
국채/NNG@$금리/NNG@$서비스/NNG,1,0.45959900188863445,227,126,101,123,0.8896647997792155,0.3293149848326595
전망/NNG@$변화/NNG@$없/VA,1,0.45787548001205347,40,23,17,24,0.5077395992859687,0.1887652389579937
예상/NNG@$금리/NNG@$인상/NNG@$가능성/NNG,1,0.45787548001205347,40,23,17,17,0.5077395992859687,0.1887652389579937
양적완화/NNG@$축소/NNG@$경제/NNG,1,0.45787548001205347,40,23,17,20,0.5077395992859687,0.1887652389579937
물가/NNG@$수요/NNG@$압력/NNG,1,0.45787548001205347,40,23,17,6,0.5077395992859687,0.1887652389579937
상승/NNG@$인플레/NNG@$압력/NNG,1,0.45787548001205347,40,23,17,16,0.5077395992859687,0.1887652389579937
경제/NNG@$보/VV@$경기/NNG,1,0.45787548001205347,40,23,17,11,0.5077395992859687,0.1887652389579937
기준금리/NNG@$인하/NNG@$여부/NNG,1,0.45757286030321587,51,29,22,19,0.5769428484868988,0.21465760319468122
개선/NNG@$기미/NNG@$보이/VV,1,0.45757286030321587,51,29,22,16,0.5769428484868988,0.21465760319468122
생산자/NNG@$물가/NNG@$상승률/NNG,1,0.45757286030321587,51,29,22,18,0.5769428484868988,0.21465760319468122
경제/NNG@$전망/NNG@$내놓/VV,1,0.45757286030321587,51,29,22,18,0.5769428484868988,0.21465760319468122
규모/NNG@$경기/NNG@$부양책/NNG,1,0.4549781792109664,159,88,71,40,0.8741699062365557,0.32738245777101416
개인/NNG@$서비스/NNG@$요금/NNG,0,0.4520222568313128,31,18,13,7,0.44560776261904156,0.16812964945186973
이전/NNG@$금리/NNG@$인상/NNG,1,0.4509651476639063,77,43,34,28,0.7071974154625245,0.2675379713071944
장기/NNG@$채권/NNG@$금리/NNG,1,0.44893637936230046,53,30,23,19,0.5867042802251958,0.22308653331957293
금리/NNG@$인상/NNG@$나서/VV@$않/VX,1,0.4460610243529455,42,24,18,15,0.5186108951570474,0.19861790120493797
경로/NNG@$하방/NNG@$위험/NNG,1,0.4460610243529455,42,24,18,12,0.5186108951570474,0.19861790120493797
하방/NNG@$위험/NNG@$요인/NNG,1,0.4451504347938442,103,57,46,41,0.7921682753543974,0.3040752105050738
수출/NNG@$호조/NNG@$보이/VV,1,0.4451504347938442,103,57,46,27,0.7921682753543974,0.3040752105050738
경제/NNG@$위협/NNG@$요인/NNG,1,0.44097107442052685,55,31,24,13,0.5962147927856045,0.2312505715448066
정책/NNG@$기조/NNG@$전환/NNG,1,0.44097107442052685,55,31,24,17,0.5962147927856045,0.2312505715448066
정책금리/NNG@$인상/NNG@$가능성/NNG,1,0.4404573507996363,105,58,47,48,0.7955262715243889,0.30895009084983033
가격/NNG@$고공/NNG@$행진/NNG,1,0.4402934951037383,68,38,30,12,0.6637128580859768,0.2578639219828685
통화/NNG@$부양/NNG@$기조/NNG,1,0.4355390258859506,44,25,19,29,0.5292758857969448,0.20806625398908482
기준금리/NNG@$동결/NNG@$통화정책/NNG@$방향/NNG,1,0.4355390258859506,44,25,19,8,0.5292758857969448,0.20806625398908482
금리/NNG@$인상/NNG@$종결/NNG,1,0.4355390258859506,44,25,19,6,0.5292758857969448,0.20806625398908482
경제/NNG@$견조/NNG@$성장세/NNG,1,0.4355390258859506,44,25,19,28,0.5292758857969448,0.20806625398908482
금리/NNG@$인하/NNG@$소비/NNG,1,0.4355390258859506,44,25,19,12,0.5292758857969448,0.20806625398908482
하방/NNG@$위험/NNG@$높/VA,1,0.4355390258859506,44,25,19,9,0.5292758857969448,0.20806625398908482
콜금리/NNG@$동결/NNG@$가능성/NNG,1,0.4355390258859506,44,25,19,16,0.5292758857969448,0.20806625398908482
시중/NNG@$자금/NNG@$단기/NNG@$부동화/NNG,1,0.4355390258859506,44,25,19,6,0.5292758857969448,0.20806625398908482
가격/NNG@$상승/NNG@$소비자/NNG,0,0.4354415784754355,33,19,14,15,0.45702436442123007,0.17970631439735116
실제/NNG@$소비자/NNG@$물가/NNG,0,0.4354415784754355,33,19,14,16,0.45702436442123007,0.17970631439735116
금리/NNG@$인상/NNG@$진행/NNG,0,0.4354415784754355,33,19,14,20,0.45702436442123007,0.17970631439735116
금리/NNG@$주가/NNG@$환율/NNG,0,0.4354415784754355,33,19,14,12,0.45702436442123007,0.17970631439735116
과거/NNG@$금융/NNG@$위기/NNG,0,0.4354415784754355,33,19,14,20,0.45702436442123007,0.17970631439735116
물가/NNG@$상승/NNG@$억제/NNG,1,0.43293228443374265,171,94,77,46,0.8721489733389699,0.3450645512720049
공격적/NNG@$금리/NNG@$인상/NNG,1,0.43237080036595343,200,110,90,60,0.8787230317188431,0.3481461937201321
산업/NNG@$평균/NNG@$지수/NNG@$하락/NNG@$거래/NNG,1,0.4294962926957542,85,47,38,51,0.7313345490115217,0.2918042903913811
국채/NNG@$가격/NNG@$하락/NNG,1,0.4294962926957542,85,47,38,21,0.7313345490115217,0.2918042903913811
평균/NNG@$지수/NNG@$하락/NNG@$거래/NNG@$마쳤/VV,1,0.4294962926957542,85,47,38,51,0.7313345490115217,0.2918042903913811
원화/NNG@$가치/NNG@$절상/NNG,1,0.42859492875934335,72,40,32,27,0.6786405129639643,0.271378127827061
단기/NNG@$외화/NNG@$차입/NNG,1,0.42859492875934335,72,40,32,37,0.6786405129639643,0.271378127827061
원자재/NNG@$가격/NNG@$상승/NNG@$인플레이션/NNG,1,0.42671284795273356,59,33,26,9,0.6144734841729963,0.2468531693102255
상승/NNG@$최고치/NNG@$기록/NNG,1,0.42671284795273356,59,33,26,31,0.6144734841729963,0.2468531693102255
금리/NNG@$정상화/NNG@$속도/NNG,1,0.42671284795273356,59,33,26,11,0.6144734841729963,0.2468531693102255
환율/NNG@$상승/NNG@$압력/NNG,1,0.42671284795273356,59,33,26,10,0.6144734841729963,0.2468531693102255
금리/NNG@$인상/NNG@$기조/NNG@$지속/NNG,1,0.4260971868322343,46,26,20,20,0.5397278706815621,0.2171520582602686
제조업/NNG@$지수/NNG@$예상치/NNG,1,0.4260971868322343,46,26,20,14,0.5397278706815621,0.2171520582602686
경제/NNG@$차지/NNG@$비중/NNG,1,0.4260971868322343,46,26,20,16,0.5397278706815621,0.2171520582602686
물가/NNG@$오르/VV@$않/VX,1,0.4260971868322343,46,26,20,28,0.5397278706815621,0.2171520582602686
성장률/NNG@$전망치/NNG@$상향/NNG@$조정/NNG,1,0.42460515837976764,87,48,39,49,0.7367549951352111,0.29750501881419644
인상/NNG@$쉽/VA@$않/VX,1,0.42374614373962993,146,80,66,44,0.8538274045236262,0.3455023941421036
물가/NNG@$안정세/NNG@$유지/NNG,1,0.4231512027590927,74,41,33,16,0.6857124930494479,0.27787703047768675
경기/NNG@$확장/NNG@$위축/NNG,0,0.4213169265075616,35,20,15,20,0.468294596676825,0.1906200114926757
무역수지/NNG@$흑자/NNG@$규모/NNG,0,0.4213169265075616,35,20,15,10,0.468294596676825,0.1906200114926757
부정적/NNG@$영향/NNG@$예상/NNG,1,0.4202824398809222,61,34,27,22,0.6232184464041615,0.25432054641851565
신중/NNG@$필요/NNG@$있/VA,1,0.41794369898022876,76,42,34,31,0.6925272035623729,0.28421177618971166
물가/NNG@$목표/NNG@$상한/NNG,0,0.41784346653614857,17,10,7,1,0.34312429210818746,0.14085172504375265
둔화/NNG@$인플레/NNG@$압력/NNG,1,0.4175643309517232,48,27,21,28,0.5499606627544515,0.22591028636782565
인플레이션/NNG@$압력/NNG@$금리/NNG,1,0.4175643309517232,48,27,21,12,0.5499606627544515,0.22591028636782565
금리/NNG@$인상/NNG@$마지막/NNG,1,0.4175643309517232,48,27,21,10,0.5499606627544515,0.22591028636782565
경제/NNG@$보/VV@$수출/NNG,1,0.41573872120695077,104,57,47,38,0.7840744286298701,0.32350450322754976
산업/NNG@$생산/NNG@$증가/NNG,1,0.4156420699626371,232,127,105,98,0.8752229325252275,0.3611962293846585
둔화/NNG@$가능성/NNG@$높/VA,1,0.4142435752015168,63,35,28,10,0.6317060270012355,0.2615813592288171
상품/NNG@$수지/NNG@$흑자/NNG,1,0.41295082177320075,78,43,35,40,0.6990880682571455,0.29038765459122956
통화정책/NNG@$기준금리/NNG@$동결/NNG,1,0.41155984275736346,106,58,48,60,0.7874070208558573,0.3281716040086874
지속/NNG@$금리/NNG@$인상/NNG,1,0.41103518100397163,205,112,93,89,0.8718988056041056,0.36384487386670344
가능성/NNG@$높/VA@$보/VX,1,0.410857565667917,93,51,42,30,0.7516256786212754,0.31378876830868446
시장/NNG@$관심/NNG@$집중/NNG,1,0.41068162237284134,119,65,54,63,0.8140777050378394,0.3400051339008268
통화/NNG@$가치/NNG@$절상/NNG,1,0.4098014979574105,50,28,22,12,0.559968656444939,0.23437021604077485
금리/NNG@$인하/NNG@$어렵/VA,1,0.4098014979574105,50,28,22,28,0.559968656444939,0.23437021604077485
확대/NNG@$필요/NNG@$있/VA,1,0.4098014979574105,50,28,22,7,0.559968656444939,0.23437021604077485
수출/NNG@$차지/NNG@$비중/NNG,1,0.4098014979574105,50,28,22,18,0.559968656444939,0.23437021604077485
통계/NNG@$유로/NNG@$유로존/NNG,1,0.4098014979574105,50,28,22,16,0.559968656444939,0.23437021604077485
주가/NNG@$상승/NNG@$환율/NNG,0,0.40915065372554804,37,21,16,9,0.4794095249845387,0.20096688693649503
상향/NNG@$조정/NNG@$예상/NNG,0,0.40915065372554804,37,21,16,16,0.4794095249845387,0.20096688693649503
금리/NNG@$인상/NNG@$물가/NNG@$상승/NNG,0,0.40915065372554804,37,21,16,15,0.4794095249845387,0.20096688693649503
금리/NNG@$인상/NNG@$늦/VA,0,0.40915065372554804,37,21,16,17,0.4794095249845387,0.20096688693649503
상승세/NNG@$보일/VV@$전망/NNG,0,0.40915065372554804,37,21,16,14,0.4794095249845387,0.20096688693649503
물가/NNG@$낮/VA@$유지/NNG,0,0.40915065372554804,37,21,16,9,0.4794095249845387,0.20096688693649503
기준금리/NNG@$인상/NNG@$검토/NNG,0,0.40915065372554804,37,21,16,19,0.4794095249845387,0.20096688693649503
하방/NNG@$위험/NNG@$상존/NNG,0,0.40915065372554804,37,21,16,11,0.4794095249845387,0.20096688693649503
개인/NNG@$소비/NNG@$지출/NNG@$가격지수/NNG,1,0.40855090140945616,65,36,29,44,0.6399361130890644,0.2686457118413783
종합/NNG@$지수/NNG@$상승/NNG,1,0.40855090140945616,65,36,29,24,0.6399361130890644,0.2686457118413783
고용/NNG@$지표/NNG@$시장/NNG,1,0.40815363383936076,80,44,36,31,0.7053988326144495,0.2964094973218932
농산물/NNG@$석유류/NNG@$근원인플레이션율/NNG,1,0.40815363383936076,80,44,36,29,0.7053988326144495,0.2964094973218932
소비/NNG@$지출/NNG@$가격지수/NNG,1,0.40316565793394243,67,37,30,44,0.6479091452854273,0.27552245231925837
생산/NNG@$소비/NNG@$투자/NNG,1,0.40316565793394243,67,37,30,22,0.6479091452854273,0.27552245231925837
금리/NNG@$인하/NNG@$유동성/NNG@$공급/NNG,1,0.40316565793394243,67,37,30,24,0.6479091452854273,0.27552245231925837
종료/NNG@$금리/NNG@$인상/NNG,1,0.40316565793394243,67,37,30,38,0.6479091452854273,0.27552245231925837
금리/NNG@$인상/NNG@$압력/NNG,1,0.4030232592892613,123,67,56,30,0.8179665234842937,0.3479574067529727
인플레/NNG@$압력/NNG@$높/VA,1,0.40236248718079826,97,53,44,25,0.7604355627199206,0.32399472887812547
금리/NNG@$낮/VA@$유지/NNG,1,0.4013795422315052,136,74,62,62,0.8353076246921072,0.35673039018681635
예상/NNG@$성장/NNG@$경로/NNG,0,0.3985622629297707,39,22,17,16,0.49036008185167784,0.21082476691938068
투자/NNG@$심리/NNG@$긍정적/NNG,0,0.3985622629297707,39,22,17,17,0.49036008185167784,0.21082476691938068
유로화/NNG@$사용/NNG@$물가/NNG@$상승률/NNG,0,0.3985622629297707,39,22,17,16,0.49036008185167784,0.21082476691938068
사용/NNG@$물가/NNG@$상승률/NNG,0,0.3985622629297707,39,22,17,16,0.49036008185167784,0.21082476691938068
경제/NNG@$회복세/NNG@$예상/NNG,0,0.3985622629297707,39,22,17,14,0.49036008185167784,0.21082476691938068
경제/NNG@$회복/NNG@$조짐/NNG,0,0.3985622629297707,39,22,17,29,0.49036008185167784,0.21082476691938068
유로존/NNG@$유로화/NNG@$사용/NNG@$물가/NNG@$상승률/NNG,0,0.3985622629297707,39,22,17,16,0.49036008185167784,0.21082476691938068
유지/NNG@$기준금리/NNG@$인상/NNG,1,0.39805458202171984,69,38,31,15,0.6556260876365809,0.28221937217722287
수출/NNG@$부정적/NNG@$영향/NNG,1,0.39785307514926926,138,75,63,49,0.8362152251966694,0.3601277687917607
채권/NNG@$시장/NNG@$통화정책/NNG,1,0.3961517348108885,54,30,24,35,0.5792909873615556,0.2504894435264957
경기/NNG@$부양/NNG@$필요/NNG,1,0.3961517348108885,54,30,24,20,0.5792909873615556,0.2504894435264957
농산물/NNG@$가격/NNG@$하락/NNG,1,0.3961517348108885,54,30,24,18,0.5792909873615556,0.2504894435264957
은행/NNG@$대출/NNG@$금리/NNG,1,0.3943270475386107,101,55,46,32,0.7684151324016982,0.33370809373743265
경제/NNG@$완만/XR@$성장/NNG,1,0.3931890168880088,71,39,32,18,0.6630883955523595,0.28874337475167267
경제/NNG@$성장세/NNG@$약화/NNG,0,0.39225806270826413,28,16,12,30,0.41690398607556517,0.18194186612672877
내수/NNG@$수출/NNG@$부진/NNG,0,0.39225806270826413,28,16,12,13,0.41690398607556517,0.18194186612672877
장기/NNG@$시장/NNG@$금리/NNG@$상승/NNG,0,0.39225806270826413,28,16,12,17,0.41690398607556517,0.18194186612672877
재정/NNG@$확대/NNG@$정책/NNG,1,0.39061661270814163,88,48,40,37,0.7282252743908171,0.3190405920809739
주택/NNG@$판매/NNG@$감소/NNG,1,0.3900939951052924,56,31,25,32,0.5885973405469218,0.2581867744069462
금리/NNG@$인하/NNG@$인상/NNG,1,0.38925786976778465,41,23,18,20,0.5011373295675714,0.22025645929098336
기준금리/NNG@$조정/NNG@$여부/NNG,1,0.38925786976778465,41,23,18,15,0.5011373295675714,0.22025645929098336
변화/NNG@$금리/NNG@$인상/NNG,1,0.38925786976778465,41,23,18,16,0.5011373295675714,0.22025645929098336
인상/NNG@$나설/VV@$예상/NNG,1,0.38925786976778465,41,23,18,22,0.5011373295675714,0.22025645929098336
기준금리/NNG@$동결/NNG@$열/VV,1,0.38925786976778465,41,23,18,9,0.5011373295675714,0.22025645929098336
시장/NNG@$영향/NNG@$제한적/NNG,1,0.38925786976778465,41,23,18,22,0.5011373295675714,0.22025645929098336
가격/NNG@$상승/NNG@$기대/NNG,1,0.38925786976778465,41,23,18,25,0.5011373295675714,0.22025645929098336
소비자/NNG@$물가/NNG@$상승세/NNG,1,0.3865836052862264,90,49,41,29,0.7333507784278527,0.32435286552258363
고려/NNG@$필요/NNG@$있/VA,1,0.3849500600578033,120,65,55,54,0.8059176267979105,0.35781904265389597
금리/NNG@$인상/NNG@$가능성/NNG@$시사/NNG,1,0.383417655666467,216,117,99,78,0.862888819005251,0.3844935090653479
인플레이션/NNG@$상승/NNG@$압력/NNG,1,0.38191130485576563,135,73,62,44,0.8265486771126608,0.369602874857529
가격/NNG@$상승/NNG@$경기/NNG,1,0.3810081116538113,43,24,19,9,0.51173265410766,0.2293126737395765
제시/NNG@$성장률/NNG@$전망치/NNG,1,0.3810081116538113,43,24,19,8,0.51173265410766,0.2293126737395765
경기/NNG@$둔화/NNG@$심화/NNG,1,0.3810081116538113,43,24,19,15,0.51173265410766,0.2293126737395765
내외/NNG@$금리/NNG@$역전/NNG,1,0.37983345314533645,77,42,35,8,0.6839687340279573,0.3073364117161188
성장/NNG@$둔화/NNG@$인플레이션/NNG,1,0.3791880989857692,60,33,27,24,0.6064854498882263,0.272931062686107
인상/NNG@$가능성/NNG@$커지/VV,1,0.3791880989857692,60,33,27,22,0.6064854498882263,0.272931062686107
소비자/NNG@$물가/NNG@$상승률/NNG@$중기/NNG,1,0.3791880989857692,60,33,27,3,0.6064854498882263,0.272931062686107
금리/NNG@$인하/NNG@$가계부채/NNG,1,0.37887088994388707,94,51,43,47,0.7429391537109842,0.3345858326965784
상품/NNG@$가격/NNG@$상승/NNG,1,0.3781237373516697,150,81,69,21,0.8397853909762689,0.3788611209996414
경기/NNG@$물가/NNG@$금융시장/NNG,0,0.3774987119817901,30,17,13,8,0.4282058705116095,0.19346284742455763
금리/NNG@$인상/NNG@$고민/NNG,0,0.3774987119817901,30,17,13,20,0.4282058705116095,0.19346284742455763
유지/NNG@$필요/NNG@$있/VA,1,0.3765297642624217,187,101,86,57,0.8563269615434238,0.3877622807356601
통화/NNG@$가치/NNG@$절하/NNG,1,0.3757324715674717,79,43,36,53,0.6904357105578807,0.31322452586523913
시장/NNG@$예상/NNG@$기준금리/NNG,1,0.3757324715674717,79,43,36,22,0.6904357105578807,0.31322452586523913
인하/NNG@$유동성/NNG@$공급/NNG,1,0.3751757452150968,96,52,44,29,0.7474124526146874,0.33951245888406334
가격/NNG@$상승/NNG@$인플레이션/NNG@$압력/NNG,1,0.37424047282205763,62,34,28,8,0.6150631761782412,0.2800013299270386
수당/NNG@$청구/NNG@$예상치/NNG,1,0.37424047282205763,62,34,28,17,0.6150631761782412,0.2800013299270386
실업/NNG@$수당/NNG@$청구/NNG@$예상치/NNG,1,0.37424047282205763,62,34,28,17,0.6150631761782412,0.2800013299270386
경기/NNG@$회복/NNG@$부진/NNG,1,0.37363214356938057,45,25,20,13,0.5221379062353303,0.2380344533353818
상승/NNG@$지수/NNG@$높/VA,1,0.37363214356938057,45,25,20,37,0.5221379062353303,0.2380344533353818
금리/NNG@$인상/NNG@$금융/NNG,1,0.3717812867856569,81,44,37,39,0.6966615233794348,0.31896515712903917
소비/NNG@$지출/NNG@$둔화/NNG,1,0.3717812867856569,81,44,37,25,0.6966615233794348,0.31896515712903917
기금/NNG@$금리/NNG@$인하/NNG,1,0.36957606767249973,64,35,29,10,0.6233950429199346,0.2868831996483572
소매/NNG@$판매/NNG@$증가/NNG,1,0.3692064465242224,143,77,66,67,0.8301119331453145,0.38234038674024845
브렉시트/NNG@$유럽연합/NNG@$탈퇴/NNG,1,0.3684119676987261,169,91,78,139,0.8473469375509076,0.3909970063864025
성장률/NNG@$기록/NNG@$전망/NNG,1,0.36796729685425644,83,45,38,29,0.702649871702855,0.324562177708933
상승/NNG@$압력/NNG@$커지/VV,1,0.36796729685425644,83,45,38,22,0.702649871702855,0.324562177708933
시장/NNG@$안정화/NNG@$조치/NNG,1,0.36698597420290513,47,26,21,21,0.5323455020437727,0.24645514106664818
예금금리/NNG@$한계/NNG@$대출/NNG,1,0.36698597420290513,47,26,21,24,0.5323455020437727,0.24645514106664818
상승/NNG@$압력/NNG@$확대/NNG,1,0.36698597420290513,47,26,21,8,0.5323455020437727,0.24645514106664818
원유/NNG@$도입/NNG@$단가/NNG,0,0.36520351336234413,32,18,14,14,0.4394058148932376,0.2042667995216385
자본/NNG@$유출/NNG@$발생/NNG,0,0.36520351336234413,32,18,14,22,0.4394058148932376,0.2042667995216385
인하/NNG@$쉽/VA@$않/VX,1,0.36516213321168234,66,36,30,26,0.6314805664503232,0.29358471700561883
금리/NNG@$인상/NNG@$기조/NNG@$유지/NNG,1,0.3642793943770626,85,46,39,28,0.7084047154140414,0.33001919512219874
고공/NNG@$행진/NNG@$지속/NNG,1,0.3613242978688871,104,56,48,30,0.7632916559465831,0.35801716517462245
금리/NNG@$인상/NNG@$자제/NNG,1,0.36097068580967107,68,37,31,44,0.639319825455181,0.3001129174476921
인상/NNG@$소비자/NNG@$물가/NNG,1,0.36097068580967107,68,37,31,16,0.639319825455181,0.3001129174476921
인상/NNG@$가능성/NNG@$시장/NNG,1,0.3609538945408628,49,27,22,8,0.5423484921538835,0.25460194778644873
전망/NNG@$금리/NNG@$인하/NNG,1,0.3580684220244663,106,57,49,48,0.7667852501762786,0.36235569989806576
전망/NNG@$힘/NNG@$얻/VV,1,0.35746890423003275,151,81,70,49,0.8322975849083116,0.3938556695956552
지속/NNG@$경기/NNG@$회복/NNG,1,0.3572437049112893,89,48,41,30,0.7192308564941512,0.3405265678773183
안전자산/NNG@$선호/NNG@$심리/NNG,1,0.35697771395481426,70,38,32,35,0.6469134289177122,0.30647400292083904
금리/NNG@$인상/NNG@$소비/NNG,1,0.3554421194036639,51,28,23,17,0.5521406065273969,0.2624971944554643
동향/NNG@$금리/NNG@$인상/NNG,1,0.3554421194036639,51,28,23,22,0.5521406065273969,0.2624971944554643
경제/NNG@$성장/NNG@$뒷받침/NNG,1,0.3554421194036639,51,28,23,26,0.5521406065273969,0.2624971944554643
의견/NNG@$적/VA@$않/VX,1,0.3554421194036639,51,28,23,9,0.5521406065273969,0.2624971944554643
주택/NNG@$매매가격/NNG@$수도권/NNG,1,0.3554421194036639,51,28,23,13,0.5521406065273969,0.2624971944554643
가능성/NNG@$낮/VA@$금리/NNG,1,0.3554421194036639,51,28,23,22,0.5521406065273969,0.2624971944554643
경기/NNG@$상승세/NNG@$지속/NNG@$수요/NNG,0,0.35482038877177624,34,19,15,9,0.45049288674282395,0.21447704996764702
경기/NNG@$부진/NNG@$심화/NNG,0,0.35482038877177624,34,19,15,8,0.45049288674282395,0.21447704996764702
확대/NNG@$경기/NNG@$부양/NNG,0,0.35482038877177624,34,19,15,15,0.45049288674282395,0.21447704996764702
대출/NNG@$증가/NNG@$속도/NNG,0,0.35482038877177624,34,19,15,11,0.45049288674282395,0.21447704996764702
위험/NNG@$요인/NNG@$영향/NNG,1,0.3531625328036967,72,39,33,22,0.6542624826011691,0.31267348689243857
인하/NNG@$가능성/NNG@$낮/VA,1,0.3517761320244468,110,59,51,58,0.7732393952762497,0.37070456387981776
지수/NNG@$하락/NNG@$거래/NNG@$마쳤/VV,1,0.35060825560546416,93,50,43,54,0.7291757559653887,0.35051224870930076
금리/NNG@$인상/NNG@$쉽/VA@$않/VX,1,0.35060825560546416,93,50,43,25,0.7291757559653887,0.35051224870930076
경기/NNG@$부양/NNG@$규모/NNG,1,0.35037402385695304,53,29,24,8,0.5617162801948052,0.27015929448588544
역전/NNG@$자본/NNG@$유출/NNG,1,0.35037402385695304,53,29,24,20,0.5617162801948052,0.27015929448588544
통화정책/NNG@$완화/NNG@$조정/NNG@$필요/NNG,1,0.35037402385695304,53,29,24,19,0.5617162801948052,0.27015929448588544
동결/NNG@$시장/NNG@$예상/NNG,1,0.34950725688577733,74,40,34,32,0.6613685547306322,0.3187163138092996
금리/NNG@$인상/NNG@$여부/NNG@$결정/NNG,1,0.34950725688577733,74,40,34,26,0.6613685547306322,0.3187163138092996
최대/NNG@$경제/NNG@$국인/NNG,1,0.34950725688577733,74,40,34,22,0.6613685547306322,0.3187163138092996
경제/NNG@$전망/NNG@$하향/NNG@$조정/NNG,0,0.3459424778595812,36,20,16,17,0.46145585491524577,0.2241882341274422
상승세/NNG@$지속/NNG@$수요/NNG,0,0.3459424778595812,36,20,16,9,0.46145585491524577,0.2241882341274422
압력/NNG@$높/VA@$금리/NNG,1,0.34568653893738244,55,30,25,22,0.5710706639810547,0.27760353109469577
기조/NNG@$지속/NNG@$전망/NNG,1,0.34568653893738244,55,30,25,30,0.5710706639810547,0.27760353109469577
엠파이어/NNG@$스테이트/NNG@$지수/NNG,1,0.34568653893738244,55,30,25,30,0.5710706639810547,0.27760353109469577
경제/NNG@$성장/NNG@$달성/NNG,1,0.34568653893738244,55,30,25,17,0.5710706639810547,0.27760353109469577
금융/NNG@$위기/NNG@$가능성/NNG,1,0.34132739792009725,57,31,26,29,0.5801996234169079,0.2848426737663049
지수/NNG@$상승/NNG@$거래/NNG@$마쳤/VV,1,0.34129416718248917,99,53,46,61,0.7425249378773698,0.36456193610843113
불확실성/NNG@$높/VA@$진/VX,1,0.33935541527589375,80,43,37,16,0.6812507768168247,0.3359477114253676
유로존/NNG@$물가/NNG@$상승률/NNG,1,0.3383395615436089,101,54,47,44,0.7465765516759296,0.36900796776859207
채권/NNG@$시장/NNG@$전망/NNG,0,0.3382649674356031,38,21,17,27,0.47228354121680544,0.23347337847810853
금리/NNG@$동반/NNG@$상승/NNG,0,0.3382649674356031,38,21,17,12,0.47228354121680544,0.23347337847810853
필요/NNG@$있/VA@$주문/NNG,0,0.3382649674356031,38,21,17,15,0.47228354121680544,0.23347337847810853
물가/NNG@$상승/NNG@$압력/NNG@$금리/NNG,0,0.3382649674356031,38,21,17,20,0.47228354121680544,0.23347337847810853
생산자/NNG@$물가/NNG@$소비자/NNG,0,0.3382649674356031,38,21,17,8,0.47228354121680544,0.23347337847810853
영향/NNG@$크/VA@$않/VX@$전망/NNG,0,0.3382649674356031,38,21,17,14,0.47228354121680544,0.23347337847810853
인상/NNG@$전제/NNG@$조건/NNG,1,0.3372530125525601,59,32,27,14,0.5890997283595868,0.29188746856007475
전망/NNG@$하방/NNG@$리스크/NNG,1,0.3372530125525601,59,32,27,17,0.5890997283595868,0.29188746856007475
경로/NNG@$불확실성/NNG@$상존/NNG,1,0.3372530125525601,59,32,27,1,0.5890997283595868,0.29188746856007475
원화/NNG@$강세/NNG@$지속/NNG,1,0.3372530125525601,59,32,27,24,0.5890997283595868,0.29188746856007475
성장/NNG@$경로/NNG@$불확실성/NNG@$상존/NNG,1,0.3372530125525601,59,32,27,1,0.5890997283595868,0.29188746856007475
인상/NNG@$필요성/NNG@$제기/NNG,1,0.3372530125525601,59,32,27,33,0.5890997283595868,0.29188746856007475
대외/NNG@$불안/NNG@$요인/NNG,1,0.33718119777103617,120,64,56,46,0.786518873967992,0.3897679733964637
금리/NNG@$인상/NNG@$단행/NNG@$가능성/NNG,1,0.33654658532321147,137,73,64,45,0.8103372256092172,0.40214670182380663
규모/NNG@$국채/NNG@$매입/NNG,1,0.3362032212309034,82,44,38,30,0.6874086510641879,0.34140507879765253
기준금리/NNG@$인상/NNG@$가능성/NNG@$높/VA,1,0.3362032212309034,82,44,38,20,0.6874086510641879,0.34140507879765253
고용/NNG@$지표/NNG@$호조/NNG,1,0.33419340446163837,169,90,79,74,0.8334926239326284,0.4158371111300496
주택/NNG@$가격/NNG@$상승률/NNG,1,0.33342682032797355,61,33,28,23,0.5977682353472049,0.29874702936097036
성장/NNG@$둔화/NNG@$경제/NNG,1,0.33342682032797355,61,33,28,31,0.5977682353472049,0.29874702936097036
부담/NNG@$크/VA@$않/VX,1,0.33342682032797355,61,33,28,19,0.5977682353472049,0.29874702936097036
해외/NNG@$경제/NNG@$포커스/NNG,1,0.33315069452416424,84,45,39,34,0.6933371262059492,0.34672487836032734
국내총생산/NNG@$성장률/NNG@$전망치/NNG,1,0.33263093432009794,105,56,49,46,0.7541134867999992,0.3775590913514255
성장/NNG@$목표/NNG@$달성/NNG,0,0.3315559636566705,40,22,18,27,0.4829650676336985,0.24238921722660262
물가/NNG@$상승/NNG@$유발/NNG,0,0.3315559636566705,40,22,18,19,0.4829650676336985,0.24238921722660262
요인/NNG@$자본/NNG@$유출입/NNG,0,0.3315559636566705,40,22,18,11,0.4829650676336985,0.24238921722660262
금융시장/NNG@$불안/NNG@$지속/NNG,0,0.3315559636566705,40,22,18,8,0.4829650676336985,0.24238921722660262
콜금리/NNG@$인상/NNG@$시장/NNG,0,0.3315559636566705,40,22,18,10,0.4829650676336985,0.24238921722660262
기준금리/NNG@$인하/NNG@$정책/NNG,0,0.3315559636566705,40,22,18,26,0.4829650676336985,0.24238921722660262
시장/NNG@$예상치/NNG@$크/VA,1,0.3298179872564613,63,34,29,17,0.6062030643307401,0.30542915113125585
개선/NNG@$모습/NNG@$보이/VV,1,0.3298179872564613,63,34,29,21,0.6062030643307401,0.30542915113125585
물가/NNG@$상승/NNG@$압력/NNG@$커지/VV,1,0.3264003813655063,65,35,30,18,0.614402771131758,0.3119405615201761
가능성/NNG@$높/VA@$전망/NNG,1,0.3263655593507844,220,117,103,79,0.8409507608814225,0.42699530585007633
기준금리/NNG@$인하/NNG@$기대감/NNG,1,0.32632419436055127,145,77,68,65,0.8142089011604917,0.4134553222294132
수입/NNG@$전망/NNG@$소비/NNG@$지출/NNG,0,0.3256365400367376,42,23,19,23,0.4934900300086955,0.2509801461305546
금융/NNG@$위기/NNG@$영향/NNG,0,0.3256365400367376,42,23,19,6,0.4934900300086955,0.2509801461305546
가계/NNG@$수입/NNG@$전망/NNG@$소비/NNG@$지출/NNG,0,0.3256365400367376,42,23,19,22,0.4934900300086955,0.2509801461305546
상승률/NNG@$중기/NNG@$물가/NNG@$목표/NNG,0,0.3256365400367376,42,23,19,1,0.4934900300086955,0.2509801461305546
채권/NNG@$투자/NNG@$과세/NNG,0,0.3256365400367376,42,23,19,8,0.4934900300086955,0.2509801461305546
지수/NNG@$오른/VV@$거래/NNG,0,0.3256365400367376,42,23,19,10,0.4934900300086955,0.2509801461305546
요인/NNG@$물가/NNG@$상승/NNG,0,0.3256365400367376,42,23,19,18,0.4934900300086955,0.2509801461305546
인상/NNG@$가능성/NNG@$배제/NNG@$없/VA,1,0.3245208678144378,111,59,52,35,0.7640813572311078,0.38956870054785775
지속/NNG@$가능성/NNG@$높/VA,1,0.3245208678144378,111,59,52,41,0.7640813572311078,0.38956870054785775
대응/NNG@$금리/NNG@$인상/NNG,1,0.3245157564428669,90,48,42,39,0.7097836609146475,0.36188902526248673
상승/NNG@$속도/NNG@$둔화/NNG,1,0.3203668506969406,44,24,20,9,0.5038486189990314,0.2592811611822731
인상/NNG@$예상/NNG@$시장/NNG,1,0.3203668506969406,44,24,20,7,0.5038486189990314,0.2592811611822731
지수/NNG@$상승/NNG@$마감/NNG,1,0.3203668506969406,44,24,20,9,0.5038486189990314,0.2592811611822731
금융시장/NNG@$기준금리/NNG@$인상/NNG,1,0.3203668506969406,44,24,20,13,0.5038486189990314,0.2592811611822731
경기/NNG@$회복/NNG@$수요/NNG@$압력/NNG,1,0.3203668506969406,44,24,20,5,0.5038486189990314,0.2592811611822731
하락/NNG@$환율/NNG@$상승/NNG,1,0.3203668506969406,44,24,20,21,0.5038486189990314,0.2592811611822731
소비자/NNG@$물가/NNG@$안정세/NNG,1,0.3170880406661434,71,38,33,15,0.6375855951127741,0.33050578271685815
금리/NNG@$인상/NNG@$자산/NNG,1,0.31563631014567295,46,25,21,36,0.5140317025473311,0.2673200512855328
성장/NNG@$물가/NNG@$상승/NNG,1,0.31563631014567295,46,25,21,12,0.5140317025473311,0.2673200512855328
투자/NNG@$활성화/NNG@$대책/NNG,1,0.31563631014567295,46,25,21,32,0.5140317025473311,0.2673200512855328
공급/NNG@$물가/NNG@$상승/NNG@$압력/NNG,1,0.31563631014567295,46,25,21,12,0.5140317025473311,0.2673200512855328
전망치/NNG@$상향/NNG@$조정/NNG,1,0.31553890251011696,347,184,163,143,0.8380730472117982,0.43593070704833314
경기/NNG@$부양/NNG@$조치/NNG,1,0.31458775937963845,155,82,73,70,0.8172050390118181,0.4259746316757013
자산/NNG@$가격/NNG@$거품/NNG,1,0.3142425601517822,73,39,34,15,0.6448419726217857,0.336386606393163
경기/NNG@$회복/NNG@$가능성/NNG,1,0.3142425601517822,73,39,34,37,0.6448419726217857,0.336386606393163
기대/NNG@$금리/NNG@$인상/NNG,1,0.3142425601517822,73,39,34,27,0.6448419726217857,0.336386606393163
요인/NNG@$금리/NNG@$인상/NNG,1,0.31400618306298766,98,52,46,39,0.7287449487597792,0.3803546459789818
가능성/NNG@$높/VA@$시장/NNG,0,0.3123267316344991,27,15,12,19,0.3989101486364163,0.20898036129167977
거시/NNG@$건전성/NNG@$조치/NNG,0,0.3123267316344991,27,15,12,28,0.3989101486364163,0.20898036129167977
예정/NNG@$금리/NNG@$인상/NNG,1,0.3115044830303948,75,40,35,24,0.6518644077203226,0.3421202295169142
금리/NNG@$인하/NNG@$반대/NNG,1,0.3115044830303948,75,40,35,20,0.6518644077203226,0.3421202295169142
주식/NNG@$투자/NNG@$자금/NNG,1,0.3115044830303948,75,40,35,20,0.6518644077203226,0.3421202295169142
통화/NNG@$가치/NNG@$급락/NNG,1,0.3115044830303948,75,40,35,31,0.6518644077203226,0.3421202295169142
필요/NNG@$있/VA@$금리/NNG@$인상/NNG,1,0.3115044830303948,75,40,35,13,0.6518644077203226,0.3421202295169142
실질/NNG@$국내총생산/NNG@$증가율/NNG,1,0.31135654122619294,48,26,22,32,0.5240308797383513,0.2751190443825065
금융/NNG@$위기/NNG@$기준금리/NNG,1,0.3088632664619735,77,41,36,26,0.6586545730147397,0.34771010836007166
주택/NNG@$담보대출/NNG@$크/VA,1,0.3074562363953621,50,27,23,8,0.5338385130185512,0.2826960521803769
가격/NNG@$하락/NNG@$압력/NNG,1,0.3074562363953621,50,27,23,14,0.5338385130185512,0.2826960521803769
금리/NNG@$인상/NNG@$달러화/NNG@$강세/NNG,1,0.3074562363953621,50,27,23,14,0.5338385130185512,0.2826960521803769
사상/NNG@$최고/NNG@$기록/NNG,1,0.3074562363953621,50,27,23,22,0.5338385130185512,0.2826960521803769
주식/NNG@$채권/NNG@$시장/NNG,1,0.3044022978076981,106,56,50,47,0.7445850569202483,0.396963338841094
공격적/NNG@$통화/NNG@$완화/NNG,1,0.30387736132261933,52,28,24,16,0.5434477438137775,0.2900656184724676
상승/NNG@$크/VA@$않/VX,1,0.30387736132261933,52,28,24,21,0.5434477438137775,0.2900656184724676
위기/NNG@$발생/NNG@$가능성/NNG,1,0.30387736132261933,52,28,24,25,0.5434477438137775,0.2900656184724676
접근/NNG@$필요/NNG@$있/VA,0,0.3026769340056985,29,16,13,14,0.40996528874699695,0.21939854165350903
석유/NNG@$제품/NNG@$가격/NNG,0,0.3026769340056985,29,16,13,18,0.40996528874699695,0.21939854165350903
기준금리/NNG@$인상/NNG@$고려/NNG,0,0.3026769340056985,29,16,13,27,0.40996528874699695,0.21939854165350903
동결/NNG@$기준금리/NNG@$인하/NNG,1,0.30057231376641425,54,29,25,19,0.5528524952627059,0.2972396470384951
민간/NNG@$소비/NNG@$위축/NNG,1,0.30057231376641425,54,29,25,25,0.5528524952627059,0.2972396470384951
시장/NNG@$경기/NNG@$회복/NNG,1,0.30057231376641425,54,29,25,21,0.5528524952627059,0.2972396470384951
내수/NNG@$부진/NNG@$수출/NNG,1,0.30057231376641425,54,29,25,15,0.5528524952627059,0.2972396470384951
시장/NNG@$예상/NNG@$크/VA,1,0.299100262316641,85,45,40,30,0.6835391763886738,0.36869364328363374
만장일치/NNG@$기준금리/NNG@$동결/NNG,1,0.299100262316641,85,45,40,26,0.6835391763886738,0.36869364328363374
물가/NNG@$상승률/NNG@$전망/NNG,1,0.2988881506115282,239,126,113,86,0.8303461318721652,0.448088410853182
민간/NNG@$소비/NNG@$회복/NNG,1,0.2976866002376506,112,59,53,35,0.7546045717581743,0.40829066257716873
산업/NNG@$생산/NNG@$수출/NNG,1,0.29750177158505253,56,30,26,22,0.5620474648764695,0.3042279643396212
성장/NNG@$발목/NNG@$잡/VV,1,0.29750177158505253,56,30,26,20,0.5620474648764695,0.3042279643396212
금리/NNG@$인하/NNG@$단행/NNG@$전망/NNG,1,0.29750177158505253,56,30,26,14,0.5620474648764695,0.3042279643396212
제조업/NNG@$평균/NNG@$가동률/NNG,1,0.29750177158505253,56,30,26,17,0.5620474648764695,0.3042279643396212
금리/NNG@$인상/NNG@$카드/NNG,1,0.2968977137878348,154,81,73,42,0.8086989911545475,0.438317181884471
금리/NNG@$인상/NNG@$가능성/NNG@$낮/VA,1,0.2948995093415985,156,82,74,38,0.809209524143722,0.44051891339823346
물가/NNG@$상승/NNG@$압력/NNG@$높/VA,1,0.2948394337493734,192,101,91,54,0.823983472191462,0.44862060704407086
청구/NNG@$감소/NNG@$기록/NNG,0,0.29472982536034675,31,17,14,38,0.42095652003634054,0.22924623593039054
부동산/NNG@$거품/NNG@$붕괴/NNG,0,0.29472982536034675,31,17,14,21,0.42095652003634054,0.22924623593039054
강구/NNG@$필요/NNG@$있/VA,0,0.29472982536034675,31,17,14,25,0.42095652003634054,0.22924623593039054
경기/NNG@$회복/NNG@$불씨/NNG,1,0.2946330443148959,58,31,27,21,0.5710281092994398,0.31103875737977804
정책금리/NNG@$인하/NNG@$가능성/NNG,1,0.2946330443148959,58,31,27,24,0.5710281092994398,0.31103875737977804
경제/NNG@$전망/NNG@$경기/NNG,1,0.2946330443148959,58,31,27,13,0.5710281092994398,0.31103875737977804
시장/NNG@$충격/NNG@$않/VX,1,0.2946330443148959,58,31,27,16,0.5710281092994398,0.31103875737977804
금리/NNG@$인상/NNG@$조치/NNG,1,0.29421942782868715,175,92,83,53,0.8187880143853569,0.4463975694379096
인상/NNG@$가능성/NNG@$반영/NNG,1,0.294185969899895,452,238,214,264,0.8290365377824409,0.4520181024585273
원/NNG@$환율/NNG@$상승/NNG,1,0.29341221481358426,116,61,55,38,0.7604727161113366,0.41533763870795454
환율/NNG@$상승/NNG@$물가/NNG,1,0.2919387972002834,60,32,28,14,0.579790622891912,0.3176789164681706
구조적/NNG@$문제/NNG@$해결/NNG,1,0.2919387972002834,60,32,28,29,0.579790622891912,0.3176789164681706
금리/NNG@$인상/NNG@$나설/VV@$가능성/NNG,1,0.2903296074947872,93,49,44,27,0.7049307344209057,0.3876061573526188
달러화/NNG@$가치/NNG@$하락/NNG,1,0.2903296074947872,93,49,44,29,0.7049307344209057,0.3876061573526188
민간/NNG@$소비/NNG@$설비투자/NNG,1,0.2902931294461184,141,74,67,56,0.7944276669575325,0.43685084426783893
체감/NNG@$경기/NNG@$회복/NNG,1,0.28939605385550893,62,33,29,26,0.5883319115232,0.3241543049582165
금융완화/NNG@$기조/NNG@$유지/NNG@$경기/NNG,1,0.28939605385550893,62,33,29,2,0.5883319115232,0.3241543049582165
지수/NNG@$상승/NNG@$기록/NNG,1,0.28939605385550893,62,33,29,29,0.5883319115232,0.3241543049582165
자본/NNG@$유출입/NNG@$변동성/NNG,1,0.28939605385550893,62,33,29,27,0.5883319115232,0.3241543049582165
가능성/NNG@$높/VA@$예상/NNG,1,0.2872762968933851,122,64,58,32,0.7681562549486216,0.4251937896405558
금리/NNG@$인상/NNG@$가능성/NNG@$배제/NNG@$없/VA,1,0.286985409617561,64,34,30,19,0.5966495627142269,0.33046997248680443
경기/NNG@$회복/NNG@$수출/NNG,1,0.286985409617561,64,34,30,26,0.5966495627142269,0.33046997248680443
고려/NNG@$기준금리/NNG@$동결/NNG,1,0.286985409617561,64,34,30,17,0.5966495627142269,0.33046997248680443
정책/NNG@$여력/NNG@$확보/NNG,1,0.28469040582792715,66,35,31,20,0.6047418130762469,0.33663032418507527
해외/NNG@$위험/NNG@$요인/NNG@$영향/NNG,1,0.28469040582792715,66,35,31,19,0.6047418130762469,0.33663032418507527
종합/NNG@$지수/NNG@$하락/NNG,1,0.28249702820422784,68,36,32,33,0.6126075138396356,0.3426392553504711
예정/NNG@$기준금리/NNG@$인상/NNG,0,0.28247711646352003,35,19,16,20,0.44268999163965544,0.2476129161312623
대내외/NNG@$경제/NNG@$환경/NNG,0,0.28247711646352003,35,19,16,18,0.44268999163965544,0.2476129161312623
지속/NNG@$성장잠재력/NNG@$훼손/NNG@$않/VX,0,0.28247711646352003,35,19,16,20,0.44268999163965544,0.2476129161312623
인상/NNG@$물가/NNG@$상승/NNG@$압력/NNG,0,0.28247711646352003,35,19,16,16,0.44268999163965544,0.2476129161312623
물가/NNG@$금리/NNG@$인하/NNG,0,0.28247711646352003,35,19,16,16,0.44268999163965544,0.2476129161312623
경제/NNG@$전망/NNG@$정책/NNG,1,0.28039330175131494,70,37,33,35,0.6202460951422548,0.34850025885893515
증가/NNG@$금리/NNG@$인상/NNG,1,0.2783689614097167,72,38,34,34,0.6276575296430585,0.3542165109435464
수요/NNG@$물가/NNG@$압력/NNG,1,0.2783689614097167,72,38,34,14,0.6276575296430585,0.3542165109435464
자산/NNG@$가격/NNG@$하락/NNG,1,0.2783689614097167,72,38,34,31,0.6276575296430585,0.3542165109435464
금리/NNG@$단기금리/NNG@$없/VA,1,0.2777163234414841,132,69,63,92,0.7782991926186124,0.4398523790796291
국채/NNG@$금리/NNG@$단기금리/NNG@$없/VA,1,0.2777163234414841,132,69,63,92,0.7782991926186124,0.4398523790796291
경기/NNG@$상승세/NNG@$둔화/NNG,0,0.2776723637013552,37,20,17,8,0.45340440400272053,0.2562639221806411
금리/NNG@$하락/NNG@$마감/NNG,0,0.2776723637013552,37,20,17,31,0.45340440400272053,0.2562639221806411
금리/NNG@$올릴/VV@$있/VA,0,0.2776723637013552,37,20,17,15,0.45340440400272053,0.2562639221806411
주택/NNG@$착공/NNG@$증가/NNG,0,0.2776723637013552,37,20,17,14,0.45340440400272053,0.2562639221806411
매파적/NNG@$금리/NNG@$인상/NNG,0,0.2776723637013552,37,20,17,14,0.45340440400272053,0.2562639221806411
자산/NNG@$시장/NNG@$과열/NNG,0,0.2776723637013552,37,20,17,12,0.45340440400272053,0.2562639221806411
제기/NNG@$금리/NNG@$인하/NNG,0,0.2776723637013552,37,20,17,14,0.45340440400272053,0.2562639221806411
금리/NNG@$인하/NNG@$시작/NNG,1,0.27641518259140474,74,39,35,19,0.6348422959382094,0.3597909397206871
가격/NNG@$상승/NNG@$경제/NNG,1,0.27641518259140474,74,39,35,26,0.6348422959382094,0.3597909397206871
경제/NNG@$성장세/NNG@$회복/NNG,1,0.27641518259140474,74,39,35,35,0.6348422959382094,0.3597909397206871
개선/NNG@$금리/NNG@$인상/NNG,1,0.27641518259140474,74,39,35,40,0.6348422959382094,0.3597909397206871
경제/NNG@$성장/NNG@$지속/NNG@$중기적/NNG,0,0.27351678409726343,39,21,18,16,0.46399964950712946,0.26462152795072524
성장/NNG@$지속/NNG@$중기적/NNG,0,0.27351678409726343,39,21,18,16,0.46399964950712946,0.26462152795072524
개선/NNG@$기준금리/NNG@$인상/NNG,0,0.27351678409726343,39,21,18,16,0.46399964950712946,0.26462152795072524
조치/NNG@$내놓/VV@$않/VX,0,0.27351678409726343,39,21,18,23,0.46399964950712946,0.26462152795072524
고용/NNG@$취업자/NNG@$증가/NNG,0,0.27351678409726343,39,21,18,12,0.46399964950712946,0.26462152795072524
부동산/NNG@$경기/NNG@$둔화/NNG,0,0.27351678409726343,39,21,18,18,0.46399964950712946,0.26462152795072524
유로화/NNG@$달러화/NNG@$유로당/NNG,0,0.27351678409726343,39,21,18,14,0.46399964950712946,0.26462152795072524
금리/NNG@$인상/NNG@$명분/NNG,1,0.2726899212499849,78,41,37,25,0.6485360502362602,0.3705251163843589
금리/NNG@$인상/NNG@$가능/NNG,1,0.2722829911999911,308,161,147,73,0.8193704675656303,0.4685388435259096
금리/NNG@$인상/NNG@$지지/NNG,1,0.2712814246520783,113,59,54,57,0.7448211618146625,0.42683157605216865
투자/NNG@$증권/NNG@$채권/NNG,1,0.2709061800573669,80,42,38,42,0.6550482006542311,0.3756899189302106
지식/NNG@$경제/NNG@$부/NNG,1,0.2709061800573669,80,42,38,20,0.6550482006542311,0.3756899189302106
금리/NNG@$인상/NNG@$시기/NNG@$결정/NNG,0,0.269886654895078,41,22,19,10,0.4744633974999809,0.27271831311999245
경제/NNG@$성장/NNG@$도움/NNG,0,0.269886654895078,41,22,19,12,0.4744633974999809,0.27271831311999245
달러/NNG@$엔/NNG@$상승/NNG,0,0.269886654895078,41,22,19,20,0.4744633974999809,0.27271831311999245
시장/NNG@$기대/NNG@$금리/NNG,0,0.269886654895078,41,22,19,9,0.4744633974999809,0.27271831311999245
해소/NNG@$금리/NNG@$인상/NNG,0,0.269886654895078,41,22,19,10,0.4744633974999809,0.27271831311999245
시장/NNG@$영향/NNG@$크/VA@$않/VX,0,0.269886654895078,41,22,19,12,0.4744633974999809,0.27271831311999245
금리/NNG@$인상/NNG@$배제/NNG,0,0.269886654895078,41,22,19,15,0.4744633974999809,0.27271831311999245
선행지수/NNG@$순환/NNG@$변동/NNG,0,0.269886654895078,41,22,19,20,0.4744633974999809,0.27271831311999245
콜금리/NNG@$인상/NNG@$예상/NNG,0,0.269886654895078,41,22,19,16,0.4744633974999809,0.27271831311999245
확대/NNG@$금리/NNG@$인상/NNG,1,0.2691682029682547,82,43,39,28,0.6613399386704707,0.38072306956081053
실물경제/NNG@$부정적/NNG@$영향/NNG,0,0.2666855414993743,43,23,20,31,0.48478411098396545,0.2805793880363526
자금/NNG@$유입/NNG@$확대/NNG,0,0.2666855414993743,43,23,20,8,0.48478411098396545,0.2805793880363526
소비/NNG@$기업/NNG@$투자/NNG,0,0.2666855414993743,43,23,20,17,0.48478411098396545,0.2805793880363526
채권/NNG@$딜러/NNG@$시장/NNG,0,0.2666855414993743,43,23,20,13,0.48478411098396545,0.2805793880363526
하방/NNG@$리스크/NNG@$커졌/VV,0,0.2666855414993743,43,23,20,13,0.48478411098396545,0.2805793880363526
외환/NNG@$위기/NNG@$이전/NNG,0,0.2666855414993743,43,23,20,20,0.48478411098396545,0.2805793880363526
경기/NNG@$회복/NNG@$지연/NNG,1,0.2666412562374407,232,121,111,72,0.8158286979860355,0.4722236902700637
가능성/NNG@$높/VA@$관측/NNG,1,0.2658129602835475,86,45,41,16,0.6732723865287246,0.3904036292127372
통화정책/NNG@$기준금리/NNG@$인상/NNG,1,0.2658129602835475,86,45,41,35,0.6732723865287246,0.3904036292127372
인플레이션/NNG@$압력/NNG@$대응/NNG,0,0.26383734535015213,45,24,21,14,0.4949510876840637,0.28822427615414586
급등/NNG@$소비자/NNG@$물가/NNG,0,0.26383734535015213,45,24,21,10,0.4949510876840637,0.28822427615414586
국내총생산/NNG@$증가율/NNG@$기록/NNG,1,0.26128135739684955,47,25,22,14,0.5049544825062078,0.29566828531609546
공급/NNG@$제조업/NNG@$지수/NNG,1,0.26128135739684955,47,25,22,25,0.5049544825062078,0.29566828531609546
체감/NNG@$경기/NNG@$악화/NNG,1,0.26128135739684955,47,25,22,22,0.5049544825062078,0.29566828531609546
소비/NNG@$심리/NNG@$회복/NNG,1,0.26127078822439787,125,65,60,47,0.7609066457233015,0.4455472217687762
채권/NNG@$시장/NNG@$강세/NNG,1,0.2596875916818726,127,66,61,67,0.7631082206173849,0.44835661567791907
가능성/NNG@$높/VA@$경제/NNG,1,0.25896867721018846,49,26,23,20,0.5147853160873638,0.30292351947389473
금리/NNG@$올릴/VV@$없/VA,1,0.25896867721018846,49,26,23,20,0.5147853160873638,0.30292351947389473
저금리/NNG@$기조/NNG@$장기화/NNG,1,0.25896867721018846,49,26,23,13,0.5147853160873638,0.30292351947389473
구매/NNG@$관리/NNG@$지수/NNG,1,0.25896867721018846,49,26,23,20,0.5147853160873638,0.30292351947389473
영향/NNG@$제한적/NNG@$전망/NNG,1,0.25896867721018846,49,26,23,16,0.5147853160873638,0.30292351947389473
원자재/NNG@$가격/NNG@$급등/NNG,1,0.2581136134833022,202,105,97,57,0.8092039301361381,0.47704642232496186
시장/NNG@$금리/NNG@$인하/NNG@$기대/NNG,1,0.2579854537771369,96,50,46,36,0.6994528472246331,0.41245858654967255
둔화/NNG@$경기/NNG@$회복/NNG,1,0.25685957944303994,51,27,24,5,0.5244354726662127,0.3099996337951111
가격/NNG@$하락/NNG@$경기/NNG,1,0.25685957944303994,51,27,24,10,0.5244354726662127,0.3099996337951111
경기/NNG@$둔화/NNG@$인플레/NNG,1,0.25685957944303994,51,27,24,23,0.5244354726662127,0.3099996337951111
소비자/NNG@$물가/NNG@$급등/NNG,1,0.2550325032519196,100,52,48,23,0.7085417643131527,0.42046768475627616
시장/NNG@$금리/NNG@$영향/NNG,1,0.254921548817161,53,28,25,16,0.5338976895805458,0.31690440409681647
경기/NNG@$부양책/NNG@$시행/NNG,1,0.2531277943730996,55,29,26,16,0.5431655401073711,0.32364416018956477
동결/NNG@$자산/NNG@$매입/NNG,1,0.2531277943730996,55,29,26,29,0.5431655401073711,0.32364416018956477
우려/NNG@$필요/NNG@$없/VA,1,0.2531277943730996,55,29,26,26,0.5431655401073711,0.32364416018956477
금리/NNG@$인상/NNG@$시기/NNG@$예상/NNG,1,0.2531277943730996,55,29,26,9,0.5431655401073711,0.32364416018956477
지수/NNG@$상승/NNG@$종합/NNG,1,0.2531277943730996,55,29,26,44,0.5431655401073711,0.32364416018956477
마련/NNG@$필요/NNG@$있/VA,1,0.2514561123385701,57,30,27,13,0.5522334109759099,0.33022411826483866
가계/NNG@$소비/NNG@$심리/NNG,1,0.2514561123385701,57,30,27,31,0.5522334109759099,0.33022411826483866
유로존/NNG@$경제/NNG@$성장/NNG,1,0.25075741562179354,106,55,51,70,0.720795685099285,0.43166411056610515
자산/NNG@$가격/NNG@$버블/NNG,1,0.2506600080403347,139,72,67,42,0.7738511698722012,0.4635338768125649
원/NNG@$환율/NNG@$원대/NNG,1,0.24988800602072647,59,31,28,24,0.561096475624011,0.33664863754735047
금리/NNG@$인상/NNG@$기준금리/NNG,1,0.24936963538786294,108,56,52,30,0.7245299313741562,0.43518685955587444
경기/NNG@$부양/NNG@$기조/NNG,1,0.24840799757289944,61,32,29,21,0.5697506640871647,0.3429214195448642
금리/NNG@$인상/NNG@$원화/NNG,1,0.24840799757289944,61,32,29,14,0.5697506640871647,0.3429214195448642
인플레/NNG@$우려/NNG@$금리/NNG,1,0.24840799757289944,61,32,29,22,0.5697506640871647,0.3429214195448642
상승/NNG@$압력/NNG@$금리/NNG,1,0.24840799757289944,61,32,29,26,0.5697506640871647,0.3429214195448642
전망/NNG@$밝/VA@$않/VX,1,0.2470030846708493,63,33,30,21,0.5781926302767999,0.34904566337945914
물가/NNG@$관리/NNG@$목표/NNG,1,0.2470030846708493,63,33,30,15,0.5781926302767999,0.34904566337945914
시장/NNG@$예상/NNG@$깨/VV,1,0.2470030846708493,63,33,30,28,0.5781926302767999,0.34904566337945914
금융/NNG@$위기/NNG@$극복/NNG,1,0.2467070217589875,197,102,95,72,0.8029960926555172,0.48506165229189513
민간/NNG@$소비/NNG@$증가/NNG,1,0.24566230781691067,65,34,31,38,0.586419717302661,0.3550241872295844
예상/NNG@$기준금리/NNG@$인하/NNG,1,0.24566230781691067,65,34,31,20,0.586419717302661,0.3550241872295844
국가신용등급/NNG@$상향/NNG@$조정/NNG,1,0.24566230781691067,65,34,31,21,0.586419717302661,0.3550241872295844
경기/NNG@$회복/NNG@$국면/NNG,1,0.24398663626070016,116,60,56,49,0.7378344983967582,0.4482873050273468
인플레이션/NNG@$압력/NNG@$증가/NNG,1,0.24313752049337745,69,36,33,19,0.6022218550451873,0.36655399289915125
금융시장/NNG@$불안/NNG@$요인/NNG,1,0.24193899648013972,71,37,34,26,0.6097947094570528,0.37210976344539803
시장/NNG@$예상/NNG@$웃돌/VV,1,0.24193899648013972,71,37,34,41,0.6097947094570528,0.37210976344539803
확대/NNG@$금리/NNG@$인하/NNG,1,0.24193899648013972,71,37,34,42,0.6097947094570528,0.37210976344539803
수출/NNG@$가격/NNG@$경쟁력/NNG,1,0.24077516506770924,73,38,35,21,0.6171482172752599,0.3775288950702763
금융/NNG@$금리/NNG@$인상/NNG,1,0.24077516506770924,73,38,35,26,0.6171482172752599,0.3775288950702763
방안/NNG@$검토/NNG@$필요/NNG@$있/VA,0,0.23988840706973646,24,13,11,9,0.36895158955635776,0.2261244160684539
인상/NNG@$가능성/NNG@$크/VA@$않/VX,1,0.23964120392553712,75,39,36,15,0.624282615344071,0.38281337518639635
단기/NNG@$경제/NNG@$관측/NNG,1,0.2374470734690195,79,41,38,40,0.6378973319509563,0.3929861233879476
수입/NNG@$물가/NNG@$하락/NNG,1,0.2363804272036285,81,42,39,34,0.6443803201848282,0.39787821566679793
가능성/NNG@$크/VA@$예상/NNG,1,0.2342952381715837,85,44,41,37,0.6567070085632651,0.40728338937538455
금융/NNG@$불안/NNG@$경제/NNG,0,0.233753505114068,26,14,12,22,0.37980898236898425,0.23582401580257487
거시/NNG@$경제/NNG@$영향/NNG,0,0.233753505114068,26,14,12,16,0.37980898236898425,0.23582401580257487
민간/NNG@$소비/NNG@$투자/NNG,1,0.2322614277929247,89,46,43,21,0.6681976388362473,0.41619608397645236
금리/NNG@$인상/NNG@$기대감/NNG,1,0.231260070697469,91,47,44,51,0.673636571969264,0.4204726441201724
금리/NNG@$인상/NNG@$불가피/XR,1,0.23026755792931697,93,48,45,34,0.6788755237195774,0.42463199530258544
양적완화/NNG@$축소/NNG@$금리/NNG,0,0.2289138990106745,28,15,13,23,0.390656865038134,0.2450524708241927
경기/NNG@$둔화/NNG@$수출/NNG,1,0.22830560189617244,97,50,47,49,0.6887674564994795,0.4326071354703195
원달러/NNG@$환율/NNG@$상승/NNG,1,0.22637009521774987,101,52,49,42,0.6979029433563402,0.44013780569588434
금리/NNG@$상승/NNG@$기조/NNG,0,0.22504677675702833,30,16,14,15,0.4014762160393475,0.25390102283068305
마이너스금리/NNG@$정책/NNG@$도입/NNG,0,0.22504677675702833,30,16,14,24,0.4014762160393475,0.25390102283068305
성장률/NNG@$상향/NNG@$조정/NNG,1,0.22350912044563365,107,55,52,35,0.7102572631836931,0.45063662427100004
실적/NNG@$시장/NNG@$예상/NNG,0,0.22192276025607627,32,17,15,19,0.4122489540948229,0.2624339456536394
요인/NNG@$가능성/NNG@$있/VA,0,0.22192276025607627,32,17,15,16,0.4122489540948229,0.2624339456536394
정책금리/NNG@$인상/NNG@$시기/NNG,0,0.22192276025607627,32,17,15,7,0.4122489540948229,0.2624339456536394
강세/NNG@$엔화/NNG@$약세/NNG,0,0.22192276025607627,32,17,15,20,0.4122489540948229,0.2624339456536394
정책/NNG@$방향/NNG@$제시/NNG,0,0.22192276025607627,32,17,15,14,0.4122489540948229,0.2624339456536394
인상/NNG@$기대/NNG@$높/VA,0,0.22192276025607627,32,17,15,20,0.4122489540948229,0.2624339456536394
유동성/NNG@$공급/NNG@$조치/NNG,1,0.22069398077381508,113,58,55,28,0.7210930283605542,0.46022890146701595
금리/NNG@$인하/NNG@$압력/NNG,1,0.22069398077381508,113,58,55,41,0.7210930283605542,0.46022890146701595
기준금리/NNG@$하향/NNG@$조정/NNG,1,0.2197654958208093,115,59,56,35,0.7243874878404721,0.46323462754900396
소비/NNG@$부정적/NNG@$영향/NNG,0,0.21937471688350607,34,18,16,11,0.4229579951612664,0.2706972810437977
금리/NNG@$인상/NNG@$기업/NNG,0,0.21937471688350607,34,18,16,15,0.4229579951612664,0.2706972810437977
결정/NNG@$중요/NNG@$변수/NNG,0,0.21937471688350607,34,18,16,15,0.4229579951612664,0.2706972810437977
물가/NNG@$경기/NNG@$회복/NNG,0,0.21937471688350607,34,18,16,16,0.4229579951612664,0.2706972810437977
문제/NNG@$경기/NNG@$회복/NNG,0,0.21937471688350607,34,18,16,12,0.4229579951612664,0.2706972810437977
환율/NNG@$등가격/NNG@$변수/NNG,0,0.21937471688350607,34,18,16,13,0.4229579951612664,0.2706972810437977
활용/NNG@$필요/NNG@$있/VA,0,0.21937471688350607,34,18,16,17,0.4229579951612664,0.2706972810437977
변화/NNG@$없/VA@$예상/NNG,0,0.21937471688350607,34,18,16,20,0.4229579951612664,0.2706972810437977
개선/NNG@$추세/NNG@$이어지/VV,0,0.21937471688350607,34,18,16,5,0.4229579951612664,0.2706972810437977
기준금리/NNG@$유지/NNG@$경제/NNG,0,0.21937471688350607,34,18,16,1,0.4229579951612664,0.2706972810437977
경제/NNG@$회복/NNG@$전망/NNG,0,0.21937471688350607,34,18,16,13,0.4229579951612664,0.2706972810437977
채권/NNG@$금리/NNG@$하락/NNG,1,0.21792362716234148,119,61,58,38,0.7305262303724516,0.46897101500834965
실업/NNG@$보험/NNG@$청구/NNG@$감소/NNG,0,0.2172782359399974,36,19,17,48,0.4335872728723017,0.27872446395342315
자금/NNG@$해외/NNG@$유출/NNG,0,0.2172782359399974,36,19,17,36,0.4335872728723017,0.27872446395342315
통화정책/NNG@$방향/NNG@$전환/NNG,0,0.2172782359399974,36,19,17,12,0.4335872728723017,0.27872446395342315
점진적/NNG@$기준금리/NNG@$인상/NNG,0,0.2172782359399974,36,19,17,24,0.4335872728723017,0.27872446395342315
은행/NNG@$금융정책/NNG@$결정/NNG@$열/VV,0,0.2172782359399974,36,19,17,17,0.4335872728723017,0.27872446395342315
보험/NNG@$청구/NNG@$감소/NNG,0,0.2172782359399974,36,19,17,48,0.4335872728723017,0.27872446395342315
경제/NNG@$금융/NNG@$기준금리/NNG,0,0.2172782359399974,36,19,17,13,0.4335872728723017,0.27872446395342315
국고채/NNG@$금리/NNG@$오른/VV,0,0.2172782359399974,36,19,17,14,0.4335872728723017,0.27872446395342315
유지/NNG@$기준금리/NNG@$동결/NNG,0,0.2155389987110654,38,20,18,17,0.44412174135445154,0.28654004498756463
예상/NNG@$좋/VA@$실적/NNG,0,0.2155389987110654,38,20,18,21,0.44412174135445154,0.28654004498756463
지속/NNG@$수요/NNG@$압력/NNG,0,0.2155389987110654,38,20,18,11,0.44412174135445154,0.28654004498756463
은행/NNG@$금리/NNG@$인상/NNG@$단행/NNG,0,0.2155389987110654,38,20,18,16,0.44412174135445154,0.28654004498756463
경제/NNG@$회복세/NNG@$둔화/NNG,0,0.2155389987110654,38,20,18,10,0.44412174135445154,0.28654004498756463
매입/NNG@$규모/NNG@$줄이/VV,0,0.2155389987110654,38,20,18,21,0.44412174135445154,0.28654004498756463
시장/NNG@$금리/NNG@$경기/NNG,0,0.2155389987110654,38,20,18,13,0.44412174135445154,0.28654004498756463
소비자/NNG@$물가/NNG@$상승/NNG@$압력/NNG,0,0.2155389987110654,38,20,18,16,0.44412174135445154,0.28654004498756463
위안화/NNG@$절상/NNG@$문제/NNG,0,0.2155389987110654,38,20,18,11,0.44412174135445154,0.28654004498756463
장단기/NNG@$금리/NNG@$스프레드/NNG,0,0.2155389987110654,38,20,18,20,0.44412174135445154,0.28654004498756463
금리/NNG@$인상/NNG@$그칠/VV,0,0.2155389987110654,38,20,18,15,0.44412174135445154,0.28654004498756463
경기/NNG@$모멘텀/NNG@$둔화/NNG,0,0.21408436878753911,40,21,19,11,0.45454736920730937,0.2941622143227927
확장/NNG@$국면/NNG@$진입/NNG,0,0.21408436878753911,40,21,19,9,0.45454736920730937,0.2941622143227927
달러화/NNG@$약세/NNG@$지속/NNG,0,0.21408436878753911,40,21,19,10,0.45454736920730937,0.2941622143227927
경제/NNG@$전망/NNG@$물가/NNG,0,0.21408436878753911,40,21,19,12,0.45454736920730937,0.2941622143227927
제품/NNG@$가격/NNG@$하락/NNG,0,0.21408436878753911,40,21,19,7,0.45454736920730937,0.2941622143227927
시장/NNG@$금리/NNG@$크/VA,0,0.21408436878753911,40,21,19,10,0.45454736920730937,0.2941622143227927
물가/NNG@$금리/NNG@$인상/NNG,1,0.21341317673975801,129,66,63,44,0.7434488880155798,0.4818032053894308
가능성/NNG@$높/VA@$기준금리/NNG,0,0.21285764780975258,42,22,20,11,0.46485112858295563,0.30160455036527717
경기/NNG@$회복/NNG@$정책/NNG,0,0.21285764780975258,42,22,20,10,0.46485112858295563,0.30160455036527717
민간/NNG@$소비/NNG@$회복세/NNG,0,0.21285764780975258,42,22,20,17,0.46485112858295563,0.30160455036527717
기준금리/NNG@$결정/NNG@$통화정책/NNG,0,0.21285764780975258,42,22,20,17,0.46485112858295563,0.30160455036527717
동결/NNG@$금리/NNG@$인상/NNG@$가능성/NNG,0,0.21285764780975258,42,22,20,17,0.46485112858295563,0.30160455036527717
중개인/NNG@$주택/NNG@$판매/NNG,0,0.21285764780975258,42,22,20,30,0.46485112858295563,0.30160455036527717
회복/NNG@$국면/NNG@$접어들/VV,0,0.21285764780975258,42,22,20,11,0.46485112858295563,0.30160455036527717
인상/NNG@$단행/NNG@$가능성/NNG@$높/VA,0,0.21181406186085172,44,23,21,12,0.475020981001399,0.30887725466158067
가능성/NNG@$낮/VA@$전망/NNG,0,0.21181406186085172,44,23,21,16,0.475020981001399,0.30887725466158067
인하/NNG@$가능성/NNG@$전망/NNG,0,0.21181406186085172,44,23,21,12,0.475020981001399,0.30887725466158067
인플레이션/NNG@$압력/NNG@$억제/NNG,0,0.21181406186085172,44,23,21,8,0.475020981001399,0.30887725466158067
물가/NNG@$상승/NNG@$확대/NNG,0,0.21181406186085172,44,23,21,8,0.475020981001399,0.30887725466158067
예상/NNG@$크/VA@$않/VX,0,0.2109178996631249,46,24,22,16,0.4850458604935436,0.31598803878347803
전망/NNG@$소비/NNG@$지출/NNG,0,0.2109178996631249,46,24,22,27,0.4850458604935436,0.31598803878347803
가능성/NNG@$적/VA@$않/VX,0,0.2109178996631249,46,24,22,9,0.4850458604935436,0.31598803878347803
금리/NNG@$인하/NNG@$동결/NNG,0,0.2109178996631249,46,24,22,18,0.4850458604935436,0.31598803878347803
국채/NNG@$매입/NNG@$결정/NNG,0,0.2109178996631249,46,24,22,6,0.4850458604935436,0.31598803878347803
소비자/NNG@$물가/NNG@$올랐/VV,0,0.2109178996631249,46,24,22,11,0.4850458604935436,0.31598803878347803
기준금리/NNG@$인상/NNG@$속도/NNG,1,0.21077913880595323,135,69,66,47,0.7497104280289374,0.4885483059359977
시장/NNG@$금리/NNG@$하락/NNG,0,0.21039303048679026,215,110,105,44,0.7877539532189056,0.5137542681459598
우려/NNG@$기준금리/NNG@$인하/NNG,0,0.2101404345194986,48,25,23,25,0.4949156542312074,0.32294277067330374
회복/NNG@$수요/NNG@$압력/NNG,0,0.2101404345194986,48,25,23,9,0.4949156542312074,0.32294277067330374
장기/NNG@$시장/NNG@$금리/NNG@$하락/NNG,0,0.2101404345194986,48,25,23,3,0.4949156542312074,0.32294277067330374
지수/NNG@$떨어진/VV@$기록/NNG,0,0.2101404345194986,48,25,23,25,0.4949156542312074,0.32294277067330374
금융기관/NNG@$경제/NNG@$실시/NNG,0,0.2101404345194986,48,25,23,10,0.4949156542312074,0.32294277067330374
인상/NNG@$가능성/NNG@$전망/NNG,1,0.20945839032914448,50,26,24,23,0.5046211806664143,0.3297459516690932
경기/NNG@$저점/NNG@$통과/NNG,1,0.20945839032914448,50,26,24,15,0.5046211806664143,0.3297459516690932
경제/NNG@$성장/NNG@$저해/NNG,1,0.20885279221108055,52,27,25,26,0.5141541651995304,0.33640107233556976
인플레이션/NNG@$압력/NNG@$낮/VA,1,0.20885279221108055,52,27,25,31,0.5141541651995304,0.33640107233556976
가능/NNG@$금리/NNG@$인상/NNG,1,0.20885279221108055,52,27,25,19,0.5141541651995304,0.33640107233556976
물가/NNG@$원자재/NNG@$가격/NNG,1,0.20885279221108055,52,27,25,15,0.5141541651995304,0.33640107233556976
물가/NNG@$상승률/NNG@$넘/VV,1,0.20885279221108055,52,27,25,21,0.5141541651995304,0.33640107233556976
경제/NNG@$심리/NNG@$위축/NNG,1,0.2083080935389776,54,28,26,27,0.523507213447536,0.3429108802186297
문제/NNG@$해결/NNG@$없/VA,1,0.2083080935389776,54,28,26,4,0.523507213447536,0.3429108802186297
상향/NNG@$조정/NNG@$경제/NNG,1,0.20781150465541898,56,29,27,22,0.5326737822501818,0.3492775827009472
콜금리/NNG@$동결/NNG@$전망/NNG,1,0.20781150465541898,56,29,27,11,0.5326737822501818,0.3492775827009472
변동성/NNG@$심한/VA@$에너지/NNG,1,0.20781150465541898,56,29,27,20,0.5326737822501818,0.3492775827009472
물가/NNG@$상승/NNG@$가능성/NNG,1,0.2073524707983947,58,30,28,18,0.541648148614258,0.35550300143670205
채권/NNG@$시장/NNG@$불안/NNG,1,0.2073524707983947,58,30,28,14,0.541648148614258,0.35550300143670205
서브프라임모기지/NNG@$우량/NNG@$주택/NNG@$담보대출/NNG@$부실/NNG,1,0.2073524707983947,58,30,28,27,0.541648148614258,0.35550300143670205
동결/NNG@$경기/NNG@$회복/NNG,1,0.2073524707983947,58,30,28,8,0.541648148614258,0.35550300143670205
회복/NNG@$발목/NNG@$잡/VV,1,0.2073524707983947,58,30,28,18,0.541648148614258,0.35550300143670205
美/NNG@$국채/NNG@$수익률/NNG,1,0.20692226184694174,60,31,29,23,0.5504253768467349,0.36158869025361096
경기/NNG@$회복세/NNG@$예상/NNG,1,0.20692226184694174,60,31,29,21,0.5504253768467349,0.36158869025361096
동결/NNG@$통화정책/NNG@$방향/NNG,1,0.20692226184694174,60,31,29,12,0.5504253768467349,0.36158869025361096
인상/NNG@$달러화/NNG@$강세/NNG,1,0.20651364686415485,62,32,30,17,0.5590012841635899,0.3675360252176283
제품/NNG@$가격/NNG@$상승/NNG,1,0.20651364686415485,62,32,30,18,0.5590012841635899,0.3675360252176283
수요/NNG@$인플레이션/NNG@$압력/NNG,1,0.20651364686415485,62,32,30,18,0.5590012841635899,0.3675360252176283
결정/NNG@$금리/NNG@$인하/NNG,1,0.20612063365813804,64,33,31,19,0.5673724050829939,0.3733462733025666
가격/NNG@$상승/NNG@$영향/NNG,1,0.20612063365813804,64,33,31,19,0.5673724050829939,0.3733462733025666
물가/NNG@$상승/NNG@$압박/NNG,1,0.20612063365813804,64,33,31,19,0.5673724050829939,0.3733462733025666
불안/NNG@$요인/NNG@$상존/NNG,1,0.2057382587087493,66,34,32,15,0.5755359549206293,0.379020644495177
물가/NNG@$상승/NNG@$우려/NNG,0,0.20546488640904226,190,97,93,70,0.7812042734987514,0.5147577759649244
임금/NNG@$상승/NNG@$압력/NNG,1,0.20536241648444564,68,35,33,32,0.5834897927032652,0.3845603309983944
위안화/NNG@$절상/NNG@$가능성/NNG,1,0.20536241648444564,68,35,33,19,0.5834897927032652,0.3845603309983944
채권/NNG@$시장/NNG@$콜금리/NNG,1,0.20536241648444564,68,35,33,17,0.5834897927032652,0.3845603309983944
경기/NNG@$하강/NNG@$우려/NNG,1,0.20536241648444564,68,35,33,20,0.5834897927032652,0.3845603309983944
기조/NNG@$변화/NNG@$없/VA,1,0.20536241648444564,68,35,33,27,0.5834897927032652,0.3845603309983944
물가/NNG@$상승/NNG@$예상/NNG,1,0.20498971984117387,70,36,34,35,0.5912323838063935,0.38996653633880557
시장/NNG@$금리/NNG@$기준금리/NNG,1,0.20498971984117387,70,36,34,10,0.5912323838063935,0.38996653633880557
한계/NNG@$대출/NNG@$금리/NNG,1,0.20461738515250505,72,37,35,37,0.5987627626047103,0.39524049654859167
금리/NNG@$상승/NNG@$요인/NNG,1,0.20461738515250505,72,37,35,16,0.5987627626047103,0.39524049654859167
동결/NNG@$전망/NNG@$우세/NNG,1,0.2042431372712008,74,38,36,20,0.6060804954023142,0.4003834951150024
지속/NNG@$가능성/NNG@$크/VA,1,0.2042431372712008,74,38,36,31,0.6060804954023142,0.4003834951150024
기조/NNG@$유지/NNG@$전망/NNG,1,0.2042431372712008,74,38,36,40,0.6060804954023142,0.4003834951150024
인상/NNG@$가능성/NNG@$있/VA,1,0.2042431372712008,74,38,36,29,0.6060804954023142,0.4003834951150024
회복/NNG@$국면/NNG@$진입/NNG,1,0.20386513050872934,76,39,37,34,0.6131856438842277,0.4053968730283687
둔화/NNG@$경제/NNG@$성장/NNG,1,0.20386513050872934,76,39,37,30,0.6131856438842277,0.4053968730283687
인상/NNG@$예상/NNG@$금리/NNG,1,0.20309221956615353,80,41,39,29,0.6267606975903937,0.41504045256398625
물가/NNG@$상승률/NNG@$중기/NNG,1,0.20309221956615353,80,41,39,10,0.6267606975903937,0.41504045256398625
인상/NNG@$금리/NNG@$동결/NNG,1,0.20187669172872313,86,44,42,26,0.6455550276424361,0.42857096410799267
경제성장률/NNG@$전망치/NNG@$상향/NNG@$조정/NNG,1,0.20145430366508643,88,45,43,32,0.651409322945325,0.43283845296751117
상승/NNG@$금리/NNG@$인상/NNG,0,0.20116041623538883,202,103,99,74,0.7814198861101394,0.5195440113828391
기조/NNG@$유지/NNG@$필요/NNG@$있/VA,1,0.19872973551920925,100,51,49,28,0.6824169150626052,0.4560228359865071
경기/NNG@$부양책/NNG@$내놓/VV,1,0.19775230013714862,104,53,51,36,0.6912640740196174,0.4628757296291381
물가/NNG@$상승률/NNG@$기록/NNG,0,0.19736645137723619,214,109,105,80,0.7810455198686822,0.5234141790067308
외국인/NNG@$자금/NNG@$이탈/NNG,1,0.19674410784008067,108,55,53,47,0.6994164840748917,0.4693181326163329
인상/NNG@$기조/NNG@$유지/NNG,1,0.19518120882915047,114,58,56,51,0.7104126347326015,0.47824860204468184
기준금리/NNG@$인하/NNG@$효과/NNG,0,0.19512874527978274,175,89,86,53,0.771132137976185,0.5191814937539186
대출/NNG@$금리/NNG@$인상/NNG,0,0.19456256450212406,224,114,110,74,0.7804628127924589,0.5260823600667082
수입/NNG@$물가/NNG@$상승/NNG,0,0.19249126172472253,183,93,90,61,0.772591199377538,0.5230222612450727
둔화/NNG@$금리/NNG@$인하/NNG,1,0.19247179438615092,124,63,61,43,0.7257283115715478,0.4913172819791587
소비자/NNG@$물가/NNG@$하락/NNG,0,0.1896842318470109,134,68,66,35,0.7377296682822766,0.5023401869698519
금리/NNG@$인상/NNG@$확률/NNG,0,0.18912274949333052,136,69,67,47,0.7397771600289881,0.5043213749524204
성장/NNG@$하방/NNG@$위험/NNG,0,0.18287458844976556,219,111,108,58,0.7740058858256631,0.5345294365215117
인상/NNG@$가능성/NNG@$높/VA,0,0.18169621153686233,509,258,251,184,0.7753734407581958,0.5367806592739381
금리/NNG@$인상/NNG@$가능성/NNG@$높/VA,0,0.18107582080654416,296,150,146,115,0.7750061804413295,0.5372151272729372
가능성/NNG@$배제/NNG@$않/VX,0,0.18092635146367253,166,84,82,67,0.7595501965188648,0.5266641492136519
금리/NNG@$인상/NNG@$지연/NNG,0,0.1720424741806026,206,104,102,96,0.7668158333199621,0.5415417376598634
금리/NNG@$정상화/NNG@$의지/NNG,1,0.17066672841388275,101,51,50,9,0.6710789519940218,0.4752755061887706
국채/NNG@$금리/NNG@$급등/NNG,1,0.1705985944974533,105,53,52,34,0.6800262550461258,0.4816798107781862
기금/NNG@$금리/NNG@$인상/NNG,1,0.17045170999857628,109,55,54,42,0.6882907429559908,0.48768127248572984
금리/NNG@$인상/NNG@$어렵/VA,1,0.17035095385873,111,56,55,38,0.6921764501388868,0.4905362319456246
주택/NNG@$경기/NNG@$둔화/NNG,1,0.17032651188311032,89,45,44,60,0.6398569250112277,0.45348090821761494
기준금리/NNG@$인상/NNG@$기대/NNG,1,0.17032651188311032,89,45,44,51,0.6398569250112277,0.45348090821761494
필요/NNG@$있/VA@$조언/NNG,1,0.17018096466939459,87,44,43,43,0.6339813234122041,0.4494514394028875
자본/NNG@$유출입/NNG@$동향/NNG,1,0.17018096466939459,87,44,43,37,0.6339813234122041,0.4494514394028875
시사/NNG@$금리/NNG@$인상/NNG,1,0.17018096466939459,87,44,43,30,0.6339813234122041,0.4494514394028875
콜금리/NNG@$동결/NNG@$예상/NNG,1,0.1700077181349584,85,43,42,28,0.627906568258847,0.4453036774751174
채권/NNG@$시장/NNG@$국채/NNG@$가격/NNG,1,0.1700077181349584,85,43,42,19,0.627906568258847,0.4453036774751174
필요/NNG@$금리/NNG@$인상/NNG,1,0.16994983283750953,117,59,58,52,0.702894479623283,0.4985436122785764
금리/NNG@$인상/NNG@$준비/NNG,1,0.16834473775008152,73,37,36,36,0.5871771231239256,0.41784691735053764
기준금리/NNG@$동결/NNG@$기조/NNG,1,0.16834473775008152,73,37,36,33,0.5871771231239256,0.41784691735053764
원자재/NNG@$가격/NNG@$상승세/NNG,1,0.16834473775008152,73,37,36,20,0.5871771231239256,0.41784691735053764
경기/NNG@$신뢰/NNG@$지수/NNG,1,0.16795814990090263,71,36,35,28,0.5796662846548093,0.4128303617155875
원자재/NNG@$가격/NNG@$오르/VV,1,0.16795814990090263,71,36,35,4,0.5796662846548093,0.4128303617155875
불안/NNG@$요인/NNG@$잠재/NNG,1,0.16795814990090263,71,36,35,26,0.5796662846548093,0.4128303617155875
기준금리/NNG@$인상/NNG@$동결/NNG,1,0.16753935706073864,69,35,34,27,0.5719488584891246,0.4076852799934386
인상/NNG@$가능성/NNG@$없/VA,1,0.16753935706073864,69,35,34,20,0.5719488584891246,0.4076852799934386
자산/NNG@$매입/NNG@$축소/NNG,0,0.16725063575346888,141,71,70,113,0.7335969357937201,0.52321877488991
가능성/NNG@$높/VA@$진단/NNG,1,0.16660535391771547,65,33,32,23,0.5558988978595549,0.39700694294851235
지속적/NNG@$금리/NNG@$인상/NNG,0,0.16640199007219358,147,74,73,39,0.7387594155808287,0.5278213722141744
에너지/NNG@$가격/NNG@$상승/NNG,0,0.16558256179704278,252,127,125,104,0.7663926809410813,0.5484879768981503
경제/NNG@$성장/NNG@$전망치/NNG,1,0.16554560987561406,61,31,30,29,0.5390422330360166,0.38580828777011084
동결/NNG@$기조/NNG@$이어질/VV,1,0.16554560987561406,61,31,30,23,0.5390422330360166,0.38580828777011084
기업/NNG@$투자/NNG@$활성화/NNG,1,0.16497085280936252,59,30,29,13,0.5303187416536709,0.38001340392689154
금리/NNG@$인상/NNG@$이유/NNG,1,0.16497085280936252,59,30,29,13,0.5303187416536709,0.38001340392689154
우량/NNG@$주택/NNG@$담보대출/NNG@$부실/NNG,1,0.16497085280936252,59,30,29,27,0.5303187416536709,0.38001340392689154
금리/NNG@$인하/NNG@$가능성/NNG@$반영/NNG,1,0.16497085280936252,59,30,29,38,0.5303187416536709,0.38001340392689154
금리/NNG@$인상/NNG@$행보/NNG,1,0.16436821986462125,57,29,28,7,0.5214037323075021,0.3740882241363169
인상/NNG@$원화/NNG@$강세/NNG,1,0.16436821986462125,57,29,28,14,0.5214037323075021,0.3740882241363169
금리/NNG@$인상/NNG@$할/VV,0,0.16401362880726378,163,82,81,63,0.7488413730956288,0.5376581331659451
기준금리/NNG@$인상/NNG@$없/VA,1,0.16373992551464944,55,28,27,22,0.5123020379336968,0.3680329797328486
마지막/NNG@$금리/NNG@$인상/NNG,1,0.16373992551464944,55,28,27,13,0.5123020379336968,0.3680329797328486
장단기/NNG@$금리/NNG@$역전/NNG,1,0.16373992551464944,55,28,27,8,0.5123020379336968,0.3680329797328486
가격/NNG@$경쟁력/NNG@$약화/NNG,1,0.16373992551464944,55,28,27,36,0.5123020379336968,0.3680329797328486
경제/NNG@$성장/NNG@$엔진/NNG,1,0.16373992551464944,55,28,27,27,0.5123020379336968,0.3680329797328486
물가/NNG@$상승/NNG@$압력/NNG@$커질/VV,1,0.16308886619041152,53,27,26,15,0.5030192443535986,0.3618480196607434
산업/NNG@$생산/NNG@$예상/NNG,1,0.16308886619041152,53,27,26,23,0.5030192443535986,0.3618480196607434
경제/NNG@$기준금리/NNG@$동결/NNG,1,0.16308886619041152,53,27,26,18,0.5030192443535986,0.3618480196607434
양적완화/NNG@$정책/NNG@$종료/NNG,0,0.16241876819870815,51,26,25,41,0.4935617217331164,0.3555337809431003
기준금리/NNG@$올릴/VV@$예상/NNG,0,0.16241876819870815,51,26,25,16,0.4935617217331164,0.3555337809431003
회복/NNG@$금리/NNG@$인하/NNG,0,0.16241876819870815,51,26,25,10,0.4935617217331164,0.3555337809431003
금융/NNG@$중개/NNG@$기능/NNG,0,0.16241876819870815,51,26,25,6,0.4935617217331164,0.3555337809431003
예상/NNG@$경기/NNG@$둔화/NNG,0,0.16241876819870815,51,26,25,14,0.4935617217331164,0.3555337809431003
금융/NNG@$위기/NNG@$대처/NNG,0,0.16241876819870815,51,26,25,16,0.4935617217331164,0.3555337809431003
인상/NNG@$시기/NNG@$결정/NNG,0,0.16241876819870815,51,26,25,14,0.4935617217331164,0.3555337809431003
기준금리/NNG@$인하/NNG@$요구/NNG,0,0.16173437244990696,49,25,24,14,0.483936654769626,0.3490907467538895
경기/NNG@$부양책/NNG@$경제/NNG,0,0.16173437244990696,49,25,24,14,0.483936654769626,0.3490907467538895
완화적/NNG@$기조/NNG@$유지/NNG,0,0.16173437244990696,49,25,24,17,0.483936654769626,0.3490907467538895
준비/NNG@$금리/NNG@$인상/NNG,0,0.16173437244990696,49,25,24,20,0.483936654769626,0.3490907467538895
기준금리/NNG@$인하/NNG@$가계부채/NNG,0,0.16173437244990696,49,25,24,22,0.483936654769626,0.3490907467538895
위험/NNG@$금리/NNG@$인상/NNG,0,0.16173437244990696,49,25,24,19,0.483936654769626,0.3490907467538895
성장률/NNG@$하향/NNG@$조정/NNG,0,0.16107960886210426,183,92,91,80,0.7558709654588048,0.5459857926445724
국내총생산/NNG@$기준/NNG@$경제성장률/NNG,0,0.1610416672863737,47,24,23,7,0.4741520716118953,0.3425193882651528
광/NNG@$통화/NNG@$증가율/NNG,0,0.1610416672863737,47,24,23,14,0.4741520716118953,0.3425193882651528
정책/NNG@$역량/NNG@$집중/NNG,0,0.1610416672863737,47,24,23,6,0.4741520716118953,0.3425193882651528
물가/NNG@$상승률/NNG@$금리/NNG,0,0.16034818491423253,45,23,22,26,0.46421687168517034,0.3358200850786599
에너지/NNG@$가격/NNG@$급등/NNG,0,0.16034818491423253,45,23,22,22,0.46421687168517034,0.3358200850786599
달러화/NNG@$강세/NNG@$보이/VV,0,0.16034818491423253,45,23,22,28,0.46421687168517034,0.3358200850786599
인상/NNG@$통화/NNG@$긴축/NNG,0,0.16034818491423253,45,23,22,16,0.46421687168517034,0.3358200850786599
자산/NNG@$시장/NNG@$버블/NNG,0,0.16034818491423253,45,23,22,13,0.46421687168517034,0.3358200850786599
수출/NNG@$호조세/NNG@$지속/NNG,0,0.16034818491423253,45,23,22,7,0.46421687168517034,0.3358200850786599
인상/NNG@$가능성/NNG@$가격/NNG@$반영/NNG,0,0.16034818491423253,45,23,22,14,0.46421687168517034,0.3358200850786599
금리/NNG@$통화정책/NNG@$결정/NNG,0,0.16034818491423253,45,23,22,18,0.46421687168517034,0.3358200850786599
달러화/NNG@$약세/NNG@$보이/VV,0,0.15966338301326366,43,22,21,19,0.4541408528336354,0.32899301709395007
시장/NNG@$관심/NNG@$금리/NNG,0,0.15966338301326366,43,22,21,27,0.4541408528336354,0.32899301709395007
조정/NNG@$여부/NNG@$결정/NNG,0,0.15966338301326366,43,22,21,15,0.4541408528336354,0.32899301709395007
동결/NNG@$예상/NNG@$금리/NNG,0,0.15966338301326366,43,22,21,28,0.4541408528336354,0.32899301709395007
시장/NNG@$불안/NNG@$요인/NNG,0,0.15966338301326366,43,22,21,19,0.4541408528336354,0.32899301709395007
성장률/NNG@$전망치/NNG@$유지/NNG,0,0.15966338301326366,43,22,21,15,0.4541408528336354,0.32899301709395007
필요/NNG@$있/VA@$경제/NNG,0,0.15899914199280585,41,21,20,23,0.4439347385344609,0.3220380178060664
해외/NNG@$투자/NNG@$확대/NNG,0,0.15899914199280585,41,21,20,23,0.4439347385344609,0.3220380178060664
부정적/NNG@$영향/NNG@$미쳤/VV,0,0.15899914199280585,41,21,20,26,0.4439347385344609,0.3220380178060664
은행/NNG@$금리/NNG@$인상/NNG@$가능성/NNG,0,0.15899914199280585,41,21,20,23,0.4439347385344609,0.3220380178060664
기준금리/NNG@$내릴/VV@$전망/NNG,0,0.15899914199280585,41,21,20,27,0.4439347385344609,0.3220380178060664
소비/NNG@$회복/NNG@$조짐/NNG,0,0.15899914199280585,41,21,20,6,0.4439347385344609,0.3220380178060664
가격/NNG@$하락/NNG@$축소/NNG,0,0.15859106001398993,23,12,11,5,0.34850267169933136,0.2530216621872255
수출/NNG@$증가세/NNG@$지속/NNG,0,0.15859106001398993,23,12,11,15,0.34850267169933136,0.2530216621872255
심리/NNG@$회복/NNG@$지연/NNG,0,0.15837042161051396,39,20,19,12,0.43361020642287956,0.3149543747765029
주택/NNG@$담보대출/NNG@$급증/NNG,0,0.15837042161051396,39,20,19,14,0.43361020642287956,0.3149543747765029
원자재/NNG@$가격/NNG@$약세/NNG,0,0.15837042161051396,39,20,19,15,0.43361020642287956,0.3149543747765029
매입/NNG@$프로그램/NNG@$규모/NNG,0,0.15837042161051396,39,20,19,15,0.43361020642287956,0.3149543747765029
기금/NNG@$금리선물/NNG@$기준금리/NNG,0,0.15837042161051396,39,20,19,24,0.43361020642287956,0.3149543747765029
美/NNG@$실업/NNG@$수당/NNG,0,0.15837042161051396,39,20,19,16,0.43361020642287956,0.3149543747765029
경기/NNG@$부진/NNG@$우려/NNG,0,0.15837042161051396,39,20,19,20,0.43361020642287956,0.3149543747765029
경기/NNG@$회복/NNG@$경제/NNG,0,0.15779614078266735,37,19,18,11,0.42317992005746025,0.30774055658133015
금리/NNG@$인상/NNG@$가시화/NNG,0,0.15779614078266735,37,19,18,9,0.42317992005746025,0.30774055658133015
금리/NNG@$역전/NNG@$자본/NNG,0,0.15779614078266735,37,19,18,14,0.42317992005746025,0.30774055658133015
물가/NNG@$상승/NNG@$목표/NNG,0,0.15779614078266735,37,19,18,31,0.42317992005746025,0.30774055658133015
제조업/NNG@$지수/NNG@$예상/NNG,0,0.15779614078266735,37,19,18,15,0.42317992005746025,0.30774055658133015
결정/NNG@$기준금리/NNG@$유지/NNG,0,0.15779614078266735,37,19,18,13,0.42317992005746025,0.30774055658133015
소비자/NNG@$물가/NNG@$반영/NNG,0,0.15779614078266735,37,19,18,7,0.42317992005746025,0.30774055658133015
달러/NNG@$원/NNG@$환율/NNG@$원대/NNG,0,0.15779614078266735,37,19,18,16,0.42317992005746025,0.30774055658133015
확산/NNG@$금리/NNG@$인상/NNG,0,0.15779614078266735,37,19,18,15,0.42317992005746025,0.30774055658133015
모니터링/NNG@$필요/NNG@$있/VA,0,0.15730037558106846,35,18,17,7,0.41265756684122257,0.300393835579565
축소/NNG@$자본/NNG@$유출/NNG,0,0.15730037558106846,35,18,17,18,0.41265756684122257,0.300393835579565
호흡기/NNG@$증후군/NNG@$메르스/NNG@$여파/NNG,0,0.15730037558106846,35,18,17,15,0.41265756684122257,0.300393835579565
부정적/NNG@$영향/NNG@$전망/NNG,0,0.15730037558106846,35,18,17,20,0.41265756684122257,0.300393835579565
흑자/NNG@$규모/NNG@$축소/NNG,0,0.15730037558106846,35,18,17,14,0.41265756684122257,0.300393835579565
국내총생산/NNG@$증가율/NNG@$전망치/NNG,0,0.15730037558106846,35,18,17,17,0.41265756684122257,0.300393835579565
달러화/NNG@$강세/NNG@$지속/NNG,0,0.15730037558106846,35,18,17,7,0.41265756684122257,0.300393835579565
증후군/NNG@$메르스/NNG@$여파/NNG,0,0.15730037558106846,35,18,17,15,0.41265756684122257,0.300393835579565
금리/NNG@$인상/NNG@$정책/NNG,0,0.15721455505356507,215,108,107,47,0.7599041874268357,0.5532691615930393
통화/NNG@$증가율/NNG@$높/VA,0,0.15691401982407105,33,17,16,4,0.40205790643871714,0.2929097600865183
국채/NNG@$매입/NNG@$확대/NNG,0,0.15691401982407105,33,17,16,32,0.40205790643871714,0.2929097600865183
회복/NNG@$기조/NNG@$유지/NNG,0,0.15691401982407105,33,17,16,13,0.40205790643871714,0.2929097600865183
외환시장/NNG@$달러/NNG@$환율/NNG,0,0.15691401982407105,33,17,16,21,0.40205790643871714,0.2929097600865183
금융/NNG@$외환시장/NNG@$영향/NNG,0,0.15691401982407105,33,17,16,22,0.40205790643871714,0.2929097600865183
금리/NNG@$상승/NNG@$영향/NNG,0,0.15687983796444827,27,14,13,18,0.3699603338378835,0.26954472325388606
소비자/NNG@$물가/NNG@$석유류/NNG,0,0.15687983796444827,27,14,13,6,0.3699603338378835,0.26954472325388606
기업/NNG@$투자/NNG@$부진/NNG,0,0.15667713302555852,31,16,15,20,0.39139683611114184,0.2852814039821466
국채/NNG@$모기지/NNG@$담보/NNG@$증권/NNG,0,0.15667713302555852,31,16,15,20,0.39139683611114184,0.2852814039821466
기준금리/NNG@$인하/NNG@$통화/NNG@$완화/NNG,0,0.15667713302555852,31,16,15,26,0.39139683611114184,0.2852814039821466
자금/NNG@$유입/NNG@$주가/NNG,0,0.1566423349107393,29,15,14,12,0.3806914824764086,0.27749827918996856
장기/NNG@$국채/NNG@$매입/NNG,0,0.156453726125666,223,112,111,47,0.7601931010454542,0.5543435209382946
경기/NNG@$부양/NNG@$정책/NNG,0,0.1543758411615943,251,126,125,118,0.7602961918323383,0.5567844927607015
금리/NNG@$인상/NNG@$기대/NNG,0,0.1510152149883266,341,171,170,140,0.7589092941703128,0.5596061671603653
인플레/NNG@$기대/NNG@$심리/NNG,0,0.14946609625581297,419,210,209,109,0.7580596978514624,0.5607541176628557
이상/NNG@$금리/NNG@$인상/NNG,0,0.14676638637669015,148,74,74,62,0.7289028817208346,0.5421705912350374
경기/NNG@$회복/NNG@$추세/NNG,0,0.14673793359001985,136,68,68,22,0.7171584655950437,0.5334659114586244
금융/NNG@$위기/NNG@$발생/NNG,0,0.14658569295201263,156,78,78,71,0.7348972992229803,0.5468312418111491
금융/NNG@$위기/NNG@$대응/NNG,0,0.14654163405760268,130,65,65,39,0.7098378313389577,0.5282322509726847
안전자산/NNG@$선호/NNG@$현상/NNG,0,0.14632684850561706,126,63,63,58,0.7043521979459992,0.5243801812881438
상승/NNG@$인플레이션/NNG@$압력/NNG,0,0.14619135445383935,124,62,62,24,0.7014162833937255,0.522339037611685
예상/NNG@$금리/NNG@$인하/NNG,0,0.14525081543846952,186,93,93,57,0.7480522950524359,0.5581400115774191
금리/NNG@$인하/NNG@$정책/NNG,0,0.14505224242494363,190,95,95,78,0.7490127536795524,0.5590833739844348
은행/NNG@$기준금리/NNG@$인상/NNG,0,0.1446189370859381,110,55,55,31,0.6768982980880527,0.505702575122146
민간/NNG@$소비/NNG@$증가율/NNG,0,0.1442914021204611,108,54,54,83,0.6727828362053733,0.5029643050774429
인상/NNG@$단행/NNG@$전망/NNG,0,0.1439344586135587,106,53,53,38,0.6685028239771401,0.5001290471138149
경제/NNG@$회복세/NNG@$보이/VV,1,0.14312705655508973,102,51,51,46,0.659434670386451,0.4941588383763032
부동산/NNG@$규제/NNG@$완화/NNG,1,0.14312705655508973,102,51,51,53,0.659434670386451,0.4941588383763032
기준금리/NNG@$인상/NNG@$예상/NNG,0,0.14309217721774936,250,125,125,96,0.7540506218602796,0.565101185285719
금리/NNG@$인상/NNG@$시장/NNG,0,0.1427356604118879,310,155,155,97,0.7543164297644871,0.5657119653902618
효과/NNG@$나타나/VV@$않/VX,1,0.14166135196734708,96,48,48,39,0.6445102779801489,0.4844220573678268
회복/NNG@$기미/NNG@$보이/VV,1,0.14166135196734708,96,48,48,30,0.6445102779801489,0.4844220573678268
콜금리/NNG@$인상/NNG@$결정/NNG,1,0.14109906830865948,94,47,47,13,0.639169910632401,0.48095968389452093
경기/NNG@$전망/NNG@$지수/NNG,1,0.14109906830865948,94,47,47,55,0.639169910632401,0.48095968389452093
경기/NNG@$회복/NNG@$신호/NNG,1,0.13916942334907145,88,44,44,28,0.6220114845156945,0.4698942936961455
국제금융시장/NNG@$변동성/NNG@$확대/NNG,1,0.13916942334907145,88,44,44,41,0.6220114845156945,0.4698942936961455
시장/NNG@$국채/NNG@$가격/NNG,1,0.13916942334907145,88,44,44,23,0.6220114845156945,0.4698942936961455
경제/NNG@$성장/NNG@$가능/NNG,1,0.13843984562578382,86,43,43,14,0.615904527890528,0.465973513338217
금리/NNG@$인상/NNG@$위안화/NNG@$절상/NNG,1,0.13766426531562037,84,42,42,11,0.6096002309344125,0.4619336661259062
미사일/NNG@$방어/NNG@$체계/NNG,1,0.13766426531562037,84,42,42,59,0.6096002309344125,0.4619336661259062
고고/NNG@$미사일/NNG@$방어/NNG@$체계/NNG,1,0.1359680305714559,80,40,40,58,0.5963928953695392,0.45349049612061476
금리/NNG@$인상/NNG@$검토/NNG,1,0.13504373884721121,78,39,39,46,0.5894872868487432,0.44908433874527576
물가/NNG@$상승/NNG@$압력/NNG@$지속/NNG,1,0.13504373884721121,78,39,39,10,0.5894872868487432,0.44908433874527576
주택/NNG@$가격/NNG@$하락/NNG,0,0.13456851521890045,347,173,174,132,0.7497609017522824,0.5717374149331295
투자/NNG@$심리/NNG@$개선/NNG,1,0.13406617148039524,76,38,38,57,0.5823792538928968,0.444553473104264
인상/NNG@$가능성/NNG@$낮/VA,0,0.1317929136825473,251,125,126,53,0.7477367605132823,0.5734249960784575
경제/NNG@$기초/NNG@$체력/NNG,1,0.13079444213766567,70,35,35,35,0.5598390624785937,0.4302030063217659
하락/NNG@$소비자/NNG@$물가/NNG,1,0.13079444213766567,70,35,35,23,0.5598390624785937,0.4302030063217659
금리/NNG@$인상/NNG@$배경/NNG,1,0.12958421949569088,68,34,34,13,0.5519220073670309,0.42516462310127945
소매/NNG@$판매/NNG@$감소/NNG,1,0.12958421949569088,68,34,34,48,0.5519220073670309,0.42516462310127945
성장/NNG@$모멘텀/NNG@$약화/NNG,1,0.12958421949569088,68,34,34,26,0.5519220073670309,0.42516462310127945
식품/NNG@$가격/NNG@$상승/NNG,1,0.12958421949569088,68,34,34,28,0.5519220073670309,0.42516462310127945
콜금리/NNG@$목표/NNG@$동결/NNG,1,0.12831077393778823,66,33,33,18,0.5438051940877393,0.419998183782499
기준금리/NNG@$인상/NNG@$시사/NNG,1,0.12831077393778823,66,33,33,33,0.5438051940877393,0.419998183782499
신경/NNG@$쓰/VV@$않/VX,1,0.12697202308894306,64,32,32,22,0.535490659874352,0.41470367545891706
금리/NNG@$인상/NNG@$포함/NNG,1,0.12697202308894306,64,32,32,14,0.535490659874352,0.41470367545891706
금융/NNG@$위기/NNG@$겪/VV,1,0.12697202308894306,64,32,32,27,0.535490659874352,0.41470367545891706
경제/NNG@$안정적/NNG@$성장/NNG,1,0.12697202308894306,64,32,32,35,0.535490659874352,0.41470367545891706
기대/NNG@$금리/NNG@$인하/NNG,1,0.12697202308894306,64,32,32,16,0.535490659874352,0.41470367545891706
기준금리/NNG@$인상/NNG@$가능성/NNG@$크/VA,1,0.12556586131334369,62,31,31,25,0.5269810137844919,0.40928134522171283
상승/NNG@$거래/NNG@$마쳤/VV,0,0.12503651327817522,133,66,67,76,0.701677304567082,0.5455461153365321
인플레이션/NNG@$금리/NNG@$인상/NNG,1,0.12409016399211503,60,30,30,26,0.5182794655835656,0.40373171831589916
침체/NNG@$빠지/VV@$않/VX,1,0.12409016399211503,60,30,30,15,0.5182794655835656,0.40373171831589916
회복세/NNG@$보일/VV@$전망/NNG,1,0.12254279231735699,58,29,29,21,0.5093898533034954,0.3980556163380227
완화/NNG@$조정/NNG@$필요/NNG,1,0.12254279231735699,58,29,29,24,0.5093898533034954,0.3980556163380227
지수/NNG@$오른/VV@$종합/NNG,1,0.12254279231735699,58,29,29,24,0.5093898533034954,0.3980556163380227
투자/NNG@$증권/NNG@$경기/NNG,1,0.12092159861203933,56,28,28,24,0.5003166690546863,0.3922541753199205
경제/NNG@$전망/NNG@$불확실성/NNG,1,0.12092159861203933,56,28,28,30,0.5003166690546863,0.3922541753199205
대외/NNG@$경제/NNG@$불확실성/NNG,1,0.12092159861203933,56,28,28,15,0.5003166690546863,0.3922541753199205
식료품/NNG@$가격/NNG@$상승/NNG,1,0.12092159861203933,56,28,28,18,0.5003166690546863,0.3922541753199205
서비스/NNG@$금리/NNG@$비교/NNG@$보/VV@$장기금리/NNG,0,0.1205690108113231,115,57,58,85,0.6731662800340129,0.5281480713981712
기준금리/NNG@$동결/NNG@$경기/NNG,0,0.1192312687839665,111,55,56,27,0.6652581787834736,0.5233621386572733
불안/NNG@$금리/NNG@$인상/NNG,0,0.1192312687839665,111,55,56,38,0.6652581787834736,0.5233621386572733
필요/NNG@$있/VA@$기준금리/NNG,0,0.11922443217978906,54,27,27,18,0.49106508264043613,0.3863288635249474
채권/NNG@$금리/NNG@$인상/NNG,0,0.11922443217978906,54,27,27,16,0.49106508264043613,0.3863288635249474
호조/NNG@$금리/NNG@$인상/NNG,0,0.11922443217978906,54,27,27,24,0.49106508264043613,0.3863288635249474
경제/NNG@$동향/NNG@$성장률/NNG,0,0.11922443217978906,54,27,27,14,0.49106508264043613,0.3863288635249474
중기/NNG@$물가/NNG@$목표치/NNG,0,0.11744914568226172,52,26,26,14,0.4816409624979073,0.38028149876515516
금리/NNG@$인상/NNG@$증시/NNG,0,0.11744914568226172,52,26,26,17,0.4816409624979073,0.38028149876515516
회복/NNG@$속도/NNG@$완만/XR,0,0.11744914568226172,52,26,26,14,0.4816409624979073,0.38028149876515516
기준금리/NNG@$인하/NNG@$않/VX,0,0.11744914568226172,52,26,26,25,0.4816409624979073,0.38028149876515516
압력/NNG@$금리/NNG@$인상/NNG,0,0.11693793516553597,105,52,53,40,0.6521947609602593,0.5154769380723164
금리/NNG@$인상/NNG@$관측/NNG,0,0.11693793516553597,105,52,53,38,0.6521947609602593,0.5154769380723164
시장/NNG@$체감/NNG@$지표/NNG,0,0.11559360203466307,50,25,25,26,0.4720508934698739,0.37411426503049966
주택/NNG@$판매/NNG@$증가/NNG,0,0.11559360203466307,50,25,25,20,0.4720508934698739,0.37411426503049966
경제성장률/NNG@$상향/NNG@$조정/NNG,0,0.11559360203466307,50,25,25,24,0.4720508934698739,0.37411426503049966
채권/NNG@$시장/NNG@$체감/NNG@$지표/NNG,0,0.11559360203466307,50,25,25,26,0.4720508934698739,0.37411426503049966
금융/NNG@$위기/NNG@$발발/NNG,0,0.11559360203466307,50,25,25,11,0.4720508934698739,0.37411426503049966
소매/NNG@$판매/NNG@$증가율/NNG,0,0.11559360203466307,50,25,25,24,0.4720508934698739,0.37411426503049966
금융시장/NNG@$혼란/NNG@$경제/NNG,0,0.11559360203466307,50,25,25,10,0.4720508934698739,0.37411426503049966
급등/NNG@$금리/NNG@$인상/NNG,0,0.11559360203466307,50,25,25,9,0.4720508934698739,0.37411426503049966
금리/NNG@$인상/NNG@$부정적/NNG,0,0.11519832597462454,101,50,51,31,0.6426441160860026,0.5097226093179796
대출/NNG@$금리/NNG@$상승/NNG,0,0.11425990949562181,99,49,50,46,0.6376062994894534,0.5066893977267292
금리/NNG@$인하/NNG@$카드/NNG,0,0.11396591454714988,182,90,92,59,0.7290364442444255,0.5796917915075177
유럽연합/NNG@$통계/NNG@$유로/NNG,0,0.11365568180207997,48,24,24,11,0.4623021908979467,0.3678297282047027
물가/NNG@$불안/NNG@$심리/NNG,0,0.11365568180207997,48,24,24,6,0.4623021908979467,0.3678297282047027
금리/NNG@$결정/NNG@$경제/NNG,0,0.11365568180207997,48,24,24,10,0.4623021908979467,0.3678297282047027
관리/NNG@$필요/NNG@$있/VA,0,0.11163329107065434,46,23,23,13,0.4524029105221391,0.36143085062737573
인상/NNG@$확률/NNG@$높/VA,0,0.11163329107065434,46,23,23,21,0.4524029105221391,0.36143085062737573
금리/NNG@$인상/NNG@$경제/NNG@$성장/NNG,0,0.11163329107065434,46,23,23,22,0.4524029105221391,0.36143085062737573
반응/NNG@$보이/VV@$않/VX,0,0.11163329107065434,46,23,23,28,0.4524029105221391,0.36143085062737573
기록/NNG@$소비자/NNG@$물가/NNG,0,0.11163329107065434,46,23,23,12,0.4524029105221391,0.36143085062737573
시장/NNG@$금리/NNG@$낮/VA,0,0.11163329107065434,46,23,23,17,0.4524029105221391,0.36143085062737573
경제/NNG@$전망/NNG@$밝/VA,0,0.11163329107065434,46,23,23,20,0.4524029105221391,0.36143085062737573
성장/NNG@$금리/NNG@$인상/NNG,0,0.11163329107065434,46,23,23,12,0.4524029105221391,0.36143085062737573
시장/NNG@$관심/NNG@$쏠리/VV,0,0.11163329107065434,46,23,23,17,0.4524029105221391,0.36143085062737573
경제/NNG@$회복/NNG@$기조/NNG,0,0.11163329107065434,46,23,23,7,0.4524029105221391,0.36143085062737573
브렉시트/NNG@$국민/NNG@$투표/NNG,0,0.11163329107065434,46,23,23,17,0.4524029105221391,0.36143085062737573
금리/NNG@$인상/NNG@$추세/NNG,0,0.11163329107065434,46,23,23,24,0.4524029105221391,0.36143085062737573
기준금리/NNG@$인상/NNG@$경기/NNG,1,0.11114679902586477,93,46,47,22,0.6214061511159586,0.49693912189085643
기준금리/NNG@$인상/NNG@$시작/NNG,1,0.11114679902586477,93,46,47,43,0.6214061511159586,0.49693912189085643
더블딥/NNG@$이중/NNG@$침체/NNG,0,0.11047651453258212,160,79,81,29,0.7169911774256845,0.5741571919812826
평균/NNG@$지수/NNG@$상승/NNG@$거래/NNG@$마쳤/VV,1,0.11000286445204321,91,45,46,59,0.6156345572999248,0.49346504869270585
기준금리/NNG@$인상/NNG@$신중/NNG,0,0.10952436975836943,44,22,22,17,0.44236185367470565,0.3549210042489469
금리선물/NNG@$시장/NNG@$금리/NNG@$인상/NNG@$가능성/NNG,0,0.10952436975836943,44,22,22,34,0.44236185367470565,0.3549210042489469
유로존/NNG@$국채/NNG@$금리/NNG,0,0.10952436975836943,44,22,22,16,0.44236185367470565,0.3549210042489469
기준금리/NNG@$인상/NNG@$할/VX,0,0.10952436975836943,44,22,22,8,0.44236185367470565,0.3549210042489469
경제/NNG@$비추/VV@$성장/NNG@$경로/NNG@$불확실성/NNG,0,0.10952436975836943,44,22,22,21,0.44236185367470565,0.3549210042489469
소비자/NNG@$물가/NNG@$상승률/NNG@$하락/NNG,0,0.10952436975836943,44,22,22,11,0.44236185367470565,0.3549210042489469
동결/NNG@$기준금리/NNG@$인상/NNG,0,0.10952436975836943,44,22,22,24,0.44236185367470565,0.3549210042489469
물가/NNG@$상승/NNG@$요인/NNG,0,0.10783997153121883,148,73,75,67,0.7068837195542813,0.5690918182816257
물가/NNG@$불안/NNG@$우려/NNG,1,0.10754227136415362,87,43,44,13,0.6035192474962359,0.48616877710972733
금리/NNG@$변동성/NNG@$확대/NNG,0,0.10732690032041092,42,21,21,5,0.43218856726932847,0.34830398211436386
장단기/NNG@$금리/NNG@$격차/NNG,0,0.10732690032041092,42,21,21,23,0.43218856726932847,0.34830398211436386
국내총생산/NNG@$증가율/NNG@$전망/NNG,0,0.10732690032041092,42,21,21,12,0.43218856726932847,0.34830398211436386
경기/NNG@$상승/NNG@$국면/NNG,0,0.10732690032041092,42,21,21,26,0.43218856726932847,0.34830398211436386
수단/NNG@$금리/NNG@$인상/NNG,0,0.10732690032041092,42,21,21,16,0.43218856726932847,0.34830398211436386
경기/NNG@$부양/NNG@$양적완화/NNG,0,0.10732690032041092,42,21,21,23,0.43218856726932847,0.34830398211436386
금리/NNG@$인상/NNG@$실시/NNG,0,0.10732690032041092,42,21,21,13,0.43218856726932847,0.34830398211436386
경제/NNG@$금융시장/NNG@$불안/NNG,0,0.10732690032041092,42,21,21,14,0.43218856726932847,0.34830398211436386
국채/NNG@$금리/NNG@$하락/NNG,0,0.1062480154235157,142,70,72,64,0.7006172003350611,0.565866187760991
인플레/NNG@$압력/NNG@$가중/NNG,0,0.1050389167938719,40,20,20,11,0.4218933381110438,0.34158400790406007
인상/NNG@$강하/VA@$시사/NNG,0,0.1050389167938719,40,20,20,14,0.4218933381110438,0.34158400790406007
금융시장/NNG@$불안/NNG@$실물경제/NNG,0,0.1050389167938719,40,20,20,8,0.4218933381110438,0.34158400790406007
엔화/NNG@$가치/NNG@$상승/NNG,0,0.1050389167938719,40,20,20,24,0.4218933381110438,0.34158400790406007
증시/NNG@$긍정적/NNG@$영향/NNG,0,0.1050389167938719,40,20,20,12,0.4218933381110438,0.34158400790406007
물가/NNG@$상승률/NNG@$마이너스/NNG,0,0.1050389167938719,40,20,20,19,0.4218933381110438,0.34158400790406007
인하/NNG@$기대/NNG@$높/VA,0,0.1050389167938719,40,20,20,7,0.4218933381110438,0.34158400790406007
안정적/NNG@$모습/NNG@$보이/VV,0,0.1050389167938719,40,20,20,9,0.4218933381110438,0.34158400790406007
유지/NNG@$경기/NNG@$회복/NNG,1,0.10483527318663421,83,41,42,21,0.5906276361705262,0.47839590471694954
콜금리/NNG@$인상/NNG@$가능성/NNG,0,0.1026793724447479,205,101,104,50,0.7276795948182566,0.5919793926817591
경기/NNG@$개선/NNG@$기대/NNG,0,0.10265851411617288,38,19,19,22,0.41148718108867594,0.33476574325686403
통화정책/NNG@$기조/NNG@$변경/NNG,0,0.10265851411617288,38,19,19,15,0.41148718108867594,0.33476574325686403
시차/NNG@$소비자/NNG@$물가/NNG,0,0.10265851411617288,38,19,19,8,0.41148718108867594,0.33476574325686403
인하/NNG@$가능성/NNG@$무게/NNG,0,0.10265851411617288,38,19,19,17,0.41148718108867594,0.33476574325686403
인하/NNG@$단행/NNG@$않/VX,0,0.10265851411617288,38,19,19,14,0.41148718108867594,0.33476574325686403
유로존/NNG@$부채/NNG@$위기/NNG,0,0.10265851411617288,38,19,19,21,0.41148718108867594,0.33476574325686403
조정/NNG@$필요/NNG@$있/VA,1,0.1018610572518086,79,39,40,27,0.5769473127379622,0.4701330004664221
경기/NNG@$회복/NNG@$예상/NNG,1,0.1018610572518086,79,39,40,16,0.5769473127379622,0.4701330004664221
양적완화/NNG@$축소/NNG@$우려/NNG,1,0.10026671934642928,77,38,39,27,0.5698088469373919,0.46581415951120925
기조/NNG@$갈/VX@$전망/NNG,1,0.10026671934642928,77,38,39,25,0.5698088469373919,0.46581415951120925
자산/NNG@$매입/NNG@$프로그램/NNG@$규모/NNG,0,0.10018385764112003,36,18,18,15,0.40098182086065615,0.3278542925999702
기준금리/NNG@$인상/NNG@$논의/NNG,0,0.10018385764112003,36,18,18,26,0.40098182086065615,0.3278542925999702
통화정책/NNG@$기조/NNG@$완화/NNG,0,0.10018385764112003,36,18,18,15,0.40098182086065615,0.3278542925999702
전망/NNG@$소비자/NNG@$물가/NNG@$상승률/NNG,0,0.10018385764112003,36,18,18,29,0.40098182086065615,0.3278542925999702
물가/NNG@$상승률/NNG@$높/VA,0,0.09979221619747447,526,259,267,127,0.7296780552614612,0.5970779561514347
성장률/NNG@$전망치/NNG@$하향/NNG@$조정/NNG,0,0.09889603394477597,185,91,94,71,0.7211242609673912,0.5911475851120983
가능성/NNG@$크/VA@$보/VX,1,0.09859688111745735,75,37,38,29,0.5624708513470131,0.46136877225384043
금융/NNG@$불안/NNG@$확산/NNG,0,0.09761319276635438,34,17,17,11,0.39038966670736025,0.3208552052163573
둔화/NNG@$우려/NNG@$있/VA,0,0.09761319276635438,34,17,17,15,0.39038966670736025,0.3208552052163573
가격/NNG@$변동성/NNG@$확대/NNG,0,0.09761319276635438,34,17,17,7,0.39038966670736025,0.3208552052163573
감소/NNG@$금리/NNG@$인상/NNG,0,0.09761319276635438,34,17,17,19,0.39038966670736025,0.3208552052163573
경기/NNG@$활성화/NNG@$정책/NNG,0,0.09761319276635438,34,17,17,19,0.39038966670736025,0.3208552052163573
수출/NNG@$경기/NNG@$둔화/NNG,0,0.09761319276635438,34,17,17,25,0.39038966670736025,0.3208552052163573
심리/NNG@$크/VA@$위축/NNG,0,0.09761319276635438,34,17,17,10,0.39038966670736025,0.3208552052163573
금리/NNG@$상승/NNG@$예상/NNG,0,0.09761319276635438,34,17,17,25,0.39038966670736025,0.3208552052163573
위험/NNG@$선호/NNG@$심리/NNG,0,0.09761319276635438,34,17,17,11,0.39038966670736025,0.3208552052163573
구조/NNG@$개혁/NNG@$필요/NNG,0,0.09761319276635438,34,17,17,34,0.39038966670736025,0.3208552052163573
금융/NNG@$외환시장/NNG@$변동성/NNG,0,0.09761319276635438,34,17,17,27,0.39038966670736025,0.3208552052163573
확인/NNG@$금리/NNG@$인상/NNG,0,0.0973293181628585,118,58,60,28,0.6652807707333831,0.5470973938212307
완화/NNG@$금리/NNG@$인상/NNG,1,0.09684834433642808,73,36,37,24,0.5549333080295444,0.4567958517305662
채권/NNG@$시장/NNG@$금리/NNG@$인상/NNG,0,0.09635426434904115,116,57,59,34,0.6614688157017778,0.5450343399807708
성장률/NNG@$소비자/NNG@$물가/NNG,0,0.0949448545762297,32,16,16,18,0.3797237802985175,0.3137744742906258
산업/NNG@$생산/NNG@$부진/NNG,0,0.0949448545762297,32,16,16,17,0.3797237802985175,0.3137744742906258
외국인투자/NNG@$자금/NNG@$이탈/NNG,0,0.0949448545762297,32,16,16,16,0.3797237802985175,0.3137744742906258
인상/NNG@$경제/NNG@$성장/NNG,1,0.09310152780738967,69,34,35,36,0.5392615934071381,0.44726451792594707
경기/NNG@$회복/NNG@$도움/NNG,1,0.09310152780738967,69,34,35,17,0.5392615934071381,0.44726451792594707
금리/NNG@$인상/NNG@$지속/NNG,0,0.0926049695256792,222,109,113,52,0.7236005561121291,0.6007570011666411
대응/NNG@$방안/NNG@$마련/NNG,0,0.0921772773952314,30,15,15,13,0.36899783621249826,0.3066185326905942
농산물/NNG@$석유류/NNG@$가격/NNG,0,0.0921772773952314,30,15,15,12,0.36899783621249826,0.3066185326905942
국제금융시장/NNG@$불안/NNG@$요인/NNG,0,0.0921772773952314,30,15,15,15,0.36899783621249826,0.3066185326905942
금리/NNG@$인하/NNG@$시기/NNG,0,0.09200566610529215,108,53,55,38,0.6446813873949887,0.5358830570753351
자산운용사/NNG@$채권/NNG@$딜러/NNG,1,0.09109594273375099,67,33,34,31,0.5311295473507612,0.44230525145454147
경제/NNG@$성장/NNG@$둔화/NNG@$우려/NNG,1,0.09109594273375099,67,33,34,34,0.5311295473507612,0.44230525145454147
인상/NNG@$여부/NNG@$결정/NNG,0,0.09090203431864041,155,76,79,45,0.7022613697838478,0.5850462783353928
정책/NNG@$금리/NNG@$인상/NNG,0,0.08953565481642767,104,51,53,34,0.6353152529186453,0.5307342457985784
인상/NNG@$시장/NNG@$금리/NNG,0,0.08953565481642767,104,51,53,40,0.6353152529186453,0.5307342457985784
전망/NNG@$경제/NNG@$성장/NNG,0,0.08953565481642767,104,51,53,22,0.6353152529186453,0.5307342457985784
발생/NNG@$가능성/NNG@$높/VA,0,0.0893090041392397,28,14,14,18,0.35822607514456917,0.29939424526447095
물가/NNG@$목표/NNG@$근접/NNG,0,0.0893090041392397,28,14,14,5,0.35822607514456917,0.29939424526447095
개별소비세/NNG@$인하/NNG@$종료/NNG,0,0.0893090041392397,28,14,14,13,0.35822607514456917,0.29939424526447095
인상/NNG@$금리/NNG@$인하/NNG,1,0.08899700411930644,65,32,33,27,0.5228022512268415,0.43721679244129563
주택/NNG@$착공/NNG@$실적/NNG,1,0.08899700411930644,65,32,33,28,0.5228022512268415,0.43721679244129563
금융정책/NNG@$결정/NNG@$열/VV,1,0.08899700411930644,65,32,33,27,0.5228022512268415,0.43721679244129563
지수/NNG@$뛴/VV@$기록/NNG,0,0.086338695345479,26,13,13,25,0.34742324985225687,0.292108897462246
내수/NNG@$경기/NNG@$부진/NNG,0,0.086338695345479,26,13,13,23,0.34742324985225687,0.292108897462246
부정적/NNG@$영향/NNG@$않/VX,0,0.086338695345479,26,13,13,26,0.34742324985225687,0.292108897462246
금리/NNG@$인상/NNG@$인하/NNG,0,0.0854138243511493,98,48,50,38,0.6199765424315905,0.5222402579856004
규모/NNG@$경상수지/NNG@$흑자/NNG,1,0.08450180639939453,61,30,31,36,0.5055715681349167,0.4266537261400986
투자/NNG@$증권/NNG@$동결/NNG,1,0.08450180639939453,61,30,31,32,0.5055715681349167,0.4266537261400986
시장/NNG@$예상/NNG@$뛰어넘/VV,1,0.08450180639939453,61,30,31,21,0.5055715681349167,0.4266537261400986
인상/NNG@$가능성/NNG@$시사/NNG,0,0.0844841871319888,339,166,173,120,0.7205223944452295,0.6080731058033643
산업/NNG@$평균/NNG@$지수/NNG@$상승/NNG@$거래/NNG,0,0.08236077319481905,94,46,48,59,0.6088561022348876,0.5160360015269898
압력/NNG@$기준금리/NNG@$인상/NNG,0,0.08209614318329428,59,29,30,13,0.49667433794622295,0.4211806836481707
원리금/NNG@$상환/NNG@$부담/NNG,0,0.08073506591405333,92,45,47,52,0.603019351769192,0.5127644436677349
금융시장/NNG@$불안/NNG@$가능성/NNG,0,0.08008725233738034,22,11,11,17,0.32578560424036745,0.2773861703288607
기조/NNG@$유지/NNG@$바람직/XR,0,0.08008725233738034,22,11,11,22,0.32578560424036745,0.2773861703288607
외환시장/NNG@$원달러/NNG@$환율/NNG,0,0.08008725233738034,22,11,11,18,0.32578560424036745,0.2773861703288607
양적/NNG@$질적/NNG@$금융완화/NNG,0,0.08008725233738034,22,11,11,31,0.32578560424036745,0.2773861703288607
금리/NNG@$인상/NNG@$여파/NNG,0,0.07957822391142666,57,28,29,22,0.48759419867535764,0.4155816383882808
불안/NNG@$모습/NNG@$보이/VV,0,0.07868123104442781,127,62,65,24,0.6676801038018446,0.5700988524374164
주택/NNG@$가격/NNG@$상승세/NNG,0,0.07727139115692605,88,43,45,32,0.5907809751032713,0.5058713834359638
이자/NNG@$상환/NNG@$부담/NNG,0,0.07694234108120734,55,27,28,23,0.47833560952130877,0.40985836197057096
달러화/NNG@$가치/NNG@$상승/NNG,0,0.07694234108120734,55,27,28,27,0.47833560952130877,0.40985836197057096
정상화/NNG@$금리/NNG@$인상/NNG,0,0.07694234108120734,55,27,28,10,0.47833560952130877,0.40985836197057096
상승/NNG@$가능성/NNG@$높/VA,0,0.07694234108120734,55,27,28,15,0.47833560952130877,0.40985836197057096
종합/NNG@$지수/NNG@$오른/VV,0,0.07542746287023294,86,42,44,46,0.5843752474044513,0.5022456566940267
물가/NNG@$상승세/NNG@$둔화/NNG,0,0.07542746287023294,86,42,44,34,0.5843752474044513,0.5022456566940267
금리/NNG@$인상/NNG@$없/VA,0,0.07519691280773877,334,163,171,81,0.7148771349445875,0.6146914177772463
금리/NNG@$인하/NNG@$요구/NNG,0,0.0751320599261096,121,59,62,52,0.6572417810365303,0.5652070222638735
부양/NNG@$금리/NNG@$인하/NNG,0,0.0751320599261096,121,59,62,55,0.6572417810365303,0.5652070222638735
불안/NNG@$심리/NNG@$확산/NNG,0,0.07418225710402515,53,26,27,12,0.4689035888139757,0.40401308375157063
은행/NNG@$가계/NNG@$대출/NNG@$주택/NNG@$담보대출/NNG,0,0.07418225710402515,53,26,27,13,0.4689035888139757,0.40401308375157063
부양/NNG@$기준금리/NNG@$인하/NNG,0,0.07418225710402515,53,26,27,38,0.4689035888139757,0.40401308375157063
경제/NNG@$혁신/NNG@$계획/NNG,1,0.07149938191438165,82,40,42,33,0.5709822551981921,0.49462592959702334
실업/NNG@$수당/NNG@$신청/NNG,0,0.07129110545514639,51,25,26,15,0.4593037066451601,0.3980485298137316
경제/NNG@$성장/NNG@$경로/NNG,0,0.07129110545514639,51,25,26,20,0.4593037066451601,0.3980485298137316
예상치/NNG@$크/VA@$웃돌/VV,0,0.07129110545514639,51,25,26,16,0.4593037066451601,0.3980485298137316
부동산/NNG@$담보대출/NNG@$모기지/NNG,0,0.07129110545514639,51,25,26,11,0.4593037066451601,0.3980485298137316
금리/NNG@$인하/NNG@$가능성/NNG@$시사/NNG,0,0.07115763816084808,115,56,59,37,0.6455220757524647,0.5595819207682244
인상/NNG@$위안화/NNG@$절상/NNG,0,0.07115763816084808,115,56,59,21,0.6455220757524647,0.5595819207682244
경기/NNG@$부진/NNG@$완화/NNG,0,0.06991899972049453,16,8,8,17,0.2934870914379315,0.25504843573109875
외화/NNG@$자금/NNG@$유출입/NNG,0,0.06991899972049453,16,8,8,6,0.2934870914379315,0.25504843573109875
가능성/NNG@$금리/NNG@$인상/NNG,0,0.0695418717545242,189,92,97,59,0.7045185320299607,0.6127103286143025
단행/NNG@$가능성/NNG@$높/VA,1,0.0694082988562501,80,39,41,32,0.5639924107969467,0.49062831104457183
경기/NNG@$부양/NNG@$기준금리/NNG@$인하/NNG,0,0.06826126640251462,49,24,25,37,0.44954206777325606,0.3919679657540495
금리/NNG@$인하/NNG@$영향/NNG,0,0.06826126640251462,49,24,25,21,0.44954206777325606,0.3919679657540495
단기적/NNG@$경기/NNG@$부양/NNG,0,0.06826126640251462,49,24,25,14,0.44954206777325606,0.3919679657540495
모습/NNG@$보이/VV@$경기/NNG,0,0.06826126640251462,49,24,25,15,0.44954206777325606,0.3919679657540495
문제/NNG@$국제금융시장/NNG@$불안/NNG,0,0.06508420957646499,47,23,24,11,0.43962528235805776,0.3857752442583808
금리/NNG@$상승/NNG@$경제/NNG,0,0.06508420957646499,47,23,24,25,0.43962528235805776,0.3857752442583808
고려/NNG@$기준금리/NNG@$인하/NNG,0,0.06508420957646499,47,23,24,21,0.43962528235805776,0.3857752442583808
금리/NNG@$인하/NNG@$명분/NNG,0,0.06508420957646499,47,23,24,20,0.43962528235805776,0.3857752442583808
금리/NNG@$상승/NNG@$압력/NNG,0,0.06298537122481895,210,102,108,82,0.7043494362271447,0.620683385566848
개선/NNG@$움직임/NNG@$보이/VV,0,0.06260538499725699,12,6,6,13,0.2722492090252278,0.24009321290690402
고려/NNG@$기준금리/NNG@$유지/NNG,0,0.06260538499725699,12,6,6,4,0.2722492090252278,0.24009321290690402
금리/NNG@$인상/NNG@$단행/NNG@$전망/NNG,1,0.06258105627126387,74,36,38,31,0.5418404046875229,0.4778656957087558
시장/NNG@$예상/NNG@$일치/NNG,0,0.061750292881526114,45,22,23,10,0.4295604213454968,0.37947485881398024
인상/NNG@$압력/NNG@$높/VA,0,0.061750292881526114,45,22,23,9,0.4295604213454968,0.37947485881398024
수출/NNG@$호조/NNG@$힘입/VV,0,0.061750292881526114,45,22,23,17,0.4295604213454968,0.37947485881398024
주택/NNG@$경기/NNG@$부진/NNG,0,0.061750292881526114,45,22,23,22,0.4295604213454968,0.37947485881398024
소비/NNG@$지출/NNG@$기업/NNG,0,0.061750292881526114,45,22,23,10,0.4295604213454968,0.37947485881398024
디플레이션/NNG@$물가/NNG@$하락/NNG,0,0.061750292881526114,45,22,23,39,0.4295604213454968,0.37947485881398024
기업/NNG@$투자/NNG@$위축/NNG,0,0.061750292881526114,45,22,23,15,0.4295604213454968,0.37947485881398024
금리/NNG@$상승/NNG@$경기/NNG,0,0.061750292881526114,45,22,23,12,0.4295604213454968,0.37947485881398024
물가/NNG@$상승률/NNG@$고려/NNG,0,0.061750292881526114,45,22,23,16,0.4295604213454968,0.37947485881398024
인플레이션/NNG@$압력/NNG@$높/VA,0,0.06150115684646229,206,100,106,69,0.7028901390902467,0.621245687951779
채권/NNG@$시장/NNG@$관심/NNG,1,0.06010653394993537,72,35,37,29,0.5340616885628293,0.4733506996894072
금리/NNG@$인상/NNG@$있/VA,0,0.05992052640344414,101,49,52,37,0.6126687753295628,0.543224650314183
위기/NNG@$금리/NNG@$인하/NNG,0,0.05824850332732501,43,21,22,13,0.41935495226513675,0.3730720054381638
금리/NNG@$인상/NNG@$강력/XR,0,0.05824850332732501,43,21,22,9,0.41935495226513675,0.3730720054381638
금리/NNG@$인상/NNG@$크/VA,0,0.05824850332732501,43,21,22,12,0.41935495226513675,0.3730720054381638
주식/NNG@$부동산/NNG@$자산/NNG,0,0.05824850332732501,43,21,22,16,0.41935495226513675,0.3730720054381638
엔/NNG@$원/NNG@$재정환율/NNG,0,0.05824850332732501,43,21,22,19,0.41935495226513675,0.3730720054381638
경기/NNG@$회복/NNG@$속도/NNG@$둔화/NNG,0,0.05824850332732501,43,21,22,6,0.41935495226513675,0.3730720054381638
상승/NNG@$기조/NNG@$유지/NNG,0,0.058056503357641676,99,48,51,28,0.6072983205912093,0.5404808050631873
경제/NNG@$발목/NNG@$잡/VV,0,0.058056503357641676,99,48,51,43,0.6072983205912093,0.5404808050631873
경제/NNG@$성장/NNG@$모멘텀/NNG,1,0.05752486682712066,70,34,36,46,0.5260862554786689,0.4687037189616856
금리/NNG@$인하/NNG@$효과/NNG,0,0.0570476628116674,559,271,288,181,0.7036554124581881,0.6275051159063283
인하/NNG@$단행/NNG@$전망/NNG,1,0.054830905491355164,68,33,35,21,0.5179150757452887,0.46392415640188256
조치/NNG@$금리/NNG@$인하/NNG,1,0.054830905491355164,68,33,35,7,0.5179150757452887,0.46392415640188256
해외/NNG@$자금/NNG@$유입/NNG,1,0.054830905491355164,68,33,35,19,0.5179150757452887,0.46392415640188256
강세/NNG@$보일/VV@$전망/NNG,0,0.05456611969192182,41,20,21,14,0.40901664965522366,0.3665726550401728
경기동행지수/NNG@$순환/NNG@$변동/NNG,0,0.05456611969192182,41,20,21,9,0.40901664965522366,0.3665726550401728
결정/NNG@$쉽/VA@$않/VX,0,0.05456611969192182,41,20,21,17,0.40901664965522366,0.3665726550401728
제로/NNG@$금리/NNG@$유지/NNG,0,0.05456611969192182,41,20,21,13,0.40901664965522366,0.3665726550401728
인플레이션/NNG@$정책/NNG@$목표/NNG,0,0.05456611969192182,41,20,21,11,0.40901664965522366,0.3665726550401728
전망/NNG@$대외/NNG@$경제/NNG,0,0.05456611969192182,41,20,21,9,0.40901664965522366,0.3665726550401728
경제/NNG@$활력/NNG@$제고/NNG,0,0.05456611969192182,41,20,21,16,0.40901664965522366,0.3665726550401728
회복/NNG@$찬물/NNG@$끼얹/VV,0,0.05456611969192182,41,20,21,13,0.40901664965522366,0.3665726550401728
잠재적/NNG@$위험/NNG@$요인/NNG,0,0.05456611969192182,41,20,21,10,0.40901664965522366,0.3665726550401728
양적완화/NNG@$축소/NNG@$테이퍼링/NNG,0,0.05456611969192182,41,20,21,41,0.40901664965522366,0.3665726550401728
곡물/NNG@$가격/NNG@$급등/NNG,0,0.05456611969192182,41,20,21,27,0.40901664965522366,0.3665726550401728
상승/NNG@$종합/NNG@$지수/NNG@$오른/VV,0,0.05456611969192182,41,20,21,29,0.40901664965522366,0.3665726550401728
예상/NNG@$기준금리/NNG@$인상/NNG,0,0.05236297264773837,122,59,63,50,0.6453731484638793,0.580963417247379
경기/NNG@$둔화/NNG@$리스크/NNG,1,0.05201910899714024,66,32,34,34,0.5095495297184461,0.4590116878853987
시장/NNG@$예상치/NNG@$웃돌/VV,1,0.05201910899714024,66,32,34,37,0.5095495297184461,0.4590116878853987
달러당/NNG@$거래/NNG@$가격/NNG,0,0.05068826861941589,39,19,20,12,0.3985534720167192,0.3599836400818328
발생/NNG@$가능성/NNG@$크/VA,0,0.05068826861941589,39,19,20,21,0.3985534720167192,0.3599836400818328
경기/NNG@$전망/NNG@$하락/NNG,0,0.05068826861941589,39,19,20,13,0.3985534720167192,0.3599836400818328
가능성/NNG@$높/VA@$내/VX,0,0.05068826861941589,39,19,20,11,0.3985534720167192,0.3599836400818328
물가/NNG@$지표/NNG@$개인/NNG@$소비/NNG@$지출/NNG,0,0.05068826861941589,39,19,20,37,0.3985534720167192,0.3599836400818328
금융/NNG@$위기/NNG@$촉발/NNG,0,0.05068826861941589,39,19,20,15,0.3985534720167192,0.3599836400818328
시장/NNG@$예상치/NNG@$상회/NNG,0,0.05068826861941589,39,19,20,24,0.3985534720167192,0.3599836400818328
기조/NNG@$유지/NNG@$금리/NNG@$인상/NNG,0,0.05068826861941589,39,19,20,12,0.3985534720167192,0.3599836400818328
금리/NNG@$인하/NNG@$어려울/VA,0,0.05068826861941589,39,19,20,18,0.3985534720167192,0.3599836400818328
달러화/NNG@$엔화/NNG@$달러당/NNG@$거래/NNG@$가격/NNG,0,0.05068826861941589,39,19,20,12,0.3985534720167192,0.3599836400818328
엔화/NNG@$달러당/NNG@$거래/NNG@$가격/NNG,0,0.05068826861941589,39,19,20,12,0.3985534720167192,0.3599836400818328
양적완화/NNG@$축소/NNG@$결정/NNG,0,0.05068826861941589,39,19,20,18,0.3985534720167192,0.3599836400818328
순환/NNG@$변동/NNG@$하락/NNG,0,0.05068826861941589,39,19,20,9,0.3985534720167192,0.3599836400818328
금리/NNG@$인상/NNG@$요구/NNG,0,0.05068826861941589,39,19,20,14,0.3985534720167192,0.3599836400818328
출구전략/NNG@$시행/NNG@$시기/NNG,1,0.04908348927405415,64,31,33,11,0.5009914171010824,0.4539662897802814
기준금리/NNG@$인하/NNG@$전망/NNG,0,0.04753643415823361,236,114,122,100,0.6967285032847904,0.6332913893852629
가능성/NNG@$배제/NNG@$어렵/VA,0,0.047367859781773713,116,56,60,38,0.6333567948673616,0.5758842067364631
소비자/NNG@$물가/NNG@$수요/NNG,0,0.04659733333161209,37,18,19,6,0.3879733936690923,0.35331276070476203
위기/NNG@$경제/NNG@$성장/NNG,0,0.04659733333161209,37,18,19,15,0.3879733936690923,0.35331276070476203
모습/NNG@$보이/VV@$금리/NNG,0,0.04659733333161209,37,18,19,22,0.3879733936690923,0.35331276070476203
양적완화/NNG@$축소/NNG@$시기/NNG,0,0.04659733333161209,37,18,19,7,0.3879733936690923,0.35331276070476203
고용/NNG@$지표/NNG@$좋/VA,0,0.04659733333161209,37,18,19,17,0.3879733936690923,0.35331276070476203
확대/NNG@$가능성/NNG@$높/VA,0,0.04659733333161209,37,18,19,13,0.3879733936690923,0.35331276070476203
경기/NNG@$회복/NNG@$발목/NNG@$잡/VV,0,0.04659733333161209,37,18,19,12,0.3879733936690923,0.35331276070476203
소비/NNG@$지출/NNG@$감소/NNG,0,0.04601754409317582,62,30,32,21,0.49224296165309583,0.44878826822659146
외국인투자/NNG@$자금/NNG@$유입/NNG,0,0.04601754409317582,62,30,32,15,0.49224296165309583,0.44878826822659146
가능성/NNG@$높/VA@$금리/NNG@$인상/NNG,0,0.04601754409317582,62,30,32,22,0.49224296165309583,0.44878826822659146
증가/NNG@$속도/NNG@$빠르/VA,0,0.04601754409317582,62,30,32,14,0.49224296165309583,0.44878826822659146
주택/NNG@$담보대출/NNG@$부실/NNG,0,0.04601754409317582,62,30,32,29,0.49224296165309583,0.44878826822659146
금리/NNG@$인상/NNG@$경기/NNG@$둔화/NNG,0,0.045238573608660904,87,42,45,48,0.5712450533163239,0.521629737446778
인상/NNG@$전망/NNG@$유지/NNG,0,0.045238573608660904,87,42,45,38,0.5712450533163239,0.521629737446778
금리/NNG@$인상/NNG@$예상/NNG,0,0.044811998576127055,719,347,372,254,0.6959455509837598,0.6360428349084825
경기/NNG@$회복/NNG@$기대/NNG,0,0.04449538480458637,344,166,178,124,0.695743043259975,0.6362612687857356
원/NNG@$환율/NNG@$하락/NNG,0,0.04373627657704615,112,54,58,40,0.6245909919717428,0.5720616900461408
금리/NNG@$상승/NNG@$가능성/NNG,0,0.042814175729552595,60,29,31,24,0.4833068100314607,0.44347829031944286
금리/NNG@$인상/NNG@$여지/NNG,0,0.042814175729552595,60,29,31,21,0.4833068100314607,0.44347829031944286
동향/NNG@$소비자/NNG@$물가/NNG,0,0.042814175729552595,60,29,31,25,0.4833068100314607,0.44347829031944286
외국인/NNG@$자본/NNG@$유출/NNG,0,0.042814175729552595,60,29,31,16,0.4833068100314607,0.44347829031944286
금리/NNG@$인하/NNG@$단행/NNG@$가능성/NNG,0,0.0427986925704984,85,41,44,35,0.5645768705668285,0.5180670880336697
달러/NNG@$원/NNG@$상승/NNG,0,0.04227215519088512,35,17,18,17,0.3772841743819592,0.3465689176686913
전미/NNG@$부동산/NNG@$중개인/NNG@$주택/NNG,0,0.04227215519088512,35,17,18,18,0.3772841743819592,0.3465689176686913
금리/NNG@$인하/NNG@$쉽/VA@$않/VX,0,0.04227215519088512,35,17,18,18,0.3772841743819592,0.3465689176686913
경기/NNG@$회복세/NNG@$가시화/NNG,0,0.04227215519088512,35,17,18,14,0.3772841743819592,0.3465689176686913
경제/NNG@$소비/NNG@$투자/NNG,0,0.04227215519088512,35,17,18,9,0.3772841743819592,0.3465689176686913
인하/NNG@$필요성/NNG@$제기/NNG,0,0.04227215519088512,35,17,18,15,0.3772841743819592,0.3465689176686913
금융/NNG@$위기/NNG@$최저/NNG,0,0.04227215519088512,35,17,18,17,0.3772841743819592,0.3465689176686913
정책금리/NNG@$인상/NNG@$기대/NNG,0,0.04227215519088512,35,17,18,5,0.3772841743819592,0.3465689176686913
부정적/NNG@$영향/NNG@$우려/NNG,0,0.041865761470457175,137,66,71,61,0.6573294649112067,0.604307076565927
경기/NNG@$부양/NNG@$금리/NNG@$인하/NNG,0,0.04182296826173837,110,53,57,44,0.6199715665303622,0.5700114518500996
인상/NNG@$필요/NNG@$있/VA,0,0.04026204037941361,83,40,43,31,0.5577155669201492,0.5143780775150995
실제/NNG@$금리/NNG@$인상/NNG,0,0.04026204037941361,83,40,43,28,0.5577155669201492,0.5143780775150995
양적완화/NNG@$규모/NNG@$확대/NNG,0,0.03946559163181962,58,28,30,13,0.4741860231778987,0.4380374173437597
채권/NNG@$가격/NNG@$하락/NNG,0,0.03946559163181962,58,28,30,19,0.4741860231778987,0.4380374173437597
경제/NNG@$전망/NNG@$금리/NNG,0,0.03946559163181962,58,28,30,34,0.4741860231778987,0.4380374173437597
금리/NNG@$인하/NNG@$가능성/NNG@$낮/VA,0,0.03946559163181962,58,28,30,36,0.4741860231778987,0.4380374173437597
경기/NNG@$부양/NNG@$효과/NNG,0,0.038455996305901685,324,156,168,97,0.6918902887794994,0.6404390599088191
문제/NNG@$금리/NNG@$인상/NNG,0,0.037788554494331494,106,51,55,28,0.6102434654206095,0.5656192699909189
결정/NNG@$기준금리/NNG@$인하/NNG,0,0.03768693881436369,33,16,17,9,0.36649304088929613,0.3397622826408646
수출/NNG@$부진/NNG@$경제/NNG,0,0.03768693881436369,33,16,17,13,0.36649304088929613,0.3397622826408646
회복/NNG@$모습/NNG@$보이/VV,0,0.03768693881436369,33,16,17,9,0.36649304088929613,0.3397622826408646
환율/NNG@$경상수지/NNG@$흑자/NNG,0,0.03768693881436369,33,16,17,13,0.36649304088929613,0.3397622826408646
물가/NNG@$전망/NNG@$하향/NNG,0,0.03768693881436369,33,16,17,13,0.36649304088929613,0.3397622826408646
경기/NNG@$둔화/NNG@$추세/NNG,0,0.03768693881436369,33,16,17,16,0.36649304088929613,0.3397622826408646
지수/NNG@$높/VA@$마감/NNG,0,0.03768693881436369,33,16,17,17,0.36649304088929613,0.3397622826408646
부양/NNG@$기조/NNG@$유지/NNG,0,0.03762435501053396,81,39,42,32,0.5506598918652217,0.5105606107858153
경제/NNG@$회복/NNG@$속도/NNG,0,0.03606211296394046,183,88,95,34,0.6818892867475107,0.6342146945196178
고용/NNG@$지표/NNG@$악화/NNG,0,0.03596318230408668,56,27,29,9,0.4648840582719875,0.43246714025033356
이자/NNG@$부담/NNG@$증가/NNG,0,0.03596318230408668,56,27,29,25,0.4648840582719875,0.43246714025033356
통화정책/NNG@$완화/NNG@$기조/NNG@$유지/NNG,0,0.03566200969125677,104,50,54,47,0.6051285271417922,0.5632717580509441
금리/NNG@$인하/NNG@$고려/NNG,0,0.03488110709928871,79,38,41,38,0.5434088622484808,0.5066127142428037
경기/NNG@$회복/NNG@$전망/NNG,0,0.03488110709928871,79,38,41,21,0.5434088622484808,0.5066127142428037
금리/NNG@$인상/NNG@$시사/NNG,0,0.03335341108808931,489,235,254,183,0.6886240892555036,0.6439614210620569
금융시장/NNG@$불안/NNG@$경제/NNG,0,0.03280972422452755,31,15,16,19,0.35560624005889346,0.33290452113426267
사태/NNG@$금융/NNG@$위기/NNG,0,0.03280972422452755,31,15,16,13,0.35560624005889346,0.33290452113426267
지수/NNG@$사상/NNG@$최고치/NNG,0,0.03280972422452755,31,15,16,37,0.35560624005889346,0.33290452113426267
산업/NNG@$생산/NNG@$증가세/NNG,0,0.03229737011173883,54,26,28,22,0.45540473873587956,0.42676941761906256
하방/NNG@$리스크/NNG@$확대/NNG,0,0.03229737011173883,54,26,28,19,0.45540473873587956,0.42676941761906256
경기/NNG@$하방/NNG@$압력/NNG,0,0.03229737011173883,54,26,28,39,0.45540473873587956,0.42676941761906256
금리/NNG@$올리/VV@$않/VX,0,0.03217697692837196,331,159,172,89,0.6878632584643517,0.644766584076091
경기/NNG@$회복/NNG@$강도/NNG,0,0.032027469841041434,77,37,40,21,0.5359617768543069,0.5025325534422829
에너지/NNG@$청/NNG@$원유/NNG@$재고/NNG,0,0.032027469841041434,77,37,40,55,0.5359617768543069,0.5025325534422829
청/NNG@$원유/NNG@$재고/NNG,0,0.032027469841041434,77,37,40,55,0.5359617768543069,0.5025325534422829
달러/NNG@$원/NNG@$환율/NNG@$상승/NNG,0,0.03117571289847021,100,48,52,32,0.5943818919928073,0.558259853787133
경기/NNG@$둔화/NNG@$조짐/NNG,0,0.03117571289847021,100,48,52,27,0.5943818919928073,0.558259853787133
제기/NNG@$금리/NNG@$인상/NNG,0,0.028457420683281054,52,25,27,29,0.4457522090566433,0.4209467164306288
금리/NNG@$인상/NNG@$부작용/NNG,0,0.028457420683281054,52,25,27,16,0.4457522090566433,0.4209467164306288
메르스/NNG@$호흡기/NNG@$증후군/NNG,0,0.028457420683281054,52,25,27,30,0.4457522090566433,0.4209467164306288
공개/NNG@$시장/NNG@$금리/NNG@$인상/NNG,0,0.028457420683281054,52,25,27,18,0.4457522090566433,0.4209467164306288
양적완화/NNG@$종료/NNG@$금리/NNG,0,0.02760021191301809,29,14,15,22,0.34462839939234036,0.3260090905863327
증가/NNG@$소매/NNG@$판매/NNG,0,0.02760021191301809,29,14,15,20,0.34462839939234036,0.3260090905863327
가계/NNG@$대출/NNG@$금리/NNG,0,0.02760021191301809,29,14,15,16,0.34462839939234036,0.3260090905863327
우려/NNG@$금리/NNG@$인하/NNG,0,0.026168579105168233,192,92,100,74,0.6779385079407392,0.6431512913471811
금리/NNG@$인하/NNG@$시그널/NNG,1,0.025968015411217182,73,35,38,23,0.5204781204637375,0.4939689121846032
회복/NNG@$조짐/NNG@$보이/VV,0,0.025301365155740108,142,68,74,53,0.6518975379909586,0.6195206844654472
채권/NNG@$시장/NNG@$국고채/NNG@$금리/NNG,0,0.024431205761090036,50,24,26,21,0.43593087020018706,0.4150020560675985
경기/NNG@$선행/NNG@$지표/NNG,0,0.024431205761090036,50,24,26,28,0.43593087020018706,0.4150020560675985
단행/NNG@$가능성/NNG@$크/VA,0,0.024431205761090036,50,24,26,16,0.43593087020018706,0.4150020560675985
경기/NNG@$둔화/NNG@$전망/NNG,0,0.024431205761090036,50,24,26,18,0.43593087020018706,0.4150020560675985
경상수지/NNG@$적자/NNG@$확대/NNG,1,0.022750708162785127,71,34,37,13,0.5124416643909757,0.48948263598157804
경기/NNG@$개선/NNG@$지속/NNG,0,0.022006595036914378,27,13,14,18,0.333561588730725,0.31909164712605487
둔화/NNG@$수출/NNG@$감소/NNG,0,0.022006595036914378,27,13,14,17,0.333561588730725,0.31909164712605487
확장적/NNG@$거시/NNG@$정책/NNG,0,0.021821383412811146,115,55,60,42,0.616623177883509,0.5900926029194893
경제/NNG@$전망/NNG@$금융시장/NNG,0,0.020204902405294378,48,23,25,11,0.4259452900009867,0.40893905609647396
금융/NNG@$경제/NNG@$위험/NNG@$요인/NNG,0,0.020204902405294378,48,23,25,13,0.4259452900009867,0.40893905609647396
금리/NNG@$인상/NNG@$이어질/VV,0,0.020204902405294378,48,23,25,15,0.4259452900009867,0.40893905609647396
소비자/NNG@$동향/NNG@$소비자심리지수/NNG,0,0.020204902405294378,48,23,25,22,0.4259452900009867,0.40893905609647396
상회/NNG@$증가세/NNG@$갔/VV,0,0.020204902405294378,48,23,25,12,0.4259452900009867,0.40893905609647396
내수/NNG@$부진/NNG@$지속/NNG,0,0.020204902405294378,48,23,25,7,0.4259452900009867,0.40893905609647396
경제/NNG@$기준금리/NNG@$인하/NNG,0,0.020204902405294378,48,23,25,25,0.4259452900009867,0.40893905609647396
금리/NNG@$인상/NNG@$이뤄질/VV,0,0.019809587506864013,182,87,95,61,0.6711498555937003,0.6448633832370454
물가/NNG@$상승률/NNG@$크/VA,1,0.019399924146020986,69,33,36,20,0.5042093957629473,0.48485854872806944
지속/NNG@$금리/NNG@$인하/NNG,1,0.019399924146020986,69,33,36,30,0.5042093957629473,0.48485854872806944
가능성/NNG@$크/VA@$전망/NNG,0,0.01844752551310358,180,86,94,77,0.669627323192023,0.6451559250726674
가능성/NNG@$가격/NNG@$반영/NNG,0,0.018446788259297575,90,43,47,30,0.5643745167527421,0.543750363535201
인상/NNG@$가능성/NNG@$열/VV,0,0.01843547212623986,203,97,106,79,0.6750276685827993,0.6503745968654865
통화정책/NNG@$방향/NNG@$기준금리/NNG@$유지/NNG,0,0.018131159161971944,134,64,70,34,0.6395172000140977,0.6165362148765774
금리/NNG@$인상/NNG@$가능성/NNG@$크/VA,0,0.016200376190170784,132,63,69,33,0.6361192493842047,0.6156333958604435
식료품/NNG@$가격/NNG@$급등/NNG,0,0.01596082142144306,25,12,13,23,0.3224039019070897,0.31217061185615214
필요/NNG@$의견/NNG@$제시/NNG,0,0.01596082142144306,25,12,13,5,0.3224039019070897,0.31217061185615214
상승/NNG@$기준금리/NNG@$인상/NNG,0,0.015908674399372158,67,32,35,24,0.49578216895005894,0.4800958232458534
기준금리/NNG@$금융/NNG@$위기/NNG,0,0.015762607845265286,46,22,24,12,0.41580008093191617,0.4027619885510735
물가/NNG@$상승률/NNG@$기준/NNG,0,0.015762607845265286,46,22,24,15,0.41580008093191617,0.4027619885510735
상승/NNG@$인플레이션/NNG@$우려/NNG,0,0.015762607845265286,46,22,24,8,0.41580008093191617,0.4027619885510735
달러/NNG@$강세/NNG@$지속/NNG,0,0.015762607845265286,46,22,24,13,0.41580008093191617,0.4027619885510735
경제/NNG@$성장/NNG@$우려/NNG,0,0.015762607845265286,46,22,24,16,0.41580008093191617,0.4027619885510735
기준금리/NNG@$인상/NNG@$물가/NNG,0,0.01561223356879693,88,42,46,30,0.5578155323435836,0.5404868518278192
인하/NNG@$가능성/NNG@$높/VA,0,0.01393640662755602,218,104,114,85,0.6739075773396129,0.6551647877167214
금융시장/NNG@$금리/NNG@$인상/NNG,0,0.012661564818118753,172,82,90,47,0.662908360742956,0.646116790958394
시작/NNG@$금리/NNG@$인상/NNG,0,0.012556341193823872,107,51,56,23,0.5974112716055563,0.5824013036913535
경기/NNG@$완만/XR@$회복/NNG,0,0.012269334935107734,65,31,34,29,0.48716115272247035,0.47519390571954184
경제/NNG@$침체/NNG@$우려/NNG,0,0.011085841179382605,44,21,23,12,0.40549973478931406,0.39647583565310673
국고채/NNG@$금리/NNG@$하락/NNG,0,0.011085841179382605,44,21,23,42,0.40549973478931406,0.39647583565310673
상승/NNG@$소비/NNG@$지출/NNG,0,0.011085841179382605,44,21,23,14,0.40549973478931406,0.39647583565310673
금리/NNG@$인하/NNG@$검토/NNG,0,0.011085841179382605,44,21,23,12,0.40549973478931406,0.39647583565310673
경제/NNG@$완만/XR@$회복세/NNG@$지속/NNG@$전망/NNG,0,0.011085841179382605,44,21,23,23,0.40549973478931406,0.39647583565310673
반대/NNG@$금리/NNG@$인상/NNG,0,0.011085841179382605,44,21,23,18,0.40549973478931406,0.39647583565310673
회복/NNG@$물가/NNG@$상승/NNG@$압력/NNG,0,0.011085841179382605,44,21,23,14,0.40549973478931406,0.39647583565310673
기준금리/NNG@$인상/NNG@$시장/NNG,0,0.010040587403487233,105,50,55,56,0.5921973235280812,0.5802303372364757
기업/NNG@$신뢰/NNG@$지수/NNG,0,0.009620704522098178,84,40,44,42,0.544124388671857,0.5335767076483032
회복세/NNG@$갈/VX@$전망/NNG,0,0.009620704522098178,84,40,44,17,0.544124388671857,0.5335767076483032
경기/NNG@$둔화/NNG@$가능성/NNG,0,0.009443285258965872,401,191,210,128,0.6730421206722843,0.660229624548256
경제/NNG@$부정적/NNG@$영향/NNG,0,0.008786432493685936,294,140,154,112,0.6725683149640893,0.6606320692357512
금리/NNG@$인상/NNG@$시작/NNG,0,0.008777617402154325,357,170,187,103,0.6726020707213152,0.6606768725867911
채권/NNG@$금리/NNG@$급등/NNG,0,0.008473545044108244,63,30,33,18,0.47834781723159436,0.47015254288856995
금리/NNG@$인상/NNG@$은행/NNG,0,0.008473545044108244,63,30,33,26,0.47834781723159436,0.47015254288856995
금리/NNG@$인하/NNG@$여지/NNG,0,0.006454131034022259,82,39,43,27,0.5369892064420322,0.5299249759511183
가계/NNG@$소비/NNG@$지출/NNG,0,0.006152891247539483,42,20,22,11,0.39504839959708743,0.3900863541759268
민간/NNG@$소비/NNG@$증가세/NNG,0,0.006152891247539483,42,20,22,15,0.39504839959708743,0.3900863541759268
가계부채/NNG@$문제/NNG@$해결/NNG,0,0.006152891247539483,42,20,22,26,0.39504839959708743,0.3900863541759268
가능성/NNG@$높/VA@$경기/NNG,0,0.006152891247539483,42,20,22,16,0.39504839959708743,0.3900863541759268
걱정/NNG@$필요/NNG@$없/VA,0,0.006152891247539483,42,20,22,25,0.39504839959708743,0.3900863541759268
금융/NNG@$위기/NNG@$우려/NNG,0,0.006152891247539483,42,20,22,18,0.39504839959708743,0.3900863541759268
성장률/NNG@$전망치/NNG@$낮췄/VV,0,0.006152891247539483,42,20,22,15,0.39504839959708743,0.3900863541759268
기준금리/NNG@$동결/NNG@$예상/NNG,0,0.005717526529138706,349,166,183,100,0.6705772183743438,0.6627310952230434
중기적/NNG@$물가/NNG@$기조/NNG@$유지/NNG@$금융/NNG,0,0.004512083320020288,61,29,32,21,0.46934391151514204,0.46497181058165443
채권/NNG@$시장/NNG@$외국인/NNG,0,0.004512083320020288,61,29,32,18,0.46934391151514204,0.46497181058165443
조치/NNG@$금리/NNG@$인상/NNG,0,0.004512083320020288,61,29,32,26,0.46934391151514204,0.46497181058165443
수요/NNG@$물가/NNG@$상승/NNG@$압력/NNG@$크/VA,0,0.004512083320020288,61,29,32,19,0.46934391151514204,0.46497181058165443
금리/NNG@$올릴/VV@$가능성/NNG,0,0.003369854165751418,181,86,95,75,0.6601170157996537,0.6554632332985658
속도/NNG@$금리/NNG@$인상/NNG,0,0.0028307327009988725,160,76,84,44,0.6506560214896522,0.6467658199863784
불안/NNG@$요인/NNG@$가능성/NNG,0,0.002111117802548579,21,10,11,11,0.29977367306406766,0.2984104599252061
금리/NNG@$인상/NNG@$가능성/NNG@$반영/NNG,0,0.0020625287298248196,139,66,73,64,0.6344648316510392,0.6316409873928773
비교/NNG@$보/VV@$장기금리/NNG@$국고채/NNG,0,0.001963538077385918,99,47,52,79,0.5755214429789708,0.5730733684675309
금리/NNG@$비교/NNG@$보/VV@$장기금리/NNG@$국고채/NNG,0,0.001963538077385918,99,47,52,79,0.5755214429789708,0.5730733684675309
기준금리/NNG@$유지/NNG@$통화정책/NNG@$경제/NNG,0,0.0009379522508161653,40,19,21,9,0.3844495776782161,0.38360014798743575
통화/NNG@$달러/NNG@$지수/NNG,0,0.0009379522508161653,40,19,21,28,0.3844495776782161,0.38360014798743575
유지/NNG@$통화정책/NNG@$경제/NNG,0,0.0009379522508161653,40,19,21,9,0.3844495776782161,0.38360014798743575
예상/NNG@$좋/VA@$않/VX,0,0.0009379522508161653,40,19,21,19,0.3844495776782161,0.38360014798743575
성장률/NNG@$전망/NNG@$낮췄/VV,0,0.0009379522508161653,40,19,21,18,0.3844495776782161,0.38360014798743575
영향/NNG@$않/VX@$전망/NNG,0,0.0009379522508161653,40,19,21,18,0.3844495776782161,0.38360014798743575
기준금리/NNG@$상향/NNG@$조정/NNG@$가능성/NNG,0,0.0009379522508161653,40,19,21,15,0.3844495776782161,0.38360014798743575
경로/NNG@$하방/NNG@$리스크/NNG,0,0.0009379522508161653,40,19,21,13,0.3844495776782161,0.38360014798743575
단행/NNG@$금리/NNG@$인하/NNG,0,0.0008979757178768644,118,56,62,20,0.6085651222482101,0.6072690587813255
금리/NNG@$인상/NNG@$아니/VCN,0,0.0008979757178768644,118,56,62,30,0.6085651222482101,0.6072690587813255
금융/NNG@$위기/NNG@$충격/NNG,0,0.0003747154999043101,59,28,31,19,0.46015142899476424,0.459652143543593
인하/NNG@$가능성/NNG@$제기/NNG,0,0.0003747154999043101,59,28,31,28,0.46015142899476424,0.459652143543593
금리/NNG@$인하/NNG@$속도/NNG,0,0.0003747154999043101,59,28,31,7,0.46015142899476424,0.459652143543593
증권/NNG@$금리/NNG@$인상/NNG,0,-2.2738087353091352e-05,137,65,72,44,0.6312024635687548,0.6310188952451713
금융/NNG@$위기/NNG@$경기침체/NNG,0,-0.0037935462110921803,76,36,40,19,0.5144117844903151,0.5181545504323359
금리/NNG@$인상/NNG@$충격/NNG,0,-0.004378355142616419,133,63,70,31,0.624310143891564,0.6295883413356901
하향/NNG@$조정/NNG@$예상/NNG,0,-0.004590038377532024,38,18,20,24,0.37370571410882664,0.3770247506947696
경기/NNG@$회복/NNG@$모멘텀/NNG,0,-0.006614830705770625,150,71,79,62,0.6380659863010212,0.646344677971175
금리/NNG@$인상/NNG@$않/VX,0,-0.007239635010791834,300,142,158,106,0.6619093626572342,0.6713356901603297
금리/NNG@$인상/NNG@$의미/NNG,0,-0.008474914442123671,55,26,29,15,0.4412096112718481,0.44859972621124594
인상/NNG@$경기/NNG@$둔화/NNG,0,-0.00946854999316804,110,52,58,58,0.5895665828868147,0.6006339512266823
부진/NNG@$모습/NNG@$보이/VV,0,-0.010180040497955845,91,43,48,45,0.5507742127616275,0.5619123271673979
고용/NNG@$비용/NNG@$지수/NNG,0,-0.010468987559152154,36,17,19,20,0.3628176295488517,0.37036872073302557
동결/NNG@$결정/NNG@$내렸/VV,0,-0.010468987559152154,36,17,19,14,0.3628176295488517,0.37036872073302557
기준금리/NNG@$인상/NNG@$인하/NNG,0,-0.010468987559152154,36,17,19,14,0.3628176295488517,0.37036872073302557
부채/NNG@$상환/NNG@$부담/NNG,0,-0.010468987559152154,36,17,19,18,0.3628176295488517,0.37036872073302557
물가/NNG@$상승/NNG@$경제/NNG,0,-0.010468987559152154,36,17,19,14,0.3628176295488517,0.37036872073302557
국채/NNG@$금리/NNG@$낮/VA,0,-0.010468987559152154,36,17,19,12,0.3628176295488517,0.37036872073302557
가능성/NNG@$높/VA@$않/VX,0,-0.011012899593145442,201,95,106,92,0.6552490186294748,0.6696142789342467
기미/NNG@$보이/VV@$않/VX,0,-0.011012899593145442,201,95,106,73,0.6552490186294748,0.6696142789342467
기준금리/NNG@$추이/NNG@$열/VV,-1,-0.011310976259689909,72,34,38,12,0.4983771246708913,0.5096069233320105
효과/NNG@$크/VA@$않/VX,0,-0.012565132420985448,199,94,105,81,0.6538688016827423,0.6702813628416318
최악/NNG@$금융/NNG@$위기/NNG,0,-0.013214646724346135,53,25,28,11,0.43146493457553403,0.4428699247895795
둔화/NNG@$모습/NNG@$보이/VV,0,-0.013214646724346135,53,25,28,6,0.43146493457553403,0.4428699247895795
자금/NNG@$유입/NNG@$지속/NNG,0,-0.013214646724346135,53,25,28,9,0.43146493457553403,0.4428699247895795
경제/NNG@$성장/NNG@$촉진/NNG,0,-0.015168695644302788,106,50,56,45,0.579096445114383,0.5967313941303094
경제/NNG@$성장/NNG@$주도/NNG,0,-0.01674585479422397,34,16,18,14,0.35178372709128236,0.3636417516233586
금융/NNG@$시스템/NNG@$불안/NNG,0,-0.01674585479422397,34,16,18,14,0.35178372709128236,0.3636417516233586
시장/NNG@$금리/NNG@$인상/NNG@$예상/NNG,0,-0.01674585479422397,34,16,18,14,0.35178372709128236,0.3636417516233586
경제/NNG@$성장/NNG@$둔화/NNG@$인플레이션/NNG,0,-0.01674585479422397,34,16,18,17,0.35178372709128236,0.3636417516233586
상승률/NNG@$높/VA@$예상/NNG,0,-0.01674585479422397,34,16,18,9,0.35178372709128236,0.3636417516233586
둔화/NNG@$조짐/NNG@$보이/VV,0,-0.016917033589661457,87,41,46,32,0.5372813355103573,0.5555823605719594
금리/NNG@$동결/NNG@$경제/NNG,0,-0.01818589219545441,51,24,27,21,0.42154077781953814,0.43700715335659895
경기/NNG@$회복/NNG@$기조/NNG,0,-0.018700716918851112,174,82,92,51,0.6430612378940153,0.6673421075369691
경기/NNG@$불확실성/NNG@$높/VA,-1,-0.019445277302373,68,32,36,19,0.4815543871503856,0.5004819004548461
유지/NNG@$가능성/NNG@$크/VA,-1,-0.019445277302373,68,32,36,20,0.4815543871503856,0.5004819004548461
금리/NNG@$인상/NNG@$금융시장/NNG,0,-0.019770594051096824,138,65,73,52,0.6195350935338377,0.6443050995408199
경기/NNG@$하방/NNG@$리스크/NNG,0,-0.019907836825241887,242,114,128,87,0.6527066723722574,0.6789893182516322
인하/NNG@$경기/NNG@$부양책/NNG,0,-0.02046899623687748,85,40,45,18,0.5302481552280933,0.5522193033683658
금리/NNG@$인하/NNG@$기대/NNG,0,-0.02094099639914826,584,275,309,243,0.6526798081617612,0.6803661069718542
가능성/NNG@$크/VA@$않/VX@$전망/NNG,0,-0.02340793109373951,49,23,26,29,0.411439128228951,0.4310141264435116
통화정책/NNG@$열/VV@$기준금리/NNG@$동결/NNG,0,-0.02340793109373951,49,23,26,24,0.411439128228951,0.4310141264435116
이례적/NNG@$낮/VA@$금리/NNG,0,-0.02340793109373951,49,23,26,14,0.411439128228951,0.4310141264435116
이전/NNG@$금리/NNG@$인하/NNG,0,-0.02340793109373951,49,23,26,9,0.411439128228951,0.4310141264435116
인상/NNG@$없/VA@$전망/NNG,0,-0.02340793109373951,49,23,26,17,0.411439128228951,0.4310141264435116
가능성/NNG@$있/VA@$전망/NNG,0,-0.02340793109373951,49,23,26,18,0.411439128228951,0.4310141264435116
가격/NNG@$하락/NNG@$경제/NNG,0,-0.02340793109373951,49,23,26,15,0.411439128228951,0.4310141264435116
하방/NNG@$위험/NNG@$크/VA,0,-0.02340793109373951,49,23,26,9,0.411439128228951,0.4310141264435116
경기/NNG@$부양/NNG@$재정/NNG,0,-0.02347978702834541,32,15,17,20,0.3405988628231203,0.35685480030358707
물가/NNG@$오름세/NNG@$둔화/NNG,0,-0.02347978702834541,32,15,17,5,0.3405988628231203,0.35685480030358707
방향/NNG@$금리/NNG@$인상/NNG,0,-0.02347978702834541,32,15,17,16,0.3405988628231203,0.35685480030358707
물가/NNG@$고공/NNG@$행진/NNG,0,-0.024150698895504474,83,39,44,14,0.5230216230593043,0.5487202215079395
경기/NNG@$부양/NNG@$의지/NNG,0,-0.024542023343188557,168,79,89,55,0.6366778408374123,0.6684841212844503
유지/NNG@$가능성/NNG@$높/VA,0,-0.02796822242378394,81,38,43,21,0.5156003175168863,0.5450822107687515
가격/NNG@$상승/NNG@$소비/NNG,0,-0.028903237982523033,47,22,25,14,0.4011614865789514,0.4248941162639851
직접적/NNG@$영향/NNG@$않/VX,0,-0.028903237982523033,47,22,25,13,0.4011614865789514,0.4248941162639851
주택/NNG@$가격/NNG@$급락/NNG,0,-0.028903237982523033,47,22,25,11,0.4011614865789514,0.4248941162639851
금리/NNG@$인상/NNG@$전망/NNG,0,-0.02924143982501859,899,422,477,333,0.6470146844057157,0.6857559359554605
소비자/NNG@$물가/NNG@$상승률/NNG@$기록/NNG,0,-0.030476838506673487,113,53,60,45,0.5816384571548034,0.6179913070596222
경제/NNG@$보/VV@$회복세/NNG,0,-0.03074667387989294,30,14,16,12,0.3292527024091173,0.3500202360265588
가격/NNG@$소비자/NNG@$물가/NNG,0,-0.03074667387989294,30,14,16,23,0.3292527024091173,0.3500202360265588
수출/NNG@$감소세/NNG@$지속/NNG,0,-0.031151818504709494,96,45,51,43,0.5498996177567806,0.5850586431982532
가계/NNG@$이자/NNG@$부담/NNG,0,-0.031151818504709494,96,45,51,46,0.5498996177567806,0.5850586431982532
금리/NNG@$인상/NNG@$반대/NNG,0,-0.031646177502543615,145,68,77,73,0.6179105527717196,0.6580688495751931
물가/NNG@$기조/NNG@$유지/NNG@$금융/NNG@$유의/NNG,0,-0.03296421856759857,62,29,33,21,0.4548487460971564,0.48568930886804007
금리/NNG@$인상/NNG@$가계부채/NNG,0,-0.03296421856759857,62,29,33,30,0.4548487460971564,0.48568930886804007
금리/NNG@$인상/NNG@$우려/NNG,0,-0.03405010996870439,318,149,169,141,0.6437052688427884,0.6888468627271821
과거/NNG@$외환/NNG@$위기/NNG,0,-0.03469828669423858,45,21,24,11,0.3907085697380356,0.41865098634336184
인플레이션/NNG@$물가/NNG@$상승/NNG,0,-0.03469828669423858,45,21,24,21,0.3907085697380356,0.41865098634336184
가능성/NNG@$높/VA@$덧붙였/VV,0,-0.03469828669423858,45,21,24,11,0.3907085697380356,0.41865098634336184
통화정책/NNG@$가늠/NNG@$볼/VX,0,-0.03469828669423858,45,21,24,15,0.3907085697380356,0.41865098634336184
시장/NNG@$고용/NNG@$지표/NNG,0,-0.03469828669423858,45,21,24,16,0.3907085697380356,0.41865098634336184
부양책/NNG@$내놓/VV@$않/VX,0,-0.03469828669423858,45,21,24,13,0.3907085697380356,0.41865098634336184
소폭/NNG@$하향/NNG@$조정/NNG,0,-0.03786699273155936,60,28,32,27,0.44555700680475735,0.4804607119324115
시장/NNG@$유동성/NNG@$공급/NNG,0,-0.03786699273155936,60,28,32,9,0.44555700680475735,0.4804607119324115
경기/NNG@$둔화/NNG@$영향/NNG,0,-0.03786699273155936,60,28,32,18,0.44555700680475735,0.4804607119324115
동결/NNG@$소수/NNG@$의견/NNG,0,-0.03786699273155936,60,28,32,22,0.44555700680475735,0.4804607119324115
실물/NNG@$경기/NNG@$회복/NNG,0,-0.038325320175392696,92,43,49,23,0.5369561928485422,0.5795515353367919
하락/NNG@$경기/NNG@$둔화/NNG,0,-0.038325320175392696,92,43,49,20,0.5369561928485422,0.5795515353367919
산업/NNG@$생산/NNG@$지표/NNG,0,-0.038325320175392696,92,43,49,36,0.5369561928485422,0.5795515353367919
외국인/NNG@$채권/NNG@$자금/NNG,0,-0.038645946002111575,28,13,15,18,0.31772726877328045,0.34315201049465205
가격/NNG@$상승/NNG@$주택/NNG,0,-0.038645946002111575,28,13,15,15,0.31772726877328045,0.34315201049465205
가능성/NNG@$배제/NNG@$없/VA,0,-0.0394673543695131,941,440,501,398,0.6399783102638038,0.6923277450607356
콜/NNG@$인상/NNG@$가능성/NNG,0,-0.03998321478981948,107,50,57,17,0.5658524387756378,0.6127712315903397
금리/NNG@$인상/NNG@$멈출/VV,0,-0.0408246158096065,43,20,23,7,0.38007991293331755,0.41228922349352976
금리/NNG@$동결/NNG@$인하/NNG,0,-0.0408246158096065,43,20,23,19,0.38007991293331755,0.41228922349352976
유통/NNG@$구조/NNG@$개선/NNG,0,-0.0408246158096065,43,20,23,14,0.38007991293331755,0.41228922349352976
조정/NNG@$가능성/NNG@$크/VA,0,-0.0408246158096065,43,20,23,13,0.38007991293331755,0.41228922349352976
동향/NNG@$산업/NNG@$생산/NNG,0,-0.0408246158096065,43,20,23,14,0.38007991293331755,0.41228922349352976
경제/NNG@$전망/NNG@$성장/NNG,0,-0.0408246158096065,43,20,23,19,0.38007991293331755,0.41228922349352976
금리/NNG@$내린/VV@$마감/NNG,0,-0.0408246158096065,43,20,23,35,0.38007991293331755,0.41228922349352976
채권/NNG@$시장/NNG@$기준금리/NNG@$인상/NNG,0,-0.0408246158096065,43,20,23,12,0.38007991293331755,0.41228922349352976
물가/NNG@$하방/NNG@$압력/NNG,0,-0.0408246158096065,43,20,23,19,0.38007991293331755,0.41228922349352976
인상/NNG@$출구전략/NNG@$시행/NNG,0,-0.0408246158096065,43,20,23,6,0.38007991293331755,0.41228922349352976
통화정책/NNG@$변경/NNG@$가능성/NNG,0,-0.0408246158096065,43,20,23,9,0.38007991293331755,0.41228922349352976
대출/NNG@$금리/NNG@$예금금리/NNG,0,-0.0408246158096065,43,20,23,12,0.38007991293331755,0.41228922349352976
인하/NNG@$가능성/NNG@$시사/NNG,0,-0.042417917288442575,152,71,81,50,0.6158953850631227,0.6702241626232653
동결/NNG@$금리/NNG@$인하/NNG,0,-0.04271725237551893,167,78,89,73,0.6240033360625519,0.6794546332841727
경제/NNG@$금융/NNG@$위기/NNG,0,-0.042890120094499995,182,85,97,68,0.6294047930461819,0.685573460463276
경기/NNG@$회복/NNG@$진행/NNG,0,-0.04299090917634296,58,27,31,8,0.4360715187647434,0.4750828609810948
경기/NNG@$국면/NNG@$예고/NNG@$선행지수/NNG,0,-0.04299090917634296,58,27,31,19,0.4360715187647434,0.4750828609810948
국면/NNG@$예고/NNG@$선행지수/NNG,0,-0.04299090917634296,58,27,31,19,0.4360715187647434,0.4750828609810948
인상/NNG@$가능성/NNG@$금리/NNG,-1,-0.04473603304190299,73,34,39,23,0.483945098535083,0.5290858752513478
생활/NNG@$형편/NNG@$전망/NNG,0,-0.045003385775654325,165,77,88,58,0.6215290667323373,0.6798673105950481
개선/NNG@$모습/NNG@$보였/VV,0,-0.04731103909190948,26,12,14,13,0.30599317473723264,0.3362658448401379
채권/NNG@$기준금리/NNG@$동결/NNG,0,-0.047320258757756695,41,19,22,13,0.36927333386566896,0.4058139666171413
내수/NNG@$회복세/NNG@$약화/NNG,0,-0.047320258757756695,41,19,22,8,0.36927333386566896,0.4058139666171413
하향/NNG@$조정/NNG@$전망/NNG,0,-0.048352517071087786,56,26,30,20,0.42639282818185514,0.4695560359784305
콜금리/NNG@$인상/NNG@$전망/NNG,0,-0.048352517071087786,56,26,30,17,0.42639282818185514,0.4695560359784305
실질/NNG@$국내총생산/NNG@$성장률/NNG,0,-0.048352517071087786,56,26,30,25,0.42639282818185514,0.4695560359784305
자금/NNG@$유출/NNG@$가능성/NNG,-1,-0.04934284531315303,71,33,38,32,0.4755346596231868,0.524712963392966
채권/NNG@$시장/NNG@$우호적/NNG,0,-0.05004519778916927,86,40,46,24,0.5161276167032661,0.5703062939551758
기준금리/NNG@$올리/VV@$않/VX,0,-0.05004519778916927,86,40,46,31,0.5161276167032661,0.5703062939551758
기준금리/NNG@$인하/NNG@$기대/NNG,0,-0.051581146215685325,174,81,93,101,0.6208262704010218,0.6881109336647597
경기/NNG@$하방/NNG@$위험/NNG,0,-0.052368012566405775,245,114,131,70,0.6304527150715235,0.6998840163813773
금리/NNG@$인하/NNG@$경제/NNG,0,-0.05384410367826764,114,53,61,48,0.568615850074876,0.6331083089184457
지금/NNG@$금리/NNG@$인상/NNG,0,-0.053970795169617,54,25,29,18,0.4165211784484939,0.46388089093188917
고용/NNG@$시장/NNG@$회복/NNG,0,-0.053970795169617,54,25,29,35,0.4165211784484939,0.46388089093188917
국내총생산/NNG@$성장률/NNG@$기록/NNG,0,-0.053970795169617,54,25,29,16,0.4165211784484939,0.46388089093188917
통화정책/NNG@$방향/NNG@$경제/NNG,-1,-0.05413456284066209,69,32,37,15,0.4669243877257562,0.5201859144938833
예금/NNG@$증서/NNG@$금리/NNG,0,-0.05413641033845695,99,46,53,8,0.5424182381914397,0.604293500463543
양도성/NNG@$예금/NNG@$증서/NNG@$금리/NNG,0,-0.05413641033845695,99,46,53,8,0.5424182381914397,0.604293500463543
물가/NNG@$상승/NNG@$압력/NNG@$크/VA@$않/VX,0,-0.05413641033845695,99,46,53,38,0.5424182381914397,0.604293500463543
하방/NNG@$위험/NNG@$남/VV,0,-0.05423169317958387,39,18,21,13,0.35828420316056225,0.39923102998361537
금리/NNG@$인상/NNG@$많/VA,0,-0.05423169317958387,39,18,21,14,0.35828420316056225,0.39923102998361537
수출/NNG@$호조/NNG@$소비/NNG,0,-0.05423169317958387,39,18,21,6,0.35828420316056225,0.39923102998361537
물가/NNG@$상승률/NNG@$기준치/NNG,0,-0.05423169317958387,39,18,21,21,0.35828420316056225,0.39923102998361537
원자재/NNG@$가격/NNG@$불안/NNG,0,-0.05423169317958387,39,18,21,6,0.35828420316056225,0.39923102998361537
경제/NNG@$불확실성/NNG@$커지/VV,0,-0.05423169317958387,39,18,21,13,0.35828420316056225,0.39923102998361537
경제/NNG@$성장/NNG@$위협/NNG,0,-0.05423169317958387,39,18,21,11,0.35828420316056225,0.39923102998361537
재정위기/NNG@$경기/NNG@$둔화/NNG,0,-0.05423169317958387,39,18,21,19,0.35828420316056225,0.39923102998361537
가격/NNG@$낮/VA@$진/VX,0,-0.05423169317958387,39,18,21,13,0.35828420316056225,0.39923102998361537
수요/NNG@$압력/NNG@$높/VA,0,-0.05423169317958387,39,18,21,5,0.35828420316056225,0.39923102998361537
산업/NNG@$생산/NNG@$증가율/NNG,0,-0.05646437474632959,127,59,68,60,0.5842023365979565,0.6538901352059724
속도/NNG@$빠르/VA@$않/VX,0,-0.05856833111068527,82,38,44,21,0.5012767706644025,0.5634459477191438
물가/NNG@$상승/NNG@$영향/NNG,-1,-0.05912243694064134,67,31,36,32,0.4581138447495233,0.5155027254567195
금리/NNG@$인상/NNG@$시기/NNG@$전망/NNG,0,-0.05986770061160995,52,24,28,24,0.40645631268543186,0.45805847488083323
금융시장/NNG@$불안/NNG@$모습/NNG,0,-0.05986770061160995,52,24,28,9,0.40645631268543186,0.45805847488083323
인하/NNG@$효과/NNG@$지켜볼/VV,0,-0.05986770061160995,52,24,28,15,0.40645631268543186,0.45805847488083323
경제/NNG@$성장/NNG@$고용/NNG,0,-0.05986770061160995,52,24,28,27,0.40645631268543186,0.45805847488083323
기조/NNG@$유지/NNG@$기준금리/NNG,0,-0.05986770061160995,52,24,28,8,0.40645631268543186,0.45805847488083323
기준금리/NNG@$인상/NNG@$단행/NNG,0,-0.06113005234381064,166,77,89,89,0.6110101455504707,0.6903284145146472
대출/NNG@$주택/NNG@$담보대출/NNG@$크/VA,0,-0.06161654416952722,37,17,20,8,0.3471044381608401,0.39254691725879454
유로존/NNG@$산업/NNG@$생산/NNG,0,-0.06161654416952722,37,17,20,14,0.3471044381608401,0.39254691725879454
하향/NNG@$조정/NNG@$불가피/XR,0,-0.06161654416952722,37,17,20,22,0.3471044381608401,0.39254691725879454
견조/NNG@$성장세/NNG@$지속/NNG,0,-0.06161654416952722,37,17,20,25,0.3471044381608401,0.39254691725879454
시중/NNG@$자금/NNG@$단기화/NNG,0,-0.06161654416952722,37,17,20,11,0.3471044381608401,0.39254691725879454
수출/NNG@$민간/NNG@$소비/NNG,0,-0.06161654416952722,37,17,20,6,0.3471044381608401,0.39254691725879454
인상/NNG@$물가/NNG@$상승률/NNG,0,-0.06161654416952722,37,17,20,18,0.3471044381608401,0.39254691725879454
민간/NNG@$소비/NNG@$개선/NNG,0,-0.06161654416952722,37,17,20,13,0.3471044381608401,0.39254691725879454
금리/NNG@$인상/NNG@$인플레이션/NNG,0,-0.061925144129195364,95,44,51,25,0.5296285693257581,0.5993380201975834
잠정/NNG@$주택/NNG@$판매/NNG,0,-0.061925144129195364,95,44,51,35,0.5296285693257581,0.5993380201975834
기준금리/NNG@$동결/NNG@$결정/NNG,0,-0.06243220346653433,274,127,147,101,0.6238382501073504,0.7066664511202438
주택/NNG@$가격/NNG@$급등/NNG,-1,-0.06431901773255178,65,30,35,25,0.44910260113796147,0.510661595192713
금리/NNG@$인상/NNG@$통화/NNG,-1,-0.06431901773255178,65,30,35,23,0.44910260113796147,0.510661595192713
악화/NNG@$금리/NNG@$인하/NNG,-1,-0.06431901773255178,65,30,35,13,0.44910260113796147,0.510661595192713
소비/NNG@$지출/NNG@$전망/NNG,0,-0.06440193111566028,136,63,73,79,0.5884490171475992,0.6692197847350277
인하/NNG@$단행/NNG@$가능성/NNG,0,-0.06441839601319,108,50,58,49,0.552492007920941,0.6283480739580264
투자/NNG@$심리/NNG@$회복/NNG,0,-0.06601522882304212,93,43,50,28,0.5229566307444654,0.5966678039354326
경기/NNG@$회복/NNG@$지속/NNG,0,-0.06601522882304212,93,43,50,36,0.5229566307444654,0.5966678039354326
경제/NNG@$전망/NNG@$영향/NNG,0,-0.0660688760805751,50,23,27,21,0.3961972150733673,0.45209024999389646
은행/NNG@$자본/NNG@$확충/NNG,0,-0.0660688760805751,50,23,27,10,0.3961972150733673,0.45209024999389646
기준금리/NNG@$동결/NNG@$전망/NNG,0,-0.06644902019450694,309,143,166,145,0.6211129960318804,0.7092770676423353
전망/NNG@$하향/NNG@$조정/NNG,0,-0.06682453664753008,523,242,281,223,0.6208625789306081,0.7095260518440952
기준금리/NNG@$동결/NNG@$배경/NNG,0,-0.06749542440438838,134,62,72,25,0.5844710121969389,0.6688382294325101
하락/NNG@$금리/NNG@$인상/NNG,-1,-0.06772575483260357,78,36,42,35,0.4856382431750447,0.5559963401827206
경기/NNG@$부양/NNG@$노력/NNG,-1,-0.06772575483260357,78,36,42,24,0.4856382431750447,0.5559963401827206
인하/NNG@$가능성/NNG@$있/VA,-1,-0.06772575483260357,78,36,42,30,0.4856382431750447,0.5559963401827206
금리/NNG@$인하/NNG@$기대감/NNG,0,-0.06781235648671824,307,142,165,115,0.6201481617073175,0.710117258148966
주시/NNG@$필요/NNG@$있/VA,0,-0.06816342176306867,106,49,57,47,0.5467826048333324,0.6265497822084262
주택담보대출비율/NNG@$부채/NNG@$상환/NNG,0,-0.0695474056406975,35,16,19,31,0.33572109334223654,0.38576882034506405
기조/NNG@$유지/NNG@$가능성/NNG,0,-0.0695474056406975,35,16,19,13,0.33572109334223654,0.38576882034506405
시장/NNG@$금리/NNG@$인상/NNG@$전망/NNG,0,-0.0695474056406975,35,16,19,16,0.33572109334223654,0.38576882034506405
변화/NNG@$없/VA@$전망/NNG,0,-0.0695474056406975,35,16,19,23,0.33572109334223654,0.38576882034506405
기업들/NNG@$체감/NNG@$경기/NNG,0,-0.0695474056406975,35,16,19,18,0.33572109334223654,0.38576882034506405
인상/NNG@$금융/NNG@$위기/NNG,0,-0.0695474056406975,35,16,19,16,0.33572109334223654,0.38576882034506405
우려/NNG@$커지/VV@$금리/NNG,0,-0.0695474056406975,35,16,19,22,0.33572109334223654,0.38576882034506405
구조/NNG@$개혁/NNG@$노력/NNG,0,-0.0695474056406975,35,16,19,20,0.33572109334223654,0.38576882034506405
유로존/NNG@$소비자/NNG@$물가/NNG,-1,-0.06973839591802145,63,29,34,31,0.4398901621186419,0.5056609439140112
충격/NNG@$크/VA@$않/VX,0,-0.07202575577165315,104,48,56,37,0.540900942974661,0.6246393100121256
경기/NNG@$둔화/NNG@$물가/NNG,0,-0.07202575577165315,104,48,56,31,0.540900942974661,0.6246393100121256
주택/NNG@$담보대출/NNG@$규제/NNG,0,-0.07260457085986127,48,22,26,26,0.3857417711981459,0.4459781053589281
소수/NNG@$의견/NNG@$냈/VV,0,-0.07260457085986127,48,22,26,11,0.3857417711981459,0.4459781053589281
전망/NNG@$경기/NNG@$회복/NNG,0,-0.07260457085986127,48,22,26,12,0.3857417711981459,0.4459781053589281
금리/NNG@$인하/NNG@$않/VX,0,-0.07321555362516485,117,54,63,39,0.5606746934354838,0.6490247292518893
경제/NNG@$성장률/NNG@$전망치/NNG,-1,-0.07539650263898134,61,28,33,22,0.43047587105748636,0.5004994319642916
시장/NNG@$금리/NNG@$인하/NNG@$가능성/NNG,-1,-0.07539650263898134,61,28,33,26,0.43047587105748636,0.5004994319642916
정책/NNG@$목표/NNG@$달성/NNG,-1,-0.07539650263898134,61,28,33,23,0.43047587105748636,0.5004994319642916
지표/NNG@$금리/NNG@$인상/NNG,0,-0.07601007856864805,102,47,55,50,0.5348441943750684,0.6226126940307253
경기/NNG@$부양책/NNG@$효과/NNG,0,-0.07601007856864805,102,47,55,36,0.5348441943750684,0.6226126940307253
성장세/NNG@$회복/NNG@$이어지/VV@$중기적/NNG@$물가/NNG,-1,-0.07758608854479954,74,34,40,24,0.46920066635742497,0.5479312307382481
장기/NNG@$대출/NNG@$프로그램/NNG,-1,-0.07758608854479954,74,34,40,41,0.46920066635742497,0.5479312307382481
금리/NNG@$올리/VV@$시작/NNG,-1,-0.07758608854479954,74,34,40,34,0.46920066635742497,0.5479312307382481
경기/NNG@$회복세/NNG@$미약/XR,-1,-0.07758608854479954,74,34,40,46,0.46920066635742497,0.5479312307382481
위축/NNG@$우려/NNG@$있/VA,0,-0.07811735989903179,33,15,18,12,0.32411434942594397,0.37890459340591803
원유/NNG@$가격/NNG@$하락/NNG,0,-0.07811735989903179,33,15,18,20,0.32411434942594397,0.37890459340591803
안정적/NNG@$경제/NNG@$성장/NNG,0,-0.07811735989903179,33,15,18,17,0.32411434942594397,0.37890459340591803
대책/NNG@$금리/NNG@$인상/NNG,0,-0.07951085463554852,46,21,25,8,0.3750863199321995,0.4397243645400348
노력/NNG@$필요/NNG@$있/VA,0,-0.07951085463554852,46,21,25,23,0.3750863199321995,0.4397243645400348
국고채/NNG@$금리/NNG@$기준금리/NNG,0,-0.07951085463554852,46,21,25,10,0.3750863199321995,0.4397243645400348
금리/NNG@$인상/NNG@$신중/NNG,0,-0.07978762053427613,165,76,89,59,0.5977028341875856,0.7010944058947342
기준금리/NNG@$인상/NNG@$전망/NNG,0,-0.08007370425408145,391,180,211,136,0.6114633877297724,0.7176483341862354
양적완화/NNG@$축소/NNG@$가능성/NNG,0,-0.08012135582505042,100,46,54,32,0.5286095966599105,0.6204658949501517
영향/NNG@$필요/NNG@$있/VA,0,-0.08018360364415056,20,9,11,7,0.2689176922465895,0.3156869675805029
인상/NNG@$경기/NNG@$회복/NNG,0,-0.08025133108737781,152,70,82,33,0.5903294363283293,0.6930920439701788
전망치/NNG@$하향/NNG@$조정/NNG,0,-0.0803019650345822,630,290,340,248,0.6113007366866886,0.7177871010599016
은행/NNG@$채권/NNG@$딜러/NNG,0,-0.08059894585849559,139,64,75,59,0.5803665331196158,0.6818717113919444
변동성/NNG@$확대/NNG@$가능성/NNG,0,-0.08075303825696867,126,58,68,58,0.5672060305502956,0.666616170846725
금리/NNG@$인하/NNG@$압박/NNG,0,-0.08185674881303284,176,81,95,97,0.6005736535385154,0.7074017594787495
인상/NNG@$시기/NNG@$전망/NNG,-1,-0.08280504555912771,72,33,39,40,0.460678995454629,0.5436600281438483
증권사/NNG@$채권/NNG@$딜러/NNG,0,-0.08296433767756972,274,126,148,117,0.6092835079770855,0.7192629717642954
금리/NNG@$인상/NNG@$할/VX,-1,-0.08382167079981118,85,39,46,18,0.49436781900666416,0.584612645197315
금리/NNG@$인하/NNG@$경기/NNG@$부양/NNG,0,-0.08430367905384006,124,57,67,48,0.5625357258678338,0.6658703578422523
소비/NNG@$심리/NNG@$개선/NNG,0,-0.08635809304514386,148,68,80,63,0.5834897950289949,0.6935375826196674
전망/NNG@$힘/NNG@$실리/VV,0,-0.08683123774441992,44,20,24,16,0.3642250581044783,0.4333317842517209
소비자물가지수/NNG@$상승률/NNG@$기록/NNG,0,-0.08683123774441992,44,20,24,12,0.3642250581044783,0.4333317842517209
상승/NNG@$압력/NNG@$가능성/NNG,0,-0.08683123774441992,44,20,24,9,0.3642250581044783,0.4333317842517209
인상/NNG@$시기/NNG@$지연/NNG,0,-0.08683123774441992,44,20,24,23,0.3642250581044783,0.4333317842517209
종사자/NNG@$기준금리/NNG@$동결/NNG,0,-0.08683123774441992,44,20,24,22,0.3642250581044783,0.4333317842517209
투자/NNG@$증권/NNG@$금리/NNG@$인상/NNG,0,-0.08683123774441992,44,20,24,16,0.3642250581044783,0.4333317842517209
완화/NNG@$필요/NNG@$있/VA,0,-0.08683123774441992,44,20,24,8,0.3642250581044783,0.4333317842517209
전망/NNG@$채권/NNG@$시장/NNG,0,-0.08683123774441992,44,20,24,16,0.3642250581044783,0.4333317842517209
대외/NNG@$의존도/NNG@$높/VA@$경제/NNG,0,-0.08683123774441992,44,20,24,20,0.3642250581044783,0.4333317842517209
인하/NNG@$나설/VV@$전망/NNG,0,-0.08683123774441992,44,20,24,18,0.3642250581044783,0.4333317842517209
기준금리/NNG@$무담보/NNG@$콜론/NNG,-1,-0.08823214682985725,70,32,38,40,0.45195370771778387,0.5392257642879822
고용/NNG@$지표/NNG@$예상/NNG,0,-0.09259877881607514,107,49,58,32,0.5332178610090872,0.6418073039420578
대응/NNG@$필요/NNG@$있/VA,0,-0.09259877881607514,107,49,58,46,0.5332178610090872,0.6418073039420578
저금리/NNG@$기조/NNG@$유지/NNG,0,-0.0928717056192303,334,153,181,88,0.6023015476361775,0.7253590163978341
가격/NNG@$반대/NNG@$움직이/VV@$수익률/NNG,0,-0.09327152310507014,94,43,51,23,0.5088121175555986,0.6132629377803169
반대/NNG@$움직이/VV@$수익률/NNG,0,-0.09327152310507014,94,43,51,23,0.5088121175555986,0.6132629377803169
금리/NNG@$인상/NNG@$나설/VV@$전망/NNG,-1,-0.09388080231163443,68,31,37,11,0.44302345957653133,0.5346256296944267
콜금리/NNG@$인상/NNG@$경기/NNG,-1,-0.09388080231163443,68,31,37,13,0.44302345957653133,0.5346256296944267
시장/NNG@$기준금리/NNG@$인하/NNG,0,-0.0939956200242491,179,82,97,90,0.5929957504217103,0.715772861389317
경제/NNG@$성장률/NNG@$기록/NNG,0,-0.09399868949574985,55,25,30,22,0.4010099831301599,0.4840402992483251
하향/NNG@$조정/NNG@$경기/NNG,0,-0.09399868949574985,55,25,30,24,0.4010099831301599,0.4840402992483251
실업/NNG@$수당/NNG@$청구/NNG@$감소/NNG,0,-0.09399868949574985,55,25,30,35,0.4010099831301599,0.4840402992483251
수당/NNG@$청구/NNG@$감소/NNG,0,-0.09399868949574985,55,25,30,35,0.4010099831301599,0.4840402992483251
인도/NNG@$금리/NNG@$인상/NNG,0,-0.09399868949574985,55,25,30,6,0.4010099831301599,0.4840402992483251
부동산/NNG@$중개인/NNG@$주택/NNG,0,-0.09461886461194657,42,19,23,24,0.35314924246185836,0.4268035404549407
수출/NNG@$내수/NNG@$부진/NNG,0,-0.09461886461194657,42,19,23,15,0.35314924246185836,0.4268035404549407
경상수지/NNG@$흑자/NNG@$기록/NNG,0,-0.09461886461194657,42,19,23,14,0.35314924246185836,0.4268035404549407
소비/NNG@$투자/NNG@$수출/NNG,0,-0.09461886461194657,42,19,23,24,0.35314924246185836,0.4268035404549407
외국/NNG@$자본/NNG@$유출/NNG,0,-0.09461886461194657,42,19,23,9,0.35314924246185836,0.4268035404549407
제조업/NNG@$서비스업/NNG@$생산/NNG,0,-0.09482277775750214,18,8,10,2,0.255509185056841,0.3089263364044086
경제/NNG@$동향/NNG@$그린북/NNG,0,-0.09497200325135491,190,87,103,74,0.5951030400477333,0.7197328950111415
유동성/NNG@$증가세/NNG@$둔화/NNG,0,-0.09770258162205514,29,13,16,12,0.30009800499263317,0.3649520108990499
기준금리/NNG@$인상/NNG@$나설/VV,0,-0.09794715067356075,92,42,50,31,0.5018398803843958,0.6105936187142914
경제/NNG@$경기/NNG@$둔화/NNG,-1,-0.09890002209444293,79,36,43,40,0.47087191123670386,0.5740179175283369
공급/NNG@$관리/NNG@$제조업/NNG@$지수/NNG,-1,-0.09890002209444293,79,36,43,30,0.47087191123670386,0.5740179175283369
우려/NNG@$기준금리/NNG@$인상/NNG,-1,-0.09890002209444293,79,36,43,36,0.47087191123670386,0.5740179175283369
물가/NNG@$목표/NNG@$달성/NNG,0,-0.09941778188166639,221,101,120,104,0.5959864976318806,0.7272993103754328
인하/NNG@$가능성/NNG@$반영/NNG,0,-0.0995539011497607,116,53,63,62,0.5423441888544679,0.6620200376755048
공개/NNG@$금리/NNG@$인상/NNG,-1,-0.09976607921478364,66,30,36,36,0.43388676010925864,0.5298569639390155
개선/NNG@$추세/NNG@$지속/NNG,-1,-0.09976607921478364,66,30,36,37,0.43388676010925864,0.5298569639390155
경기/NNG@$금리/NNG@$인상/NNG,-1,-0.09976607921478364,66,30,36,19,0.43388676010925864,0.5298569639390155
소비자들/NNG@$경제/NNG@$심리/NNG@$나타내/VV@$소비자심리지수/NNG,0,-0.10082320501268449,53,24,29,20,0.390773228667124,0.47822733274974266
통화정책/NNG@$경기/NNG@$부양/NNG,0,-0.10082320501268449,53,24,29,25,0.390773228667124,0.47822733274974266
경기/NNG@$둔화/NNG@$막/VV,0,-0.10082320501268449,53,24,29,11,0.390773228667124,0.47822733274974266
경기/NNG@$부진/NNG@$지속/NNG,0,-0.10293952944688445,40,18,22,25,0.34184610812986765,0.4201431966507845
상승/NNG@$금리/NNG@$인하/NNG,0,-0.10293952944688445,40,18,22,19,0.34184610812986765,0.4201431966507845
기조/NNG@$금리/NNG@$인상/NNG,0,-0.10293952944688445,40,18,22,20,0.34184610812986765,0.4201431966507845
물가/NNG@$상승률/NNG@$하락/NNG,0,-0.10364761394663657,114,52,62,42,0.5369032777008539,0.6608216854507093
회복/NNG@$금리/NNG@$인상/NNG,0,-0.10364761394663657,114,52,62,41,0.5369032777008539,0.6608216854507093
금리/NNG@$동결/NNG@$경기/NNG,-1,-0.10430159012712625,77,35,42,17,0.46263837044674827,0.5701695278950146
만장일치/NNG@$금리/NNG@$동결/NNG,-1,-0.10430159012712625,77,35,42,28,0.46263837044674827,0.5701695278950146
고용/NNG@$시장/NNG@$호조/NNG,0,-0.10571164997722093,101,46,55,71,0.5147012810183199,0.6361444713633267
채권/NNG@$딜러/NNG@$금리/NNG,-1,-0.10590502026201365,64,29,35,26,0.42454187101033547,0.5249172710167312
결정/NNG@$열/VV@$기준금리/NNG,0,-0.10801093968288789,51,23,28,14,0.3803229725714217,0.47225095338760686
인플레/NNG@$상승/NNG@$압력/NNG,0,-0.10801093968288789,51,23,28,18,0.3803229725714217,0.47225095338760686
물가/NNG@$상승률/NNG@$억제/NNG,0,-0.10801093968288789,51,23,28,8,0.3803229725714217,0.47225095338760686
물가/NNG@$상승률/NNG@$유지/NNG,0,-0.10801093968288789,51,23,28,16,0.3803229725714217,0.47225095338760686
경제/NNG@$구조/NNG@$개혁/NNG,0,-0.10910405766758746,27,12,15,18,0.28757995774246514,0.3578816963469187
소비자/NNG@$물가/NNG@$경기/NNG,0,-0.10910405766758746,27,12,15,13,0.28757995774246514,0.3578816963469187
물가/NNG@$안정세/NNG@$지속/NNG,0,-0.10910405766758746,27,12,15,6,0.28757995774246514,0.3578816963469187
고용/NNG@$시장/NNG@$개선/NNG,0,-0.10930639522440333,290,132,158,115,0.5903904201478216,0.7350180508321815
통화/NNG@$가치/NNG@$상승/NNG,-1,-0.10990894941815499,75,34,41,34,0.45420092936818474,0.5661562992145951
통화정책/NNG@$금리/NNG@$인상/NNG,0,-0.11101313265723056,145,66,79,78,0.5644591499323012,0.7051663211723389
금리/NNG@$인하/NNG@$필요성/NNG,0,-0.11116618547946033,211,96,115,97,0.5866752102277641,0.7331474941407343
경제/NNG@$성장세/NNG@$둔화/NNG,0,-0.11121448686972346,321,146,175,124,0.5890443309045228,0.7361800896609548
증권/NNG@$기준금리/NNG@$인하/NNG,0,-0.11187589371314854,38,17,21,16,0.3302973839281561,0.4133546468793726
국제금융시장/NNG@$불안/NNG@$완화/NNG,0,-0.11187589371314854,38,17,21,5,0.3302973839281561,0.4133546468793726
실물/NNG@$지표/NNG@$개선/NNG,0,-0.11187589371314854,38,17,21,10,0.3302973839281561,0.4133546468793726
자산/NNG@$매입/NNG@$규모/NNG@$확대/NNG,0,-0.11187589371314854,38,17,21,18,0.3302973839281561,0.4133546468793726
저금리/NNG@$정책/NNG@$유지/NNG,0,-0.11187589371314854,38,17,21,13,0.3302973839281561,0.4133546468793726
경제/NNG@$불안/NNG@$요인/NNG,0,-0.11220226765226404,110,50,60,36,0.5255285664823394,0.6581138720367053
금리/NNG@$인상/NNG@$동결/NNG,-1,-0.11231703929742787,62,28,34,31,0.41498667844471254,0.519804233736889
자본/NNG@$유출/NNG@$우려/NNG,0,-0.1134363485511044,220,100,120,112,0.5858011385717944,0.7354284428720903
인플레이션/NNG@$경제/NNG@$성장/NNG,0,-0.11515827716626392,97,44,53,33,0.5014584576489564,0.6317427827993513
영향/NNG@$금리/NNG@$인상/NNG,0,-0.11515827716626392,97,44,53,45,0.5014584576489564,0.6317427827993513
확인/NNG@$금리/NNG@$인하/NNG,0,-0.11560145958700385,49,22,27,18,0.36965320358306225,0.4661115398799378
엔화/NNG@$약세/NNG@$수출/NNG,0,-0.11560145958700385,49,22,27,30,0.36965320358306225,0.4661115398799378
금리/NNG@$인상/NNG@$강하/VA,0,-0.11560145958700385,49,22,27,18,0.36965320358306225,0.4661115398799378
확인/NNG@$필요/NNG@$있/VA,-1,-0.11573471231329224,73,33,40,37,0.4455576524308441,0.561974453699885
경기/NNG@$부양/NNG@$필요성/NNG,-1,-0.11573471231329224,73,33,40,30,0.4455576524308441,0.561974453699885
금리/NNG@$인상/NNG@$대응/NNG,-1,-0.11573471231329224,73,33,40,28,0.4455576524308441,0.561974453699885
환율/NNG@$상승/NNG@$수출/NNG,-1,-0.11573471231329224,73,33,40,25,0.4455576524308441,0.561974453699885
시장/NNG@$금리/NNG@$급등/NNG,0,-0.1166727063981956,108,49,59,28,0.5195888185645859,0.6565959009742662
금리/NNG@$인상/NNG@$문제/NNG,-1,-0.11830117931793227,84,38,46,29,0.47202122946285596,0.5984582536293049
에너지/NNG@$원자재/NNG@$가격/NNG,-1,-0.11830117931793227,84,38,46,23,0.47202122946285596,0.5984582536293049
경제성장률/NNG@$물가/NNG@$상승률/NNG,-1,-0.11830117931793227,84,38,46,41,0.47202122946285596,0.5984582536293049
국내총생산/NNG@$성장률/NNG@$전망/NNG,-1,-0.11830117931793227,84,38,46,38,0.47202122946285596,0.5984582536293049
원자재/NNG@$가격/NNG@$급락/NNG,-1,-0.11902441658261309,60,27,33,33,0.40521852943135767,0.5145157265065584
기준금리/NNG@$동결/NNG@$물가/NNG,-1,-0.11902441658261309,60,27,33,10,0.40521852943135767,0.5145157265065584
경제/NNG@$성장/NNG@$견인/NNG,0,-0.12153349637396282,36,16,20,27,0.3184772241537169,0.40644202252013223
경기/NNG@$둔화/NNG@$신호/NNG,0,-0.12153349637396282,36,16,20,18,0.3184772241537169,0.40644202252013223
가계/NNG@$대출/NNG@$주택/NNG@$담보대출/NNG@$크/VA,0,-0.12153349637396282,36,16,20,8,0.3184772241537169,0.40644202252013223
회복/NNG@$조짐/NNG@$나타나/VV,0,-0.12153349637396282,36,16,20,12,0.3184772241537169,0.40644202252013223
금리/NNG@$인상/NNG@$미루/VV,0,-0.12153349637396282,36,16,20,16,0.3184772241537169,0.40644202252013223
방향/NNG@$기준금리/NNG@$유지/NNG@$통화정책/NNG@$경제/NNG,0,-0.12153349637396282,36,16,20,9,0.3184772241537169,0.40644202252013223
금리/NNG@$인상/NNG@$하지/NNG@$않/VX,-1,-0.12179296034482534,71,32,39,31,0.4367064813502728,0.5576202865691094
달러/NNG@$원/NNG@$환율하락/NNG,-1,-0.12179296034482534,71,32,39,35,0.4367064813502728,0.5576202865691094
이상/NNG@$금리/NNG@$인하/NNG,-1,-0.12179296034482534,71,32,39,25,0.4367064813502728,0.5576202865691094
금리/NNG@$인하/NNG@$가능성/NNG@$높/VA,0,-0.12191590561095011,117,53,64,41,0.5291416279759399,0.6758171857612699
고려/NNG@$금리/NNG@$인하/NNG,0,-0.12191590561095011,117,53,64,52,0.5291416279759399,0.6758171857612699
대출/NNG@$높/VA@$증가세/NNG,0,-0.12196822262368212,25,11,14,9,0.27460437550760386,0.3507606555270765
물가/NNG@$상승세/NNG@$지속/NNG,0,-0.12364239590681625,47,21,26,8,0.35875557061936,0.4598097575207617
위안화/NNG@$가치/NNG@$하락/NNG,0,-0.12364239590681625,47,21,26,35,0.35875557061936,0.4598097575207617
기준금리/NNG@$인상/NNG@$출구전략/NNG,0,-0.12364239590681625,47,21,26,22,0.35875557061936,0.4598097575207617
지수/NNG@$내린/VV@$종합/NNG,0,-0.12364239590681625,47,21,26,35,0.35875557061936,0.4598097575207617
경제/NNG@$성장/NNG@$전망/NNG,0,-0.1239249870674285,369,167,202,152,0.5797876284047344,0.7435286263659608
조치/NNG@$취하/VV@$않/VX,-1,-0.12522759420974527,93,42,51,31,0.48747170731182304,0.6267973851909688
물가/NNG@$불안/NNG@$요인/NNG,0,-0.12602575242280512,104,47,57,32,0.5071899329532678,0.6532096896078896
채권/NNG@$시장/NNG@$기준금리/NNG@$인하/NNG,-1,-0.1260529236466813,58,26,32,39,0.3952340232199838,0.5090498256845564
투자/NNG@$채권/NNG@$시장/NNG,-1,-0.1260529236466813,58,26,32,14,0.3952340232199838,0.5090498256845564
달러/NNG@$환율/NNG@$상승/NNG,-1,-0.1260529236466813,58,26,32,24,0.3952340232199838,0.5090498256845564
통상/NNG@$자원/NNG@$부/NNG,0,-0.1262596423884217,126,57,69,48,0.5370413607845294,0.6919841093480199
산업/NNG@$통상/NNG@$자원/NNG@$부/NNG,0,-0.1262596423884217,126,57,69,48,0.5370413607845294,0.6919841093480199
경제/NNG@$금리/NNG@$인상/NNG,0,-0.12710595174634876,323,146,177,124,0.5774544315699418,0.745337588856391
금리/NNG@$인하/NNG@$전망/NNG,0,-0.12877162801873576,290,131,159,109,0.5761951696530138,0.7462347260489807
고려/NNG@$금리/NNG@$인상/NNG,0,-0.1296433721907495,248,112,136,96,0.5751701600364437,0.7462288916614761
초저/NNG@$금리/NNG@$유지/NNG,0,-0.13016282994380335,268,121,147,89,0.5750666368958229,0.7468832543521285
최대/NNG@$채권/NNG@$펀드/NNG,-1,-0.13051398118245972,91,41,50,44,0.48019283084200415,0.6241089773367252
경기/NNG@$확장/NNG@$국면/NNG,0,-0.13088760123943377,113,51,62,46,0.5178646970461991,0.6735830533291594
금리/NNG@$인하/NNG@$예상/NNG,0,-0.13097804742156105,257,116,141,75,0.5743490722125884,0.7471893669410833
가격/NNG@$상승/NNG@$물가/NNG,0,-0.1316135795570499,155,70,85,42,0.5564750822534174,0.7248732188104019
기준금리/NNG@$인상/NNG@$금융시장/NNG,0,-0.13204949926871534,34,15,19,17,0.3063492797174957,0.39940954678661933
물가/NNG@$오름세/NNG@$지속/NNG,0,-0.13204949926871534,34,15,19,16,0.3063492797174957,0.39940954678661933
경제/NNG@$성장/NNG@$기여/NNG,0,-0.13204949926871534,34,15,19,16,0.3063492797174957,0.39940954678661933
수출/NNG@$부진/NNG@$경기/NNG,0,-0.13204949926871534,34,15,19,13,0.3063492797174957,0.39940954678661933
모습/NNG@$보일/VV@$예상/NNG,0,-0.13219174705249515,45,20,25,23,0.3476185939057356,0.45334653212102377
양적완화/NNG@$축소/NNG@$시작/NNG,0,-0.13219174705249515,45,20,25,25,0.3476185939057356,0.45334653212102377
금융/NNG@$위기/NNG@$금리/NNG@$인상/NNG,0,-0.13219174705249515,45,20,25,11,0.3476185939057356,0.45334653212102377
채권/NNG@$시장/NNG@$투자/NNG,0,-0.13219174705249515,45,20,25,15,0.3476185939057356,0.45334653212102377
내수/NNG@$부진/NNG@$심화/NNG,0,-0.13219174705249515,45,20,25,9,0.3476185939057356,0.45334653212102377
경기/NNG@$회복세/NNG@$유지/NNG,0,-0.13219174705249515,45,20,25,22,0.3476185939057356,0.45334653212102377
소비자/NNG@$물가/NNG@$상승률/NNG@$목표치/NNG,0,-0.13219174705249515,45,20,25,20,0.3476185939057356,0.45334653212102377
성장/NNG@$둔화/NNG@$금리/NNG,-1,-0.13343261802399264,56,25,31,16,0.38502874519532454,0.5034048164621499
금리/NNG@$인상/NNG@$시기상조/NNG,-1,-0.13343261802399264,56,25,31,13,0.38502874519532454,0.5034048164621499
금리/NNG@$인상/NNG@$채권/NNG,-1,-0.13343261802399264,56,25,31,17,0.38502874519532454,0.5034048164621499
대외/NNG@$불확실성/NNG@$높/VA,-1,-0.13343261802399264,56,25,31,21,0.38502874519532454,0.5034048164621499
인상/NNG@$채권/NNG@$시장/NNG,-1,-0.1346722381779063,67,30,37,21,0.41837112706769497,0.5483806142214493
경제/NNG@$위험/NNG@$요인/NNG,0,-0.13543340257471326,213,96,117,63,0.5692345415672253,0.7472826578838584
방안/NNG@$강구/NNG@$필요/NNG@$있/VA,0,-0.13553769489613077,14,6,8,5,0.22519162758385583,0.2956910355719674
통화정책/NNG@$방향/NNG@$경기/NNG,-1,-0.13596698149071595,100,45,55,16,0.49407947448383505,0.6493255904429412
수출/NNG@$증가세/NNG@$둔화/NNG,-1,-0.13597911155515985,89,40,49,42,0.47272019790557884,0.621270307207933
내수/NNG@$경기/NNG@$회복/NNG,0,-0.13729797010236988,162,73,89,55,0.5559622985664792,0.7326370146759968
통화정책/NNG@$방향/NNG@$의결/NNG,0,-0.1407241013888768,140,63,77,56,0.5402022426005235,0.7168590118343422
금리/NNG@$인하/NNG@$금융시장/NNG,0,-0.14119886291941497,54,24,30,15,0.37459692686502316,0.49757919493660757
인상/NNG@$가능성/NNG@$희박/XR,0,-0.14119886291941497,54,24,30,10,0.37459692686502316,0.49757919493660757
파산/NNG@$보호/NNG@$신청/NNG,0,-0.14119886291941497,54,24,30,6,0.37459692686502316,0.49757919493660757
강세/NNG@$금리/NNG@$인상/NNG,0,-0.14119886291941497,54,24,30,26,0.37459692686502316,0.49757919493660757
경제/NNG@$리스크/NNG@$요인/NNG,0,-0.14119886291941497,54,24,30,15,0.37459692686502316,0.49757919493660757
시장/NNG@$국고채/NNG@$금리/NNG,0,-0.14119886291941497,54,24,30,21,0.37459692686502316,0.49757919493660757
모습/NNG@$보이/VV@$않/VX,0,-0.14119886291941497,54,24,30,10,0.37459692686502316,0.49757919493660757
가격/NNG@$하락/NNG@$영향/NNG,0,-0.14132100412734383,43,19,24,21,0.3362266163545205,0.4467230058130697
물가/NNG@$상승/NNG@$금리/NNG@$인상/NNG,0,-0.14132100412734383,43,19,24,14,0.3362266163545205,0.4467230058130697
물가/NNG@$목표/NNG@$하단/NNG,0,-0.14132100412734383,43,19,24,11,0.3362266163545205,0.4467230058130697
위기/NNG@$금리/NNG@$인상/NNG,-1,-0.1415314863876579,65,29,36,17,0.4088814112959296,0.5434881845135398
부진/NNG@$경기/NNG@$회복/NNG,-1,-0.1415314863876579,65,29,36,22,0.4088814112959296,0.5434881845135398
채권/NNG@$시장/NNG@$기준금리/NNG@$동결/NNG,-1,-0.14173930501901544,76,34,42,22,0.43900436444627355,0.5837753325263583
금리/NNG@$인하/NNG@$시사/NNG,0,-0.14284332311761783,149,67,82,28,0.5450586714837772,0.7264382201935927
부진/NNG@$경제/NNG@$성장/NNG,0,-0.1436057096034956,32,14,18,20,0.2938624745820386,0.3922613127603546
가격/NNG@$상승/NNG@$가능성/NNG,0,-0.1436057096034956,32,14,18,7,0.2938624745820386,0.3922613127603546
부동산/NNG@$경기/NNG@$회복/NNG,0,-0.1436057096034956,32,14,18,14,0.2938624745820386,0.3922613127603546
유로지역/NNG@$경기/NNG@$부진/NNG,0,-0.1436057096034956,32,14,18,34,0.2938624745820386,0.3922613127603546
금리/NNG@$인하/NNG@$필요/NNG,0,-0.1437256939276701,178,80,98,83,0.5571839686787969,0.7439373225636055
부진/NNG@$금리/NNG@$인상/NNG,-1,-0.14748282226076992,85,38,47,60,0.45718344325848737,0.6151224093387485
인플레율/NNG@$억제/NNG@$목표치/NNG@$허용/NNG@$한도/NNG,-1,-0.14748282226076992,85,38,47,18,0.45718344325848737,0.6151224093387485
공개/NNG@$시장/NNG@$기준금리/NNG,-1,-0.14816822259250717,74,33,41,11,0.4302326606538624,0.5796727984132078
가격/NNG@$상승세/NNG@$둔화/NNG,0,-0.14939364774412278,52,23,29,11,0.363931010040676,0.49157166366894506
상승/NNG@$압력/NNG@$기준금리/NNG,0,-0.14939364774412278,52,23,29,12,0.363931010040676,0.49157166366894506
경제/NNG@$전망/NNG@$악화/NNG,0,-0.14939364774412278,52,23,29,18,0.363931010040676,0.49157166366894506
경제/NNG@$성장/NNG@$하방/NNG@$위험/NNG,0,-0.14939364774412278,52,23,29,14,0.363931010040676,0.49157166366894506
기업/NNG@$투자/NNG@$확대/NNG,0,-0.15111945701669693,41,18,23,20,0.32455839571173184,0.4399404682897666
환시/NNG@$달러화/NNG@$엔화/NNG@$달러당/NNG@$거래/NNG,0,-0.15111945701669693,41,18,23,9,0.32455839571173184,0.4399404682897666
채무/NNG@$상환/NNG@$부담/NNG,0,-0.15111945701669693,41,18,23,19,0.32455839571173184,0.4399404682897666
금리/NNG@$인상/NNG@$성장/NNG,0,-0.15111945701669693,41,18,23,32,0.32455839571173184,0.4399404682897666
성장/NNG@$전망/NNG@$하향/NNG@$조정/NNG,0,-0.15111945701669693,41,18,23,21,0.32455839571173184,0.4399404682897666
리스크/NNG@$금리/NNG@$인상/NNG,0,-0.15111945701669693,41,18,23,17,0.32455839571173184,0.4399404682897666
금융/NNG@$통화정책/NNG@$금리/NNG,0,-0.15111945701669693,41,18,23,15,0.32455839571173184,0.4399404682897666
실업률/NNG@$물가/NNG@$상승률/NNG,0,-0.15111945701669693,41,18,23,11,0.32455839571173184,0.4399404682897666
경제/NNG@$동향/NNG@$경기/NNG,0,-0.15133385471635996,125,56,69,30,0.5191242618403691,0.7039842271956758
경기/NNG@$회복/NNG@$기대감/NNG,0,-0.15291769078727357,333,149,184,106,0.5584456302490011,0.7597670658618051
경제/NNG@$성장/NNG@$예상/NNG,-1,-0.1535422497646507,83,37,46,37,0.4491141579708215,0.6118031538062054
경제/NNG@$성장세/NNG@$예상/NNG,0,-0.1541719348773788,21,9,12,28,0.24662415753483388,0.33639586378596026
경제/NNG@$긍정적/NNG@$영향/NNG,-1,-0.15485505398978883,72,32,40,22,0.42124863226459,0.5753886033016387
전망/NNG@$금리/NNG@$인상/NNG,0,-0.1558060803919079,264,118,146,121,0.5561268128451727,0.7611019971877727
달러/NNG@$엔/NNG@$환율/NNG,-1,-0.1562063570150547,61,27,34,32,0.3892399344718592,0.5331417369580473
규모/NNG@$개방/NNG@$경제/NNG,0,-0.1564484748897984,30,13,17,17,0.2809447941235118,0.3850009481786666
인상/NNG@$속도/NNG@$시장/NNG,0,-0.1564484748897984,30,13,17,9,0.2809447941235118,0.3850009481786666
제시/NNG@$금리/NNG@$인상/NNG,0,-0.1564484748897984,30,13,17,22,0.2809447941235118,0.3850009481786666
흑자/NNG@$기조/NNG@$지속/NNG,0,-0.1564484748897984,30,13,17,10,0.2809447941235118,0.3850009481786666
소매/NNG@$판매/NNG@$지표/NNG,0,-0.15806731554025188,50,22,28,17,0.35302108580490094,0.4853811185285801
통화정책/NNG@$변화/NNG@$해외/NNG@$위험/NNG@$요인/NNG,0,-0.15806731554025188,50,22,28,10,0.35302108580490094,0.4853811185285801
과거/NNG@$금리/NNG@$인상/NNG,0,-0.15806731554025188,50,22,28,17,0.35302108580490094,0.4853811185285801
완화적/NNG@$통화정책/NNG@$기조/NNG@$유지/NNG,0,-0.15806731554025188,50,22,28,30,0.35302108580490094,0.4853811185285801
사회/NNG@$기반/NNG@$시설/NNG,0,-0.15806731554025188,50,22,28,11,0.35302108580490094,0.4853811185285801
통화정책/NNG@$금융/NNG@$경제/NNG,0,-0.15806731554025188,50,22,28,18,0.35302108580490094,0.4853811185285801
물가/NNG@$상승/NNG@$위험/NNG,-1,-0.1611937326296201,101,45,56,37,0.47995118883717486,0.6641485416557956
완화/NNG@$정책/NNG@$종료/NNG,0,-0.1613389468554589,168,75,93,66,0.5412228448752595,0.7491585490803594
기술/NNG@$지수/NNG@$높/VA,0,-0.16170022272686202,39,17,22,17,0.31258519330410084,0.4330002546358071
기준금리/NNG@$인하/NNG@$가능성/NNG@$높/VA,0,-0.16170022272686202,39,17,22,13,0.31258519330410084,0.4330002546358071
긍정적/NNG@$영향/NNG@$미쳤/VV,0,-0.16170022272686202,39,17,22,25,0.31258519330410084,0.4330002546358071
은행/NNG@$통화/NNG@$완화/NNG@$정책/NNG@$종료/NNG,0,-0.16170022272686202,39,17,22,14,0.31258519330410084,0.4330002546358071
상승/NNG@$경기/NNG@$둔화/NNG,0,-0.16170022272686202,39,17,22,13,0.31258519330410084,0.4330002546358071
채권/NNG@$기준금리/NNG@$전망/NNG,0,-0.16170022272686202,39,17,22,21,0.31258519330410084,0.4330002546358071
미/NNG@$금리/NNG@$역전/NNG,0,-0.16170022272686202,39,17,22,12,0.31258519330410084,0.4330002546358071
긴축/NNG@$기조/NNG@$전환/NNG,-1,-0.16181822795211442,70,31,39,24,0.41204914782915775,0.5709183431171256
주택/NNG@$담보대출/NNG@$금리/NNG,0,-0.16238207236016333,130,58,72,45,0.5166810634613261,0.7167213909789893
정책/NNG@$기조/NNG@$유지/NNG,0,-0.16302797029037175,267,119,148,69,0.5507947009945265,0.7650568587278922
경제/NNG@$물가/NNG@$상승/NNG,-1,-0.1640801559283126,59,26,33,17,0.37907849598620763,0.5276815623588961
규모/NNG@$크/VA@$않/VX,-1,-0.1640801559283126,59,26,33,37,0.37907849598620763,0.5276815623588961
기준금리/NNG@$내릴/VV@$가능성/NNG,-1,-0.1640801559283126,59,26,33,16,0.37907849598620763,0.5276815623588961
금리/NNG@$인하/NNG@$경기/NNG@$부양책/NNG,-1,-0.1640801559283126,59,26,33,9,0.37907849598620763,0.5276815623588961
기준금리/NNG@$인상/NNG@$여부/NNG@$결정/NNG,-1,-0.1640801559283126,59,26,33,12,0.37907849598620763,0.5276815623588961
경기/NNG@$살아나/VV@$않/VX,-1,-0.1640801559283126,59,26,33,20,0.37907849598620763,0.5276815623588961
기조/NNG@$유지/NNG@$금융/NNG@$유의/NNG@$통화정책/NNG,-1,-0.1640801559283126,59,26,33,21,0.37907849598620763,0.5276815623588961
달러/NNG@$가치/NNG@$상승/NNG,-1,-0.1640801559283126,59,26,33,29,0.37907849598620763,0.5276815623588961
유지/NNG@$금융/NNG@$유의/NNG@$통화정책/NNG,-1,-0.1640801559283126,59,26,33,21,0.37907849598620763,0.5276815623588961
거시/NNG@$건전성/NNG@$정책/NNG,0,-0.16482221534815122,157,70,87,81,0.5339987576188016,0.7444667730623978
성장/NNG@$둔화/NNG@$우려/NNG,0,-0.16482221534815122,157,70,87,74,0.5339987576188016,0.7444667730623978
통화/NNG@$완화/NNG@$정책/NNG@$종료/NNG,0,-0.1651128139288618,166,74,92,64,0.5377480960505497,0.7501417956877963
광공업/NNG@$생산/NNG@$감소/NNG,-1,-0.1663365732612474,79,35,44,17,0.43236037506088953,0.6046486206096161
소비자/NNG@$물가/NNG@$높/VA,-1,-0.16680331655076608,99,44,55,24,0.4730064441575352,0.6621267229468335
증권/NNG@$기준금리/NNG@$인상/NNG,0,-0.1672808471401056,48,21,27,18,0.34185416840746136,0.4790066239851588
경기/NNG@$둔화/NNG@$지속/NNG,0,-0.1672808471401056,48,21,27,31,0.34185416840746136,0.4790066239851588
기준금리/NNG@$인상/NNG@$영향/NNG,0,-0.1672808471401056,48,21,27,20,0.34185416840746136,0.4790066239851588
호조/NNG@$지속/NNG@$경제/NNG,0,-0.1672808471401056,48,21,27,7,0.34185416840746136,0.4790066239851588
경제성장률/NNG@$전망치/NNG@$하향/NNG@$조정/NNG,0,-0.1689352606913328,173,77,96,48,0.5374389624127377,0.755628321532524
기준금리/NNG@$인상/NNG@$통화정책/NNG,-1,-0.1690786677294246,68,30,38,18,0.4026306436166678,0.5662576702297305
관리/NNG@$제조업/NNG@$지수/NNG,-1,-0.16988568371300294,88,39,49,32,0.4502563911861642,0.634291189880083
상향/NNG@$조정/NNG@$가능성/NNG,-1,-0.17074871649490952,117,52,65,38,0.4969317043100052,0.7012894844410789
목표치/NNG@$허용/NNG@$한도/NNG,-1,-0.17074871649490952,117,52,65,26,0.4969317043100052,0.7012894844410789
투자/NNG@$심리/NNG@$부정적/NNG,0,-0.17091995468641075,28,12,16,22,0.2674939564779979,0.3776311100939441
경제/NNG@$전망/NNG@$반영/NNG,0,-0.17091995468641075,28,12,16,7,0.2674939564779979,0.3776311100939441
물가/NNG@$목표치/NNG@$달성/NNG,0,-0.17091995468641075,28,12,16,20,0.2674939564779979,0.3776311100939441
금리/NNG@$동결/NNG@$예상/NNG,0,-0.17169722418299782,358,159,199,117,0.5444951005537242,0.7699156322247223
상승/NNG@$압력/NNG@$지속/NNG,0,-0.17187659586624926,126,56,70,16,0.5062791923170229,0.7161429792956102
매입/NNG@$규모/NNG@$유지/NNG,-1,-0.17235862227046217,57,25,32,37,0.3686814588530689,0.5220262200939044
경제/NNG@$경기/NNG@$회복/NNG,-1,-0.17259178421071952,97,43,54,34,0.4658752940933276,0.6599626838795394
통화/NNG@$긴축/NNG@$기조/NNG,-1,-0.17309963996704392,77,34,43,21,0.4236701443702389,0.6008030828364306
여부/NNG@$결정/NNG@$예정/NNG,0,-0.17320883292716238,37,16,21,18,0.3002681479418582,0.4259035974530951
인하/NNG@$단행/NNG@$예상/NNG,0,-0.17320883292716238,37,16,21,18,0.3002681479418582,0.4259035974530951
통화정책/NNG@$결정/NNG@$영향/NNG,0,-0.17320883292716238,37,16,21,11,0.3002681479418582,0.4259035974530951
금리/NNG@$인하/NNG@$가능성/NNG@$제기/NNG,0,-0.17320883292716238,37,16,21,17,0.3002681479418582,0.4259035974530951
경기/NNG@$활성화/NNG@$대책/NNG,0,-0.17320883292716238,37,16,21,13,0.3002681479418582,0.4259035974530951
가능성/NNG@$없/VA@$않/VX,0,-0.17320883292716238,37,16,21,18,0.3002681479418582,0.4259035974530951
시장/NNG@$금리/NNG@$정책금리/NNG,0,-0.17320883292716238,37,16,21,9,0.3002681479418582,0.4259035974530951
회복세/NNG@$나타낼/VV@$전망/NNG,0,-0.17320883292716238,37,16,21,19,0.3002681479418582,0.4259035974530951
물가/NNG@$목표/NNG@$크/VA,0,-0.17320883292716238,37,16,21,13,0.3002681479418582,0.4259035974530951
콜금리/NNG@$인상/NNG@$효과/NNG,0,-0.17320883292716238,37,16,21,11,0.3002681479418582,0.4259035974530951
전망/NNG@$상향/NNG@$조정/NNG,0,-0.17465344533607197,275,122,153,93,0.5421932288017783,0.7713468937074115
모기지/NNG@$금리/NNG@$상승/NNG,-1,-0.17595031151057638,115,51,64,50,0.490983852968522,0.700365473348072
금리/NNG@$인하/NNG@$중단/NNG,-1,-0.17666028154636637,66,29,37,9,0.3929889811412061,0.5614023046288317
둔화/NNG@$물가/NNG@$상승/NNG,-1,-0.17666028154636637,66,29,37,25,0.3929889811412061,0.5614023046288317
기준금리/NNG@$만장일치/NNG@$동결/NNG,0,-0.17710891662798145,46,20,26,26,0.33041324961530893,0.4724473731558795
경제/NNG@$성장/NNG@$부정적/NNG,0,-0.17710891662798145,46,20,26,10,0.33041324961530893,0.4724473731558795
대응/NNG@$금리/NNG@$인하/NNG,0,-0.17710891662798145,46,20,26,20,0.33041324961530893,0.4724473731558795
성장률/NNG@$전망치/NNG@$제시/NNG,0,-0.17710891662798145,46,20,26,30,0.33041324961530893,0.4724473731558795
예측/NNG@$가능/NNG@$속도/NNG@$금리/NNG@$인상/NNG,0,-0.17710891662798145,46,20,26,7,0.33041324961530893,0.4724473731558795
테이퍼링/NNG@$자산/NNG@$매입/NNG@$축소/NNG,0,-0.17710891662798145,46,20,26,38,0.33041324961530893,0.4724473731558795
경제/NNG@$침체/NNG@$빠지/VV,0,-0.17710891662798145,46,20,26,17,0.33041324961530893,0.4724473731558795
가능/NNG@$속도/NNG@$금리/NNG@$인상/NNG,0,-0.17710891662798145,46,20,26,7,0.33041324961530893,0.4724473731558795
기준금리/NNG@$사상/NNG@$최저/NNG,0,-0.177181449247387,212,94,118,72,0.5383933304915979,0.7699467351164854
통화정책/NNG@$기조/NNG@$유지/NNG,0,-0.177283334706131,151,67,84,63,0.5219523551392097,0.7465918006498015
완화/NNG@$금리/NNG@$인하/NNG,-1,-0.17856767915996485,95,42,53,30,0.45855490555969963,0.6576509514666015
인상/NNG@$단행/NNG@$금리/NNG,-1,-0.17856767915996485,95,42,53,30,0.45855490555969963,0.6576509514666015
인플레/NNG@$압력/NNG@$완화/NNG,-1,-0.1801282064620402,75,33,42,27,0.4147668559602573,0.5967718277528076
서브프라임모기지/NNG@$부실/NNG@$사태/NNG,-1,-0.1801282064620402,75,33,42,38,0.4147668559602573,0.5967718277528076
수출/NNG@$호조/NNG@$내수/NNG,-1,-0.18108509357974478,55,24,31,19,0.35804041449836765,0.5161729876652006
가격/NNG@$상승/NNG@$인플레/NNG,-1,-0.18108509357974478,55,24,31,20,0.35804041449836765,0.5161729876652006
경기/NNG@$완만/XR@$회복세/NNG,-1,-0.18108509357974478,55,24,31,29,0.35804041449836765,0.5161729876652006
금융/NNG@$투자/NNG@$채권/NNG@$시장/NNG,-1,-0.18108509357974478,55,24,31,12,0.35804041449836765,0.5161729876652006
억제/NNG@$금리/NNG@$인상/NNG,0,-0.18112870021074234,158,70,88,42,0.5228206916076377,0.7537982768737225
금융/NNG@$위기/NNG@$여파/NNG,-1,-0.1847402796250628,93,41,52,24,0.45104243181198844,0.6551859284551268
확대/NNG@$가능성/NNG@$있/VA,0,-0.1858357005449658,35,15,20,11,0.28755462154847733,0.4186514159873984
필요/NNG@$있/VA@$경기/NNG,0,-0.1858357005449658,35,15,20,15,0.28755462154847733,0.4186514159873984
상승률/NNG@$물가/NNG@$목표치/NNG,0,-0.1858357005449658,35,15,20,22,0.28755462154847733,0.4186514159873984
시장/NNG@$금리/NNG@$인상/NNG@$가능성/NNG@$반영/NNG,0,-0.1858357005449658,35,15,20,28,0.28755462154847733,0.4186514159873984
부정적/NNG@$영향/NNG@$크/VA@$않/VX,0,-0.18750884962427938,26,11,15,18,0.2533630980932985,0.37015272012021744
금리/NNG@$경기/NNG@$부양/NNG,0,-0.18764402957622328,44,19,25,18,0.3186760585020901,0.46570262777805305
금리/NNG@$하향/NNG@$조정/NNG,0,-0.18764402957622328,44,19,25,13,0.3186760585020901,0.46570262777805305
상승/NNG@$물가/NNG@$불안/NNG,0,-0.18764402957622328,44,19,25,10,0.3186760585020901,0.46570262777805305
긍정적/NNG@$영향/NNG@$전망/NNG,0,-0.18764402957622328,44,19,25,10,0.3186760585020901,0.46570262777805305
채권/NNG@$보유/NNG@$종사자/NNG,0,-0.18764402957622328,44,19,25,20,0.3186760585020901,0.46570262777805305
성장률/NNG@$마이너스/NNG@$기록/NNG,0,-0.18764402957622328,44,19,25,17,0.3186760585020901,0.46570262777805305
인하/NNG@$금리/NNG@$인상/NNG,0,-0.18764402957622328,44,19,25,20,0.3186760585020901,0.46570262777805305
경제/NNG@$위기/NNG@$대응/NNG,0,-0.18764402957622328,44,19,25,6,0.3186760585020901,0.46570262777805305
정책/NNG@$기조/NNG@$변경/NNG,0,-0.18764402957622328,44,19,25,21,0.3186760585020901,0.46570262777805305
소비자/NNG@$물가/NNG@$전망/NNG,0,-0.18764402957622328,44,19,25,14,0.3186760585020901,0.46570262777805305
투자/NNG@$심리/NNG@$위축/NNG,0,-0.18906151859152154,213,94,119,84,0.5296480751637279,0.77628792401649
금리/NNG@$인상/NNG@$임박/XR,-1,-0.18960503064793832,82,36,46,26,0.4256813222056978,0.6246108790307401
금리/NNG@$인상/NNG@$전제/NNG,-1,-0.1903112413014637,53,23,30,15,0.3471447297267282,0.510119275933497
통화정책/NNG@$방향/NNG@$물가/NNG,-1,-0.1903112413014637,53,23,30,17,0.3471447297267282,0.510119275933497
통화정책/NNG@$파급/NNG@$경로/NNG,-1,-0.1903112413014637,53,23,30,45,0.3471447297267282,0.510119275933497
경기/NNG@$부양/NNG@$통화정책/NNG,-1,-0.1903112413014637,53,23,30,18,0.3471447297267282,0.510119275933497
결정/NNG@$금리/NNG@$동결/NNG,-1,-0.1903112413014637,53,23,30,17,0.3471447297267282,0.510119275933497
소비/NNG@$지출/NNG@$증가/NNG,-1,-0.1924804792207112,118,52,66,58,0.4836429720971187,0.7139065521565119
경기/NNG@$둔화/NNG@$예상/NNG,-1,-0.1929013924100944,62,27,35,33,0.37301564740826876,0.5510907721895019
회복/NNG@$속도/NNG@$둔화/NNG,-1,-0.1950591191539469,71,31,40,15,0.3963067044430856,0.5881315408225584
경기/NNG@$둔화/NNG@$위험/NNG,-1,-0.1966676035600573,80,35,45,22,0.417075621214015,0.6210267857191932
금리/NNG@$인상/NNG@$자본/NNG@$유출/NNG,-1,-0.1977170037181899,89,39,50,42,0.435429669900249,0.6497730238362882
경기/NNG@$부양적/NNG@$통화정책/NNG,-1,-0.1982465438020825,98,43,55,17,0.45151566676996163,0.674520381467452
필요/NNG@$있/VA@$덧붙였/VV,0,-0.19875088862007206,150,66,84,79,0.5061204263462515,0.7568887285785106
인하/NNG@$통화/NNG@$완화/NNG@$정책/NNG,0,-0.1990022026689554,42,18,24,26,0.30661342276453796,0.458771631744447
경기/NNG@$회복세/NNG@$이어지/VV,0,-0.1990022026689554,42,18,24,18,0.30661342276453796,0.458771631744447
경제/NNG@$경착륙/NNG@$가능성/NNG,0,-0.1990022026689554,42,18,24,25,0.30661342276453796,0.458771631744447
물가/NNG@$상승/NNG@$경기/NNG,0,-0.1990022026689554,42,18,24,11,0.30661342276453796,0.458771631744447
목표/NNG@$하향/NNG@$조정/NNG,0,-0.1990022026689554,42,18,24,18,0.30661342276453796,0.458771631744447
성장률/NNG@$전망/NNG@$유지/NNG,0,-0.1990022026689554,42,18,24,15,0.30661342276453796,0.458771631744447
상승률/NNG@$물가/NNG@$목표/NNG@$유지/NNG@$통화정책/NNG,0,-0.1990022026689554,42,18,24,27,0.30661342276453796,0.458771631744447
전세/NNG@$가격/NNG@$수도권/NNG,0,-0.1990022026689554,42,18,24,17,0.30661342276453796,0.458771631744447
국제금융시장/NNG@$불안/NNG@$경제/NNG,0,-0.1990022026689554,42,18,24,7,0.30661342276453796,0.458771631744447
회복세/NNG@$찬물/NNG@$끼얹/VV,0,-0.1990022026689554,42,18,24,15,0.30661342276453796,0.458771631744447
고려/NNG@$금리/NNG@$동결/NNG,0,-0.1990022026689554,42,18,24,18,0.30661342276453796,0.458771631744447
필요/NNG@$있/VA@$물가/NNG,0,-0.1998345916022094,33,14,19,11,0.27437304824113184,0.41124401768761437
성장/NNG@$경로/NNG@$하방/NNG@$리스크/NNG,0,-0.1998345916022094,33,14,19,11,0.27437304824113184,0.41124401768761437
경기/NNG@$회복세/NNG@$이어질/VV,0,-0.1998345916022094,33,14,19,12,0.27437304824113184,0.41124401768761437
정책금리/NNG@$인상/NNG@$예상/NNG,0,-0.1998345916022094,33,14,19,8,0.27437304824113184,0.41124401768761437
영향/NNG@$금리/NNG@$인하/NNG,0,-0.1998345916022094,33,14,19,18,0.27437304824113184,0.41124401768761437
인하/NNG@$여부/NNG@$결정/NNG,-1,-0.20009923733267376,51,22,29,8,0.33598091391263946,0.5038626117143971
공격적/NNG@$금리/NNG@$인하/NNG@$단행/NNG,-1,-0.20009923733267376,51,22,29,6,0.33598091391263946,0.5038626117143971
기준금리/NNG@$낮/VA@$유지/NNG,-1,-0.20162990980214623,60,26,34,21,0.3626710050353988,0.5456264649629808
금리/NNG@$인하/NNG@$불가피/XR,-1,-0.20162990980214623,60,26,34,13,0.3626710050353988,0.5456264649629808
부진/NNG@$모습/NNG@$보였/VV,-1,-0.20162990980214623,60,26,34,26,0.3626710050353988,0.5456264649629808
필요/NNG@$있/VA@$의견/NNG@$제시/NNG,0,-0.20214524400512013,17,7,10,7,0.21371841041365708,0.3218778107489772
가격/NNG@$변수/NNG@$변동성/NNG@$확대/NNG,0,-0.20214524400512013,17,7,10,7,0.21371841041365708,0.3218778107489772
금리/NNG@$인상/NNG@$신호/NNG,-1,-0.20272251357739146,123,54,69,41,0.4822543164831395,0.7271900487156664
금리/NNG@$인상/NNG@$가계/NNG,-1,-0.20300674580761457,69,30,39,27,0.3867414744450869,0.5835122295948175
부담/NNG@$금리/NNG@$인상/NNG,-1,-0.20300674580761457,69,30,39,25,0.3867414744450869,0.5835122295948175
통화정책/NNG@$경기/NNG@$회복/NNG,-1,-0.20400129540955303,78,34,44,17,0.4082574395697534,0.6172544985303406
금리/NNG@$인하/NNG@$시장/NNG,0,-0.2042373396893088,164,72,92,40,0.5086954072639968,0.7694880087440616
인하/NNG@$단행/NNG@$금리/NNG,-1,-0.2045443520150091,87,38,49,13,0.4273234481036546,0.6468133647368299
필요/NNG@$있/VA@$진단/NNG,-1,-0.2045443520150091,87,38,49,27,0.4273234481036546,0.6468133647368299
경기/NNG@$부정적/NNG@$영향/NNG,-1,-0.2045443520150091,87,38,49,32,0.4273234481036546,0.6468133647368299
자산/NNG@$가격/NNG@$상승/NNG,0,-0.20524484003950716,340,149,191,96,0.5193768048413517,0.7872990811601825
통화/NNG@$가치/NNG@$하락/NNG,-1,-0.20822559785107175,146,64,82,101,0.49705192635929124,0.7581635476616476
금리/NNG@$인상/NNG@$가능성/NNG@$열/VV,-1,-0.21020463763308583,137,60,77,46,0.48955505566018337,0.749824910463748
수출/NNG@$비중/NNG@$높/VA,-1,-0.21020463763308583,137,60,77,46,0.48955505566018337,0.749824910463748
예상/NNG@$크/VA@$벗어나/VV@$않/VX,0,-0.21052460637944503,49,21,28,13,0.3245318122357762,0.4974006088444725
통화정책/NNG@$정상화/NNG@$속도/NNG,0,-0.21052460637944503,49,21,28,12,0.3245318122357762,0.4974006088444725
가능성/NNG@$높/VA@$보/VV,0,-0.21052460637944503,49,21,28,16,0.3245318122357762,0.4974006088444725
심리/NNG@$부정적/NNG@$영향/NNG,0,-0.21052460637944503,49,21,28,27,0.3245318122357762,0.4974006088444725
물가/NNG@$기준금리/NNG@$인상/NNG,0,-0.21052460637944503,49,21,28,16,0.3245318122357762,0.4974006088444725
금리/NNG@$동결/NNG@$물가/NNG,0,-0.21052460637944503,49,21,28,8,0.3245318122357762,0.4974006088444725
경기/NNG@$둔화/NNG@$속도/NNG,-1,-0.21081980699488512,58,25,33,13,0.35207664833204527,0.5399511926148818
문제/NNG@$해결/NNG@$않/VX,-1,-0.21081980699488512,58,25,33,23,0.35207664833204527,0.5399511926148818
흑자/NNG@$기조/NNG@$유지/NNG,-1,-0.21081980699488512,58,25,33,16,0.35207664833204527,0.5399511926148818
시장/NNG@$교란/NNG@$요인/NNG,0,-0.21133086992380568,40,17,23,11,0.294187087150801,0.4516534897664294
경제성장률/NNG@$전망/NNG@$상향/NNG@$조정/NNG,0,-0.21133086992380568,40,17,23,21,0.294187087150801,0.4516534897664294
기업/NNG@$구조조정/NNG@$추진/NNG,0,-0.21133086992380568,40,17,23,13,0.294187087150801,0.4516534897664294
지속/NNG@$전망/NNG@$통화정책/NNG,0,-0.21133086992380568,40,17,23,8,0.294187087150801,0.4516534897664294
상승/NNG@$기조/NNG@$갈/VX@$전망/NNG,0,-0.21133086992380568,40,17,23,13,0.294187087150801,0.4516534897664294
성장/NNG@$둔화/NNG@$위험/NNG,0,-0.21133086992380568,40,17,23,13,0.294187087150801,0.4516534897664294
금리/NNG@$인하/NNG@$아니/VCN,0,-0.21133086992380568,40,17,23,12,0.294187087150801,0.4516534897664294
경기/NNG@$둔화/NNG@$수요/NNG,0,-0.21133086992380568,40,17,23,19,0.294187087150801,0.4516534897664294
통화정책/NNG@$방향/NNG@$금리/NNG,0,-0.21133086992380568,40,17,23,10,0.294187087150801,0.4516534897664294
매입/NNG@$규모/NNG@$축소/NNG,-1,-0.21161515777204043,85,37,48,53,0.41901321469876707,0.6436768720661417
기준금리/NNG@$인상/NNG@$필요성/NNG,-1,-0.21162482385684567,76,33,43,22,0.3992230936056152,0.6132882270003717
물가/NNG@$상승률/NNG@$목표치/NNG,0,-0.21353005725536,348,152,196,159,0.5131462071860813,0.7914487975002896
완화/NNG@$기조/NNG@$유지/NNG,0,-0.21382804935782262,261,114,147,92,0.5127340134137915,0.791306936662704
기준금리/NNG@$인상/NNG@$시기/NNG,0,-0.21496255149417143,323,141,182,182,0.5120631478636438,0.7921528433599728
인상/NNG@$나설/VV@$전망/NNG,-1,-0.2155191686181671,110,48,62,19,0.4584087730001069,0.7099785168203583
개인/NNG@$소비/NNG@$지출/NNG@$물가지수/NNG@$상승률/NNG,0,-0.21555060326053677,31,13,18,24,0.2606255855370639,0.40368067697789206
오름세/NNG@$지속/NNG@$예상/NNG,0,-0.21555060326053677,31,13,18,8,0.2606255855370639,0.40368067697789206
소비/NNG@$지출/NNG@$물가지수/NNG@$상승률/NNG,0,-0.21555060326053677,31,13,18,24,0.2606255855370639,0.40368067697789206
불안/NNG@$심리/NNG@$진정/NNG,0,-0.21555060326053677,31,13,18,6,0.2606255855370639,0.40368067697789206
원화/NNG@$가치/NNG@$하락/NNG,-1,-0.21692190329160543,101,44,57,39,0.44454560204922633,0.6905361516429624
부동산/NNG@$자산/NNG@$가격/NNG,-1,-0.2180704607650492,92,40,52,30,0.42863400706559596,0.667426746275639
금리/NNG@$인상/NNG@$보/VV,-1,-0.21955930309241034,74,32,42,25,0.38996851866405646,0.6091221482295132
동결/NNG@$가능성/NNG@$크/VA,-1,-0.21955930309241034,74,32,42,20,0.38996851866405646,0.6091221482295132
금리/NNG@$동결/NNG@$인상/NNG,-1,-0.21955930309241034,74,32,42,33,0.38996851866405646,0.6091221482295132
기준금리/NNG@$올릴/VV@$전망/NNG,-1,-0.22000514922275005,65,28,37,32,0.36691476749766144,0.573649787773937
경기/NNG@$수출/NNG@$호조/NNG,-1,-0.22000514922275005,65,28,37,12,0.36691476749766144,0.573649787773937
소득/NNG@$주도/NNG@$성장/NNG,-1,-0.22000514922275005,65,28,37,23,0.36691476749766144,0.573649787773937
중기/NNG@$물가/NNG@$목표/NNG,0,-0.22164114826311154,225,98,127,60,0.506016751138372,0.7938528231539623
금리/NNG@$인하/NNG@$나설/VV@$가능성/NNG,0,-0.22168001979332774,47,20,27,25,0.31277557316706156,0.4907309243265484
가능성/NNG@$낮/VA@$보/VX,0,-0.22168001979332774,47,20,27,21,0.31277557316706156,0.4907309243265484
유지/NNG@$소비자/NNG@$물가/NNG,0,-0.22168001979332774,47,20,27,19,0.31277557316706156,0.4907309243265484
금리/NNG@$인상/NNG@$조건/NNG,0,-0.22168001979332774,47,20,27,29,0.31277557316706156,0.4907309243265484
회복/NNG@$쉽/VA@$않/VX,0,-0.22168001979332774,47,20,27,19,0.31277557316706156,0.4907309243265484
하지/NNG@$않/VX@$생각/NNG,0,-0.22168001979332774,47,20,27,11,0.31277557316706156,0.4907309243265484
금리/NNG@$인상/NNG@$걸림돌/NNG,0,-0.22168001979332774,47,20,27,21,0.31277557316706156,0.4907309243265484
하락/NNG@$물가/NNG@$상승률/NNG,0,-0.22482005445669995,38,16,22,19,0.2813467885652052,0.44434699991969895
가능성/NNG@$크/VA@$덧붙였/VV,0,-0.22482005445669995,38,16,22,14,0.2813467885652052,0.44434699991969895
매입/NNG@$프로그램/NNG@$종료/NNG,0,-0.22482005445669995,38,16,22,17,0.2813467885652052,0.44434699991969895
통화정책/NNG@$변화/NNG@$가능성/NNG,0,-0.22482005445669995,38,16,22,12,0.2813467885652052,0.44434699991969895
반영/NNG@$기준금리/NNG@$인상/NNG,0,-0.22482005445669995,38,16,22,24,0.2813467885652052,0.44434699991969895
지표/NNG@$개인/NNG@$소비/NNG@$지출/NNG@$물가지수/NNG,0,-0.22482005445669995,38,16,22,26,0.2813467885652052,0.44434699991969895
소비자/NNG@$물가/NNG@$상승률/NNG@$높/VA,-1,-0.22619770660023986,131,57,74,36,0.4736531824970491,0.7502415873396787
취업/NNG@$기회/NNG@$전망/NNG,-1,-0.22654827735795635,81,35,46,36,0.40176744690250377,0.6368487215218254
예상/NNG@$소비자/NNG@$물가/NNG,-1,-0.22782867890882774,72,31,41,20,0.380489162557329,0.6047504182592792
경기/NNG@$회복/NNG@$불확실성/NNG,-1,-0.22782867890882774,72,31,41,7,0.380489162557329,0.6047504182592792
위험/NNG@$요인/NNG@$상존/NNG,-1,-0.22807855109242647,106,46,60,50,0.44476019348786583,0.7072755844774578
금융/NNG@$유의/NNG@$통화정책/NNG,-1,-0.22807855109242647,106,46,60,34,0.44476019348786583,0.7072755844774578
금융시장/NNG@$금리/NNG@$인하/NNG,-1,-0.22912471473521134,63,27,36,26,0.3566401057390314,0.5683965916176931
금리/NNG@$인상/NNG@$무게/NNG,-1,-0.22912471473521134,63,27,36,20,0.3566401057390314,0.5683965916176931
가능성/NNG@$크/VA@$내/VX,-1,-0.23080076254942672,54,23,31,20,0.33009344008943803,0.527952486686601
외국인투자/NNG@$자금/NNG@$유출/NNG,-1,-0.23080076254942672,54,23,31,22,0.33009344008943803,0.527952486686601
서두/NNG@$필요/NNG@$없/VA,-1,-0.23080076254942672,54,23,31,30,0.33009344008943803,0.527952486686601
금융/NNG@$위기/NNG@$경기/NNG,-1,-0.23187628095870738,113,49,64,37,0.4514208196855856,0.7236461656339267
자본/NNG@$유출/NNG@$가능성/NNG,-1,-0.23187628095870738,113,49,64,77,0.4514208196855856,0.7236461656339267
금융/NNG@$위기/NNG@$경제/NNG,-1,-0.23301694638443482,189,82,107,52,0.4940986186126979,0.7939723732673125
정책적/NNG@$노력/NNG@$필요/NNG,0,-0.23346353855244306,29,12,17,11,0.24617752631373854,0.39595904043734154
성장/NNG@$전망치/NNG@$하향/NNG,0,-0.23346353855244306,29,12,17,20,0.24617752631373854,0.39595904043734154
내수/NNG@$회복/NNG@$지연/NNG,0,-0.23346353855244306,29,12,17,19,0.24617752631373854,0.39595904043734154
외국인/NNG@$채권/NNG@$투자/NNG@$자금/NNG,0,-0.23368039592893064,45,19,26,12,0.3006843222830766,0.48385119525342984
금융/NNG@$시스템/NNG@$안정성/NNG,0,-0.23368039592893064,45,19,26,24,0.3006843222830766,0.48385119525342984
중기적/NNG@$물가/NNG@$상승률/NNG@$목표/NNG,0,-0.23368039592893064,45,19,26,17,0.3006843222830766,0.48385119525342984
경기/NNG@$부양/NNG@$대책/NNG,0,-0.23368039592893064,45,19,26,11,0.3006843222830766,0.48385119525342984
변화/NNG@$해외/NNG@$위험/NNG@$요인/NNG,-1,-0.23444563661722095,79,34,45,12,0.3928247191195958,0.6331445209432748
금리/NNG@$인하/NNG@$행진/NNG,-1,-0.23646025871867105,70,30,40,10,0.37077985624269105,0.6001671837517993
사상/NNG@$최대치/NNG@$기록/NNG,-1,-0.23646025871867105,70,30,40,20,0.37077985624269105,0.6001671837517993
금융/NNG@$위기/NNG@$실물경제/NNG,-1,-0.23871332930617184,61,26,35,6,0.34611363902850434,0.5629221250136475
경제/NNG@$성장/NNG@$이끌/VV,-1,-0.23871332930617184,61,26,35,25,0.34611363902850434,0.5629221250136475
시작/NNG@$금리/NNG@$인하/NNG,-1,-0.23871332930617184,61,26,35,11,0.34611363902850434,0.5629221250136475
환율/NNG@$급/NNG@$등락/NNG,0,-0.2397184037038721,36,15,21,15,0.26802631232870044,0.436850425025165
확대/NNG@$가능성/NNG@$크/VA,0,-0.2397184037038721,36,15,21,27,0.26802631232870044,0.436850425025165
유지/NNG@$물가/NNG@$상승/NNG,0,-0.2397184037038721,36,15,21,12,0.26802631232870044,0.436850425025165
금리/NNG@$인상/NNG@$속도/NNG@$완만/XR,0,-0.2397184037038721,36,15,21,16,0.26802631232870044,0.436850425025165
기금/NNG@$금리선물/NNG@$시장/NNG@$금리/NNG@$인상/NNG,0,-0.2397184037038721,36,15,21,28,0.26802631232870044,0.436850425025165
금리/NNG@$인상/NNG@$경기/NNG@$회복/NNG,-1,-0.23999639300314002,86,37,49,20,0.40396824577824114,0.6588077297497444
원화/NNG@$가치/NNG@$상승/NNG,-1,-0.24010864228016893,229,99,130,75,0.4922976624398997,0.8030501410818984
가계/NNG@$저축/NNG@$전망/NNG,-1,-0.2417280056480584,52,22,30,25,0.3186749138029239,0.5216216136547396
점진적/NNG@$금리/NNG@$인상/NNG@$기조/NNG,-1,-0.2417280056480584,52,22,30,17,0.3186749138029239,0.5216216136547396
기준금리/NNG@$동결/NNG@$했/VV,-1,-0.2417280056480584,52,22,30,20,0.3186749138029239,0.5216216136547396
고용/NNG@$지표/NNG@$금리/NNG@$인상/NNG,-1,-0.2417280056480584,52,22,30,26,0.3186749138029239,0.5216216136547396
결정/NNG@$금리/NNG@$인상/NNG,-1,-0.24504493885620926,169,73,96,42,0.4806463380531535,0.7923096433050212
인하/NNG@$가능성/NNG@$크/VA,-1,-0.2453645030534849,132,57,75,58,0.4611753120282203,0.760730094294679
조정/NNG@$가능성/NNG@$높/VA,-1,-0.2454853601840249,68,29,39,17,0.3608346573126831,0.5953665937160172
테이퍼링/NNG@$양적완화/NNG@$축소/NNG,-1,-0.2454853601840249,68,29,39,64,0.3608346573126831,0.5953665937160172
지속/NNG@$경기/NNG@$둔화/NNG,0,-0.24666983341251913,43,18,25,16,0.2882224542311615,0.4767589510516283
인상/NNG@$전망/NNG@$힘/NNG,0,-0.24666983341251913,43,18,25,17,0.2882224542311615,0.4767589510516283
자산/NNG@$매입/NNG@$확대/NNG,0,-0.24666983341251913,43,18,25,22,0.2882224542311615,0.4767589510516283
기업/NNG@$수익성/NNG@$악화/NNG,0,-0.24666983341251913,43,18,25,26,0.2882224542311615,0.4767589510516283
악화/NNG@$금리/NNG@$인상/NNG,0,-0.24666983341251913,43,18,25,8,0.2882224542311615,0.4767589510516283
금리/NNG@$인상/NNG@$늦출/VV,0,-0.24666983341251913,43,18,25,12,0.2882224542311615,0.4767589510516283
경제/NNG@$회복/NNG@$신호/NNG,0,-0.24666983341251913,43,18,25,9,0.2882224542311615,0.4767589510516283
우려/NNG@$금리/NNG@$인상/NNG@$가능성/NNG,0,-0.24666983341251913,43,18,25,15,0.2882224542311615,0.4767589510516283
회복/NNG@$이어지/VV@$중기적/NNG@$물가/NNG@$상승률/NNG,0,-0.24666983341251913,43,18,25,16,0.2882224542311615,0.4767589510516283
전망/NNG@$고개/NNG@$들/VV,0,-0.24666983341251913,43,18,25,10,0.2882224542311615,0.4767589510516283
경영/NNG@$애로/NNG@$요인/NNG,0,-0.24666983341251913,43,18,25,24,0.2882224542311615,0.4767589510516283
물가/NNG@$압력/NNG@$완화/NNG,0,-0.24666983341251913,43,18,25,19,0.2882224542311615,0.4767589510516283
금리/NNG@$동결/NNG@$배경/NNG,-1,-0.2468304632000976,139,60,79,44,0.4652764007791508,0.7698933947369315
금리/NNG@$결정/NNG@$영향/NNG,-1,-0.2483960318075097,100,43,57,38,0.42293409643040153,0.7021671561042139
인하/NNG@$나설/VV@$가능성/NNG,-1,-0.24882175103962534,59,25,34,33,0.3353250731866005,0.5572214978887092
기준금리/NNG@$인상/NNG@$가능성/NNG@$시사/NNG,-1,-0.24882175103962534,59,25,34,23,0.3353250731866005,0.5572214978887092
은행/NNG@$기준금리/NNG@$인하/NNG,-1,-0.24882175103962534,59,25,34,20,0.3353250731866005,0.5572214978887092
보유/NNG@$자산/NNG@$축소/NNG,-1,-0.24956771340622086,123,53,70,184,0.4503898119522472,0.7496197672457272
인상/NNG@$경제/NNG@$영향/NNG,-1,-0.25339491565285477,50,21,29,20,0.3069458462933048,0.51506485366928
통화정책/NNG@$기준금리/NNG@$유지/NNG,-1,-0.25339491565285477,50,21,29,17,0.3069458462933048,0.51506485366928
시장/NNG@$금리/NNG@$결정/NNG,-1,-0.25339491565285477,50,21,29,19,0.3069458462933048,0.51506485366928
사상/NNG@$최저/NNG@$유지/NNG,-1,-0.25339491565285477,50,21,29,8,0.3069458462933048,0.51506485366928
가계/NNG@$기업/NNG@$대출/NNG,-1,-0.25339491565285477,50,21,29,5,0.3069458462933048,0.51506485366928
경기/NNG@$좋/VA@$않/VX,-1,-0.25342295907003476,144,62,82,46,0.463761433707953,0.7782530073179095
석유류/NNG@$제품/NNG@$가격/NNG,0,-0.2542567826388249,27,11,16,5,0.23084197469732934,0.3880742850218209
성장/NNG@$하향/NNG@$리스크/NNG,0,-0.2542567826388249,27,11,16,2,0.23084197469732934,0.3880742850218209
금융시장/NNG@$기준금리/NNG@$인하/NNG,0,-0.2542567826388249,27,11,16,6,0.23084197469732934,0.3880742850218209
금리/NNG@$인상/NNG@$확실/XR,-1,-0.2549401086978903,66,28,38,30,0.35064666113364523,0.5903428109539552
금리/NNG@$인상/NNG@$단행/NNG@$않/VX,-1,-0.2549401086978903,66,28,38,18,0.35064666113364523,0.5903428109539552
성장률/NNG@$전망/NNG@$상향/NNG@$조정/NNG,-1,-0.2549401086978903,66,28,38,25,0.35064666113364523,0.5903428109539552
외국인/NNG@$증권/NNG@$투자/NNG@$자금/NNG@$유입/NNG,-1,-0.2549401086978903,66,28,38,6,0.35064666113364523,0.5903428109539552
하락/NNG@$경기/NNG@$회복/NNG,0,-0.25635657729639827,34,14,20,11,0.25413816043252696,0.42916118272508064
하방/NNG@$리스크/NNG@$요인/NNG,0,-0.25635657729639827,34,14,20,12,0.25413816043252696,0.42916118272508064
성장/NNG@$모멘텀/NNG@$둔화/NNG,0,-0.25635657729639827,34,14,20,13,0.25413816043252696,0.42916118272508064
인상/NNG@$시기/NNG@$늦추/VV,0,-0.25635657729639827,34,14,20,17,0.25413816043252696,0.42916118272508064
기준금리/NNG@$인하/NNG@$결정/NNG,-1,-0.2590268207241596,142,61,81,47,0.45858972644220225,0.7788583272987188
기금/NNG@$금리/NNG@$동결/NNG,-1,-0.25951009845991113,57,24,33,18,0.324261947044687,0.5512898814610511
기준금리/NNG@$동결/NNG@$시장/NNG,-1,-0.25951009845991113,57,24,33,28,0.324261947044687,0.5512898814610511
부진/NNG@$금리/NNG@$인하/NNG,-1,-0.25951009845991113,57,24,33,29,0.324261947044687,0.5512898814610511
회복/NNG@$속도/NNG@$예상/NNG,-1,-0.25951009845991113,57,24,33,16,0.324261947044687,0.5512898814610511
수출/NNG@$경기/NNG@$회복/NNG,-1,-0.25951009845991113,57,24,33,28,0.324261947044687,0.5512898814610511
상태/NNG@$금리/NNG@$인상/NNG,-1,-0.25951009845991113,57,24,33,21,0.324261947044687,0.5512898814610511
의존도/NNG@$높/VA@$경제/NNG,-1,-0.25951009845991113,57,24,33,27,0.324261947044687,0.5512898814610511
금리/NNG@$인하/NNG@$소수/NNG@$의견/NNG,-1,-0.26011968488169634,73,31,42,37,0.36466690207813446,0.62079473710129
하락/NNG@$물가/NNG@$상승/NNG,-1,-0.26011968488169634,73,31,42,19,0.36466690207813446,0.62079473710129
물가/NNG@$압력/NNG@$높/VA,0,-0.26083114307260613,41,17,24,12,0.27534443086567845,0.4694514941285738
상승률/NNG@$기록/NNG@$물가/NNG,0,-0.26083114307260613,41,17,24,18,0.27534443086567845,0.4694514941285738
금리/NNG@$결정/NNG@$시장/NNG,0,-0.26083114307260613,41,17,24,13,0.27534443086567845,0.4694514941285738
재정/NNG@$건전성/NNG@$유지/NNG,0,-0.26083114307260613,41,17,24,15,0.27534443086567845,0.4694514941285738
동결/NNG@$경제/NNG@$동향/NNG,0,-0.26083114307260613,41,17,24,10,0.27534443086567845,0.4694514941285738
금리/NNG@$인상/NNG@$부동산시장/NNG,0,-0.26083114307260613,41,17,24,11,0.27534443086567845,0.4694514941285738
자본/NNG@$확충/NNG@$펀드/NNG,-1,-0.26304073617859003,96,41,55,36,0.4074478092567528,0.6979855311055211
금리/NNG@$인상/NNG@$재개/NNG,-1,-0.26304073617859003,96,41,55,38,0.4074478092567528,0.6979855311055211
금리/NNG@$동결/NNG@$전망/NNG,-1,-0.2637476561607154,271,116,155,84,0.47515241679808157,0.8152052704242639
하향/NNG@$조정/NNG@$가능성/NNG,-1,-0.2643791542399049,175,75,100,81,0.4680701501026896,0.80414512823384
긴축/NNG@$기조/NNG@$유지/NNG,-1,-0.2648664225062115,64,27,37,18,0.3402077736346886,0.5850900228171028
부동산/NNG@$종합/NNG@$대책/NNG,-1,-0.2648664225062115,64,27,37,40,0.3402077736346886,0.5850900228171028
금융/NNG@$위기/NNG@$이전/NNG@$회복/NNG,-1,-0.265912222365166,48,20,28,18,0.2948807531237863,0.5082785631728453
금리/NNG@$기준금리/NNG@$인상/NNG,-1,-0.265912222365166,48,20,28,12,0.2948807531237863,0.5082785631728453
금리/NNG@$내릴/VV@$전망/NNG,-1,-0.265912222365166,48,20,28,16,0.2948807531237863,0.5082785631728453
에너지/NNG@$가격/NNG@$하락/NNG,-1,-0.26742676174520874,110,47,63,51,0.4242620902378324,0.7336778337797989
기준금리/NNG@$유지/NNG@$했/VV,-1,-0.27072769049149825,94,40,54,49,0.39941521126641133,0.6956420035332485
유로존/NNG@$유로화/NNG@$사용/NNG@$경제/NNG,-1,-0.2708500919878497,55,23,32,21,0.31290911844111075,0.545122503624923
경제/NNG@$차지/NNG@$소비/NNG,-1,-0.2708500919878497,55,23,32,27,0.31290911844111075,0.545122503624923
금리/NNG@$인상/NNG@$자금/NNG,-1,-0.2708500919878497,55,23,32,14,0.31290911844111075,0.545122503624923
경제/NNG@$체질/NNG@$개선/NNG,-1,-0.2728860793791815,101,43,58,61,0.4087776985969656,0.7152734292414161
금리/NNG@$올릴/VV@$예상/NNG,-1,-0.27448661110514894,108,46,62,46,0.4171524762674781,0.732456842296565
인하/NNG@$기조/NNG@$유지/NNG,0,-0.2751819015198066,32,13,19,21,0.23956636607736445,0.4212754274636146
지출/NNG@$물가지수/NNG@$상승률/NNG,0,-0.2751819015198066,32,13,19,24,0.23956636607736445,0.4212754274636146
불안/NNG@$심리/NNG@$완화/NNG,0,-0.2751819015198066,32,13,19,6,0.23956636607736445,0.4212754274636146
지속/NNG@$경제/NNG@$성장/NNG,0,-0.2751819015198066,32,13,19,13,0.23956636607736445,0.4212754274636146
유지/NNG@$기준금리/NNG@$인하/NNG,0,-0.2751819015198066,32,13,19,16,0.23956636607736445,0.4212754274636146
금리/NNG@$재할인율/NNG@$인하/NNG,-1,-0.27531323538563435,62,26,36,20,0.3295084389129695,0.5796024507679314
상승/NNG@$압력/NNG@$낮/VA,-1,-0.27531323538563435,62,26,36,24,0.3295084389129695,0.5796024507679314
경제/NNG@$성장/NNG@$인플레이션/NNG,-1,-0.2756021585288241,115,49,66,54,0.42461535735259565,0.7473617170762535
기준금리/NNG@$인하/NNG@$기조/NNG,0,-0.2763990998555892,39,16,23,22,0.2619919496649352,0.46192574020929783
금리/NNG@$상향/NNG@$조정/NNG,0,-0.2763990998555892,39,16,23,12,0.2619919496649352,0.46192574020929783
소비자/NNG@$물가/NNG@$상승률/NNG@$농산물/NNG@$가격/NNG,0,-0.2763990998555892,39,16,23,3,0.2619919496649352,0.46192574020929783
성장세/NNG@$회복/NNG@$지원/NNG@$중기적/NNG,0,-0.2763990998555892,39,16,23,15,0.2619919496649352,0.46192574020929783
경제/NNG@$전망/NNG@$낙관적/NNG,0,-0.2763990998555892,39,16,23,11,0.2619919496649352,0.46192574020929783
회복/NNG@$지원/NNG@$중기적/NNG,0,-0.2763990998555892,39,16,23,15,0.2619919496649352,0.46192574020929783
생각/NNG@$볼/VX@$필요/NNG,0,-0.27892924203662117,25,10,15,15,0.21435782622635124,0.3800179243652315
소비자/NNG@$물가/NNG@$동향/NNG,-1,-0.2791652024901652,69,29,40,31,0.34473485014902977,0.6114657256464492
선행/NNG@$지표/NNG@$역할/NNG,-1,-0.2794168831693813,46,19,27,13,0.2824478431793126,0.5012590439570255
환율/NNG@$변동/NNG@$확대/NNG,-1,-0.2794168831693813,46,19,27,27,0.2824478431793126,0.5012590439570255
제품/NNG@$가격/NNG@$경쟁력/NNG,-1,-0.2794168831693813,46,19,27,17,0.2824478431793126,0.5012590439570255
매입/NNG@$규모/NNG@$확대/NNG,-1,-0.2817585664453628,106,45,61,39,0.40986603338432037,0.7310936174386958
달러/NNG@$원/NNG@$환율/NNG@$하락/NNG,-1,-0.2823675761041109,76,32,44,28,0.3586433486631447,0.6405726187075428
기업/NNG@$경기/NNG@$전망/NNG,-1,-0.2823675761041109,76,32,44,28,0.3586433486631447,0.6405726187075428
억제/NNG@$목표치/NNG@$허용/NNG@$한도/NNG,-1,-0.28257688481502763,113,48,65,25,0.4177599360277264,0.7465001246265822
불안/NNG@$요인/NNG@$남/VV,-1,-0.28292792644486875,53,22,31,16,0.3012481405305596,0.5387146379271992
경제/NNG@$전망/NNG@$기준금리/NNG,-1,-0.28292792644486875,53,22,31,14,0.3012481405305596,0.5387146379271992
가계/NNG@$대출/NNG@$증가세/NNG,-1,-0.28292792644486875,53,22,31,24,0.3012481405305596,0.5387146379271992
통화정책/NNG@$금리/NNG@$동결/NNG,-1,-0.2863380212606832,60,25,35,20,0.3185373141044829,0.5738743581352144
경제/NNG@$심리/NNG@$나타내/VV@$소비자심리지수/NNG,-1,-0.2863380212606832,60,25,35,21,0.3185373141044829,0.5738743581352144
기준금리/NNG@$인상/NNG@$기조/NNG,-1,-0.2863380212606832,60,25,35,27,0.3185373141044829,0.5738743581352144
경제/NNG@$전망/NNG@$통화정책/NNG,-1,-0.2863380212606832,60,25,35,37,0.3185373141044829,0.5738743581352144
은행권/NNG@$채권/NNG@$딜러/NNG,-1,-0.28690003352989313,90,38,52,17,0.38275580560924566,0.6904146177917536
시중/NNG@$유동성/NNG@$풍부/XR,-1,-0.28690003352989313,90,38,52,22,0.38275580560924566,0.6904146177917536
조짐/NNG@$보이/VV@$않/VX,-1,-0.28690003352989313,90,38,52,37,0.38275580560924566,0.6904146177917536
소비/NNG@$투자/NNG@$내수/NNG,-1,-0.287306982726666,179,76,103,63,0.4520407872521348,0.8161141720660733
경기/NNG@$회복/NNG@$조짐/NNG,-1,-0.289238195526515,132,56,76,45,0.4306844400771947,0.780838776100208
금리/NNG@$인상/NNG@$어려울/VA,-1,-0.289252502684465,104,44,60,55,0.4024001222572598,0.7295815650689861
증권/NNG@$투자/NNG@$자금/NNG@$유입/NNG,-1,-0.28937227699739954,67,28,39,8,0.3344011983845068,0.606452897810046
금리/NNG@$인상/NNG@$앞두/VV,-1,-0.28937227699739954,67,28,39,34,0.3344011983845068,0.606452897810046
동향/NNG@$그린북/NNG@$경제/NNG,-1,-0.28937227699739954,67,28,39,28,0.3344011983845068,0.606452897810046
금리/NNG@$동결/NNG@$이유/NNG,-1,-0.28937227699739954,67,28,39,19,0.3344011983845068,0.606452897810046
시장/NNG@$금리/NNG@$인상/NNG@$시기/NNG,0,-0.2936790607775399,37,15,22,13,0.24809033320646248,0.45417800752765175
경기/NNG@$하강/NNG@$가능성/NNG,0,-0.2936790607775399,37,15,22,10,0.24809033320646248,0.45417800752765175
신용등급/NNG@$상향/NNG@$조정/NNG,-1,-0.29392546317570667,81,34,47,21,0.36212554816681347,0.6632993817886375
시장/NNG@$충격/NNG@$최소화/NNG,0,-0.2940799156798609,44,18,26,15,0.26960744932819275,0.4940024666912916
물가/NNG@$목표/NNG@$유지/NNG@$통화정책/NNG,0,-0.2940799156798609,44,18,26,27,0.26960744932819275,0.4940024666912916
경기/NNG@$회복/NNG@$시작/NNG,0,-0.2940799156798609,44,18,26,2,0.26960744932819275,0.4940024666912916
경제/NNG@$내수/NNG@$회복세/NNG,0,-0.2940799156798609,44,18,26,10,0.26960744932819275,0.4940024666912916
목표/NNG@$유지/NNG@$통화정책/NNG,0,-0.2940799156798609,44,18,26,28,0.26960744932819275,0.4940024666912916
성장률/NNG@$전망치/NNG@$낮/VA,-1,-0.29584797394412066,51,21,30,14,0.28925650939577335,0.532061584438579
원화/NNG@$강세/NNG@$기조/NNG,-1,-0.29584797394412066,51,21,30,12,0.28925650939577335,0.532061584438579
경제/NNG@$구조적/NNG@$문제/NNG,-1,-0.29584797394412066,51,21,30,18,0.28925650939577335,0.532061584438579
인상/NNG@$하지/NNG@$않/VX,-1,-0.29642081046723157,95,40,55,40,0.3849727928650363,0.7090127018128938
조치/NNG@$취할/VV@$준비/NNG,-1,-0.29642081046723157,95,40,55,19,0.3849727928650363,0.7090127018128938
성장/NNG@$물가/NNG@$전망/NNG,0,-0.29681045673208206,30,12,18,16,0.22415695138491418,0.41318748937657185
기업/NNG@$가격/NNG@$경쟁력/NNG,0,-0.29681045673208206,30,12,18,27,0.22415695138491418,0.41318748937657185
하방/NNG@$리스크/NNG@$높/VA,0,-0.29681045673208206,30,12,18,11,0.22415695138491418,0.41318748937657185
기준치/NNG@$허용/NNG@$한도/NNG,-1,-0.2969791139594693,102,43,59,51,0.3947521008187439,0.7279138890225819
금리/NNG@$인상/NNG@$부동산/NNG,-1,-0.29800870388720246,58,24,34,13,0.30728088361753375,0.5679000553366877
기준금리/NNG@$인하/NNG@$통화정책/NNG,-1,-0.29800870388720246,58,24,34,24,0.30728088361753375,0.5679000553366877
실물/NNG@$경기/NNG@$둔화/NNG,-1,-0.29800870388720246,58,24,34,16,0.30728088361753375,0.5679000553366877
영향/NNG@$가능성/NNG@$상존/NNG,-1,-0.3000954299147558,65,27,38,21,0.3238113725207347,0.6011991505121086
물가/NNG@$상승/NNG@$속도/NNG,-1,-0.3000954299147558,65,27,38,29,0.3238113725207347,0.6011991505121086
개선/NNG@$경기/NNG@$회복/NNG,-1,-0.30188473775546065,72,30,42,20,0.33893767312381223,0.631763541975549
임금/NNG@$인상/NNG@$요구/NNG,-1,-0.30188473775546065,72,30,42,8,0.33893767312381223,0.631763541975549
금리/NNG@$인하/NNG@$할/VV,-1,-0.30188473775546065,72,30,42,28,0.33893767312381223,0.631763541975549
필요성/NNG@$크/VA@$않/VX,-1,-0.30188473775546065,72,30,42,26,0.33893767312381223,0.631763541975549
인상/NNG@$단행/NNG@$않/VX,-1,-0.3032786220833472,79,33,46,26,0.352736516904007,0.6595040149822295
경제/NNG@$둔화/NNG@$우려/NNG,-1,-0.3032786220833472,79,33,46,31,0.352736516904007,0.6595040149822295
금융/NNG@$경제/NNG@$고려/NNG,-1,-0.3034488869333426,121,51,70,28,0.4118931709310572,0.7703967480811844
인상/NNG@$자본/NNG@$유출/NNG,-1,-0.3049500137397815,100,42,58,49,0.3869193171205261,0.7260835918818326
자산/NNG@$축소/NNG@$계획/NNG,0,-0.30898077161520987,23,9,14,33,0.1963591889625874,0.37177611767442925
인상/NNG@$성장/NNG@$둔화/NNG,0,-0.30898077161520987,23,9,14,28,0.1963591889625874,0.37177611767442925
경기/NNG@$부진/NNG@$장기화/NNG,0,-0.30898077161520987,23,9,14,14,0.1963591889625874,0.37177611767442925
압력/NNG@$크/VA@$않/VX@$전망/NNG,-1,-0.3097375828639026,49,20,29,24,0.2769067651458141,0.5251586405559392
인플레이션/NNG@$억제/NNG@$금리/NNG@$인상/NNG,-1,-0.3097375828639026,49,20,29,16,0.2769067651458141,0.5251586405559392
억제/NNG@$기준금리/NNG@$인상/NNG,-1,-0.3097375828639026,49,20,29,21,0.2769067651458141,0.5251586405559392
지표/NNG@$좋/VA@$않/VX,0,-0.31011694789898936,42,17,25,16,0.2563101144234164,0.48650476925407826
통화정책/NNG@$긴축/NNG@$기조/NNG,0,-0.31011694789898936,42,17,25,12,0.2563101144234164,0.48650476925407826
가계부채/NNG@$증가/NNG@$우려/NNG,0,-0.31011694789898936,42,17,25,15,0.2563101144234164,0.48650476925407826
내수/NNG@$경기/NNG@$부양/NNG,0,-0.31011694789898936,42,17,25,16,0.2563101144234164,0.48650476925407826
성장률/NNG@$전망/NNG@$제시/NNG,-1,-0.3104060588069677,56,23,33,30,0.2957230052971464,0.5616739017243353
소폭/NNG@$상향/NNG@$조정/NNG,-1,-0.3104060588069677,56,23,33,20,0.2957230052971464,0.5616739017243353
인플레이션/NNG@$상승/NNG@$위험/NNG,-1,-0.3104060588069677,56,23,33,4,0.2957230052971464,0.5616739017243353
통화정책/NNG@$기조/NNG@$전환/NNG,-1,-0.3104060588069677,56,23,33,8,0.2957230052971464,0.5616739017243353
금리/NNG@$인상/NNG@$적절/XR,-1,-0.31061021102947517,119,50,69,68,0.4052008545510547,0.7699555748004351
금리/NNG@$인하/NNG@$부작용/NNG,-1,-0.3113888063297088,63,26,37,27,0.3129553375001445,0.595697980093508
우려/NNG@$적/VA@$않/VX,-1,-0.3113888063297088,63,26,37,17,0.3129553375001445,0.595697980093508
금융시장/NNG@$변동성/NNG@$확대/NNG,-1,-0.3120856205824015,188,79,109,83,0.43521962477546605,0.8297025216214087
지수/NNG@$오른/VV@$기록/NNG,-1,-0.31301997196609255,77,32,45,42,0.34312277961273235,0.655484805897629
전망/NNG@$통화정책/NNG@$완화/NNG@$기조/NNG@$유지/NNG,0,-0.31307335235226164,35,14,21,20,0.23354401592839813,0.44620374176261657
추진/NNG@$필요/NNG@$있/VA,0,-0.31307335235226164,35,14,21,13,0.23354401592839813,0.44620374176261657
인상/NNG@$시기/NNG@$가능성/NNG,0,-0.31307335235226164,35,14,21,14,0.23354401592839813,0.44620374176261657
인하/NNG@$가능성/NNG@$없/VA,0,-0.31307335235226164,35,14,21,21,0.23354401592839813,0.44620374176261657
시장/NNG@$금리/NNG@$오르/VV,0,-0.31307335235226164,35,14,21,14,0.23354401592839813,0.44620374176261657
상승/NNG@$압력/NNG@$커질/VV,-1,-0.31340807781776425,84,35,49,29,0.35623171690099503,0.6811132235810228
금리/NNG@$인상/NNG@$부담/NNG,-1,-0.317187036866728,186,78,108,37,0.43116036935817376,0.8313215919869362
경제/NNG@$하방/NNG@$리스크/NNG,-1,-0.31797010527483727,117,49,68,37,0.39834790712660806,0.7693943148504457
경기/NNG@$하강/NNG@$리스크/NNG,-1,-0.3197157490198902,179,75,104,28,0.4281488881741454,0.8301728534483914
경기/NNG@$둔화/NNG@$경제/NNG,-1,-0.3206672325041291,103,43,60,50,0.3808860726699682,0.7400982041797854
투자/NNG@$자금/NNG@$유입/NNG,-1,-0.3223757680781296,172,72,100,33,0.42476452104402906,0.8285086652971072
기업/NNG@$채산성/NNG@$악화/NNG,-1,-0.32292520711837036,82,34,48,18,0.34696659134546826,0.6775931289112331
기준금리/NNG@$사상/NNG@$최저치/NNG,-1,-0.3231807597254238,75,31,44,26,0.3332791192256829,0.6512341865854399
확장적/NNG@$정책/NNG@$기조/NNG,-1,-0.3232628464813304,68,28,40,13,0.31826168805061955,0.6220038010543079
통화/NNG@$완화/NNG@$조치/NNG,-1,-0.32331579837186974,61,25,36,22,0.3018213596841168,0.589942918416755
출구전략/NNG@$금리/NNG@$인상/NNG,-1,-0.32331579837186974,61,25,36,10,0.3018213596841168,0.589942918416755
경제/NNG@$완만/XR@$속도/NNG,-1,-0.32331579837186974,61,25,36,15,0.3018213596841168,0.589942918416755
고용/NNG@$시장/NNG@$악화/NNG,-1,-0.32331579837186974,61,25,36,24,0.3018213596841168,0.589942918416755
결정/NNG@$시장/NNG@$예상/NNG,-1,-0.3236267452224839,54,22,32,22,0.28384438322000766,0.5551903030976862
주의/NNG@$필요/NNG@$있/VA,-1,-0.3236267452224839,54,22,32,12,0.28384438322000766,0.5551903030976862
경기/NNG@$회복/NNG@$물가/NNG@$상승/NNG,-1,-0.3236267452224839,54,22,32,18,0.28384438322000766,0.5551903030976862
기록/NNG@$금리/NNG@$인상/NNG,-1,-0.32475332474224816,47,19,28,20,0.2641654352193525,0.5180010595320448
예상/NNG@$물가/NNG@$상승/NNG,-1,-0.32475332474224816,47,19,28,10,0.2641654352193525,0.5180010595320448
외환시장/NNG@$달러/NNG@$원/NNG,0,-0.3278025025088951,40,16,24,12,0.24249431220915627,0.47876152449119186
우려/NNG@$가시/VV@$않/VX,0,-0.3278025025088951,40,16,24,13,0.24249431220915627,0.47876152449119186
약세/NNG@$원화/NNG@$강세/NNG,0,-0.3278025025088951,40,16,24,16,0.24249431220915627,0.47876152449119186
구매자/NNG@$관리/NNG@$지수/NNG,0,-0.3278025025088951,40,16,24,16,0.24249431220915627,0.47876152449119186
경제/NNG@$성장/NNG@$금리/NNG,0,-0.3278025025088951,40,16,24,12,0.24249431220915627,0.47876152449119186
시장/NNG@$금리/NNG@$동결/NNG,-1,-0.32859759960642965,127,53,74,40,0.39979269705776826,0.7907264413642245
투자자들/NNG@$금리/NNG@$인상/NNG,-1,-0.32900062817451414,101,42,59,46,0.37297466378416333,0.7383513982649096
둔화/NNG@$우려/NNG@$금리/NNG,-1,-0.3317297158595873,87,36,51,29,0.350482638234061,0.6980881120985762
인상/NNG@$가능성/NNG@$무게/NNG,-1,-0.3328238646391789,80,33,47,19,0.337482855354581,0.6738502581260014
예상/NNG@$금리/NNG@$동결/NNG,-1,-0.3328238646391789,80,33,47,34,0.337482855354581,0.6738502581260014
경제성장률/NNG@$하향/NNG@$조정/NNG,-1,-0.33331816000612724,113,47,66,50,0.3841514333047521,0.7678862458809604
금리/NNG@$인하/NNG@$여부/NNG,-1,-0.33331816000612724,113,47,66,42,0.3841514333047521,0.7678862458809604
물가/NNG@$경제/NNG@$성장/NNG,-1,-0.3337964961281292,73,30,43,12,0.3231997406083561,0.6467445308951942
고려/NNG@$기준금리/NNG@$인상/NNG,-1,-0.3337964961281292,73,30,43,35,0.3231997406083561,0.6467445308951942
선제적/NNG@$금리/NNG@$인상/NNG,-1,-0.33405151057106175,144,60,84,37,0.4065874520164384,0.8140759943021261
금리/NNG@$인하/NNG@$통한/VV,-1,-0.3347634545377072,66,27,39,26,0.30754018091422286,0.6167495626143389
금리/NNG@$사상/NNG@$최저/NNG,-1,-0.3347634545377072,66,27,39,38,0.30754018091422286,0.6167495626143389
금리/NNG@$인상/NNG@$기정사실화/NNG,-1,-0.3347634545377072,66,27,39,22,0.30754018091422286,0.6167495626143389
하향/NNG@$조정/NNG@$기준금리/NNG,0,-0.3351188644859322,33,13,20,23,0.2182311380733864,0.43799716173264713
원유/NNG@$재고/NNG@$증가/NNG,0,-0.3351188644859322,33,13,20,24,0.2182311380733864,0.43799716173264713
경기/NNG@$부양/NNG@$목적/NNG,0,-0.3351188644859322,33,13,20,18,0.2182311380733864,0.43799716173264713
필요/NNG@$있/VA@$권고/NNG,0,-0.3351188644859322,33,13,20,31,0.2182311380733864,0.43799716173264713
경제/NNG@$불확실성/NNG@$확대/NNG,0,-0.3351188644859322,33,13,20,21,0.2182311380733864,0.43799716173264713
경제/NNG@$전망/NNG@$하방/NNG,0,-0.3351188644859322,33,13,20,17,0.2182311380733864,0.43799716173264713
금리/NNG@$상승/NNG@$우려/NNG,0,-0.3351188644859322,33,13,20,20,0.2182311380733864,0.43799716173264713
소비자/NNG@$물가/NNG@$낮/VA,-1,-0.33595101167159136,59,24,35,16,0.2903956932470582,0.5839275447118277
투자/NNG@$증권/NNG@$기준금리/NNG,-1,-0.33595101167159136,59,24,35,23,0.2903956932470582,0.5839275447118277
경기/NNG@$회복/NNG@$금리/NNG@$인상/NNG,-1,-0.33595101167159136,59,24,35,25,0.2903956932470582,0.5839275447118277
통화정책/NNG@$기준금리/NNG@$인하/NNG,-1,-0.3376005915230821,99,41,58,42,0.3648786651707002,0.7364322615329344
금리/NNG@$상승/NNG@$주택/NNG,-1,-0.33778714283126754,52,21,31,16,0.2716219671150278,0.5484437038503978
신용등급/NNG@$하향/NNG@$조정/NNG,-1,-0.33778714283126754,52,21,31,22,0.2716219671150278,0.5484437038503978
금융/NNG@$위기/NNG@$해소/NNG,-1,-0.33778714283126754,52,21,31,1,0.2716219671150278,0.5484437038503978
전망/NNG@$국내총생산/NNG@$성장률/NNG,-1,-0.33778714283126754,52,21,31,21,0.2716219671150278,0.5484437038503978
금리/NNG@$인하/NNG@$물가/NNG,-1,-0.34108914813318636,45,18,27,27,0.2509918261725654,0.510583994383539
완화/NNG@$기조/NNG@$지속/NNG,-1,-0.34108914813318636,45,18,27,19,0.2509918261725654,0.510583994383539
완화/NNG@$기준금리/NNG@$인하/NNG,-1,-0.34108914813318636,45,18,27,23,0.2509918261725654,0.510583994383539
상승/NNG@$원자재/NNG@$가격/NNG,-1,-0.34108914813318636,45,18,27,16,0.2509918261725654,0.510583994383539
인상/NNG@$시기/NNG@$예상/NNG,-1,-0.3413776852374646,85,35,50,32,0.3413479646832585,0.6948458773617772
지속/NNG@$물가/NNG@$기조/NNG@$유지/NNG,-1,-0.343133227878868,78,32,46,18,0.32777598336030705,0.6698766754375872
기준금리/NNG@$인하/NNG@$필요/NNG,-1,-0.34490769661133314,71,29,42,22,0.31287816864364315,0.6420081731344157
주가/NNG@$환율/NNG@$등가격/NNG@$변수/NNG,0,-0.3467214222109495,21,8,13,8,0.17633722108114822,0.36332729656478696
시장/NNG@$기준금리/NNG@$동결/NNG,-1,-0.3469412460760378,152,63,89,36,0.4009631785269122,0.8265621150746135
인플레이션/NNG@$압력/NNG@$완화/NNG,-1,-0.3469412460760378,152,63,89,55,0.4009631785269122,0.8265621150746135
경기/NNG@$개선/NNG@$추세/NNG,0,-0.347489375531411,38,15,23,11,0.22808385574201143,0.47076777176124046
금리/NNG@$인상/NNG@$기정사실/NNG,0,-0.347489375531411,38,15,23,18,0.22808385574201143,0.47076777176124046
물가/NNG@$보/VV@$소비자/NNG,0,-0.34827307450642764,16,6,10,1,0.15999860273653962,0.33082820552057346
유로화/NNG@$사용/NNG@$경제/NNG,-1,-0.34938269567091984,57,23,34,21,0.2786622327577611,0.5776454959121445
금리/NNG@$인상/NNG@$예고/NNG,-1,-0.35074804206540344,145,60,85,46,0.39528415311726556,0.8219468852741815
달러/NNG@$가치/NNG@$하락/NNG,-1,-0.35262113627304026,102,42,60,51,0.3592271930412938,0.7501696106106477
수요/NNG@$압력/NNG@$증대/NNG,-1,-0.3538862263257657,76,31,45,30,0.3178410430114133,0.6656643622199504
기준금리/NNG@$올릴/VV@$가능성/NNG,-1,-0.35565841740267556,95,39,56,22,0.34812312619044816,0.7320462429831324
생각/NNG@$금리/NNG@$인상/NNG,-1,-0.35656076367418577,69,28,41,22,0.3023071376474153,0.6370174285237156
금리/NNG@$인상/NNG@$계획/NNG,-1,-0.35870436570712727,88,36,52,47,0.33589036817378176,0.7112702879697118
외국인/NNG@$자금/NNG@$유출/NNG,-1,-0.3587053380775994,131,54,77,37,0.38197210054234826,0.8088532385943747
모기지/NNG@$주택/NNG@$담보대출/NNG,-1,-0.35898702040858077,43,17,26,17,0.2373367096851851,0.5029024249123001
금리/NNG@$격차/NNG@$축소/NNG,-1,-0.35898702040858077,43,17,26,26,0.2373367096851851,0.5029024249123001
정상화/NNG@$기조/NNG@$유지/NNG,-1,-0.35898702040858077,43,17,26,9,0.2373367096851851,0.5029024249123001
담보대출/NNG@$모기지/NNG@$금리/NNG,-1,-0.35898702040858077,43,17,26,19,0.2373367096851851,0.5029024249123001
전세/NNG@$가격/NNG@$상승/NNG,-1,-0.3596815910086332,62,25,37,19,0.2852803157769912,0.6054567310161971
부진/NNG@$경기/NNG@$둔화/NNG,-1,-0.3596815910086332,62,25,37,20,0.2852803157769912,0.6054567310161971
정책/NNG@$결정/NNG@$영향/NNG,0,-0.3605405033311214,31,12,19,22,0.20199766345497383,0.42955081082648033
물가/NNG@$상승률/NNG@$기준금리/NNG,0,-0.3605405033311214,31,12,19,25,0.20199766345497383,0.42955081082648033
움직임/NNG@$보이/VV@$않/VX,0,-0.3605405033311214,31,12,19,10,0.20199766345497383,0.42955081082648033
수출/NNG@$타격/NNG@$입/VV,0,-0.3605405033311214,31,12,19,23,0.20199766345497383,0.42955081082648033
변수/NNG@$변동성/NNG@$확대/NNG,0,-0.3605405033311214,31,12,19,14,0.20199766345497383,0.42955081082648033
금융/NNG@$외환시장/NNG@$불안/NNG,0,-0.3605405033311214,31,12,19,14,0.20199766345497383,0.42955081082648033
경제/NNG@$좋/VA@$않/VX,-1,-0.36157622016026836,100,41,59,39,0.3510669168361722,0.7483283423972797
美/NNG@$금리/NNG@$인상/NNG,-1,-0.36157622016026836,100,41,59,40,0.3510669168361722,0.7483283423972797
예상/NNG@$기준금리/NNG@$동결/NNG,-1,-0.36157622016026836,100,41,59,30,0.3510669168361722,0.7483283423972797
경제/NNG@$수출/NNG@$호조/NNG,-1,-0.3637157463509789,55,22,33,13,0.26660214203308036,0.5710904750523211
기준금리/NNG@$인하/NNG@$경제/NNG,-1,-0.3637157463509789,55,22,33,19,0.26660214203308036,0.5710904750523211
금리/NNG@$인하/NNG@$조치/NNG,-1,-0.3679763654814885,344,141,203,66,0.39694077996763527,0.8586931951848426
금리/NNG@$동결/NNG@$결정/NNG,-1,-0.36823947566177306,427,175,252,145,0.39674713541883255,0.8587966863573694
경제/NNG@$성장/NNG@$영향/NNG,-1,-0.3695216416602738,48,19,29,28,0.24603077362269554,0.5341393811049706
비철/NNG@$금속/NNG@$가격/NNG,-1,-0.3695216416602738,48,19,29,15,0.24603077362269554,0.5341393811049706
물가/NNG@$상승률/NNG@$달성/NNG,-1,-0.3695216416602738,48,19,29,29,0.24603077362269554,0.5341393811049706
회복세/NNG@$보이/VV@$경제/NNG,-1,-0.3695216416602738,48,19,29,14,0.24603077362269554,0.5341393811049706
소비자/NNG@$물가/NNG@$상승률/NNG@$예상/NNG,-1,-0.3695216416602738,48,19,29,15,0.24603077362269554,0.5341393811049706
금리/NNG@$올릴/VV@$필요/NNG,-1,-0.3695216416602738,48,19,29,18,0.24603077362269554,0.5341393811049706
소수/NNG@$의견/NNG@$나올/VV,-1,-0.3695216416602738,48,19,29,18,0.24603077362269554,0.5341393811049706
완화적/NNG@$통화정책/NNG@$유지/NNG,0,-0.3696348259825373,36,14,22,25,0.21298522193921185,0.4625178073062257
달러/NNG@$강세/NNG@$보이/VV,0,-0.3696348259825373,36,14,22,14,0.21298522193921185,0.4625178073062257
고용/NNG@$시장/NNG@$부진/NNG,0,-0.3696348259825373,36,14,22,21,0.21298522193921185,0.4625178073062257
예상/NNG@$채권/NNG@$시장/NNG,0,-0.3696348259825373,36,14,22,15,0.21298522193921185,0.4625178073062257
기준금리/NNG@$인하/NNG@$단행/NNG,-1,-0.37137214817222874,110,45,65,36,0.3561546184230584,0.7765439545722334
물가/NNG@$상승률/NNG@$예상/NNG,-1,-0.37193084274921884,139,57,82,48,0.3775006939922324,0.8241533974736157
지수/NNG@$하락/NNG@$기록/NNG,-1,-0.372671816748504,79,32,47,21,0.31265752654091733,0.6837637492402691
도시/NNG@$주택/NNG@$가격/NNG,-1,-0.372671816748504,79,32,47,42,0.31265752654091733,0.6837637492402691
금리/NNG@$인상/NNG@$결정/NNG,-1,-0.37358825027968035,494,202,292,172,0.39277295129782247,0.8608017945495805
엔화/NNG@$가치/NNG@$하락/NNG,-1,-0.37687735281958223,72,29,43,47,0.2972648127690847,0.656491175187683
자산/NNG@$매입/NNG@$규모/NNG@$축소/NNG,-1,-0.37687735281958223,72,29,43,47,0.2972648127690847,0.656491175187683
전망/NNG@$기준금리/NNG@$인상/NNG,-1,-0.37687735281958223,72,29,43,20,0.2972648127690847,0.656491175187683
양적완화/NNG@$규모/NNG@$줄이/VV,0,-0.3787507482675194,41,16,25,16,0.22314103040077368,0.494951066144726
경제/NNG@$회복/NNG@$기대감/NNG,0,-0.3787507482675194,41,16,25,11,0.22314103040077368,0.494951066144726
정책/NNG@$수단/NNG@$활용/NNG,0,-0.3787507482675194,41,16,25,30,0.22314103040077368,0.494951066144726
경제/NNG@$회복/NNG@$기대/NNG,0,-0.3787507482675194,41,16,25,10,0.22314103040077368,0.494951066144726
무담보/NNG@$콜론/NNG@$금리/NNG@$동결/NNG,0,-0.3787507482675194,41,16,25,22,0.22314103040077368,0.494951066144726
영향/NNG@$소비자/NNG@$물가/NNG,0,-0.3787507482675194,41,16,25,10,0.22314103040077368,0.494951066144726
콜론/NNG@$금리/NNG@$동결/NNG,0,-0.3787507482675194,41,16,25,23,0.22314103040077368,0.494951066144726
소비/NNG@$투자/NNG@$부진/NNG,0,-0.3787507482675194,41,16,25,32,0.22314103040077368,0.494951066144726
대응/NNG@$한계/NNG@$있/VA,0,-0.3787507482675194,41,16,25,13,0.22314103040077368,0.494951066144726
국내총생산/NNG@$갭/NNG@$마이너스/NNG,-1,-0.37907540669319295,53,21,32,9,0.25419348158943605,0.5642562573992765
경기/NNG@$위축/NNG@$우려/NNG,-1,-0.37907540669319295,53,21,32,21,0.25419348158943605,0.5642562573992765
규모/NNG@$자산/NNG@$매입/NNG@$프로그램/NNG,-1,-0.37907540669319295,53,21,32,17,0.25419348158943605,0.5642562573992765
위기/NNG@$이전/NNG@$회복/NNG,-1,-0.379316990204555,84,34,50,27,0.3172759201424601,0.7046834465011862
지속적/NNG@$경제/NNG@$성장/NNG,-1,-0.3817140425887495,65,26,39,30,0.28038298655040234,0.6262420799221925
가격/NNG@$하락/NNG@$물가/NNG,-1,-0.3817140425887495,65,26,39,13,0.28038298655040234,0.6262420799221925
유지/NNG@$금리/NNG@$인상/NNG,-1,-0.38329771723329764,275,112,163,87,0.3855128956724427,0.8642516100785284
성장/NNG@$지속/NNG@$물가/NNG@$기조/NNG@$유지/NNG,-1,-0.38398808197827883,77,31,46,17,0.3026515788029365,0.6795901761667116
지속/NNG@$가능/NNG@$경제/NNG@$성장/NNG,-1,-0.38509080439861876,101,41,60,27,0.33749049326403996,0.7597824926389867
동결/NNG@$가능성/NNG@$높/VA,-1,-0.38644888662889776,157,64,93,60,0.37455155497452647,0.8459109837763389
금리/NNG@$인상/NNG@$대외/NNG,-1,-0.38747757929447413,46,18,28,15,0.23259108473453624,0.5265705737512798
양적/NNG@$통화/NNG@$완화/NNG,-1,-0.38747757929447413,46,18,28,8,0.23259108473453624,0.5265705737512798
수출/NNG@$기업/NNG@$채산성/NNG@$악화/NNG,-1,-0.38747757929447413,46,18,28,8,0.23259108473453624,0.5265705737512798
증권/NNG@$금리/NNG@$인하/NNG,-1,-0.38747757929447413,46,18,28,15,0.23259108473453624,0.5265705737512798
가능성/NNG@$유의/NNG@$필요/NNG@$있/VA,0,-0.38917466771210685,24,9,15,6,0.17052784397297688,0.3876091139021326
경제/NNG@$민간/NNG@$소비/NNG,0,-0.38917466771210685,24,9,15,18,0.17052784397297688,0.3876091139021326
주가/NNG@$하락/NNG@$환율/NNG,0,-0.38917466771210685,24,9,15,15,0.17052784397297688,0.3876091139021326
금리/NNG@$인상/NNG@$의지/NNG,-1,-0.3902424295110838,94,38,56,19,0.32547936690948553,0.7416777284046542
감소세/NNG@$지속/NNG@$소비/NNG,0,-0.39032593412720384,29,11,18,22,0.1846524989011625,0.4208550044579047
하락/NNG@$종합/NNG@$지수/NNG,0,-0.39032593412720384,29,11,18,22,0.1846524989011625,0.4208550044579047
금리/NNG@$인상/NNG@$영향/NNG,-1,-0.39057764411706175,177,72,105,51,0.37607107037292864,0.8576401241453504
둔화/NNG@$수출/NNG@$부진/NNG,0,-0.3948354532212005,34,13,21,17,0.19708541330703055,0.4540049313312011
금리/NNG@$경기/NNG@$회복/NNG,-1,-0.39534696702335104,63,25,38,12,0.2690103487129347,0.6204422213572679
물가/NNG@$하락/NNG@$압력/NNG,-1,-0.39534696702335104,63,25,38,41,0.2690103487129347,0.6204422213572679
소비자/NNG@$물가/NNG@$상승률/NNG@$목표/NNG,-1,-0.3956117991815641,51,20,31,27,0.24141087814566778,0.557136694226401
금리/NNG@$인하/NNG@$대응/NNG,-1,-0.3956117991815641,51,20,31,16,0.24141087814566778,0.557136694226401
신호/NNG@$보내/VV@$않/VX,-1,-0.3956117991815641,51,20,31,15,0.24141087814566778,0.557136694226401
기준금리/NNG@$결정/NNG@$전문가별/NNG,-1,-0.3956117991815641,51,20,31,37,0.24141087814566778,0.557136694226401
완화적/NNG@$정책/NNG@$기조/NNG@$유지/NNG,0,-0.39577326746779284,19,7,12,12,0.15360850659624214,0.3546389346263181
금리/NNG@$인하/NNG@$결정/NNG,-1,-0.4001905692562544,277,112,165,117,0.37305095065407035,0.8703549506260893
경기/NNG@$회복/NNG@$지원/NNG,-1,-0.4004557288690622,92,37,55,26,0.3165745196580504,0.7390577381224847
성장세/NNG@$둔화/NNG@$우려/NNG,0,-0.40076368723281064,39,15,24,15,0.20833492588870162,0.48672425802837205
하방/NNG@$리스크/NNG@$커지/VV,0,-0.40076368723281064,39,15,24,22,0.20833492588870162,0.48672425802837205
금융정책/NNG@$열/VV@$기준금리/NNG,0,-0.40076368723281064,39,15,24,26,0.20833492588870162,0.48672425802837205
딜러/NNG@$금리/NNG@$인하/NNG,0,-0.40076368723281064,39,15,24,16,0.20833492588870162,0.48672425802837205
차지/NNG@$비중/NNG@$높/VA,0,-0.40076368723281064,39,15,24,17,0.20833492588870162,0.48672425802837205
기준금리/NNG@$인하/NNG@$조치/NNG,-1,-0.40305999191010344,56,22,34,16,0.24965093581588196,0.5864513030729865
채권/NNG@$투자/NNG@$자금/NNG,-1,-0.40664832323864886,85,34,51,23,0.3028316228467263,0.7175072282621197
엔화/NNG@$약세/NNG@$지속/NNG,-1,-0.4071542347739283,44,17,27,23,0.2186646730644421,0.518716531539199
상승/NNG@$압력/NNG@$크/VA@$않/VX@$전망/NNG,-1,-0.4071542347739283,44,17,27,21,0.2186646730644421,0.518716531539199
가격/NNG@$상승/NNG@$압력/NNG,-1,-0.40817264569162215,73,29,44,19,0.2819482421917969,0.6704730306508839
지속/NNG@$기준금리/NNG@$인상/NNG,-1,-0.4097903959727439,61,24,37,18,0.25734903245118984,0.614357521570011
통화정책/NNG@$기조/NNG@$변화/NNG,-1,-0.4122159625019566,134,54,80,51,0.34713075861930537,0.8335386671154086
광공업/NNG@$생산/NNG@$증가/NNG,-1,-0.41344131401059514,78,31,47,26,0.28776314947031034,0.6930272096493444
증가/NNG@$시장/NNG@$예상치/NNG,-1,-0.4135054121504662,49,19,30,18,0.22822531547958433,0.5497257146127305
통화/NNG@$완화/NNG@$기조/NNG@$유지/NNG,-1,-0.4135054121504662,49,19,30,8,0.22822531547958433,0.5497257146127305
국채/NNG@$가격/NNG@$상승/NNG,-1,-0.4135054121504662,49,19,30,22,0.22822531547958433,0.5497257146127305
상승률/NNG@$농산물/NNG@$가격/NNG,-1,-0.4135054121504662,49,19,30,12,0.22822531547958433,0.5497257146127305
유럽연합/NNG@$탈퇴/NNG@$브렉시트/NNG,-1,-0.41590815423419825,117,47,70,66,0.3334213029384154,0.8077835618346267
경기/NNG@$회복세/NNG@$보이/VV,-1,-0.4180388032706296,100,40,60,33,0.3157500698566184,0.7689256314506636
차원/NNG@$금리/NNG@$인하/NNG,-1,-0.4195480012675412,54,21,33,33,0.23711105637711669,0.579537721469152
의심/NNG@$여지/NNG@$없/VA,-1,-0.4195480012675412,54,21,33,16,0.23711105637711669,0.579537721469152
경기/NNG@$둔화/NNG@$우려/NNG@$금리/NNG,-1,-0.4195480012675412,54,21,33,22,0.23711105637711669,0.579537721469152
금리/NNG@$인상/NNG@$점쳤/VV,-1,-0.4195480012675412,54,21,33,15,0.23711105637711669,0.579537721469152
자금/NNG@$유출/NNG@$우려/NNG,-1,-0.42199080341303374,88,35,53,30,0.29818969525444905,0.7331616172063745
대내외/NNG@$경제/NNG@$변화/NNG,0,-0.42207125244133026,14,5,9,3,0.1310820113319871,0.3223555636483545
동결/NNG@$기조/NNG@$유지/NNG,-1,-0.4231267618666029,157,63,94,56,0.3486244793105247,0.8595390583152857
회복세/NNG@$지속/NNG@$예상/NNG,0,-0.42387197306125823,32,12,20,4,0.18025181423044917,0.44522115719460786
체감/NNG@$경기/NNG@$수치화/NNG,0,-0.42387197306125823,32,12,20,18,0.18025181423044917,0.44522115719460786
서비스수지/NNG@$적자/NNG@$확대/NNG,0,-0.42387197306125823,32,12,20,18,0.18025181423044917,0.44522115719460786
금리/NNG@$인하/NNG@$기준금리/NNG,-1,-0.4251403313991544,59,23,36,20,0.24538627719158826,0.6079805756831356
경제/NNG@$침체/NNG@$빠질/VV,-1,-0.4251403313991544,59,23,36,17,0.24538627719158826,0.6079805756831356
사상/NNG@$최저/NNG@$금리/NNG,-1,-0.4251403313991544,59,23,36,23,0.24538627719158826,0.6079805756831356
전망/NNG@$기준금리/NNG@$인하/NNG,-1,-0.4251403313991544,59,23,36,23,0.24538627719158826,0.6079805756831356
전통적/NNG@$통화정책/NNG@$수단/NNG,0,-0.42551078021989563,37,14,23,12,0.1928376629034758,0.47821583961841146
경제/NNG@$성장/NNG@$속도/NNG@$둔화/NNG,0,-0.42551078021989563,37,14,23,14,0.1928376629034758,0.47821583961841146
통화/NNG@$달러/NNG@$가치/NNG,0,-0.42551078021989563,37,14,23,27,0.1928376629034758,0.47821583961841146
소비자/NNG@$물가/NNG@$근원물가/NNG,0,-0.42551078021989563,37,14,23,8,0.1928376629034758,0.47821583961841146
끝/NNG@$나지/NNG@$않/VX,0,-0.42551078021989563,37,14,23,13,0.1928376629034758,0.47821583961841146
전망/NNG@$경제성장률/NNG@$전망치/NNG,0,-0.42551078021989563,37,14,23,18,0.1928376629034758,0.47821583961841146
완화/NNG@$정책/NNG@$지속/NNG,0,-0.42551078021989563,37,14,23,15,0.1928376629034758,0.47821583961841146
성장세/NNG@$둔화/NNG@$경제/NNG,0,-0.425825055636466,27,10,17,12,0.1659676645038118,0.41189718262946895
종합/NNG@$지수/NNG@$내린/VV,0,-0.425825055636466,27,10,17,33,0.1659676645038118,0.41189718262946895
상승/NNG@$가능성/NNG@$크/VA,-1,-0.4288695169034704,42,16,26,18,0.20420078560430585,0.5105715289066873
인상/NNG@$속도/NNG@$조절/NNG,-1,-0.4288695169034704,42,16,26,14,0.20420078560430585,0.5105715289066873
소비자/NNG@$물가/NNG@$상승률/NNG@$둔화/NNG,-1,-0.4288695169034704,42,16,26,20,0.20420078560430585,0.5105715289066873
경제/NNG@$나쁘/VA@$않/VX,-1,-0.4288695169034704,42,16,26,11,0.20420078560430585,0.5105715289066873
효과/NNG@$지켜볼/VV@$필요/NNG@$있/VA,-1,-0.42986679623860835,81,32,49,25,0.2833010941938843,0.7100828079088659
경제/NNG@$둔화/NNG@$가능성/NNG,-1,-0.42986679623860835,81,32,49,28,0.2833010941938843,0.7100828079088659
금리/NNG@$인상/NNG@$예측/NNG,-1,-0.4302141854245486,64,25,39,17,0.25309895379997016,0.634923115602748
해외/NNG@$자본/NNG@$유입/NNG,-1,-0.4302141854245486,64,25,39,21,0.25309895379997016,0.634923115602748
인플레이션/NNG@$압력/NNG@$크/VA,-1,-0.43297359971643656,47,18,29,20,0.21460418593964795,0.542017326511436
인하/NNG@$경기/NNG@$부양/NNG@$효과/NNG,-1,-0.43297359971643656,47,18,29,12,0.21460418593964795,0.542017326511436
가계/NNG@$실질/NNG@$구매력/NNG,-1,-0.43297359971643656,47,18,29,13,0.21460418593964795,0.542017326511436
자산/NNG@$축소/NNG@$시작/NNG,-1,-0.43297359971643656,47,18,29,37,0.21460418593964795,0.542017326511436
기조/NNG@$유지/NNG@$예상/NNG,-1,-0.43297359971643656,47,18,29,26,0.21460418593964795,0.542017326511436
경제/NNG@$둘러싼/VV@$불확실성/NNG,-1,-0.43297359971643656,47,18,29,10,0.21460418593964795,0.542017326511436
금리/NNG@$인하/NNG@$통화정책/NNG,-1,-0.43336027385843123,86,34,52,26,0.28870608949947774,0.729867762371959
금리/NNG@$인하/NNG@$부정적/NNG,-1,-0.43474494222967597,69,27,42,32,0.2602877268644998,0.660272464962594
통화정책/NNG@$완화/NNG@$축소/NNG,0,-0.4353012988199232,22,8,14,19,0.14903952068407061,0.3785878966833872
경기/NNG@$회복/NNG@$자신감/NNG,-1,-0.43654625047844575,123,49,74,46,0.32422137541551765,0.8261166849877043
수출/NNG@$경제/NNG@$성장/NNG,-1,-0.43728733177497725,52,20,32,14,0.22420581313355312,0.572323840217349
전망/NNG@$기준금리/NNG@$동결/NNG,-1,-0.43728733177497725,52,20,32,9,0.22420581313355312,0.572323840217349
금리/NNG@$인상/NNG@$고려/NNG,-1,-0.43809060332263716,148,59,89,48,0.3354342124774761,0.8579559600648418
소비/NNG@$심리/NNG@$위축/NNG,-1,-0.43825815167974,264,105,159,93,0.3451989168822875,0.8832976933776375
갭/NNG@$마이너스/NNG@$상태/NNG,-1,-0.44546693611175825,62,24,38,8,0.24138295581424804,0.6288129629867893
석유류/NNG@$가격/NNG@$하락/NNG,-1,-0.44546693611175825,62,24,38,18,0.24138295581424804,0.6288129629867893
금리/NNG@$인하/NNG@$있/VA,-1,-0.44546693611175825,62,24,38,16,0.24138295581424804,0.6288129629867893
우려/NNG@$금리/NNG@$동결/NNG,-1,-0.44546693611175825,62,24,38,17,0.24138295581424804,0.6288129629867893
금리/NNG@$인상/NNG@$점진적/NNG,-1,-0.44766845440186365,89,35,54,30,0.2844218236280979,0.7450154530440914
의미/NNG@$금리/NNG@$인상/NNG,-1,-0.4530144759321961,40,15,25,18,0.1891434561745856,0.502129690626287
경제/NNG@$경기/NNG@$회복세/NNG,-1,-0.4530144759321961,40,15,25,11,0.1891434561745856,0.502129690626287
인상/NNG@$전망/NNG@$금리/NNG,-1,-0.4530144759321961,40,15,25,19,0.1891434561745856,0.502129690626287
문제/NNG@$금리/NNG@$인하/NNG,-1,-0.4530144759321961,40,15,25,19,0.1891434561745856,0.502129690626287
인플레율/NNG@$상승/NNG@$압력/NNG,-1,-0.4530144759321961,40,15,25,29,0.1891434561745856,0.502129690626287
경상수지/NNG@$흑자/NNG@$규모/NNG,-1,-0.4533734985057267,149,59,90,55,0.3252228484098653,0.864167436795512
조정/NNG@$가능성/NNG@$있/VA,0,-0.45360432744456325,35,13,22,20,0.1765596846462857,0.4694190178861848
금융시장/NNG@$불안/NNG@$금리/NNG,0,-0.45360432744456325,35,13,22,13,0.1765596846462857,0.4694190178861848
가능성/NNG@$낮/VA@$진/VX,0,-0.45360432744456325,35,13,22,13,0.1765596846462857,0.4694190178861848
자산/NNG@$매입/NNG@$규모/NNG@$유지/NNG,-1,-0.4542779877217066,45,17,28,31,0.20051184099998287,0.5340056198379929
소비자/NNG@$물가/NNG@$기준/NNG,-1,-0.4542779877217066,45,17,28,9,0.20051184099998287,0.5340056198379929
동결/NNG@$결정/NNG@$금리/NNG,-1,-0.4542779877217066,45,17,28,10,0.20051184099998287,0.5340056198379929
주택/NNG@$담보대출/NNG@$증가/NNG,-1,-0.45439150720671717,114,45,69,22,0.30610423754387006,0.8154537561798343
유동성/NNG@$공급/NNG@$확대/NNG,-1,-0.454814469089042,119,47,72,17,0.30953032703286404,0.8254600768590031
성장/NNG@$속도/NNG@$둔화/NNG,-1,-0.4550636765599382,77,30,47,28,0.26293230571723236,0.7016324131332756
매입/NNG@$규모/NNG@$늘리/VV,-1,-0.45645963724572025,50,19,31,13,0.21091224097288672,0.5648032561011119
투자/NNG@$심리/NNG@$악화/NNG,-1,-0.45645963724572025,50,19,31,25,0.21091224097288672,0.5648032561011119
인하/NNG@$시장/NNG@$금리/NNG,-1,-0.45645963724572025,50,19,31,10,0.21091224097288672,0.5648032561011119
경기/NNG@$상승/NNG@$하강/NNG,-1,-0.457440895678504,82,32,50,11,0.269148305021961,0.7225431748818769
가계부채/NNG@$문제/NNG@$악화/NNG,0,-0.4577618944709969,30,11,19,12,0.16233721739880486,0.43615690536184665
인플레이션/NNG@$압력/NNG@$증대/NNG,0,-0.4577618944709969,30,11,19,12,0.16233721739880486,0.43615690536184665
경제/NNG@$회복/NNG@$수출/NNG,-1,-0.4590248991703,55,21,34,19,0.2204998349354974,0.594321103699064
차원/NNG@$금리/NNG@$인상/NNG,-1,-0.4594203846510285,87,34,53,18,0.27493240334695906,0.7417779629899754
인상/NNG@$속도/NNG@$완만/XR,-1,-0.461660423366248,60,23,37,20,0.22937875527246476,0.622399855614579
경제/NNG@$금리/NNG@$인하/NNG,-1,-0.4628733800494559,137,54,83,32,0.31426249324842903,0.8553583544162737
물가/NNG@$상승률/NNG@$둔화/NNG,-1,-0.4634675228578997,132,52,80,66,0.31153966290712004,0.8492305366352969
기준금리/NNG@$인상/NNG@$가능/NNG,-1,-0.46418157930914006,65,25,40,20,0.23762361375843358,0.6489208214371437
경제/NNG@$성장/NNG@$물가/NNG,-1,-0.46518356458364263,211,83,128,49,0.3251286854830866,0.8901575431931229
부정적/NNG@$영향/NNG@$가능성/NNG,-1,-0.4664816191779939,70,27,43,38,0.2452912953410512,0.6738030826314877
심리/NNG@$나타내/VV@$소비자심리지수/NNG,-1,-0.46850222821137255,75,29,46,24,0.25242765273760026,0.6969997971575597
자본/NNG@$유출/NNG@$확대/NNG,0,-0.4688653838167387,25,9,16,18,0.1456934589000547,0.4026612274757177
금리/NNG@$내릴/VV@$가능성/NNG,-1,-0.4727017182599097,90,35,55,24,0.27101330011212105,0.7564311031342902
전망/NNG@$성장률/NNG@$전망치/NNG,-1,-0.4734909610655764,95,37,58,36,0.2763698276928994,0.7729513966733946
경기/NNG@$회복/NNG@$확신/NNG,-1,-0.47364427837952583,120,47,73,26,0.29799628057892447,0.8337656315538684
경기/NNG@$둔화/NNG@$인플레이션/NNG,-1,-0.4742463634302888,105,41,64,37,0.28598364179624514,0.8013984179037537
물가/NNG@$상승률/NNG@$농산물/NNG@$가격/NNG,-1,-0.4772790514874905,48,18,30,12,0.1972064533632118,0.556969773482351
기업/NNG@$체감/NNG@$경기/NNG,-1,-0.4777322977373897,43,16,27,17,0.1859110402637565,0.5256847768883203
물가/NNG@$상승률/NNG@$지속/NNG,-1,-0.4777322977373897,43,16,27,21,0.1859110402637565,0.5256847768883203
하강/NNG@$국면/NNG@$진입/NNG,-1,-0.4777322977373897,43,16,27,18,0.1859110402637565,0.5256847768883203
지준율/NNG@$인상/NNG@$효과/NNG,-1,-0.4777322977373897,43,16,27,12,0.1859110402637565,0.5256847768883203
기준금리/NNG@$인하/NNG@$동결/NNG,-1,-0.4777322977373897,43,16,27,13,0.1859110402637565,0.5256847768883203
금리/NNG@$인하/NNG@$기조/NNG,-1,-0.47782047739275413,143,56,87,37,0.306536404077984,0.8669648245006812
금리/NNG@$인상/NNG@$마무리/NNG,-1,-0.4778405220040791,53,20,33,9,0.20754600669706594,0.5870246677196772
회복/NNG@$속도/NNG@$빠르/VA,-1,-0.4778405220040791,53,20,33,9,0.20754600669706594,0.5870246677196772
경제/NNG@$호조/NNG@$지속/NNG,-1,-0.478904023488699,58,22,36,10,0.21707666801128933,0.6156762511053546
원자재/NNG@$가격/NNG@$하락/NNG,-1,-0.4795396179212361,374,146,228,155,0.3156135647796869,0.8966257752611366
동결/NNG@$인상/NNG@$가능성/NNG,0,-0.4800673386211899,38,14,24,18,0.17343437671372944,0.49338495868661864
기업/NNG@$많/VA@$의미/NNG,0,-0.4800673386211899,38,14,24,13,0.17343437671372944,0.49338495868661864
부동산/NNG@$대책/NNG@$효과/NNG,0,-0.4800673386211899,38,14,24,18,0.17343437671372944,0.49338495868661864
금융/NNG@$위기/NNG@$낮/VA,0,-0.4800673386211899,38,14,24,20,0.17343437671372944,0.49338495868661864
재정/NNG@$건전성/NNG@$악화/NNG,-1,-0.48015922870370553,63,24,39,29,0.22590013271030304,0.6427926188677782
경기/NNG@$하강/NNG@$속도/NNG,-1,-0.4814167658758106,68,26,42,12,0.23409094378483652,0.6682808244361539
더블딥/NNG@$경기/NNG@$상승/NNG@$하강/NNG,-1,-0.4825621023744996,73,28,45,10,0.24170678540919815,0.6920834643618448
외환/NNG@$위기/NNG@$금융/NNG,-1,-0.4825621023744996,73,28,45,26,0.24170678540919815,0.6920834643618448
저금리/NNG@$기조/NNG@$지속/NNG,-1,-0.48352819942107217,78,30,48,28,0.248794510652798,0.714174630783805
담보/NNG@$증권/NNG@$매입/NNG,-1,-0.4840450618445984,113,44,69,35,0.28645573784626316,0.8233926492680713
원화/NNG@$강세/NNG@$수출/NNG,-1,-0.48496971126576294,103,40,63,59,0.27754868093264085,0.7997193807988803
건전성/NNG@$종/NNG@$세트/NNG,0,-0.48580998869950964,33,12,21,19,0.15940904147722645,0.4603262547059719
거시/NNG@$금융/NNG@$경제/NNG,0,-0.48580998869950964,33,12,21,19,0.15940904147722645,0.4603262547059719
수출/NNG@$증가세/NNG@$유지/NNG,0,-0.48580998869950964,33,12,21,14,0.15940904147722645,0.4603262547059719
상승/NNG@$압력/NNG@$높/VA@$않/VX,0,-0.48580998869950964,33,12,21,15,0.15940904147722645,0.4603262547059719
금리/NNG@$인하/NNG@$가능성/NNG@$배제/NNG@$없/VA,0,-0.48580998869950964,33,12,21,22,0.15940904147722645,0.4603262547059719
경제/NNG@$소비자들/NNG@$심리/NNG,0,-0.48580998869950964,33,12,21,21,0.15940904147722645,0.4603262547059719
해외/NNG@$자본/NNG@$유출/NNG,0,-0.48580998869950964,33,12,21,23,0.15940904147722645,0.4603262547059719
하방/NNG@$리스크/NNG@$있/VA,0,-0.48580998869950964,33,12,21,18,0.15940904147722645,0.4603262547059719
물가/NNG@$상승률/NNG@$낮/VA,-1,-0.48954166885598793,386,150,236,179,0.30851161737950145,0.8996527865824744
소비자/NNG@$물가/NNG@$상승률/NNG@$낮/VA,-1,-0.49204944387034477,121,47,74,58,0.28674854098465585,0.8417296049880484
경기/NNG@$회복/NNG@$뒷받침/NNG,-1,-0.4938550783311786,206,80,126,48,0.30466491037167054,0.8985962239436104
금리/NNG@$인상/NNG@$압박/NNG,-1,-0.4972955378288856,71,27,44,28,0.23076820991203087,0.686874402130129
전망/NNG@$물가/NNG@$상승률/NNG,-1,-0.4973226848133451,56,21,35,20,0.20446744309580187,0.6086348666460745
소비자/NNG@$물가/NNG@$상승률/NNG@$전망치/NNG,-1,-0.49733500365184136,86,33,53,31,0.2518898863410763,0.7498210032791982
주례/NNG@$경제/NNG@$동향/NNG,-1,-0.4974186851581439,76,29,47,18,0.23831716209455636,0.7095756709332757
수요/NNG@$하방/NNG@$압력/NNG,0,-0.49780793960790726,28,10,18,9,0.14319657166201577,0.42680074184118605
성장세/NNG@$보일/VV@$전망/NNG,0,-0.49780793960790726,28,10,18,24,0.14319657166201577,0.42680074184118605
소비자/NNG@$물가/NNG@$오르/VV,-1,-0.4981299223832527,51,19,32,13,0.19423184728788012,0.5794082642399839
금리/NNG@$인상/NNG@$필요/NNG@$있/VA,-1,-0.4981299223832527,51,19,32,18,0.19423184728788012,0.5794082642399839
인상/NNG@$시장/NNG@$예상/NNG,-1,-0.4981299223832527,51,19,32,20,0.19423184728788012,0.5794082642399839
경기/NNG@$회복/NNG@$긍정적/NNG,-1,-0.4981299223832527,51,19,32,26,0.19423184728788012,0.5794082642399839
목표/NNG@$물가/NNG@$상승률/NNG,-1,-0.4999964167344765,46,17,29,23,0.18306521958937222,0.5488174492386886
인하/NNG@$시장/NNG@$기대/NNG,-1,-0.4999964167344765,46,17,29,12,0.18306521958937222,0.5488174492386886
기준금리/NNG@$동결/NNG@$가능성/NNG@$높/VA,-1,-0.4999964167344765,46,17,29,16,0.18306521958937222,0.5488174492386886
필요/NNG@$있/VA@$생각/NNG,-1,-0.4999964167344765,46,17,29,17,0.18306521958937222,0.5488174492386886
은행/NNG@$주택/NNG@$담보대출/NNG,-1,-0.4999964167344765,46,17,29,14,0.18306521958937222,0.5488174492386886
가능성/NNG@$높/VA@$진/VX,-1,-0.5017879807478391,142,55,87,26,0.2900879461110853,0.8738321200906506
자본/NNG@$유출/NNG@$위험/NNG,-1,-0.5037093041368165,41,15,26,21,0.17076595398832045,0.5170490996696427
상승률/NNG@$목표/NNG@$달성/NNG,-1,-0.5037093041368165,41,15,26,20,0.17076595398832045,0.5170490996696427
경기/NNG@$위축/NNG@$가능성/NNG,-1,-0.5037093041368165,41,15,26,13,0.17076595398832045,0.5170490996696427
물가/NNG@$상승률/NNG@$목표/NNG@$달성/NNG,-1,-0.5037093041368165,41,15,26,20,0.17076595398832045,0.5170490996696427
성장률/NNG@$전망/NNG@$낮/VA,-1,-0.5037093041368165,41,15,26,14,0.17076595398832045,0.5170490996696427
확대/NNG@$경기/NNG@$회복/NNG,-1,-0.5037093041368165,41,15,26,13,0.17076595398832045,0.5170490996696427
상환/NNG@$비율/NNG@$규제/NNG@$완화/NNG,-1,-0.5037093041368165,41,15,26,23,0.17076595398832045,0.5170490996696427
비율/NNG@$규제/NNG@$완화/NNG,-1,-0.5037093041368165,41,15,26,23,0.17076595398832045,0.5170490996696427
긍정적/NNG@$효과/NNG@$있/VA,-1,-0.5037093041368165,41,15,26,14,0.17076595398832045,0.5170490996696427
부채/NNG@$상환/NNG@$비율/NNG@$규제/NNG@$완화/NNG,-1,-0.5037093041368165,41,15,26,23,0.17076595398832045,0.5170490996696427
경기/NNG@$부양책/NNG@$필요/NNG,-1,-0.5037093041368165,41,15,26,15,0.17076595398832045,0.5170490996696427
금리/NNG@$인하/NNG@$이뤄질/VV,-1,-0.5037093041368165,41,15,26,13,0.17076595398832045,0.5170490996696427
위안화/NNG@$절상/NNG@$속도/NNG,-1,-0.510342223521323,84,32,52,22,0.2420666414410814,0.7461331654472779
전망/NNG@$지수/NNG@$하락/NNG,0,-0.5106046987573086,36,13,23,14,0.15701920783366685,0.4843310897327951
경제/NNG@$성장/NNG@$목표/NNG,0,-0.5106046987573086,36,13,23,12,0.15701920783366685,0.4843310897327951
성장률/NNG@$전망/NNG@$하향/NNG@$조정/NNG,-1,-0.511745005087967,153,59,94,76,0.28652597080781234,0.886530459307733
시장/NNG@$불안/NNG@$심리/NNG,-1,-0.5127602797541828,69,26,43,29,0.21961114831041134,0.6813637091966984
경제/NNG@$전망/NNG@$성장률/NNG@$전망치/NNG,-1,-0.5137533208447381,64,24,40,27,0.21096883371595543,0.6563165087081918
가능성/NNG@$금리/NNG@$인하/NNG,-1,-0.5138654928400918,112,43,69,31,0.2670159463379663,0.830930181692032
실시/NNG@$금리/NNG@$인상/NNG,-1,-0.5150920992488459,59,22,37,20,0.20164313016898022,0.6295916025569508
상승/NNG@$압력/NNG@$예상/NNG,-1,-0.5150920992488459,59,22,37,26,0.20164313016898022,0.6295916025569508
시중/NNG@$유동성/NNG@$공급/NNG,-1,-0.5156866402587373,107,41,66,33,0.2621505238139323,0.8198398996664709
금리/NNG@$인상/NNG@$불확실성/NNG,-1,-0.517435842724336,102,39,63,36,0.25693743359415305,0.8073779699958226
인플레율/NNG@$억제/NNG@$기준치/NNG@$허용/NNG@$한도/NNG,-1,-0.5200932041701105,49,18,31,21,0.18054451981396694,0.5714656903843433
압력/NNG@$높/VA@$않/VX,-1,-0.5207293152604158,92,35,57,34,0.24536606515391954,0.7779965543555319
금리/NNG@$인상/NNG@$환율/NNG,-1,-0.5222975673146099,87,33,54,36,0.2389504301087822,0.7609235461732063
수출/NNG@$증가율/NNG@$둔화/NNG,-1,-0.5222975673146099,87,33,54,18,0.2389504301087822,0.7609235461732063
경기/NNG@$회복세/NNG@$둔화/NNG,-1,-0.5226917760693125,159,61,98,40,0.2803908492817314,0.8938564340211778
대외/NNG@$경제정책/NNG@$경제/NNG,0,-0.5230623562047267,31,11,20,24,0.14130635333670036,0.4509292209626727
완화/NNG@$정책/NNG@$시행/NNG,0,-0.5230623562047267,31,11,20,20,0.14130635333670036,0.4509292209626727
통화/NNG@$금융/NNG@$대책/NNG,0,-0.5230623562047267,31,11,20,21,0.14130635333670036,0.4509292209626727
금리/NNG@$인상/NNG@$가능성/NNG@$무게/NNG,-1,-0.5249020779165746,44,16,28,12,0.1684687751604079,0.5403406570943414
금리/NNG@$동결/NNG@$가능성/NNG@$높/VA,-1,-0.5249020779165746,44,16,28,24,0.1684687751604079,0.5403406570943414
유로존/NNG@$경기/NNG@$회복/NNG,-1,-0.5249020779165746,44,16,28,26,0.1684687751604079,0.5403406570943414
해외/NNG@$위험/NNG@$요인/NNG@$상존/NNG,-1,-0.5249020779165746,44,16,28,18,0.1684687751604079,0.5403406570943414
경기/NNG@$하강/NNG@$국면/NNG,-1,-0.5290208461479406,100,38,62,18,0.2482502536203062,0.805356361191954
결정/NNG@$금융/NNG@$통화/NNG,-1,-0.5313158124001954,62,23,39,34,0.1990438845219236,0.6498579442953052
금리/NNG@$인상/NNG@$리스크/NNG,-1,-0.5326440542201072,39,14,25,27,0.15504776538073106,0.508093070755161
경제/NNG@$전망/NNG@$국내총생산/NNG@$성장률/NNG,-1,-0.5326440542201072,39,14,25,16,0.15504776538073106,0.508093070755161
주택/NNG@$판매/NNG@$지수/NNG,-1,-0.5326440542201072,39,14,25,12,0.15504776538073106,0.508093070755161
하방/NNG@$리스크/NNG@$크/VA,-1,-0.5326440542201072,39,14,25,26,0.15504776538073106,0.508093070755161
요인/NNG@$경기/NNG@$회복/NNG,-1,-0.5326440542201072,39,14,25,9,0.15504776538073106,0.508093070755161
경제/NNG@$침체/NNG@$가능성/NNG,-1,-0.5342652887790057,57,21,36,21,0.18910236394011967,0.6225036946881359
사상/NNG@$최대/NNG@$기록/NNG,-1,-0.5342652887790057,57,21,36,31,0.18910236394011967,0.6225036946881359
은행/NNG@$금리/NNG@$인하/NNG,-1,-0.535596860206639,85,32,53,20,0.22919078662729284,0.7572886235431886
기준금리/NNG@$인상/NNG@$결정/NNG,-1,-0.5359056031936484,160,61,99,54,0.27166741351716456,0.8984165516356101
물가/NNG@$상승률/NNG@$전망치/NNG,-1,-0.5370287916153049,234,89,145,81,0.2751018782846086,0.9126469267805682
소수/NNG@$의견/NNG@$등장/NNG,-1,-0.5382700625617253,52,19,33,16,0.17829862981834033,0.5935713340404901
물가/NNG@$상승/NNG@$압력/NNG@$낮/VA,-1,-0.5382700625617253,52,19,33,16,0.17829862981834033,0.5935713340404901
체감/NNG@$경기/NNG@$개선/NNG,-1,-0.5403235844551739,75,28,47,21,0.21408904078536695,0.7168579448367861
억제/NNG@$기준치/NNG@$허용/NNG@$한도/NNG,-1,-0.5430223627512212,70,26,44,31,0.20568899009297756,0.694009372025161
대외/NNG@$위험/NNG@$요인/NNG,-1,-0.5430223627512212,70,26,44,36,0.20568899009297756,0.694009372025161
금리/NNG@$인상/NNG@$반영/NNG,-1,-0.5430223627512212,70,26,44,27,0.20568899009297756,0.694009372025161
물가/NNG@$안정세/NNG@$보이/VV,-1,-0.5436766282534439,93,35,58,12,0.23316312207737894,0.7881702342308746
금융시장/NNG@$영향/NNG@$제한적/NNG,-1,-0.5439564446407206,47,17,30,9,0.16647567021440465,0.5631911812106576
상품/NNG@$가격/NNG@$하락/NNG,-1,-0.5441477151455467,137,52,85,34,0.2604743510102691,0.8816696419958144
금리/NNG@$인하/NNG@$나서/VV,-1,-0.5446601187418587,124,47,77,39,0.25478647813911803,0.8636732497472275
경기동행지수/NNG@$순환/NNG@$변동치/NNG,0,-0.5453017058237508,34,12,22,9,0.13985991527989738,0.47496172057349556
정책/NNG@$수단/NNG@$개발/NNG,0,-0.545602394413873,26,9,17,16,0.12272814901844989,0.4171392973082662
내수/NNG@$경기/NNG@$활성화/NNG,0,-0.545602394413873,26,9,17,21,0.12272814901844989,0.4171392973082662
디플레이션/NNG@$우려/NNG@$제기/NNG,0,-0.545602394413873,26,9,17,12,0.12272814901844989,0.4171392973082662
금리/NNG@$인상/NNG@$경로/NNG,-1,-0.5461435788234429,65,24,41,61,0.19664430013102235,0.6694027365452238
공개/NNG@$시장/NNG@$열/VV,-1,-0.5499289037023548,60,22,38,6,0.18687724456492466,0.64307127403167
정책/NNG@$경기/NNG@$부양/NNG,-1,-0.5499289037023548,60,22,38,26,0.18687724456492466,0.64307127403167
최고/NNG@$투자/NNG@$책임자/NNG,-1,-0.551674520672278,233,88,145,93,0.2650366490028106,0.9166085200831277
환매/NNG@$조건/NNG@$부채권/NNG@$금리/NNG,-1,-0.5523250134543367,42,15,27,29,0.1534055614421596,0.5315341844242042
조건/NNG@$부채권/NNG@$금리/NNG,-1,-0.5523250134543367,42,15,27,29,0.1534055614421596,0.5315341844242042
자금/NNG@$채권/NNG@$시장/NNG,-1,-0.5523250134543367,42,15,27,7,0.1534055614421596,0.5315341844242042
경상수지/NNG@$흑자/NNG@$축소/NNG,-1,-0.5523250134543367,42,15,27,13,0.1534055614421596,0.5315341844242042
이유/NNG@$금리/NNG@$인하/NNG,-1,-0.5523250134543367,42,15,27,23,0.1534055614421596,0.5315341844242042
필요/NNG@$금리/NNG@$인하/NNG,-1,-0.5524855374636111,78,29,49,33,0.21157507163137385,0.73342403018377
소비자/NNG@$물가/NNG@$근원인플레이션/NNG,0,-0.5528556030089019,15,5,10,14,0.09692115479485451,0.3363347467829618
금리/NNG@$올릴/VV@$전망/NNG,-1,-0.5532317799460439,96,36,60,47,0.23047350532278643,0.8006534863271998
지속/NNG@$가능/NNG@$성장/NNG,-1,-0.5578186317570357,175,66,109,74,0.25885425619848507,0.9112507877297558
소비자/NNG@$물가/NNG@$영향/NNG,-1,-0.5597094974108758,68,25,43,11,0.19442228371037917,0.6882007636971086
위험/NNG@$요인/NNG@$경제/NNG,-1,-0.5597094974108758,68,25,43,9,0.19442228371037917,0.6882007636971086
농산물/NNG@$가격/NNG@$급등/NNG,-1,-0.5611341060478974,50,18,32,9,0.16473354276981936,0.585536585756426
금리/NNG@$인상/NNG@$국제금융시장/NNG,-1,-0.5611341060478974,50,18,32,8,0.16473354276981936,0.585536585756426
경상수지/NNG@$흑자/NNG@$지속/NNG,-1,-0.563692195688104,81,30,51,35,0.20920724785831707,0.7491980676772105
시장/NNG@$부정적/NNG@$영향/NNG,0,-0.5650274688869174,37,13,24,24,0.13874447961988237,0.4988114756695399
인상/NNG@$전망/NNG@$우세/NNG,0,-0.5650274688869174,37,13,24,17,0.13874447961988237,0.4988114756695399
경기/NNG@$회복/NNG@$촉진/NNG,0,-0.5650274688869174,37,13,24,11,0.13874447961988237,0.4988114756695399
자본/NNG@$유출/NNG@$막/VV,0,-0.5650274688869174,37,13,24,15,0.13874447961988237,0.4988114756695399
완화/NNG@$정책/NNG@$펴/VV,0,-0.5650274688869174,37,13,24,13,0.13874447961988237,0.4988114756695399
소매/NNG@$판매/NNG@$설비투자/NNG,0,-0.5664431361833494,29,10,19,7,0.12221543996803533,0.44121891358818494
수출/NNG@$높/VA@$증가세/NNG,0,-0.5664431361833494,29,10,19,9,0.12221543996803533,0.44121891358818494
인상/NNG@$가능/NNG@$전망/NNG,-1,-0.5696930871327697,58,21,37,9,0.17447333383870609,0.6359491266555857
경제/NNG@$성장/NNG@$회복/NNG,-1,-0.5699689013864863,45,16,29,6,0.15202533679311023,0.5545795260162004
회복/NNG@$지연/NNG@$가능성/NNG,-1,-0.5699689013864863,45,16,29,10,0.15202533679311023,0.5545795260162004
물가/NNG@$상승/NNG@$부담/NNG,-1,-0.5699689013864863,45,16,29,19,0.15202533679311023,0.5545795260162004
금리/NNG@$인상/NNG@$통화정책/NNG,-1,-0.5742267990316315,155,58,97,47,0.24536998625757106,0.9064912978622146
둔화/NNG@$우려/NNG@$커지/VV,-1,-0.5785451909063233,79,29,50,17,0.1989936578615335,0.7447232160206755
상승/NNG@$압력/NNG@$증대/NNG,-1,-0.5826241792526854,40,14,26,5,0.13787989502378056,0.5223933822644595
기준금리/NNG@$인하/NNG@$배경/NNG,-1,-0.5826241792526854,40,14,26,12,0.13787989502378056,0.5223933822644595
경제정책/NNG@$방향/NNG@$성장률/NNG,-1,-0.5826241792526854,40,14,26,10,0.13787989502378056,0.5223933822644595
경기/NNG@$둔화/NNG@$우려/NNG@$커지/VV,-1,-0.5832876895176866,61,22,39,8,0.17283169094232056,0.6561339799241206
가능성/NNG@$크/VA@$진단/NNG,-1,-0.5835232628346614,74,27,47,39,0.19043657325358423,0.7234849516806553
국면/NNG@$진입/NNG@$가능성/NNG,0,-0.5849036693700068,32,11,21,11,0.12195717171727975,0.46527056821240753
대외/NNG@$불확실성/NNG@$확대/NNG,-1,-0.5858394757737739,48,17,31,19,0.1508556422523707,0.5771590816952066
유로존/NNG@$국채/NNG@$매입/NNG,-1,-0.5858394757737739,48,17,31,24,0.1508556422523707,0.5771590816952066
둔화/NNG@$금리/NNG@$인상/NNG,-1,-0.586972973428852,229,85,144,97,0.24111873696500538,0.9256876930867143
기준금리/NNG@$인하/NNG@$예상/NNG,-1,-0.5870180424817669,156,58,98,57,0.23718108684374628,0.9106956691807917
전망/NNG@$성장/NNG@$경로/NNG,-1,-0.5891434834077112,69,25,44,20,0.18124247320061934,0.7004441043169919
둔화/NNG@$인플레이션/NNG@$압력/NNG,-1,-0.5891434834077112,69,25,44,30,0.18124247320061934,0.7004441043169919
금리/NNG@$인하/NNG@$환율/NNG,-1,-0.5907147075081567,56,20,36,19,0.16184129193186728,0.6284846588422163
외국인/NNG@$자금/NNG@$유입/NNG,-1,-0.5939746971335899,77,28,49,20,0.18864155331716814,0.7399493020865079
금리/NNG@$인상/NNG@$사이클/NNG,-1,-0.594686142721562,200,74,126,88,0.23554175046828085,0.9259495015774982
산업/NNG@$생산/NNG@$감소/NNG,-1,-0.5951409515595623,98,36,62,48,0.20803577158648456,0.8189708749682559
회복세/NNG@$지속/NNG@$전망/NNG,-1,-0.5951409515595623,98,36,62,41,0.20803577158648456,0.8189708749682559
동일/NNG@$점포/NNG@$매출/NNG,-1,-0.5956669420665033,64,23,41,22,0.1713378570026658,0.6756022326097684
모기지/NNG@$담보/NNG@$증권/NNG@$매입/NNG,-1,-0.5969906564035808,106,39,67,35,0.21262374530404848,0.8418458338317539
자국/NNG@$통화/NNG@$가치/NNG,-1,-0.5980069397520817,165,61,104,58,0.23123426171000916,0.9184275470577097
가능/NNG@$경제/NNG@$성장/NNG,-1,-0.5980550224125114,114,42,72,28,0.21669619600403917,0.8608133190827911
물가/NNG@$상승률/NNG@$머물/VV,-1,-0.5983941483519659,43,15,28,16,0.13720790531396596,0.5456262299006542
물가/NNG@$상승/NNG@$인플레이션/NNG,-1,-0.5983941483519659,43,15,28,14,0.13720790531396596,0.5456262299006542
금리/NNG@$하락/NNG@$압력/NNG,-1,-0.5983941483519659,43,15,28,14,0.13720790531396596,0.5456262299006542
기준금리/NNG@$인상/NNG@$이뤄질/VV,-1,-0.5983941483519659,43,15,28,19,0.13720790531396596,0.5456262299006542
고용/NNG@$지표/NNG@$부진/NNG,-1,-0.59846350956895,122,45,77,43,0.22031222911853982,0.8762913112194171
환율/NNG@$변동성/NNG@$확대/NNG,-1,-0.59846350956895,122,45,77,72,0.22031222911853982,0.8762913112194171
금리/NNG@$기조/NNG@$유지/NNG,-1,-0.5996004821259829,176,65,111,63,0.23119029670804894,0.9228236735161587
경상수지/NNG@$흑자/NNG@$기조/NNG,-1,-0.602370079997885,101,37,64,40,0.20610870831192593,0.8298673476670347
경제지표/NNG@$금리/NNG@$인상/NNG,-1,-0.6034699894976343,59,21,38,17,0.16062966431076947,0.6489900759878202
기준금리/NNG@$인하/NNG@$시장/NNG,-1,-0.606955219277926,67,24,43,26,0.1699722076272066,0.6943267045036104
통화/NNG@$완화/NNG@$선호/NNG,-1,-0.606955219277926,67,24,43,40,0.1699722076272066,0.6943267045036104
가계부채/NNG@$증가/NNG@$속도/NNG,-1,-0.6100109223542587,75,27,48,36,0.17816037362865836,0.7348670070359008
불안/NNG@$경기/NNG@$둔화/NNG,-1,-0.6123986050942087,83,30,53,30,0.18538315213882303,0.7705064145002736
개선/NNG@$조짐/NNG@$보이/VV,-1,-0.6123986050942087,83,30,53,31,0.18538315213882303,0.7705064145002736
관측/NNG@$힘/NNG@$얻/VV,-1,-0.6125801977903355,46,16,30,22,0.13668534570139113,0.5684341971795427
가능성/NNG@$열/VV@$둔/VX,-1,-0.6131025013605543,54,19,35,25,0.14899705056379486,0.6206716829231466
구조/NNG@$개혁/NNG@$경제/NNG,-1,-0.6150635482503634,62,22,40,35,0.15954276194867595,0.6687964320847231
곡물/NNG@$가격/NNG@$상승/NNG,-1,-0.6150635482503634,62,22,40,20,0.15954276194867595,0.6687964320847231
가능성/NNG@$있/VA@$덧붙였/VV,-1,-0.6161648130121984,38,13,25,15,0.12192390698104388,0.5129144008113564
소매/NNG@$판매/NNG@$부진/NNG,-1,-0.6161648130121984,38,13,25,14,0.12192390698104388,0.5129144008113564
상승/NNG@$공공요금/NNG@$인상/NNG,-1,-0.6161648130121984,38,13,25,5,0.12192390698104388,0.5129144008113564
상승률/NNG@$낮/VA@$물가/NNG,-1,-0.6161648130121984,38,13,25,12,0.12192390698104388,0.5129144008113564
가치/NNG@$하락/NNG@$막/VV,-1,-0.6161648130121984,38,13,25,14,0.12192390698104388,0.5129144008113564
국고채/NNG@$금리/NNG@$내린/VV,0,-0.6170610568473869,27,9,18,23,0.1022006430609856,0.4311861153350326
금융/NNG@$통화정책/NNG@$열/VV@$기준금리/NNG,-1,-0.6172619080429957,70,25,45,30,0.1687182482159058,0.7122866090204055
인하/NNG@$소수/NNG@$의견/NNG,-1,-0.6194356474165675,145,53,92,62,0.21436075626590764,0.9113657614034342
통화정책/NNG@$결정/NNG@$기준금리/NNG,-1,-0.6294904728402724,41,14,27,10,0.12206089573540305,0.5363277434041951
금리/NNG@$인상/NNG@$주택/NNG,-1,-0.6294904728402724,41,14,27,19,0.12206089573540305,0.5363277434041951
경기/NNG@$해외/NNG@$위험/NNG@$요인/NNG@$상존/NNG,-1,-0.6294904728402724,41,14,27,17,0.12206089573540305,0.5363277434041951
성장세/NNG@$둔화/NNG@$가능성/NNG,0,-0.6301341864873817,30,10,20,12,0.10338844776510336,0.45525187870096007
전망/NNG@$힘/NNG@$실/VV,-1,-0.635238641886897,68,24,44,21,0.15767265712976353,0.7061934113054027
장기/NNG@$국채/NNG@$금리/NNG,-1,-0.635238641886897,68,24,44,21,0.15767265712976353,0.7061934113054027
정책/NNG@$대응/NNG@$필요/NNG,-1,-0.6354883122456437,60,21,39,19,0.14760233424110666,0.6616432580387507
기준금리/NNG@$동결/NNG@$경제/NNG,-1,-0.6361290893268716,119,43,76,32,0.19622821989663433,0.8815067768892749
시중/NNG@$유동성/NNG@$확대/NNG,-1,-0.63696148204562,52,18,34,14,0.13596612771881292,0.6125048226397848
시장/NNG@$금리/NNG@$인하/NNG@$기대감/NNG,-1,-0.63696148204562,52,18,34,23,0.13596612771881292,0.6125048226397848
기준금리/NNG@$유지/NNG@$결정/NNG,-1,-0.6399381171417342,216,78,138,53,0.20614100726059092,0.9380032819626027
인플레이션/NNG@$우려/NNG@$금리/NNG@$인상/NNG,-1,-0.6415393846981443,44,15,29,20,0.12226226262104137,0.5593583200666741
속도/NNG@$완만/XR@$예상/NNG,-1,-0.6415393846981443,44,15,29,12,0.12226226262104137,0.5593583200666741
선제적/NNG@$대응/NNG@$필요/NNG,-1,-0.6415393846981443,44,15,29,14,0.12226226262104137,0.5593583200666741
정책/NNG@$기조/NNG@$변화/NNG,-1,-0.6415688382422033,133,48,85,38,0.19770978571994643,0.9046264533481516
실업/NNG@$보험/NNG@$청구자/NNG,0,-0.642178175548288,33,11,22,25,0.10452617210423512,0.4792538061042458
정책/NNG@$방향/NNG@$결정/NNG,0,-0.642178175548288,33,11,22,7,0.10452617210423512,0.4792538061042458
영향/NNG@$주지/NNG@$않/VX,-1,-0.6432030766946497,79,28,51,31,0.1654973883240008,0.7614601273341376
성장/NNG@$부정적/NNG@$영향/NNG,-1,-0.647460672929692,55,19,36,17,0.13572541240218902,0.6336501181167609
시장/NNG@$신뢰/NNG@$회복/NNG,-1,-0.647460672929692,55,19,36,27,0.13572541240218902,0.6336501181167609
정책/NNG@$공조/NNG@$차원/NNG,-1,-0.647460672929692,55,19,36,33,0.13572541240218902,0.6336501181167609
단행/NNG@$금리/NNG@$인상/NNG,-1,-0.6488507761587873,90,32,58,27,0.17206361704877143,0.8071567607160378
위험/NNG@$요인/NNG@$가능성/NNG,-1,-0.6488507761587873,90,32,58,14,0.17206361704877143,0.8071567607160378
금리/NNG@$인하/NNG@$가능성/NNG@$열/VV,-1,-0.6518242381301975,131,47,84,39,0.19089774251230185,0.9047772812829737
금리/NNG@$인하/NNG@$배경/NNG,-1,-0.6518242381301975,131,47,84,22,0.19089774251230185,0.9047772812829737
경제/NNG@$완만/XR@$회복/NNG,-1,-0.6520444693330325,74,26,48,30,0.15611837822969274,0.7405038923242027
금리/NNG@$인하/NNG@$사이클/NNG,-1,-0.6520444693330325,74,26,48,18,0.15611837822969274,0.7405038923242027
지속/NNG@$소비자/NNG@$물가/NNG,-1,-0.6524617203436636,47,16,31,10,0.12250907319213775,0.5819314495278723
기대/NNG@$심리/NNG@$확산/NNG,-1,-0.6524617203436636,47,16,31,11,0.12250907319213775,0.5819314495278723
위기/NNG@$대응/NNG@$능력/NNG,-1,-0.6532677083388334,36,12,24,18,0.10561531676732235,0.5030945596069231
금리/NNG@$인상/NNG@$서두/NNG,-1,-0.6532677083388334,36,12,24,20,0.10561531676732235,0.5030945596069231
금리/NNG@$인상/NNG@$논의/NNG,-1,-0.6575125283974437,104,37,67,47,0.1765313436245972,0.853497944363587
금리/NNG@$인상/NNG@$요인/NNG,-1,-0.6620453057094853,69,24,45,32,0.14607779668988907,0.7176807558343872
위기/NNG@$경기/NNG@$둔화/NNG,-1,-0.6623828689821789,50,17,33,12,0.12278731093640317,0.6039797056114823
상승/NNG@$수입/NNG@$물가/NNG,-1,-0.6623828689821789,50,17,33,23,0.12278731093640317,0.6039797056114823
금리/NNG@$인상/NNG@$효과/NNG,-1,-0.6631441174733789,185,66,119,72,0.1906614996651408,0.9403944092898222
근거/NNG@$금리/NNG@$인상/NNG,-1,-0.663473326141072,39,13,26,20,0.10665742695003255,0.5266817934834819
전미/NNG@$주택/NNG@$건설/NNG,-1,-0.663473326141072,39,13,26,23,0.10665742695003255,0.5266817934834819
중단/NNG@$가능성/NNG@$시사/NNG,-1,-0.663473326141072,39,13,26,11,0.10665742695003255,0.5266817934834819
등가격/NNG@$변수/NNG@$변동성/NNG,0,-0.6690910482836365,16,5,11,7,0.06938252399100378,0.3496028652770866
경기/NNG@$둔화/NNG@$금리/NNG@$인상/NNG,-1,-0.6722589760746556,83,29,54,42,0.15421376567673473,0.7860404911229326
체감/NNG@$경기/NNG@$좋/VA,-1,-0.6728613193066699,42,14,28,13,0.1076540773951529,0.549929147139661
금리/NNG@$사상/NNG@$최저치/NNG,-1,-0.6728613193066699,42,14,28,18,0.1076540773951529,0.549929147139661
경제/NNG@$경기/NNG@$부양/NNG,-1,-0.6728613193066699,42,14,28,20,0.1076540773951529,0.549929147139661
경상수지/NNG@$적자/NNG@$기록/NNG,-1,-0.6728613193066699,42,14,28,12,0.1076540773951529,0.549929147139661
채권/NNG@$자금/NNG@$유입/NNG,0,-0.6757120649738384,25,8,17,16,0.08152412337009353,0.42082252057388086
금리/NNG@$인하/NNG@$여력/NNG,-1,-0.6779025745342317,86,30,56,29,0.1536658263744785,0.7996462493384966
경기/NNG@$부양/NNG@$나서/VV,-1,-0.6786914416682821,97,34,63,37,0.16071592588741546,0.8387788852655851
경제/NNG@$지속/NNG@$가능/NNG,-1,-0.6796320051084911,56,19,37,25,0.12339865636281208,0.6462701345555613
금리/NNG@$결정/NNG@$앞두/VV,-1,-0.6814937148660258,45,15,30,13,0.1086068591564621,0.57275703080867
금리/NNG@$동결/NNG@$반대/NNG,-1,-0.6814937148660258,45,15,30,22,0.1086068591564621,0.57275703080867
실시/NNG@$금리/NNG@$동결/NNG,-1,-0.6814937148660258,45,15,30,12,0.1086068591564621,0.57275703080867
인하/NNG@$가능성/NNG@$열/VV,-1,-0.6824104063050419,227,80,147,72,0.1790985579338548,0.9477468750062235
경제/NNG@$전망/NNG@$경제성장률/NNG,-1,-0.6835071812709481,125,44,81,62,0.17021359984902149,0.9044370445557433
인하/NNG@$가능성/NNG@$배제/NNG@$없/VA,-1,-0.6871306058002067,59,20,39,31,0.12371781700722612,0.6664160061541464
투자/NNG@$내수/NNG@$부진/NNG,0,-0.6877217771298345,31,10,21,10,0.08686824080665004,0.4689719130122242
소비/NNG@$위축/NNG@$우려/NNG,-1,-0.689428338322543,48,16,32,14,0.10951736799445042,0.5950932039552626
하락/NNG@$금리/NNG@$인하/NNG,-1,-0.689428338322543,48,16,32,20,0.10951736799445042,0.5950932039552626
성장률/NNG@$물가/NNG@$상승률/NNG,-1,-0.693356935305371,73,25,48,25,0.13515584749811288,0.7455351662778708
기준금리/NNG@$동결/NNG@$인상/NNG,-1,-0.693974334833735,62,21,41,27,0.12403937361654363,0.6858442378618893
시장/NNG@$콜금리/NNG@$인상/NNG,-1,-0.693974334833735,62,21,41,17,0.12403937361654363,0.6858442378618893
진행/NNG@$금리/NNG@$인상/NNG,-1,-0.693974334833735,62,21,41,19,0.12403937361654363,0.6858442378618893
선제/NNG@$안내/NNG@$포워드가이던스/NNG,0,-0.6941134582275835,34,11,23,19,0.08910231147761741,0.4929329251783378
상승률/NNG@$높/VA@$않/VX,0,-0.6941134582275835,34,11,23,23,0.08910231147761741,0.4929329251783378
목표/NNG@$소비자/NNG@$물가/NNG,-1,-0.6967189314995889,51,17,34,14,0.11038719430011718,0.6168731542519926
금리/NNG@$동결/NNG@$기조/NNG@$유지/NNG,-1,-0.6967189314995889,51,17,34,12,0.11038719430011718,0.6168731542519926
규모/NNG@$유동성/NNG@$공급/NNG,-1,-0.6967189314995889,51,17,34,13,0.11038719430011718,0.6168731542519926
금리/NNG@$인상/NNG@$늦추/VV,-1,-0.7002242826206382,65,22,43,20,0.12435982649471544,0.7045255182255069
일본식/NNG@$장기/NNG@$불황/NNG,-1,-0.7004496968416043,37,12,25,11,0.0911229454536951,0.5166878629517759
소비/NNG@$내수/NNG@$회복세/NNG,-1,-0.7004496968416043,37,12,25,22,0.0911229454536951,0.5166878629517759
물가/NNG@$상승/NNG@$주도/NNG,-1,-0.7004496968416043,37,12,25,9,0.0911229454536951,0.5166878629517759
수출/NNG@$부진/NNG@$내수/NNG,-1,-0.7004496968416043,37,12,25,22,0.0911229454536951,0.5166878629517759
양적완화/NNG@$정책/NNG@$시행/NNG,-1,-0.7034153112808474,54,18,36,24,0.11121791443555747,0.6380402913638146
경제/NNG@$견실/XR@$성장세/NNG,-1,-0.7034153112808474,54,18,36,20,0.11121791443555747,0.6380402913638146
채권/NNG@$시장/NNG@$주식시장/NNG,-1,-0.7066056197995054,40,13,27,12,0.09296805635230973,0.5401460893871749
경기/NNG@$호전/NNG@$예상/NNG,-1,-0.7066056197995054,40,13,27,24,0.09296805635230973,0.5401460893871749
예상/NNG@$벗어나/VV@$않/VX,-1,-0.7066056197995054,40,13,27,16,0.09296805635230973,0.5401460893871749
환율/NNG@$하락/NNG@$수출/NNG,-1,-0.7066056197995054,40,13,27,12,0.09296805635230973,0.5401460893871749
예금/NNG@$대출/NNG@$금리/NNG,-1,-0.7084487921125022,82,28,54,23,0.13513818721227458,0.7909665559839244
채권/NNG@$시장/NNG@$금리/NNG@$인하/NNG,-1,-0.709224242372871,110,38,72,36,0.15026969433099896,0.8822746607060878
통화정책/NNG@$금리/NNG@$인하/NNG,-1,-0.7111533507761225,71,24,47,31,0.12498741783089758,0.7395644817434658
은행/NNG@$대출/NNG@$증가/NNG,-1,-0.7125057436658684,43,14,29,13,0.09466561399020702,0.5632236182760954
전망/NNG@$불확실성/NNG@$높/VA,-1,-0.7125057436658684,43,14,29,17,0.09466561399020702,0.5632236182760954
기업/NNG@$투자/NNG@$심리/NNG,-1,-0.7152062147646907,60,20,40,29,0.11276822854031544,0.6783493954891567
산업/NNG@$생산/NNG@$소매/NNG@$판매/NNG,-1,-0.7181065177541447,46,15,31,9,0.09623681564680543,0.5858437377517137
금리/NNG@$인하/NNG@$부담/NNG,-1,-0.7202841646816324,77,26,51,20,0.1255862447700734,0.7714301651919776
인상/NNG@$크/VA@$않/VX,-1,-0.723385363259266,49,16,33,6,0.09769811582599472,0.6079374488949555
경기/NNG@$과도/NNG@$위축/NNG,-1,-0.723385363259266,49,16,33,3,0.09769811582599472,0.6079374488949555
견조/NNG@$성장/NNG@$지속/NNG@$물가/NNG@$기조/NNG,-1,-0.7251285922448198,66,22,44,15,0.11418038978970622,0.7157238599349662
금융시장/NNG@$불안/NNG@$경기/NNG,-1,-0.7251285922448198,66,22,44,13,0.11418038978970622,0.7157238599349662
초저/NNG@$금리/NNG@$기조/NNG@$유지/NNG,-1,-0.7257680821192238,114,39,75,50,0.14245231838950356,0.8953539703189859
관심/NNG@$금리/NNG@$인상/NNG,-1,-0.7283335917554905,52,17,35,20,0.09906256506757967,0.6294437230565753
금리/NNG@$인하/NNG@$가능/NNG,-1,-0.7288192600685172,100,34,66,33,0.13523617826485584,0.8610698265478474
경기/NNG@$부양/NNG@$나설/VV,-1,-0.7294777001969395,69,23,46,36,0.11483828174116315,0.733249849647302
물가/NNG@$잡/VV@$금리/NNG,-1,-0.7329517235592917,55,18,37,15,0.10034071652054445,0.6503095902207684
조정/NNG@$금리/NNG@$인하/NNG,-1,-0.7329517235592917,55,18,37,18,0.10034071652054445,0.6503095902207684
금리/NNG@$인하/NNG@$가능성/NNG@$크/VA,-1,-0.737246336160714,58,19,39,22,0.10154125421526183,0.6704900763699271
대출/NNG@$증가세/NNG@$둔화/NNG,0,-0.7378633082551815,29,9,20,7,0.06922739872072942,0.45835470390190886
인상/NNG@$사이클/NNG@$종료/NNG,0,-0.7385792640591741,32,10,22,18,0.07263510877322242,0.48243119875762375
가격/NNG@$하락/NNG@$확대/NNG,0,-0.7387465983039067,26,8,18,9,0.06532795932332647,0.4342175779256536
경제/NNG@$견조/NNG@$성장/NNG@$지속/NNG@$물가/NNG,-1,-0.7404370353438552,78,26,52,14,0.1166355682876085,0.7810464729740726
주택/NNG@$착공/NNG@$감소/NNG,-1,-0.7426770170109314,38,12,26,18,0.07836481423810587,0.530010827087565
우려/NNG@$경기/NNG@$회복/NNG,-1,-0.7426770170109314,38,12,26,15,0.07836481423810587,0.530010827087565
콜금리/NNG@$동결/NNG@$경기/NNG,-1,-0.7426770170109314,38,12,26,12,0.07836481423810587,0.530010827087565
은행권/NNG@$가계/NNG@$대출/NNG,-1,-0.7426770170109314,38,12,26,24,0.07836481423810587,0.530010827087565
물가/NNG@$목표/NNG@$소비자/NNG,-1,-0.7426770170109314,38,12,26,9,0.07836481423810587,0.530010827087565
경제/NNG@$금리/NNG@$동결/NNG,-1,-0.7426770170109314,38,12,26,15,0.07836481423810587,0.530010827087565
경제/NNG@$성장/NNG@$하방/NNG@$리스크/NNG,-1,-0.7426770170109314,38,12,26,9,0.07836481423810587,0.530010827087565
성장/NNG@$하방/NNG@$리스크/NNG,-1,-0.7439605001234724,101,34,67,46,0.1275902001662091,0.8678994500225131
경제/NNG@$영향/NNG@$제한적/NNG,-1,-0.7449093651946807,64,21,43,38,0.10373742158142515,0.7086537283678261
물가/NNG@$관리/NNG@$목표치/NNG,-1,-0.7449093651946807,64,21,43,18,0.10373742158142515,0.7086537283678261
달러/NNG@$환율/NNG@$하락/NNG,-1,-0.7454120236754368,41,13,28,16,0.08081776726610948,0.5533323275140116
중소기업/NNG@$금융/NNG@$지원/NNG,-1,-0.7454120236754368,41,13,28,17,0.08081776726610948,0.5533323275140116
인상/NNG@$이뤄질/VV@$전망/NNG,-1,-0.748339645550093,44,14,30,22,0.08305652607555905,0.5762316594958505
채권/NNG@$가격/NNG@$상승/NNG,-1,-0.748339645550093,44,14,30,10,0.08305652607555905,0.5762316594958505
금리/NNG@$인상/NNG@$점치/VV,-1,-0.7513376808185835,47,15,32,13,0.08511329456560991,0.59863563758604
경제/NNG@$하방/NNG@$위험/NNG,-1,-0.7520110618857732,163,55,108,51,0.13521177660453063,0.9539435816154614
인상/NNG@$속도/NNG@$점진적/NNG,-1,-0.754322189991888,50,16,34,12,0.08701329790247643,0.6204789753692795
원화/NNG@$강세/NNG@$요인/NNG,-1,-0.754322189991888,50,16,34,13,0.08701329790247643,0.6204789753692795
인플레이션/NNG@$압력/NNG@$커지/VV,-1,-0.7652308317808224,62,20,42,18,0.09339533896809313,0.7012221800910126
사상/NNG@$최대/NNG@$규모/NNG,-1,-0.7675927194440175,65,21,44,27,0.09474863384522202,0.7195633227086211
금리/NNG@$인상/NNG@$부동산가격/NNG,-1,-0.7697924825890768,68,22,46,3,0.09602326545260051,0.7371176527794082
생산/NNG@$소매/NNG@$판매/NNG,-1,-0.7697924825890768,68,22,46,23,0.09602326545260051,0.7371176527794082
민간/NNG@$소비/NNG@$부진/NNG,-1,-0.7697924825890768,68,22,46,22,0.09602326545260051,0.7371176527794082
개인/NNG@$소비/NNG@$지출/NNG@$물가/NNG,-1,-0.7799192454878597,42,13,29,12,0.07012446522295791,0.5662597404578829
저금리/NNG@$정책/NNG@$기조/NNG,-1,-0.7799192454878597,42,13,29,13,0.07012446522295791,0.5662597404578829
시장/NNG@$금리/NNG@$상승/NNG@$압력/NNG,-1,-0.7799192454878597,42,13,29,20,0.07012446522295791,0.5662597404578829
긍정적/NNG@$영향/NNG@$기대/NNG,-1,-0.7799192454878597,42,13,29,15,0.07012446522295791,0.5662597404578829
소비/NNG@$지출/NNG@$위축/NNG,-1,-0.7799468588379387,39,12,27,11,0.0672453274158796,0.5430869696107997
경기/NNG@$하강/NNG@$막/VV,-1,-0.7799468588379387,39,12,27,10,0.0672453274158796,0.5430869696107997
채무/NNG@$상환/NNG@$능력/NNG,-1,-0.7799468588379387,39,12,27,15,0.0672453274158796,0.5430869696107997
금리/NNG@$인하/NNG@$신중/NNG,-1,-0.7799468588379387,39,12,27,18,0.0672453274158796,0.5430869696107997
위험/NNG@$크/VA@$않/VX,-1,-0.7804081179099506,45,14,31,13,0.07275503168556677,0.5889693726787883
상승/NNG@$지수/NNG@$오른/VV,-1,-0.7807266350537041,36,11,25,14,0.06407258216270294,0.5195280643829754
자금/NNG@$단기화/NNG@$현상/NNG,-1,-0.7807266350537041,36,11,25,5,0.06407258216270294,0.5195280643829754
인상/NNG@$어려울/VA@$전망/NNG,-1,-0.7807266350537041,36,11,25,14,0.06407258216270294,0.5195280643829754
돈/NNG@$돌/VV@$않/VX,-1,-0.7807266350537041,36,11,25,14,0.06407258216270294,0.5195280643829754
기조/NNG@$변화/NNG@$가능성/NNG,0,-0.7825873972341779,33,10,23,8,0.060548647195414494,0.49566721309539924
기준금리/NNG@$인하/NNG@$추가경정예산/NNG,-1,-0.783490116460881,54,17,37,13,0.079477900319606,0.6536663929987635
대내외/NNG@$위험/NNG@$요인/NNG,0,-0.7859924686276084,30,9,21,22,0.05659914577052346,0.47159504707113875
금리/NNG@$인상/NNG@$유동성/NNG,-1,-0.7869423516994807,134,44,90,33,0.1124336304107863,0.9414892259240593
시장/NNG@$금리/NNG@$역전/NNG,-1,-0.7884908195245435,66,21,45,10,0.08648824668063697,0.7301552365737851
국채/NNG@$매입/NNG@$재개/NNG,-1,-0.7934888299629705,81,26,55,36,0.09318547614792103,0.8079547343898124
하락/NNG@$크/VA@$않/VX,0,-0.8003636384641871,24,7,17,29,0.04700796196748696,0.42320519310934046
경기/NNG@$회복/NNG@$가시화/NNG,-1,-0.8031533585841529,148,48,100,41,0.10465828890380764,0.9570326456987523
수출/NNG@$높/VA@$신장세/NNG,-1,-0.807262032118822,61,19,42,8,0.0752583572579191,0.7044351436569237
금리/NNG@$동결/NNG@$요인/NNG,-1,-0.807262032118822,61,19,42,16,0.0752583572579191,0.7044351436569237
금리/NNG@$인하/NNG@$양적완화/NNG,-1,-0.8076780920875697,67,21,46,15,0.07891608433826121,0.7404378878306295
가능성/NNG@$크/VA@$금리/NNG,-1,-0.8079558263191496,49,15,34,19,0.0663348595116749,0.6233875845937056
금리/NNG@$인상/NNG@$인내심/NNG,-1,-0.808192549503786,73,23,50,24,0.08216655768787469,0.7732198588884709
유지/NNG@$금리/NNG@$인하/NNG,-1,-0.8086575057363296,79,25,54,30,0.08507626754265757,0.8027497159738326
금리/NNG@$정상화/NNG@$기조/NNG,-1,-0.8087688191819805,106,34,72,23,0.09510646438851564,0.8979678145290687
가격/NNG@$하락/NNG@$기록/NNG,-1,-0.8088596536995769,46,14,32,22,0.06366790197021616,0.6014493394222693
경로/NNG@$크/VA@$벗어나/VV@$않/VX,-1,-0.8088596536995769,46,14,32,15,0.06366790197021616,0.6014493394222693
전격적/NNG@$금리/NNG@$인하/NNG,-1,-0.8091576830933345,91,29,62,31,0.090067769044019,0.852306785514841
발생/NNG@$가능성/NNG@$낮/VA,-1,-0.8102951853632343,43,13,30,8,0.060777747472515325,0.578942978859732
경기/NNG@$둔화/NNG@$대응/NNG,-1,-0.8124525336556159,40,12,28,18,0.05763103957823417,0.5559337801559445
상승/NNG@$원화/NNG@$가치/NNG,-1,-0.8124525336556159,40,12,28,15,0.05763103957823417,0.5559337801559445
완화/NNG@$정책/NNG@$필요/NNG,-1,-0.8124525336556159,40,12,28,14,0.05763103957823417,0.5559337801559445
경기/NNG@$하강/NNG@$위험/NNG,-1,-0.8137177067541476,271,87,184,39,0.10010564076160705,0.9728871680094474
금리/NNG@$인상/NNG@$중단/NNG@$가능성/NNG,-1,-0.8192013288251445,110,35,75,24,0.09062331879258599,0.9101378915850025
해외/NNG@$투자/NNG@$활성화/NNG,-1,-0.8242871083273002,74,23,51,38,0.07550946930313321,0.7824362869853865
금리/NNG@$내리/VV@$않/VX,-1,-0.8252410231951693,68,21,47,33,0.07198959794351865,0.7504191002247801
공급/NNG@$과잉/NNG@$우려/NNG,-1,-0.8258342946330892,65,20,45,44,0.07007539543589605,0.733187061429987
가계부채/NNG@$증가세/NNG@$둔화/NNG,0,-0.8262415518531301,31,9,22,15,0.04620327772749886,0.484656010089738
하방/NNG@$위험/NNG@$확대/NNG,0,-0.8262415518531301,31,9,22,10,0.04620327772749886,0.484656010089738
인상/NNG@$지연/NNG@$가능성/NNG,0,-0.8262415518531301,31,9,22,20,0.04620327772749886,0.484656010089738
상승/NNG@$경제/NNG@$성장/NNG,-1,-0.8285199286468803,56,17,39,18,0.06359047340318362,0.6767298088898784
가격/NNG@$금리/NNG@$인상/NNG,-1,-0.829903426213705,53,16,37,13,0.06113712258378536,0.6563988088778773
성장/NNG@$전망/NNG@$경로/NNG,0,-0.834823577996394,28,8,20,7,0.04153543568794149,0.46043602021853847
주택/NNG@$가격/NNG@$전망/NNG,-1,-0.8368087239669172,44,13,31,33,0.05265212109619484,0.5913930669578035
환율/NNG@$가격/NNG@$변수/NNG,-1,-0.8368087239669172,44,13,31,3,0.05265212109619484,0.5913930669578035
국제금융시장/NNG@$불안/NNG@$경기/NNG,-1,-0.8405253661768033,41,12,29,12,0.049369300801134365,0.5685640485034733
소비/NNG@$투자/NNG@$위축/NNG,-1,-0.8405253661768033,41,12,29,13,0.049369300801134365,0.5685640485034733
경기/NNG@$조절적/NNG@$통화정책/NNG,-1,-0.843998843031821,63,19,44,24,0.061517555641764775,0.7255769143947315
에너지/NNG@$상품/NNG@$가격/NNG,-1,-0.8451377689028471,94,29,65,10,0.07337523343615196,0.8723230862079695
인상/NNG@$중단/NNG@$가능성/NNG,-1,-0.8465379149485751,116,36,80,25,0.07740000231173044,0.9292530023820303
확장/NNG@$국면/NNG@$지속/NNG,0,-0.8465727628688149,25,7,18,14,0.03631867662260341,0.4361437181471574
완화적/NNG@$통화정책/NNG@$지속/NNG,0,-0.8465727628688149,25,7,18,14,0.03631867662260341,0.4361437181471574
국채/NNG@$매입/NNG@$양적완화/NNG,-1,-0.8498801980214585,54,16,38,15,0.05431841882224201,0.6678318607105719
대출/NNG@$금리/NNG@$인하/NNG,-1,-0.8515472890740562,104,32,72,22,0.07263470768122104,0.9038454856934409
원달러/NNG@$환율/NNG@$하락/NNG,-1,-0.8525947677636585,51,15,36,20,0.051606383486276115,0.6470937423706401
상승/NNG@$수요/NNG@$압력/NNG,-1,-0.8525947677636585,51,15,36,24,0.051606383486276115,0.6470937423706401
회복세/NNG@$지속/NNG@$유로지역/NNG,-1,-0.8525947677636585,51,15,36,24,0.051606383486276115,0.6470937423706401
소비/NNG@$지출/NNG@$물가/NNG,-1,-0.8558528308759058,48,14,34,14,0.048712040278050484,0.6256728176201766
통화정책/NNG@$기조/NNG@$경기/NNG,-1,-0.8558528308759058,48,14,34,5,0.048712040278050484,0.6256728176201766
비용/NNG@$상승/NNG@$압력/NNG,-1,-0.8558528308759058,48,14,34,7,0.048712040278050484,0.6256728176201766
경제/NNG@$완만/XR@$회복세/NNG@$갈/VX,0,-0.8593709630480846,32,9,23,12,0.037723050551375835,0.4975602978157326
상품/NNG@$가격/NNG@$급등/NNG,-1,-0.8597449780026895,64,19,45,11,0.055620377822039754,0.7357223927559693
달성/NNG@$쉽/VA@$않/VX,-1,-0.8597912101706336,45,13,32,27,0.045617200258301946,0.6036181572157723
경제/NNG@$동향/NNG@$인플레율/NNG,-1,-0.8597912101706336,45,13,32,7,0.045617200258301946,0.6036181572157723
확장/NNG@$기조/NNG@$유지/NNG,-1,-0.8620283666996871,61,18,43,7,0.05330431556587396,0.717606669262047
수출/NNG@$견조/NNG@$증가세/NNG,0,-0.8624976551166246,22,6,16,10,0.03048315975450745,0.4118789150351609
정책/NNG@$경기/NNG@$회복/NNG,-1,-0.8645790041234023,42,12,30,7,0.042302315313630705,0.5809868932153706
국채/NNG@$매입/NNG@$방안/NNG,-1,-0.8645790041234023,42,12,30,14,0.042302315313630705,0.5809868932153706
구조/NNG@$개혁/NNG@$정책/NNG,-1,-0.86461611454234,58,17,41,23,0.050857753221927794,0.6986935603028542
하향/NNG@$조정/NNG@$경제/NNG,-1,-0.867063313995976,74,22,52,26,0.056671399393191345,0.7938987702989493
금리/NNG@$인상/NNG@$행진/NNG@$중단/NNG,-1,-0.8675761987324663,55,16,39,17,0.04827010461894818,0.6790053637566442
통화정책/NNG@$방향/NNG@$논의/NNG@$기준금리/NNG,-1,-0.8709910799827185,52,15,37,8,0.04553002880675352,0.6585716286056643
방향/NNG@$논의/NNG@$기준금리/NNG,-1,-0.8709910799827185,52,15,37,8,0.04553002880675352,0.6585716286056643
인위적/NNG@$경기/NNG@$부양/NNG,-1,-0.8739191058680349,65,19,46,21,0.05030061797303982,0.7455922183594422
위안화/NNG@$변동/NNG@$확대/NNG,-1,-0.8775743243725089,36,10,26,40,0.03493323165312317,0.5342626981916526
전망/NNG@$크/VA@$벗어나/VV@$않/VX,0,-0.8824418870272099,26,7,19,12,0.028119715069918002,0.4489741417963154
인상/NNG@$행진/NNG@$중단/NNG,-1,-0.8832020181574136,56,16,40,21,0.04291474142776689,0.6899241177709462
금융시장/NNG@$불안/NNG@$심리/NNG,-1,-0.8850629029242676,43,12,31,8,0.03627680550826068,0.5932085676236989
변동성/NNG@$확대/NNG@$경제/NNG,-1,-0.887103694180134,53,15,38,15,0.040192345961766,0.6698057764850327
삭제/NNG@$금리/NNG@$인상/NNG,-1,-0.8974508525360992,90,26,64,12,0.04734970090877316,0.8731987124580942
하방/NNG@$위험/NNG@$커지/VV,-1,-0.8991090648981056,37,10,27,17,0.029147190340827227,0.5467995277949185
외환/NNG@$위기/NNG@$겪/VV,-1,-0.8991090648981056,37,10,27,19,0.029147190340827227,0.5467995277949185
소비/NNG@$투자/NNG@$심리/NNG@$위축/NNG,-1,-0.9020035662366243,74,21,53,17,0.04158706164889722,0.8043585722573652
자금/NNG@$이탈/NNG@$우려/NNG,-1,-0.9024275451914834,44,12,32,19,0.031149991046578205,0.6052330973343525
선제적/NNG@$금리/NNG@$인하/NNG,-1,-0.9026215746908098,94,27,67,32,0.045644727867266074,0.8887121612213187
금리/NNG@$인상/NNG@$달러/NNG@$강세/NNG,-1,-0.9051372278934372,81,23,58,27,0.04193176143547074,0.8391008148203837
외환/NNG@$위기/NNG@$가능성/NNG,-1,-0.9080764458404307,34,9,25,18,0.02528726296194471,0.5229516816468821
금융/NNG@$경제/NNG@$부장/NNG,-1,-0.9080764458404307,34,9,25,20,0.02528726296194471,0.5229516816468821
결정/NNG@$기준금리/NNG@$인상/NNG,-1,-0.9080764458404307,34,9,25,14,0.02528726296194471,0.5229516816468821
은행/NNG@$마이너스금리/NNG@$도입/NNG,-1,-0.9091088069691913,41,11,30,13,0.02783491912180065,0.5824670463566256
가계부채/NNG@$상환/NNG@$부담/NNG,0,-0.9098935465727632,27,7,20,16,0.021865777190661583,0.46171772244087456
기준금리/NNG@$인상/NNG@$지연/NNG,-1,-0.9171010791002838,45,12,33,25,0.026792756894355674,0.6170627881768508
비둘기파/NNG@$통화/NNG@$완화/NNG@$선호/NNG,-1,-0.9171010791002838,45,12,33,29,0.026792756894355674,0.6170627881768508
주택/NNG@$담보대출/NNG@$증가세/NNG,-1,-0.917471334738439,69,19,50,26,0.033814816029473276,0.782418145392127
경기/NNG@$하향/NNG@$리스크/NNG,0,-0.9187575511896434,20,5,15,7,0.017019091225137787,0.4002699211845442
인하/NNG@$경기/NNG@$회복/NNG,-1,-0.9210582566801969,66,18,48,22,0.031619781924702134,0.7661595291000126
지속/NNG@$필요/NNG@$있/VA,-1,-0.9255441471561855,35,9,26,12,0.020799461592432414,0.5354520134498734
경제/NNG@$성장/NNG@$완만/XR,-1,-0.9255441471561855,35,9,26,23,0.020799461592432414,0.5354520134498734
긴급/NNG@$금리/NNG@$인하/NNG,-1,-0.9266351254177045,133,37,96,10,0.03716123924055247,0.9713725421954441
소비자/NNG@$물가/NNG@$상승률/NNG@$석유류/NNG@$가격/NNG,-1,-0.9312316820324962,39,10,29,10,0.020448147970232845,0.5714126095965714
요인/NNG@$소비자/NNG@$물가/NNG,-1,-0.9312316820324962,39,10,29,9,0.020448147970232845,0.5714126095965714
상승률/NNG@$석유류/NNG@$가격/NNG,-1,-0.9312316820324962,39,10,29,10,0.020448147970232845,0.5714126095965714
기준금리/NNG@$인상/NNG@$어려울/VA,-1,-0.9312316820324962,39,10,29,14,0.020448147970232845,0.5714126095965714
물가/NNG@$상승률/NNG@$석유류/NNG@$가격/NNG,-1,-0.9312316820324962,39,10,29,10,0.020448147970232845,0.5714126095965714
이중/NNG@$침체/NNG@$우려/NNG,-1,-0.9359472517478752,43,11,32,11,0.02016988804192098,0.6063887624474162
인상/NNG@$달러/NNG@$강세/NNG,-1,-0.9377531834399903,93,25,68,32,0.02897881168946269,0.897195272706823
원화/NNG@$강세/NNG@$보이/VV,-1,-0.9395348735342326,36,9,27,18,0.017174884900132116,0.547824858086989
인상/NNG@$서두르/VV@$않/VX,-1,-0.9403610780124221,65,17,48,33,0.023723865863713643,0.7674670068673193
유지/NNG@$금융/NNG@$경제/NNG@$고려/NNG,-1,-0.9432427449871015,51,13,38,0,0.019759233829965327,0.6724681748703244
금융/NNG@$위기/NNG@$확산/NNG,-1,-0.9443383231673306,62,16,46,16,0.021610372712512732,0.7502787566146317
경제/NNG@$전망/NNG@$불확실/NNG,-1,-0.9460628370548102,44,11,33,13,0.017239340041373855,0.6180869523612482
인하/NNG@$전망/NNG@$유지/NNG,-1,-0.9486533136198385,33,8,25,21,0.013894581244084672,0.5238295248359549
달러/NNG@$약세/NNG@$지속/NNG,-1,-0.9486805980164632,48,12,36,7,0.017268710732520315,0.6513880929838431
자본/NNG@$유출/NNG@$환율/NNG,-1,-0.9526806684411759,41,10,31,8,0.014532743030933774,0.595413168028016
예상/NNG@$기업/NNG@$많/VA,-1,-0.959703994873012,38,9,29,26,0.011865053489176226,0.5721822523427993
기준금리/NNG@$인하/NNG@$경기/NNG@$부양/NNG,-1,-0.9605637572928254,42,10,32,22,0.012318976164601904,0.6071789328399525
검토/NNG@$볼/VX@$필요/NNG@$있/VA,0,-0.961796542500835,18,4,14,11,0.007631818901686832,0.3884326222724448
지준/NNG@$금리/NNG@$인하/NNG,-1,-0.9669041267361074,39,9,30,27,0.009930696009816439,0.5841602318917508
성장/NNG@$경로/NNG@$크/VA,-1,-0.9670193710379701,43,10,33,13,0.010482428767805278,0.6187840038069896
물가/NNG@$경기/NNG@$금융시장/NNG,-1,-0.9672693298021994,47,11,36,8,0.010962714062371487,0.652109424578238
금리/NNG@$인상/NNG@$이어지/VV,-1,-0.9672693298021994,47,11,36,14,0.010962714062371487,0.652109424578238
견조/NNG@$성장/NNG@$지속/NNG@$물가/NNG@$유지/NNG,-1,-0.9679408396983252,55,13,42,0,0.0117580218707831,0.7141570157773107
소비자/NNG@$물가/NNG@$농산물/NNG,0,-0.9707095734469557,23,5,18,6,0.006582583908119516,0.43778453807132844
성장/NNG@$지속/NNG@$물가/NNG@$유지/NNG,-1,-0.9720520319731977,56,13,43,0,0.01038660025868967,0.7240495535622555
지속/NNG@$물가/NNG@$유지/NNG,-1,-0.9720520319731977,56,13,43,0,0.01038660025868967,0.7240495535622555
국책은행/NNG@$자본/NNG@$확충/NNG,-1,-0.9772760576986949,78,18,60,41,0.010009553171857496,0.8580676499503463
금리/NNG@$인하/NNG@$공조/NNG,-1,-0.9793319113741042,104,24,80,3,0.010042805639566924,0.9461445041245818
금리/NNG@$인상/NNG@$서두르/VV@$않/VX,-1,-0.9795888933249346,50,11,39,27,0.007175439105516568,0.6844664646667474
수요/NNG@$상승/NNG@$압력/NNG,-1,-0.9824522298713434,51,11,40,13,0.006270338445802732,0.6948682425611588
물가/NNG@$농산물/NNG@$가격/NNG,0,-0.984213395934233,25,5,20,5,0.003761482276824215,0.46277029999039093
정책/NNG@$다지기/NNG@$필요/NNG,-1,-0.984867299169577,52,11,41,15,0.00549679622246354,0.7050733421987498
역할/NNG@$할/VV@$기대/NNG,-1,-0.9854267649458951,61,13,48,7,0.005786568103931271,0.7703016336835784
하향/NNG@$조정/NNG@$금리/NNG@$인하/NNG,-1,-0.9854898500451847,39,8,31,15,0.004460794992120239,0.5963574558585172
서부텍사스산원유/NNG@$가격/NNG@$하락/NNG,-1,-0.9857530793120818,30,6,24,22,0.003763564442105469,0.5122922079978225
세월/NNG@$사고/NNG@$영향/NNG,-1,-0.9870029293528345,35,7,28,15,0.003765511433964448,0.5609377146850288
초과/NNG@$지준/NNG@$금리/NNG@$인하/NNG,-1,-0.9930088618994429,33,6,27,24,0.0020199815615135077,0.5490325802541571
식료품/NNG@$에너지/NNG@$지수/NNG,-1,-0.9930088618994429,33,6,27,9,0.0020199815615135077,0.5490325802541571
단기/NNG@$시장/NNG@$금리/NNG,-1,-0.9941703299722736,44,8,36,20,0.0020210666961647723,0.6530963146846194
소비/NNG@$설비투자/NNG@$내수/NNG,-1,-0.9960462187440041,41,7,34,12,0.0013578440217648794,0.6310024450047375
경기/NNG@$상승/NNG@$수요/NNG@$압력/NNG,-1,-0.9974616702212425,32,5,27,20,0.0007916946356121817,0.5491260296565557
저축/NNG@$은행/NNG@$부실/NNG,-1,-0.9980124721551127,39,6,33,11,0.0007224208990923462,0.6197504944941246
유지/NNG@$물가/NNG@$상승률/NNG,-1,-0.9989924855587512,36,5,31,13,0.0004026933236491682,0.5967239665707391
결정적/NNG@$역할/NNG@$할/VV,-1,-0.9997732926597097,49,6,43,1,0.00020611450367799834,0.7254234864498935
석유류/NNG@$가격/NNG@$상승/NNG,-1,-1.0,29,3,26,7,9.169632704939482e-05,0.5370388354286247
