word,label,polarity,count,pos_count,neg_count,neu_count,pos_score,neg_score
원유/NNG;가격/NNG;올랐/VV,1,1.0,20,20,0,3,0.6727533024647047,2.5878321297242177e-05
금리/NNG;낮/VA;아니/VCN;올리/VV,1,0.9999958341800472,17,17,0,0,0.638221195189187,2.5878321297242177e-05
금리인상/NNG;부동산가격/NNG;영향/NNG;주/VV;아니/VCN,1,0.9999942962054746,16,16,0,0,0.6263516154585209,2.5878321297242177e-05
상환능력/NNG;유지~할/VVX,1,0.9999926760710711,15,15,0,5,0.6143162659140284,2.5878321297242177e-05
성장/NNG;안/MAG;될/VV,1,0.9995380306765842,18,17,1,0,0.6382063206384324,0.00017188418195920413
플러스/NNG;성장세/NNG;이/VV,1,0.9994668181237429,17,16,1,1,0.6263354144083159,0.00019098220303137822
성장경로/NNG;불확실성/NNG;상존~하/VVX,1,0.99829124909132,21,19,2,10,0.6613677721742108,0.0005905378972187154
통화정책/NNG;금융완화/NNG;유지~하/VVX,1,0.9965862446858766,25,22,3,21,0.694662761530109,0.0012135235663129661
경기회복세/NNG;되/VV,1,0.9963846917016124,17,15,2,18,0.6142113605678486,0.0011350485203135263
콜금리/NNG;목표/NNG;인상~하/VVX,1,0.995889809447549,38,33,5,5,0.8002379470088402,0.0016774444025703177
경제성장/NNG;가능~할/VVX,1,0.9941202420514126,15,13,2,3,0.5896340885582614,0.0017598831789647031
지정학적리스크/NNG;커지/VV,1,0.9941202420514126,15,13,2,15,0.5896340885582614,0.0017598831789647031
시장금리/NNG;하락~했/VVX,1,0.9930774455580604,21,18,3,13,0.6496773526963,0.0022797459628700807
인플레이션/NNG;완화~되/VVX;않/VX,1,0.991461985916982,20,17,3,5,0.6379414335411426,0.002757446201393676
기준금리/NNG;상향조정~하/VVX,1,0.9900583966365442,31,26,5,18,0.7358862927190937,0.003701639507291296
금리인상/NNG;나타나/VV,1,0.9892963560141925,19,16,3,8,0.6260193471201932,0.003389806393814086
인플레이션/NNG;우려/NNG;상존~해/VVX,1,0.9839765014146549,28,23,5,28,0.7048086336793785,0.005714984237762088
잠재/NNG;성장률/NNG;밑도/VV,1,0.9821941840366721,17,14,3,14,0.6016295151964413,0.005423249104466234
경기상승세/NNG;지속~되/VVX,1,0.9811872763382248,22,18,4,7,0.6492579213111537,0.00618525863364112
내수/NNG;증가~하/VVX,1,0.9811872763382248,22,18,4,9,0.6492579213111537,0.00618525863364112
기준금리/NNG;인상~함/VVX,1,0.9811872763382248,22,18,4,36,0.6492579213111537,0.00618525863364112
금리/NNG;올려서/VV,1,0.9808976028797527,27,22,5,29,0.6939887011385585,0.006713759911608757
경제/NNG;호조/NNG;지속~하/VVX,1,0.9776968672063049,31,25,6,11,0.7252244969353305,0.00820002758307948
인플레이션기대/NNG;심리/NNG;확산~될/VVX,1,0.9762667229694506,16,13,3,2,0.5891617625406362,0.007092398057292591
기준금리인상/NNG;이어질/VV,1,0.9762667229694506,16,13,3,11,0.5891617625406362,0.007092398057292591
경제/NNG;물가안정/NNG;견조~한/VAX;성장/NNG;지속~할/VVX,1,0.9762667229694506,16,13,3,0,0.5891617625406362,0.007092398057292591
금리/NNG;올라야/VV,1,0.9762667229694506,16,13,3,12,0.5891617625406362,0.007092398057292591
경기회복모멘텀/NNG;둔화~되/VVX,1,0.9762667229694506,16,13,3,8,0.5891617625406362,0.007092398057292591
콜금리/NNG;인상~해야/VVX,1,0.9762667229694506,16,13,3,5,0.5891617625406362,0.007092398057292591
성장세/NNG;둔화~하/VVX,1,0.972072587574728,25,20,5,13,0.6716577225280972,0.009529947015610465
경기/NNG;회복세/NNG;지속~하/VVX,1,0.9700484289072737,20,16,4,10,0.6254018473532531,0.009524791175839414
적자/NNG;나/VV,1,0.9700484289072737,20,16,4,7,0.6254018473532531,0.009524791175839414
인플레이션/NNG;우려/NNG;상존~하/VVX,1,0.9675611002218001,15,12,3,4,0.5765031906219391,0.009519351219587325
경제회복/NNG;지연~되/VVX,1,0.9675611002218001,15,12,3,11,0.5765031906219391,0.009519351219587325
불확실성/NNG;해소~되/VVX;않/VX,1,0.9661897599417817,46,36,10,36,0.8220583045692327,0.014156347901087453
금리인상/NNG;다가오/VV,1,0.9657139111405182,24,19,5,21,0.6601425871100757,0.011530479948538595
성장/NNG;될/VV,1,0.9627189633362785,28,22,6,9,0.6931783474170329,0.0131828137328398
기준금리/NNG;동결~된다면/VVX,1,0.9613216151359385,19,15,4,7,0.6131482419806076,0.012105581956465569
단기금리/NNG;올리/VV,1,0.9613216151359385,19,15,4,3,0.6131482419806076,0.012105581956465569
경기/NNG;해외/NNG;위험요인/NNG;상존~하/VVX,1,0.9574501413868817,23,18,5,8,0.6483876407326099,0.01410793921310683
이자/NNG;부담/NNG;늘어날/VV,1,0.9550683769696366,27,21,6,17,0.6819942137415258,0.015687374232943564
경기회복세/NNG;둔화~될/VVX,1,0.9492150670298465,18,14,4,11,0.6006612366989589,0.015660203840232388
엔화/NNG;급락~했/VVX,1,0.9492150670298465,18,14,4,6,0.6006612366989589,0.015660203840232388
부동산가격/NNG;잡/VV,1,0.9469958402133696,54,41,13,12,0.8555226388442477,0.02330457433113939
매수/NNG;심리/NNG;회복~되/VVX,1,0.945410866818823,26,20,6,13,0.6705480513367373,0.018826557468972854
경기상승/NNG;이어지/VV,1,0.9450092114915598,30,23,7,7,0.7029603844439961,0.01988569348194541
금리/NNG;높여/VV,1,0.9450092114915598,30,23,7,38,0.7029603844439961,0.01988569348194541
위험/NNG;존재~하/VVX,1,0.9322284217276415,21,16,5,22,0.6241112433261113,0.02189655513554653
비용/NNG;줄여/VV,1,0.9321705609303752,17,13,4,16,0.5879148057534934,0.020644833548631957
통화가치/NNG;하락~하/VVX,1,0.9321705609303752,17,13,4,29,0.5879148057534934,0.020644833548631957
채권/NNG;시장/NNG;국채선물/NNG;상승~한/VAX;거래~되/VVX,1,0.9321705609303752,17,13,4,31,0.5879148057534934,0.020644833548631957
경기둔화우려/NNG;부각~되/VVX,1,0.9321705609303752,17,13,4,19,0.5879148057534934,0.020644833548631957
부동산/NNG;잡/VV,1,0.9298617758378207,40,30,10,19,0.7700085966328358,0.027991856841474604
경기선행지수/NNG;상승~하/VVX,1,0.9274070175675024,36,27,9,15,0.7421494346884485,0.02795783668921616
달러화/NNG;엔화/NNG;상승~했/VVX,1,0.9212768824294102,28,21,7,23,0.680449144454155,0.027884443913198935
국제/NNG;원자재/NNG;가격/NNG;오르/VV,1,0.9174613946194756,24,18,6,7,0.6468163438112746,0.027844865042668192
가산금리/NNG;올리/VV,1,0.9174613946194756,24,18,6,17,0.6468163438112746,0.027844865042668192
금리상승/NNG;예상~하/VVX,1,0.9174613946194756,24,18,6,27,0.6468163438112746,0.027844865042668192
통화정책/NNG;완화/NNG;유지~해/VVX,1,0.9174613946194756,24,18,6,14,0.6468163438112746,0.027844865042668192
성장경로/NNG;벗어나/VV;않/VX,1,0.9130287995266677,20,15,5,25,0.6115457255739929,0.02780321620611065
기준금리인상/NNG;나서/VV,1,0.9082570388187201,38,28,10,27,0.7503748386921819,0.03607492013389031
완화/NNG;줄여/VV,1,0.9078692538056388,16,12,4,16,0.5748626820271675,0.027759377450054263
집값안정/NNG;위해/VV,1,0.9078692538056388,16,12,4,5,0.5748626820271675,0.027759377450054263
국채선물/NNG;하락~하/VVX,1,0.9078692538056388,16,12,4,15,0.5748626820271675,0.027759377450054263
경상수지적자/NNG;확대~되/VVX,1,0.9078692538056388,16,12,4,5,0.5748626820271675,0.027759377450054263
산업생산/NNG;증가~할/VVX,1,0.8973423569333678,23,17,6,12,0.6344867346143522,0.03432562875596457
기준금리인상/NNG;결정~하/VVX,1,0.8973423569333678,23,17,6,13,0.6344867346143522,0.03432562875596457
국제/NNG;원자재/NNG;가격/NNG;상승~하/VVX,1,0.8973423569333678,23,17,6,12,0.6344867346143522,0.03432562875596457
국채수익률/NNG;오르/VV,1,0.8945651734054008,30,22,8,13,0.6898391280884197,0.0383851822499006
기준금리인상/NNG;필요~하/VVX,1,0.8872376490730951,19,14,5,6,0.5986426575358054,0.03576221265740808
유동성/NNG;늘/VV,1,0.8872376490730951,19,14,5,9,0.5986426575358054,0.03576221265740808
성장/NNG;이룰/VV,1,0.8872376490730951,19,14,5,12,0.5986426575358054,0.03576221265740808
소비자물가/NNG;상회~하/VVX,1,0.8729345320353186,15,11,4,12,0.5614236552395844,0.038078392275214305
산업생산/NNG;감소~했/VVX,1,0.8729345320353186,15,11,4,10,0.5614236552395844,0.038078392275214305
재정위기/NNG;확산~되/VVX,1,0.8729345320353186,15,11,4,31,0.5614236552395844,0.038078392275214305
콜금리/NNG;올렸/VV,1,0.8729345320353186,15,11,4,6,0.5614236552395844,0.038078392275214305
조달금리/NNG;낮출/VV,1,0.8729345320353186,15,11,4,13,0.5614236552395844,0.038078392275214305
위험/NNG;요인/NNG;작용~할/VVX,1,0.8729345320353186,15,11,4,16,0.5614236552395844,0.038078392275214305
부도위험/NNG;나타내/VV,1,0.8729345320353186,15,11,4,7,0.5614236552395844,0.038078392275214305
금리인상/NNG;남/VV,1,0.8714710328323703,22,16,6,16,0.6218001042220356,0.04269218275209265
호황/NNG;누렸/VV,1,0.8595005413970132,25,18,7,11,0.6442780660353697,0.04866388171592523
달러화/NNG;약세/NNG;나타내/VV,1,0.8595005413970132,25,18,7,11,0.6442780660353697,0.04866388171592523
유가/NNG;급락~하/VVX,1,0.8595005413970132,25,18,7,19,0.6442780660353697,0.04866388171592523
인플레이션억제/NNG;위한/VV,1,0.854600842681464,38,27,11,24,0.7373574005806036,0.057787713788800106
위험/NNG;확대~될/VVX,1,0.8525293674703822,18,13,5,15,0.5853325653609763,0.04657850056312565
이자/NNG;부담/NNG;커질/VV,1,0.8525293674703822,18,13,5,16,0.5853325653609763,0.04657850056312565
위안화절상/NNG;따른/VV,1,0.8525293674703822,18,13,5,9,0.5853325653609763,0.04657850056312565
금리인상/NNG;빨라질/VA;있/VV,1,0.8525293674703822,18,13,5,24,0.5853325653609763,0.04657850056312565
금융완화/NNG;줄여/VV,1,0.8525293674703822,18,13,5,21,0.5853325653609763,0.04657850056312565
물가/NNG;올리/VV,1,0.8525293674703822,18,13,5,10,0.5853325653609763,0.04657850056312565
성장/NNG;이루/VV,1,0.8503915822186943,28,20,8,13,0.6660216854618441,0.05382938880583339
채권/NNG;시장/NNG;오/VV,1,0.8503915822186943,28,20,8,18,0.6660216854618441,0.05382938880583339
국제/NNG;유가/NNG;하락~하/VVX,1,0.8500644108028861,92,64,28,64,0.940604289170775,0.07620140415045462
자금유입/NNG;증가~하/VVX,1,0.8382352553358865,21,15,6,16,0.6086984256850035,0.05354320030533312
중소기업대출/NNG;늘어나/VV,1,0.8382352553358865,21,15,6,6,0.6086984256850035,0.05354320030533312
부동산가격/NNG;급등~하/VVX,1,0.8382352553358865,21,15,6,11,0.6086984256850035,0.05354320030533312
이자/NNG;부담/NNG;늘어나/VV,1,0.8305871616670437,40,28,12,31,0.7448094550158245,0.06889845833244754
고용부진/NNG;따른/VV,1,0.821091158781003,27,19,8,29,0.6535094072283937,0.06417234036285417
달러약세/NNG;지속~될/VVX,1,0.821091158781003,27,19,8,21,0.6535094072283937,0.06417234036285417
부동산가격/NNG;안정/NNG;위해/VV,1,0.821091158781003,27,19,8,9,0.6535094072283937,0.06417234036285417
경기회복세/NNG;둔화~되/VVX,1,0.8160640842518057,30,21,9,8,0.6748276813173226,0.06831530132739574
국제/NNG;유가/NNG;급락~하/VVX,1,0.809985586717346,36,25,11,19,0.7150469332414741,0.07502889973263543
유가/NNG;떨어질/VV,1,0.8060143551227199,17,12,5,12,0.5715042647495612,0.06135444129601626
경제/NNG;확산~될/VVX,1,0.8060143551227199,17,12,5,6,0.5715042647495612,0.06135444129601626
경제성장률/NNG;떨어질/VV,1,0.8060143551227199,17,12,5,12,0.5715042647495612,0.06135444129601626
경기회복세/NNG;찬물/NNG;끼얹/VV,1,0.8060143551227199,17,12,5,14,0.5715042647495612,0.06135444129601626
경제/NNG;부담/NNG;되/VV,1,0.8060143551227199,17,12,5,15,0.5715042647495612,0.06135444129601626
경기침체/NNG;우려/NNG;커지/VV,1,0.8060143551227199,17,12,5,3,0.5715042647495612,0.06135444129601626
변동성/NNG;높이/VV,1,0.8060143551227199,17,12,5,18,0.5715042647495612,0.06135444129601626
구조/NNG;개선~되/VVX,1,0.7957652565002831,20,14,6,16,0.5950951304308782,0.0676446875661376
기대심리/NNG;유지~되/VVX,1,0.7957652565002831,20,14,6,29,0.5950951304308782,0.0676446875661376
금리인상/NNG;카드/NNG;꺼내/VV,1,0.789512095113617,23,16,7,11,0.6181300196089933,0.07266634815625174
통화정책/NNG;경제/NNG;견조~한/VAX;성장/NNG;지속~하/VVX,1,0.789512095113617,23,16,7,8,0.6181300196089933,0.07266634815625174
기준금리인상/NNG;단행~하/VVX,1,0.7840816016078953,44,30,14,31,0.7584472781764625,0.09173944755238403
물가/NNG;안정세/NNG;유지~하/VVX,1,0.7837620226184836,29,20,9,6,0.6622148190831537,0.08023233653242115
기준금리인상/NNG;예상~하/VVX,1,0.7837620226184836,29,20,9,30,0.6622148190831537,0.08023233653242115
실적/NNG;부진~할/VVX,1,0.7837620226184836,29,20,9,11,0.6622148190831537,0.08023233653242115
기준금리인상/NNG;통해/VV,1,0.7833562483183836,41,28,13,34,0.740929329721552,0.08995803370405853
금리인상/NNG;필요~할/VVX,1,0.759502226868604,43,29,14,14,0.7475714416902043,0.10211941878943173
미국채금리/NNG;하락~했/VVX,1,0.7588892524372777,66,44,22,56,0.8522277322345777,0.11675288903078719
금융완화/NNG;유지~하/VVX,1,0.7568403252287881,40,27,13,42,0.7295817615536648,0.1009172692394823
성장/NNG;지속~되/VVX,1,0.7540742064575827,37,25,12,30,0.7107136798978263,0.09958200540954694
불확실성/NNG;줄어들/VV,1,0.7540742064575827,37,25,12,25,0.7107136798978263,0.09958200540954694
금리인상/NNG;가능성/NNG;시사~하/VVX,1,0.7540386070586456,60,40,20,40,0.8284185335287855,0.11609343150437998
경제성장/NNG;둔화~하/VVX,1,0.7458658094955368,28,19,9,15,0.6490848972075907,0.09442293987200599
국고채/NNG;지표금리/NNG;오른/VV,1,0.7446939634210987,51,34,17,50,0.7863213766162674,0.11499125298038668
소비지출/NNG;증가~하/VVX,1,0.7444729706316888,16,11,5,12,0.5569779979114189,0.08153299106160028
외환시장안정/NNG;위한/VV,1,0.7444729706316888,16,11,5,9,0.5569779979114189,0.08153299106160028
하방경직성/NNG;강화~되/VVX,1,0.7444729706316888,16,11,5,19,0.5569779979114189,0.08153299106160028
국제/NNG;유가급등/NNG;따른/VV,1,0.7444729706316888,16,11,5,8,0.5569779979114189,0.08153299106160028
경제성장률/NNG;전망/NNG;낮추/VV,1,0.7444729706316888,16,11,5,7,0.5569779979114189,0.08153299106160028
이자/NNG;낮추/VV,1,0.7444729706316888,16,11,5,11,0.5569779979114189,0.08153299106160028
소비자물가/NNG;오른/VV,1,0.7444729706316888,16,11,5,11,0.5569779979114189,0.08153299106160028
소비자물가/NNG;안정~되/VVX,1,0.7444729706316888,16,11,5,8,0.5569779979114189,0.08153299106160028
금리/NNG;상승~한다면/VVX,1,0.7444729706316888,16,11,5,15,0.5569779979114189,0.08153299106160028
금리인상/NNG;전망~하/VVX,1,0.7421888143970106,22,15,7,24,0.6042306622798257,0.08935736117644537
경제/NNG;완만~한/VAX;회복세/NNG;이/VV,1,0.7421888143970106,22,15,7,6,0.6042306622798257,0.08935736117644537
달러화/NNG;강세/NNG;나타낼/VV,1,0.7421888143970106,22,15,7,16,0.6042306622798257,0.08935736117644537
신용경색/NNG;우려/NNG;완화~되/VVX,1,0.7421888143970106,22,15,7,17,0.6042306622798257,0.08935736117644537
금리인상/NNG;진행~되/VVX,1,0.7421888143970106,22,15,7,17,0.6042306622798257,0.08935736117644537
불확실성해소/NNG;따른/VV,1,0.7420984461682003,19,13,6,22,0.5808600830129822,0.08593573012467788
투자/NNG;위축~될/VVX,1,0.7420984461682003,19,13,6,10,0.5808600830129822,0.08593573012467788
경기둔화/NNG;감안~할/VVX,1,0.7420984461682003,19,13,6,7,0.5808600830129822,0.08593573012467788
호주달러/NNG;강세/NNG;보이/VV,1,0.7420984461682003,19,13,6,6,0.5808600830129822,0.08593573012467788
경제/NNG;회복세/NNG;지속~하/VVX,1,0.7420984461682003,19,13,6,15,0.5808600830129822,0.08593573012467788
금리인상/NNG;가능성/NNG;따른/VV,1,0.7420984461682003,19,13,6,33,0.5808600830129822,0.08593573012467788
금리/NNG;유지~했/VVX,1,0.7420984461682003,19,13,6,8,0.5808600830129822,0.08593573012467788
경제성장/NNG;뒷받침~하/VVX,1,0.7420984461682003,19,13,6,10,0.5808600830129822,0.08593573012467788
경제/NNG;충격/NNG;줄/VV,1,0.715685674932667,33,22,11,28,0.6781953166051501,0.11231000495599402
금리인상/NNG;대비~해/VVX,1,0.7090658076144154,30,20,10,20,0.6571680718012275,0.11179201810308771
인플레이션/NNG;억제~될/VVX,1,0.7018043127389799,27,18,9,12,0.6353599435753395,0.11125136695068666
유가급락/NNG;따른/VV,1,0.7018043127389799,27,18,9,21,0.6353599435753395,0.11125136695068666
양적완화/NNG;줄이/VV,1,0.7018043127389799,27,18,9,41,0.6353599435753395,0.11125136695068666
듀레이션/NNG;늘리/VV,1,0.7017033338891281,52,34,18,34,0.7811833896666106,0.13683943550474095
금리/NNG;인상~해야/VVX,1,0.6960883486647642,101,65,36,82,0.916787132242299,0.16415633884190906
금리인상/NNG;예상~되/VVX,1,0.6923247436098978,87,56,31,85,0.8924190649379129,0.16213086388992567
cd금리/NNG;오르/VV,1,0.6877888847326674,65,42,23,31,0.8308466108012558,0.15358060448040886
경제/NNG;견조~한/VAX;성장/NNG;지속~하/VVX,1,0.6855184824052052,35,23,12,14,0.6855402909802153,0.12781403127687685
불확실성/NNG;줄이/VV,1,0.685108903805191,21,14,7,19,0.5896092750781619,0.11009824953039278
경제/NNG;영향/NNG;줄/VV,1,0.6786279232378738,43,28,15,18,0.7306870245401151,0.13978643205342783
기준금리/NNG;수준/NNG;동결~하/VVX,1,0.6786279232378738,43,28,15,60,0.7306870245401151,0.13978643205342783
금리인상/NNG;필요~하/VVX,1,0.675655088330301,51,33,18,43,0.770470773496374,0.14902421802716695
금리인상/NNG;단행~되/VVX,1,0.675655088330301,51,33,18,46,0.770470773496374,0.14902421802716695
금리/NNG;상승세/NNG;지속~하/VVX,1,0.6755363502864937,18,12,6,8,0.5657955280988036,0.1094837995057097
소비자물가/NNG;급등~하/VVX,1,0.6755363502864937,18,12,6,10,0.5657955280988036,0.1094837995057097
기대심리/NNG;올랐/VV,1,0.6755363502864937,18,12,6,16,0.5657955280988036,0.1094837995057097
경기/NNG;상승세/NNG;지속~하/VVX,1,0.6755363502864937,18,12,6,3,0.5657955280988036,0.1094837995057097
부채/NNG;증가~하/VVX,1,0.6755363502864937,18,12,6,30,0.5657955280988036,0.1094837995057097
물가상승률/NNG;둔화~되/VVX,1,0.6755363502864937,18,12,6,20,0.5657955280988036,0.1094837995057097
단기금리/NNG;상승~하/VVX,1,0.6664608915705168,64,41,23,44,0.8218436357317268,0.1643667139370298
단기금리/NNG;올라가/VV,1,0.6650440615925448,15,10,5,5,0.5414585091441952,0.10884271989218258
금리/NNG;넘어서/VV,1,0.6650440615925448,15,10,5,14,0.5414585091441952,0.10884271989218258
높/VA;수익률/NNG;보였/VV,1,0.6650440615925448,15,10,5,7,0.5414585091441952,0.10884271989218258
위험/NNG;빠질/VV,1,0.6650440615925448,15,10,5,10,0.5414585091441952,0.10884271989218258
달러원/NNG;상승압력/NNG;받/VV,1,0.6650440615925448,15,10,5,12,0.5414585091441952,0.10884271989218258
연방기금/NNG;금리/NNG;인하~할/VVX,1,0.6650440615925448,15,10,5,9,0.5414585091441952,0.10884271989218258
엔화/NNG;강세/NNG;저지~하/VVX,1,0.6650440615925448,15,10,5,13,0.5414585091441952,0.10884271989218258
불확실성/NNG;확대/NNG;따른/VV,1,0.6650440615925448,15,10,5,10,0.5414585091441952,0.10884271989218258
안정적/VAX;성장세/NNG;이/VV,1,0.6650440615925448,15,10,5,3,0.5414585091441952,0.10884271989218258
국제금융시장/NNG;변동성/NNG;확대~될/VVX,1,0.6650440615925448,15,10,5,17,0.5414585091441952,0.10884271989218258
실적/NNG;줄/VV,1,0.6650440615925448,15,10,5,12,0.5414585091441952,0.10884271989218258
회사채스프레드/NNG;확대~되/VVX,1,0.6650440615925448,15,10,5,8,0.5414585091441952,0.10884271989218258
유로화/NNG;오르/VV,1,0.6650440615925448,15,10,5,10,0.5414585091441952,0.10884271989218258
경기둔화/NNG;지속~될/VVX,1,0.6650440615925448,15,10,5,10,0.5414585091441952,0.10884271989218258
가격변수/NNG;변동성/NNG;확대~되/VVX,1,0.6650440615925448,15,10,5,10,0.5414585091441952,0.10884271989218258
채권스왑/NNG;스프레드/NNG;역전폭/NNG;확대~되/VVX,1,0.6650440615925448,15,10,5,30,0.5414585091441952,0.10884271989218258
기준금리인상/NNG;이어지/VV,1,0.6650440615925448,15,10,5,9,0.5414585091441952,0.10884271989218258
원자재/NNG;가격/NNG;오르/VV,1,0.6642490409376163,29,19,10,16,0.6432706407007932,0.12967745780854248
경제/NNG;타격/NNG;줄/VV,1,0.6642490409376163,29,19,10,21,0.6432706407007932,0.12967745780854248
내수/NNG;개선~되/VVX,1,0.6511735169707009,26,17,9,18,0.6209362984052422,0.13107759857356183
달러화/NNG;하락압력/NNG;가했/VV,1,0.6511735169707009,26,17,9,21,0.6209362984052422,0.13107759857356183
주택가격/NNG;상승~하/VVX,1,0.6511735169707009,26,17,9,32,0.6209362984052422,0.13107759857356183
경제성장률/NNG;둔화~될/VVX,1,0.650063049349382,58,37,21,30,0.7948194264372397,0.16843092592020173
불확실성/NNG;해소~하/VVX,1,0.6453147388347453,34,22,12,27,0.6720685157326994,0.1447669016492641
경제/NNG;안정~되/VVX,1,0.6358784246127311,23,15,8,16,0.5978540046520808,0.13296800997134067
대출/NNG;줄/VV,1,0.6358784246127311,23,15,8,10,0.5978540046520808,0.13296800997134067
수요/NNG;둔화~될/VVX,1,0.6358784246127311,23,15,8,13,0.5978540046520808,0.13296800997134067
부동산가격/NNG;상승~하/VVX,1,0.6358784246127311,23,15,8,20,0.5978540046520808,0.13296800997134067
소비/NNG;개선~되/VVX,1,0.6358784246127311,23,15,8,26,0.5978540046520808,0.13296800997134067
물가상승압력/NNG;커질/VV,1,0.630794280525159,31,20,11,18,0.6507748913189583,0.14721567222833168
수익성/NNG;개선~될/VVX,1,0.630794280525159,31,20,11,27,0.6507748913189583,0.14721567222833168
인플레이션압력/NNG;완화~되/VVX,1,0.6243095051223908,57,36,21,21,0.7842939966101814,0.18125542961056468
금리인상/NNG;둘러싼/VV,1,0.6179992952051063,36,23,13,28,0.6789536136757157,0.16016715980403323
투자심리/NNG;안정~시키/VVX,1,0.6176287606034414,20,13,7,10,0.5740638472352996,0.13558570534581377
외환시장안정/NNG;위해/VV,1,0.6176287606034414,20,13,7,8,0.5740638472352996,0.13558570534581377
금리인상/NNG;가능성/NNG;남/VV,1,0.6176287606034414,20,13,7,18,0.5740638472352996,0.13558570534581377
금리인상/NNG;보/VV,1,0.6176287606034414,20,13,7,25,0.5740638472352996,0.13558570534581377
성장/NNG;견인~할/VVX,1,0.6176287606034414,20,13,7,15,0.5740638472352996,0.13558570534581377
금리인상/NNG;우려/NNG;커지/VV,1,0.6176287606034414,20,13,7,17,0.5740638472352996,0.13558570534581377
높/VA;금리/NNG;제시~하/VVX,1,0.6176287606034414,20,13,7,23,0.5740638472352996,0.13558570534581377
국채선물/NNG;하락~한/VAX;거래/NNG;마쳤/VV,1,0.6176287606034414,20,13,7,18,0.5740638472352996,0.13558570534581377
금리인하/NNG;효과/NNG;지켜보/VV,1,0.6176287606034414,20,13,7,7,0.5740638472352996,0.13558570534581377
경제/NNG;회복세/NNG;이/VV,1,0.6176287606034414,20,13,7,15,0.5740638472352996,0.13558570534581377
기준금리/NNG;오를/VV,1,0.6175947197935752,49,31,18,61,0.7475180647555286,0.17657254786536875
위험/NNG;줄/VV,1,0.6138644483205293,28,18,10,11,0.6286369784490728,0.15028586274401998
금리/NNG;하락압력/NNG;받/VV,1,0.6138644483205293,28,18,10,28,0.6286369784490728,0.15028586274401998
성장/NNG;유지~하/VVX,1,0.6096460582865557,41,26,15,35,0.7053475750979862,0.17091285762072264
금리인상/NNG;예상~했/VVX,1,0.6039812836681266,46,29,17,36,0.7298801449993055,0.1800563980067669
실적/NNG;개선~되/VVX,1,0.5999766738629451,51,32,19,57,0.7525174946340788,0.18798660465811018
실적/NNG;악화~되/VVX,1,0.5952213697908941,17,11,6,10,0.5495966229755685,0.13934038396842474
엔화/NNG;오르/VV,1,0.5952213697908941,17,11,6,8,0.5495966229755685,0.13934038396842474
경기둔화/NNG;이어질/VV,1,0.5952213697908941,17,11,6,15,0.5495966229755685,0.13934038396842474
물가/NNG;오른/VV,1,0.5952213697908941,17,11,6,12,0.5495966229755685,0.13934038396842474
금리/NNG;인상~된/VVX,1,0.5952213697908941,17,11,6,23,0.5495966229755685,0.13934038396842474
국채발행/NNG;증가/NNG;따른/VV,1,0.5952213697908941,17,11,6,3,0.5495966229755685,0.13934038396842474
경기지표/NNG;호조/NNG;보이/VV,1,0.5952213697908941,17,11,6,17,0.5495966229755685,0.13934038396842474
경제/NNG;호조/NNG;나타내/VV,1,0.5952213697908941,17,11,6,10,0.5495966229755685,0.13934038396842474
채권/NNG;시장/NNG;국채선물/NNG;내린/VV,1,0.5952213697908941,17,11,6,24,0.5495966229755685,0.13934038396842474
금융시장/NNG;안정~될/VVX,1,0.5952213697908941,17,11,6,11,0.5495966229755685,0.13934038396842474
실적/NNG;부진~하/VVX,1,0.5952213697908941,17,11,6,11,0.5495966229755685,0.13934038396842474
대외불확실성/NNG;완화~되/VVX,1,0.5952213697908941,17,11,6,10,0.5495966229755685,0.13934038396842474
변동성/NNG;줄어드/VV,1,0.5952213697908941,17,11,6,6,0.5495966229755685,0.13934038396842474
소득/NNG;늘/VV,1,0.5952213697908941,17,11,6,22,0.5495966229755685,0.13934038396842474
금리상승압력/NNG;지속~될/VVX,1,0.5952213697908941,17,11,6,12,0.5495966229755685,0.13934038396842474
자산건전성/NNG;악화~되/VVX,1,0.5952213697908941,17,11,6,7,0.5495966229755685,0.13934038396842474
경기회복/NNG;진행~되/VVX,1,0.5952213697908941,17,11,6,21,0.5495966229755685,0.13934038396842474
금리인상/NNG;단행~되/VVX;않/VX,1,0.5952213697908941,17,11,6,17,0.5495966229755685,0.13934038396842474
달러원/NNG;떨어지/VV,1,0.5952213697908941,17,11,6,25,0.5495966229755685,0.13934038396842474
자산매입/NNG;축소~할/VVX,1,0.5952213697908941,17,11,6,25,0.5495966229755685,0.13934038396842474
달러화/NNG;떨어졌/VV,1,0.5938416334275531,25,16,9,15,0.6056750431980639,0.15421463096913884
금리상승/NNG;제한~할/VVX,1,0.5938416334275531,25,16,9,26,0.6056750431980639,0.15421463096913884
성장/NNG;보였/VV,1,0.5938416334275531,25,16,9,9,0.6056750431980639,0.15421463096913884
금리동결/NNG;예상~되/VVX,1,0.5938416334275531,25,16,9,31,0.6056750431980639,0.15421463096913884
금리인상/NNG;시작~하/VVX,1,0.5938416334275531,25,16,9,32,0.6056750431980639,0.15421463096913884
매출/NNG;늘/VV,1,0.5938416334275531,25,16,9,24,0.6056750431980639,0.15421463096913884
주택담보대출/NNG;늘/VV,1,0.5933371788094748,38,24,14,31,0.6854993742275393,0.17481120303257025
금리/NNG;인상~해/VVX,1,0.587863996391695,81,50,31,42,0.8504084894953359,0.22054013177898568
금리인상/NNG;이/VV,1,0.5821198492407922,58,36,22,39,0.7773888683590142,0.2051543489535467
유로화/NNG;하락압력/NNG;받/VV,1,0.5812961775420626,30,19,11,19,0.6359698280939137,0.16825185916672422
주택가격/NNG;오르/VV,1,0.5812961775420626,30,19,11,25,0.6359698280939137,0.16825185916672422
금리/NNG;급등~해/VVX,1,0.5812961775420626,30,19,11,16,0.6359698280939137,0.16825185916672422
기대심리/NNG;높여/VV,1,0.5812961775420626,30,19,11,18,0.6359698280939137,0.16825185916672422
콜금리/NNG;인상~했/VVX,1,0.5812961775420626,30,19,11,23,0.6359698280939137,0.16825185916672422
하방위험/NNG;요인/NNG;작용~할/VVX,1,0.5812961775420626,30,19,11,5,0.6359698280939137,0.16825185916672422
물가안정/NNG;위해/VV,1,0.5804925390945486,124,76,48,93,0.9082381785331384,0.2408664247180237
달러화/NNG;급락~하/VVX,1,0.5697138339749488,22,14,8,17,0.5819003675237301,0.1593711530640496
인플레이션압력/NNG;줄어들/VV,1,0.5697138339749488,22,14,8,8,0.5819003675237301,0.1593711530640496
gdp/NNG;증가~할/VVX,1,0.5697138339749488,22,14,8,13,0.5819003675237301,0.1593711530640496
수요/NNG;증가~했/VVX,1,0.5692406747794347,45,28,17,35,0.7169274555522893,0.19662752267016925
콜금리/NNG;올릴/VV,1,0.5692406747794347,45,28,17,12,0.7169274555522893,0.19662752267016925
마이너스금리/NNG;도입~하/VVX,1,0.568094372185282,60,37,23,37,0.7812675685846108,0.21500070775969712
성장/NNG;이/VV,1,0.568094372185282,60,37,23,50,0.7812675685846108,0.21500070775969712
기준금리인상/NNG;따른/VV,1,0.5647981478594493,169,103,66,103,0.9183341778175674,0.25518494174408535
기준금리/NNG;유지~하/VVX,1,0.5585822718102462,212,129,83,179,0.9187734883689704,0.25998451583458654
수출/NNG;늘어날/VV,1,0.5579841701135935,27,17,10,13,0.6131337268740006,0.17379957076786515
위험/NNG;줄일/VV,1,0.5579841701135935,27,17,10,22,0.6131337268740006,0.17379957076786515
금리인상/NNG;가능성/NNG;열/VV,1,0.5550030974391764,117,71,46,130,0.8955185277326286,0.25604578683572715
설비투자/NNG;증가~하/VVX,1,0.5527955203656185,32,20,12,11,0.6429721835163352,0.18501220021627376
경기둔화/NNG;인한/VV,1,0.5509242417279663,37,23,14,18,0.671195929894436,0.19417521065380003
원화/NNG;강세/NNG;이어질/VV,1,0.5509242417279663,37,23,14,15,0.671195929894436,0.19417521065380003
금리인상/NNG;신호/NNG;보내/VV,1,0.539905826909358,19,12,7,10,0.5572978663956243,0.1663605428165308
신용스프레드/NNG;확대~됐/VVX,1,0.539905826909358,19,12,7,14,0.5572978663956243,0.1663605428165308
고용지표/NNG;부진~했/VVX,1,0.539905826909358,19,12,7,15,0.5572978663956243,0.1663605428165308
금리인상/NNG;결정~되/VVX,1,0.539905826909358,19,12,7,7,0.5572978663956243,0.1663605428165308
cd금리/NNG;급등~하/VVX,1,0.539905826909358,19,12,7,4,0.5572978663956243,0.1663605428165308
기준금리인하/NNG;예상~하/VVX,1,0.539905826909358,19,12,7,21,0.5572978663956243,0.1663605428165308
물가안정/NNG;하/VV,1,0.539905826909358,19,12,7,15,0.5572978663956243,0.1663605428165308
전원/NNG;기준금리동결/NNG;예상~했/VVX,1,0.539905826909358,19,12,7,2,0.5572978663956243,0.1663605428165308
내수회복/NNG;따른/VV,1,0.539905826909358,19,12,7,5,0.5572978663956243,0.1663605428165308
물가상승/NNG;인해/VV,1,0.539905826909358,19,12,7,6,0.5572978663956243,0.1663605428165308
금리하락/NNG;나타날/VV,1,0.539905826909358,19,12,7,7,0.5572978663956243,0.1663605428165308
위험/NNG;낮추/VV,1,0.539905826909358,19,12,7,10,0.5572978663956243,0.1663605428165308
주택담보대출/NNG;증가세/NNG;둔화~되/VVX,1,0.539905826909358,19,12,7,9,0.5572978663956243,0.1663605428165308
경기회복/NNG;맞물려/VV,1,0.539905826909358,19,12,7,13,0.5572978663956243,0.1663605428165308
기준금리인상/NNG;이/VV,1,0.539905826909358,19,12,7,9,0.5572978663956243,0.1663605428165308
금리/NNG;올린/VV,1,0.5385229791105619,141,85,56,92,0.9048276904702173,0.271157562036423
고용호조/NNG;따른/VV,1,0.5350788131239985,49,30,19,46,0.7273761001494709,0.22009787899837888
양적완화/NNG;축소~하/VVX,1,0.5323167393628767,44,27,17,54,0.7033153979287111,0.21446692040557233
금리인상/NNG;이어지/VV,1,0.5297139525963446,39,24,15,29,0.6773928450400333,0.20806459990529313
기준금리/NNG;인상~했/VVX,1,0.5294885596655208,231,139,92,170,0.9111152590102378,0.28002892718719624
유가/NNG;올랐/VV,1,0.5277361428153275,34,21,13,30,0.6496734552561226,0.20064867843694556
경기개선/NNG;따른/VV,1,0.5274476949325726,61,37,24,39,0.7735882245038176,0.23911018868647327
글로벌경기/NNG;회복/NNG;따른/VV,1,0.5272631189120096,29,18,11,35,0.6202758114964093,0.1918205254153762
인플레이션/NNG;우려/NNG;완화~됐/VVX,1,0.5272631189120096,29,18,11,8,0.6202758114964093,0.1918205254153762
소득/NNG;늘어나/VV,1,0.5272631189120096,29,18,11,17,0.6202758114964093,0.1918205254153762
금리인상/NNG;위한/VV,1,0.5239249595180273,56,34,22,86,0.75383212150723,0.2352824658238108
기준금리/NNG;올라갈/VV,1,0.5018127155544783,16,10,6,14,0.5317847560198122,0.1762405530383034
자금유입/NNG;둔화~되/VVX,1,0.5018127155544783,16,10,6,17,0.5317847560198122,0.1762405530383034
금리변동위험/NNG;헤지~하/VVX,1,0.5018127155544783,16,10,6,1,0.5317847560198122,0.1762405530383034
자산건전성/NNG;악화~될/VVX,1,0.5018127155544783,16,10,6,11,0.5317847560198122,0.1762405530383034
금리인상/NNG;힘/NNG;실/VV,1,0.5018127155544783,16,10,6,22,0.5317847560198122,0.1762405530383034
회사채/NNG;신용스프레드/NNG;확대~되/VVX,1,0.5018127155544783,16,10,6,20,0.5317847560198122,0.1762405530383034
미국채금리/NNG;하락~한/VAX;영향/NNG;받/VV,1,0.5018127155544783,16,10,6,14,0.5317847560198122,0.1762405530383034
기준금리/NNG;인상~한/VAX;있/VV,1,0.5018127155544783,16,10,6,6,0.5317847560198122,0.1762405530383034
기준금리인상/NNG;가능성/NNG;시사~하/VVX,1,0.5018127155544783,16,10,6,8,0.5317847560198122,0.1762405530383034
기업/NNG;실적호조/NNG;힘입/VV,1,0.5018127155544783,16,10,6,7,0.5317847560198122,0.1762405530383034
금리/NNG;상승/NNG;마감~했/VVX,1,0.5018127155544783,16,10,6,20,0.5317847560198122,0.1762405530383034
금리/NNG;상승세/NNG;돌아섰/VV,1,0.5018127155544783,16,10,6,14,0.5317847560198122,0.1762405530383034
수급/NNG;영향/NNG;줄/VV,1,0.5018127155544783,16,10,6,7,0.5317847560198122,0.1762405530383034
환율상승/NNG;요인/NNG;작용~하/VVX,1,0.5018127155544783,16,10,6,12,0.5317847560198122,0.1762405530383034
금리인상/NNG;계속~할/VVX,1,0.5018127155544783,16,10,6,9,0.5317847560198122,0.1762405530383034
내외금리차/NNG;확대~되/VVX,1,0.5018127155544783,16,10,6,11,0.5317847560198122,0.1762405530383034
기준금리인상/NNG;지속~될/VVX,1,0.5018127155544783,16,10,6,12,0.5317847560198122,0.1762405530383034
고용/NNG;회복~되/VVX,1,0.5018127155544783,16,10,6,9,0.5317847560198122,0.1762405530383034
기준금리/NNG;동결~키로/VVX,1,0.5018127155544783,16,10,6,11,0.5317847560198122,0.1762405530383034
금융시장/NNG;개선~되/VVX,1,0.5018127155544783,16,10,6,5,0.5317847560198122,0.1762405530383034
불확실성/NNG;완화~됐/VVX,1,0.5018127155544783,16,10,6,13,0.5317847560198122,0.1762405530383034
경제여건/NNG;악화~되/VVX,1,0.5018127155544783,16,10,6,8,0.5317847560198122,0.1762405530383034
근원/NNG;소비자물가/NNG;상승~하/VVX,1,0.5018127155544783,16,10,6,6,0.5317847560198122,0.1762405530383034
금리인상/NNG;중단~되/VVX,1,0.5018127155544783,16,10,6,6,0.5317847560198122,0.1762405530383034
주택담보대출/NNG;금리/NNG;올랐/VV,1,0.5018127155544783,16,10,6,10,0.5317847560198122,0.1762405530383034
아파트가격/NNG;오르/VV,1,0.5018127155544783,16,10,6,19,0.5317847560198122,0.1762405530383034
경기/NNG;호조/NNG;보이/VV,1,0.5018127155544783,16,10,6,12,0.5317847560198122,0.1762405530383034
연방기금금리/NNG;인상~할/VVX,1,0.5018127155544783,16,10,6,9,0.5317847560198122,0.1762405530383034
경기/NNG;부양~해야/VVX,1,0.5018127155544783,16,10,6,7,0.5317847560198122,0.1762405530383034
수급/NNG;개선~되/VVX,1,0.5007581077547718,31,19,12,19,0.6271352282421796,0.20842708108576052
성장/NNG;촉진~하/VVX,1,0.5007581077547718,31,19,12,16,0.6271352282421796,0.20842708108576052
투자심리/NNG;위축~시킬/VVX,1,0.5007581077547718,31,19,12,22,0.6271352282421796,0.20842708108576052
변동성/NNG;축소~되/VVX,1,0.5007581077547718,31,19,12,26,0.6271352282421796,0.20842708108576052
기준금리인상/NNG;예상~되/VVX,1,0.49995025339911625,48,29,19,29,0.7138420571862505,0.2377555977589417
신용등급/NNG;유지~하/VVX,1,0.4969569252052597,26,16,10,26,0.596585232164838,0.20029000925789256
경제성장/NNG;위한/VV,1,0.4969569252052597,26,16,10,18,0.596585232164838,0.20029000925789256
금리인상/NNG;신중~하/VVX,1,0.4969569252052597,26,16,10,12,0.596585232164838,0.20029000925789256
실적/NNG;올렸/VV,1,0.49590788822647913,21,13,8,20,0.5646809268527194,0.19010722108412478
기준금리인상/NNG;반영~하/VVX,1,0.49590788822647913,21,13,8,17,0.5646809268527194,0.19010722108412478
회사채/NNG;금리/NNG;하락~했/VVX,1,0.49590788822647913,21,13,8,19,0.5646809268527194,0.19010722108412478
경기둔화/NNG;심화~될/VVX,1,0.49590788822647913,21,13,8,3,0.5646809268527194,0.19010722108412478
불확실성/NNG;확대~될/VVX,1,0.49590788822647913,21,13,8,19,0.5646809268527194,0.19010722108412478
채권/NNG;시장/NNG;강세/NNG;보임/VV,1,0.49590788822647913,21,13,8,23,0.5646809268527194,0.19010722108412478
변동성/NNG;줄어든/VV,1,0.49590788822647913,21,13,8,13,0.5646809268527194,0.19010722108412478
금리동결/NNG;유지~할/VVX,1,0.49590788822647913,21,13,8,13,0.5646809268527194,0.19010722108412478
금리/NNG;유지~되/VVX,1,0.49590788822647913,21,13,8,14,0.5646809268527194,0.19010722108412478
경제과열/NNG;막/VV,1,0.49590788822647913,21,13,8,3,0.5646809268527194,0.19010722108412478
국채금리/NNG;떨어진/VV,1,0.49590788822647913,21,13,8,14,0.5646809268527194,0.19010722108412478
유로화/NNG;하락~하/VVX,1,0.49590788822647913,21,13,8,12,0.5646809268527194,0.19010722108412478
고용시장/NNG;개선~되/VVX,1,0.4927307870890858,55,33,22,50,0.7411657588906038,0.251629398706612
금리인상/NNG;앞두/VV,1,0.48613476402435274,127,75,52,130,0.8815416554096926,0.30452288770281366
물가/NNG;안정세/NNG;보이/VV,1,0.48584951140876576,38,23,15,14,0.6622610069651974,0.22894467166494362
금리인상/NNG;유지~할/VVX,1,0.48584951140876576,38,23,15,16,0.6622610069651974,0.22894467166494362
물가안정/NNG;유지~되/VVX,1,0.47939521955707654,76,45,31,33,0.8046323740377718,0.2828814542158798
금리인상/NNG;맞물려/VV,1,0.4777054976868964,33,20,13,27,0.6337371709255871,0.2237788416501026
위안화/NNG;절상~되/VVX,1,0.4777054976868964,33,20,13,23,0.6337371709255871,0.2237788416501026
채권/NNG;시장/NNG;국채선물/NNG;하락~한/VAX;거래~되/VVX,1,0.46906462010918903,28,17,11,33,0.6035304162609837,0.21791058693974996
달러화/NNG;떨어지/VV,1,0.46906462010918903,28,17,11,19,0.6035304162609837,0.21791058693974996
금리상승/NNG;요인/NNG;작용~하/VVX,1,0.46906462010918903,28,17,11,22,0.6035304162609837,0.21791058693974996
단기금리/NNG;오르/VV,1,0.4681843567578945,40,24,16,23,0.6681807403847978,0.24179787273684766
수출/NNG;줄어들/VV,1,0.4681843567578945,40,24,16,17,0.6681807403847978,0.24179787273684766
수출호조/NNG;힘입/VV,1,0.46312160329997654,47,28,19,40,0.6995984580987201,0.25646026515915993
달러강세/NNG;부추기/VV,1,0.4604477428111924,23,14,9,7,0.571819448609269,0.21104785993413094
금리인상/NNG;단행~해/VVX,1,0.4604477428111924,23,14,9,12,0.571819448609269,0.21104785993413094
금리인하/NNG;가능~할/VVX,1,0.4604477428111924,23,14,9,17,0.571819448609269,0.21104785993413094
국고채/NNG;금리/NNG;오르/VV,1,0.4604477428111924,23,14,9,25,0.571819448609269,0.21104785993413094
자금난/NNG;덜/VV,1,0.4604477428111924,23,14,9,8,0.571819448609269,0.21104785993413094
지출/NNG;증가~하/VVX,1,0.4604477428111924,23,14,9,21,0.571819448609269,0.21104785993413094
경기회복/NNG;기대/NNG;커지/VV,1,0.4604477428111924,23,14,9,17,0.571819448609269,0.21104785993413094
인플레이션/NNG;우려/NNG;따른/VV,1,0.458257095376182,61,36,25,31,0.7529524404614333,0.27944750403075264
콜금리/NNG;목표/NNG;수준/NNG;유지~하/VVX,1,0.458257095376182,61,36,25,41,0.7529524404614333,0.27944750403075264
주택담보대출/NNG;늘어나/VV,1,0.4574883667148304,35,21,14,19,0.6401004664329707,0.23802650137716758
투자/NNG;확대~할/VVX,1,0.4574883667148304,35,21,14,21,0.6401004664329707,0.23802650137716758
수입/NNG;늘/VV,1,0.4574883667148304,35,21,14,33,0.6401004664329707,0.23802650137716758
기준금리인상/NNG;이뤄질/VV,1,0.4574883667148304,35,21,14,28,0.6401004664329707,0.23802650137716758
금리/NNG;낮춰/VV,1,0.4571504514227489,113,66,47,87,0.8602255305681706,0.32015513599896617
기준금리/NNG;인상~되/VVX,1,0.45677640263944674,195,114,81,126,0.8885799197249257,0.33102067187420586
기준금리/NNG;유지~할/VVX,1,0.45674427992359323,68,40,28,43,0.7749759415896079,0.2887234670927643
금리/NNG;동결~했/VVX,1,0.4536423380835626,156,91,65,111,0.8828686327930456,0.3315026826979815
고용악화/NNG;따른/VV,1,0.4531496778918782,18,11,7,5,0.5388692089491497,0.20258755159151778
연방기금금리/NNG;인하~될/VVX,1,0.4531496778918782,18,11,7,7,0.5388692089491497,0.20258755159151778
금리/NNG;오른다/VV,1,0.4531496778918782,18,11,7,15,0.5388692089491497,0.20258755159151778
경제/NNG;충격/NNG;주/VV,1,0.4531496778918782,18,11,7,4,0.5388692089491497,0.20258755159151778
물가상승압력/NNG;지속~되/VVX,1,0.4531496778918782,18,11,7,16,0.5388692089491497,0.20258755159151778
신용등급/NNG;상향조정~되/VVX,1,0.4531496778918782,18,11,7,11,0.5388692089491497,0.20258755159151778
국채금리/NNG;올랐/VV,1,0.4531496778918782,18,11,7,22,0.5388692089491497,0.20258755159151778
국채가격/NNG;급락~했/VVX,1,0.4531496778918782,18,11,7,5,0.5388692089491497,0.20258755159151778
금리하락/NNG;요인/NNG;작용~할/VVX,1,0.4531496778918782,18,11,7,12,0.5388692089491497,0.20258755159151778
성장/NNG;기대~되/VVX,1,0.4531496778918782,18,11,7,25,0.5388692089491497,0.20258755159151778
물가상승률/NNG;목표/NNG;밑돌/VV,1,0.4531496778918782,18,11,7,11,0.5388692089491497,0.20258755159151778
기준금리/NNG;인상~되/VVX;않/VX,1,0.4531496778918782,18,11,7,23,0.5388692089491497,0.20258755159151778
실적/NNG;악화~된/VVX,1,0.4531496778918782,18,11,7,7,0.5388692089491497,0.20258755159151778
유가/NNG;급락~했/VVX,1,0.4531496778918782,18,11,7,14,0.5388692089491497,0.20258755159151778
채권/NNG;시장/NNG;우호적/VAX;작용~하/VVX,1,0.4531496778918782,18,11,7,20,0.5388692089491497,0.20258755159151778
연방기금/NNG;금리/NNG;재할인율/NNG;인하~키로/VVX,1,0.4531496778918782,18,11,7,0,0.5388692089491497,0.20258755159151778
물가상승률/NNG;감안~하/VVX,1,0.4531496778918782,18,11,7,11,0.5388692089491497,0.20258755159151778
금융시장/NNG;오/VV,1,0.4531496778918782,18,11,7,12,0.5388692089491497,0.20258755159151778
경기모멘텀/NNG;둔화~되/VVX,1,0.4531496778918782,18,11,7,33,0.5388692089491497,0.20258755159151778
실업률/NNG;떨어지/VV,1,0.4522654773123733,42,25,17,38,0.6738683059412087,0.2539042670739073
금리인상/NNG;가능성/NNG;배제~할/VVX;없/VA,1,0.4522654773123733,42,25,17,42,0.6738683059412087,0.2539042670739073
금리인상/NNG;있/VV,1,0.4519128269253758,139,81,58,92,0.8766177243691577,0.33059025956454763
내수/NNG;회복~되/VVX,1,0.4498836766305425,49,29,20,25,0.7045650482919178,0.26706210350637105
불확실성/NNG;해소~됐/VVX,1,0.4487580684758734,56,33,23,52,0.7320937440073678,0.2782802387994496
경제/NNG;개선~되/VVX,1,0.44757168263115954,70,41,29,62,0.7778259282625828,0.2965425585075287
달러화/NNG;급락~했/VVX,1,0.44528703281320525,30,18,12,18,0.6102505775838459,0.23398614688219393
수출/NNG;개선~되/VVX,1,0.44528703281320525,30,18,12,29,0.6102505775838459,0.23398614688219393
유동성/NNG;줄어들/VV,1,0.44528703281320525,30,18,12,24,0.6102505775838459,0.23398614688219393
달러원/NNG;떨어진/VV,1,0.44528703281320525,30,18,12,19,0.6102505775838459,0.23398614688219393
경기회복/NNG;지연~될/VVX,1,0.44528703281320525,30,18,12,22,0.6102505775838459,0.23398614688219393
금융시장/NNG;변동성/NNG;확대~될/VVX,1,0.439613416115761,37,22,15,25,0.6462393382509187,0.2513045892083551
기준금리/NNG;인상~한/VAX;이/VV,1,0.4314102575465968,25,15,10,12,0.5787579896536799,0.22966424423860554
금리차/NNG;확대~될/VVX,1,0.4314102575465968,25,15,10,27,0.5787579896536799,0.22966424423860554
현금/NNG;확보~하/VVX,1,0.4314102575465968,25,15,10,18,0.5787579896536799,0.22966424423860554
물가/NNG;상승~하/VVX,1,0.4312172975279631,95,55,40,82,0.8274232415504805,0.32849587779656725
콜금리/NNG;인상~하/VVX,1,0.4311615798045041,81,47,34,48,0.8002931758008398,0.317768428141713
통화정책/NNG;유지~하/VVX,1,0.4294870063705538,67,39,28,61,0.7629700280010313,0.3041959518044256
위험/NNG;커졌/VV,1,0.42479108827920475,32,19,13,27,0.6167638227422061,0.24874354141515176
하방위험/NNG;작용~할/VVX,1,0.42479108827920475,32,19,13,22,0.6167638227422061,0.24874354141515176
유로화/NNG;강세/NNG;나타냈/VV,1,0.42479108827920475,32,19,13,9,0.6167638227422061,0.24874354141515176
물가/NNG;올라가/VV,1,0.42479108827920475,32,19,13,12,0.6167638227422061,0.24874354141515176
경기둔화우려/NNG;커지/VV,1,0.4246835907879254,46,27,19,36,0.6845860674893726,0.27616895231686145
대출/NNG;늘어난/VV,1,0.42368692501724503,39,23,16,38,0.652164698843064,0.2637298393914763
저금리/NNG;유지~하/VVX,1,0.42137308490915504,132,76,56,128,0.8623122744858163,0.35068086849472385
성장/NNG;따른/VV,1,0.4186307860311489,62,36,26,44,0.743614539914193,0.304429156501123
금리인상/NNG;우려/NNG;완화~되/VVX,1,0.4158303492917892,55,32,23,39,0.718206622686605,0.2960272101313637
금리/NNG;올리/VV;쉽/VA;않/VX,1,0.41567430262699245,20,12,8,17,0.5457969849447741,0.2250490337666414
매출/NNG;늘어나/VV,1,0.41567430262699245,20,12,8,10,0.5457969849447741,0.2250490337666414
낮/VA;금리/NNG;유지~할/VVX,1,0.41567430262699245,20,12,8,12,0.5457969849447741,0.2250490337666414
유로달러/NNG;상승~했/VVX,1,0.41567430262699245,20,12,8,13,0.5457969849447741,0.2250490337666414
경쟁력/NNG;떨어지/VV,1,0.41567430262699245,20,12,8,15,0.5457969849447741,0.2250490337666414
외환시장/NNG;현물환/NNG;상승~했/VVX,1,0.41567430262699245,20,12,8,16,0.5457969849447741,0.2250490337666414
위험/NNG;고려~하/VVX,1,0.41567430262699245,20,12,8,9,0.5457969849447741,0.2250490337666414
소비자물가/NNG;하락~하/VVX,1,0.41567430262699245,20,12,8,22,0.5457969849447741,0.2250490337666414
달러강세/NNG;부추겼/VV,1,0.41567430262699245,20,12,8,12,0.5457969849447741,0.2250490337666414
인플레이션/NNG;낮추/VV,1,0.41567430262699245,20,12,8,9,0.5457969849447741,0.2250490337666414
고용지표/NNG;호조/NNG;보였/VV,1,0.41567430262699245,20,12,8,11,0.5457969849447741,0.2250490337666414
금리인상/NNG;단행~될/VVX,1,0.41249597530901005,188,108,80,113,0.8733184259904974,0.36286843629264715
기준금리/NNG;올린/VV,1,0.41214962757301365,101,58,43,82,0.8295197620052267,0.34495751011721515
금리상승/NNG;되돌리/VV,1,0.40724962467368075,27,16,11,27,0.5855227772289068,0.24637410043892122
금리상승/NNG;인해/VV,1,0.40724962467368075,27,16,11,30,0.5855227772289068,0.24637410043892122
일자리/NNG;늘리/VV,1,0.40724962467368075,27,16,11,12,0.5855227772289068,0.24637410043892122
금리/NNG;인상~됐/VVX,1,0.40693774816496364,34,20,14,13,0.6230824321855235,0.26237432026380036
국제/NNG;유가상승/NNG;따른/VV,1,0.40693774816496364,34,20,14,24,0.6230824321855235,0.26237432026380036
성장/NNG;지속~할/VVX,1,0.40693774816496364,34,20,14,28,0.6230824321855235,0.26237432026380036
수요/NNG;증가~할/VVX,1,0.4014035676008476,112,64,48,100,0.8389206859835967,0.3579642949586344
마이너스금리/NNG;적용~하/VVX,1,0.39788312105446066,15,9,6,6,0.5115909900560797,0.22012994474643974
역외/NNG;환율상승/NNG;반영~해/VVX,1,0.39788312105446066,15,9,6,6,0.5115909900560797,0.22012994474643974
경기/NNG;꺾이/VV,1,0.39788312105446066,15,9,6,14,0.5115909900560797,0.22012994474643974
금리인상/NNG;속도/NNG;늦출/VV,1,0.39788312105446066,15,9,6,10,0.5115909900560797,0.22012994474643974
미국채금리/NNG;내린/VV,1,0.39788312105446066,15,9,6,13,0.5115909900560797,0.22012994474643974
경제/NNG;침체/NNG;벗어나/VV,1,0.39788312105446066,15,9,6,8,0.5115909900560797,0.22012994474643974
금리인상/NNG;대비~하/VVX,1,0.39788312105446066,15,9,6,15,0.5115909900560797,0.22012994474643974
위험/NNG;존재~한다/VVX,1,0.39788312105446066,15,9,6,9,0.5115909900560797,0.22012994474643974
금리인상/NNG;신중~할/VVX,1,0.39788312105446066,15,9,6,18,0.5115909900560797,0.22012994474643974
금리하락/NNG;제한~할/VVX,1,0.39788312105446066,15,9,6,10,0.5115909900560797,0.22012994474643974
신뢰도/NNG;떨어지/VV,1,0.39788312105446066,15,9,6,5,0.5115909900560797,0.22012994474643974
시장/NNG;기준금리/NNG;인상~할/VVX,1,0.39788312105446066,15,9,6,14,0.5115909900560797,0.22012994474643974
경기침체/NNG;우려~하/VVX,1,0.39788312105446066,15,9,6,5,0.5115909900560797,0.22012994474643974
성장/NNG;발목/NNG;잡/VV,1,0.39788312105446066,15,9,6,8,0.5115909900560797,0.22012994474643974
인플레이션압력/NNG;낮추/VV,1,0.39788312105446066,15,9,6,11,0.5115909900560797,0.22012994474643974
수출증가율/NNG;둔화~될/VVX,1,0.39788312105446066,15,9,6,13,0.5115909900560797,0.22012994474643974
성장성/NNG;있/VV,1,0.39788312105446066,15,9,6,10,0.5115909900560797,0.22012994474643974
수출호조/NNG;지속~되/VVX,1,0.39788312105446066,15,9,6,12,0.5115909900560797,0.22012994474643974
위험자산/NNG;투자~하/VVX,1,0.39788312105446066,15,9,6,8,0.5115909900560797,0.22012994474643974
수요감소/NNG;따른/VV,1,0.39788312105446066,15,9,6,15,0.5115909900560797,0.22012994474643974
채권투자/NNG;심리/NNG;위축~되/VVX,1,0.39788312105446066,15,9,6,11,0.5115909900560797,0.22012994474643974
기준금리인상/NNG;예상~했/VVX,1,0.39788312105446066,15,9,6,13,0.5115909900560797,0.22012994474643974
금리인상/NNG;의미~하/VVX,1,0.39788312105446066,15,9,6,10,0.5115909900560797,0.22012994474643974
물가/NNG;상승~했/VVX,1,0.39788312105446066,15,9,6,12,0.5115909900560797,0.22012994474643974
경기/NNG;부양책/NNG;쓰/VV,1,0.39788312105446066,15,9,6,11,0.5115909900560797,0.22012994474643974
평균/NNG;금리/NNG;하락~했/VVX,1,0.39788312105446066,15,9,6,11,0.5115909900560797,0.22012994474643974
기준금리인하/NNG;단행~할/VVX,1,0.39788312105446066,15,9,6,13,0.5115909900560797,0.22012994474643974
낮/VA;금리/NNG;인해/VV,1,0.39788312105446066,15,9,6,7,0.5115909900560797,0.22012994474643974
실적/NNG;감소~하/VVX,1,0.39788312105446066,15,9,6,7,0.5115909900560797,0.22012994474643974
경제지표/NNG;악화~될/VVX,1,0.39788312105446066,15,9,6,6,0.5115909900560797,0.22012994474643974
국고채/NNG;상승~한/VAX;마감~되/VVX,1,0.39788312105446066,15,9,6,9,0.5115909900560797,0.22012994474643974
수익/NNG;감소~할/VVX,1,0.39788312105446066,15,9,6,11,0.5115909900560797,0.22012994474643974
기준금리/NNG;수준/NNG;유지~하/VVX,1,0.3968502167701391,273,156,117,293,0.8694847513028745,0.3750447854643418
산업생산/NNG;증가~하/VVX,1,0.3964806056190646,43,25,18,19,0.6634073660945349,0.2864061029569058
지표금리/NNG;하락~한/VAX;거래~됐/VVX,1,0.391283568758785,52,30,22,77,0.6991329810535318,0.30556417782711254
경기상승/NNG;따른/VV,1,0.39123479591836596,36,21,15,18,0.6292147675483774,0.2750372738501661
변동성/NNG;커질/VV,1,0.3889709046108023,181,103,78,177,0.8642929427274245,0.3798148405239731
채권/NNG;시장/NNG;영향/NNG;줄/VV,1,0.3868439521163931,29,17,12,14,0.5921286214685506,0.26151747772811207
위험/NNG;작용~할/VVX,1,0.3868439521163931,29,17,12,23,0.5921286214685506,0.26151747772811207
인플레이션/NNG;완화~될/VVX,1,0.3868439521163931,29,17,12,26,0.5921286214685506,0.26151747772811207
경제/NNG;침체/NNG;빠질/VV,1,0.3868439521163931,29,17,12,28,0.5921286214685506,0.26151747772811207
환율안정/NNG;위해/VV,1,0.3868439521163931,29,17,12,24,0.5921286214685506,0.26151747772811207
순이익/NNG;증가~하/VVX,1,0.38608842402400123,22,13,9,15,0.5526136177288452,0.24449915795774838
금리/NNG;낮춰야/VV,1,0.38608842402400123,22,13,9,20,0.5526136177288452,0.24449915795774838
투자심리/NNG;호전~되/VVX,1,0.38608842402400123,22,13,9,19,0.5526136177288452,0.24449915795774838
지급준비금적수/NNG;늘/VV,1,0.38608842402400123,22,13,9,19,0.5526136177288452,0.24449915795774838
경제성장세/NNG;둔화~될/VVX,1,0.38608842402400123,22,13,9,12,0.5526136177288452,0.24449915795774838
위험/NNG;따른/VV,1,0.38608842402400123,22,13,9,24,0.5526136177288452,0.24449915795774838
완화/NNG;인해/VV,1,0.38608842402400123,22,13,9,13,0.5526136177288452,0.24449915795774838
기준금리동결/NNG;전망~했/VVX,1,0.38608842402400123,22,13,9,16,0.5526136177288452,0.24449915795774838
채권가격/NNG;하락/NNG;채권/NNG;약세/NNG;한/XSA;의미~한다/VVX,1,0.38608842402400123,22,13,9,23,0.5526136177288452,0.24449915795774838
불확실성/NNG;완화~된/VVX,1,0.38608842402400123,22,13,9,19,0.5526136177288452,0.24449915795774838
국제/NNG;유가/NNG;떨어지/VV,1,0.38608842402400123,22,13,9,17,0.5526136177288452,0.24449915795774838
기준금리/NNG;인상~됐/VVX,1,0.38608842402400123,22,13,9,17,0.5526136177288452,0.24449915795774838
신용스프레드/NNG;확대~된/VVX,1,0.38608842402400123,22,13,9,15,0.5526136177288452,0.24449915795774838
성장/NNG;보이/VV,1,0.38608842402400123,22,13,9,36,0.5526136177288452,0.24449915795774838
가계대출/NNG;늘어나/VV,1,0.3773001835256762,38,22,16,19,0.6351665795847596,0.286863059851614
달러원/NNG;상승~하/VVX,1,0.3772269049202568,81,46,35,63,0.7805135146259973,0.3525669450201628
지출/NNG;줄이/VV,1,0.37401111870997084,47,27,20,49,0.6738793781912681,0.3066859465521568
금리인상/NNG;하/VV,1,0.3736864894556937,99,56,43,98,0.8118831928716826,0.3697710368245456
대출/NNG;늘리/VV,1,0.3736864894556937,99,56,43,63,0.8118831928716826,0.3697710368245456
글로벌경기/NNG;둔화/NNG;따른/VV,1,0.37288411294556045,56,32,24,30,0.7078816468665762,0.32300510930265436
금리인하/NNG;나서/VV,1,0.3718201421008367,74,42,32,61,0.7618935561594484,0.3485101698689936
소비자물가/NNG;오르/VV,1,0.3693736717726328,31,18,13,23,0.5985832933755737,0.2753644722941297
금리인하/NNG;기대~하/VVX,1,0.3693736717726328,31,18,13,35,0.5985832933755737,0.2753644722941297
수출부진/NNG;지속~되/VVX,1,0.3693736717726328,31,18,13,27,0.5985832933755737,0.2753644722941297
기준금리인상/NNG;늦춰질/VV,1,0.3693736717726328,31,18,13,22,0.5985832933755737,0.2753644722941297
경기/NNG;개선~되/VVX,1,0.36835612214609625,101,57,44,106,0.8126339367297298,0.37471478172786304
경기회복/NNG;따른/VV,1,0.36567369752515133,241,136,105,177,0.857896630784904,0.39804503467948266
달러화/NNG;하락~하/VVX,1,0.36431219821803706,94,53,41,80,0.8003898747682681,0.37253110681437557
금리수준/NNG;유지~하/VVX,1,0.3621878779428127,24,14,10,20,0.5593384578784858,0.26161358443912985
원달러/NNG;오르/VV,1,0.3621878779428127,24,14,10,23,0.5593384578784858,0.26161358443912985
수익성/NNG;유지~하/VVX,1,0.3621878779428127,24,14,10,10,0.5593384578784858,0.26161358443912985
연방기금/NNG;금리/NNG;인상~할/VVX,1,0.3621878779428127,24,14,10,19,0.5593384578784858,0.26161358443912985
부동산가격/NNG;오르/VV,1,0.3621878779428127,24,14,10,20,0.5593384578784858,0.26161358443912985
채권/NNG;시장/NNG;부담/NNG;될/VV,1,0.3621878779428127,24,14,10,19,0.5593384578784858,0.26161358443912985
투자심리/NNG;악화~된/VVX,1,0.3621878779428127,24,14,10,20,0.5593384578784858,0.26161358443912985
유로달러/NNG;하락~했/VVX,1,0.35957585220434485,17,10,7,11,0.5181060133666769,0.2437875512762136
국채가격/NNG;반등~했/VVX,1,0.35957585220434485,17,10,7,10,0.5181060133666769,0.2437875512762136
침체/NNG;빠지/VV;않/VX,1,0.35957585220434485,17,10,7,8,0.5181060133666769,0.2437875512762136
고용자수/NNG;감소~하/VVX,1,0.35957585220434485,17,10,7,10,0.5181060133666769,0.2437875512762136
하방위험/NNG;있/VV,1,0.35957585220434485,17,10,7,18,0.5181060133666769,0.2437875512762136
시장/NNG;금리/NNG;올릴/VV,1,0.35957585220434485,17,10,7,5,0.5181060133666769,0.2437875512762136
수출증가/NNG;힘입/VV,1,0.35957585220434485,17,10,7,13,0.5181060133666769,0.2437875512762136
금리인상/NNG;나섰/VV,1,0.35957585220434485,17,10,7,20,0.5181060133666769,0.2437875512762136
기준금리/NNG;인상~했으나/VVX,1,0.35957585220434485,17,10,7,18,0.5181060133666769,0.2437875512762136
기준금리/NNG;인상~한다고/VVX,1,0.35957585220434485,17,10,7,10,0.5181060133666769,0.2437875512762136
cd금리/NNG;올랐/VV,1,0.35957585220434485,17,10,7,17,0.5181060133666769,0.2437875512762136
수출/NNG;늘어난/VV,1,0.35957585220434485,17,10,7,13,0.5181060133666769,0.2437875512762136
금리인하/NNG;지지~하/VVX,1,0.35957585220434485,17,10,7,5,0.5181060133666769,0.2437875512762136
자산/NNG;늘/VV,1,0.35957585220434485,17,10,7,12,0.5181060133666769,0.2437875512762136
금리/NNG;인상~되/VVX;않/VX,1,0.35957585220434485,17,10,7,17,0.5181060133666769,0.2437875512762136
적자/NNG;보였/VV,1,0.35957585220434485,17,10,7,11,0.5181060133666769,0.2437875512762136
회사채/NNG;금리/NNG;올랐/VV,1,0.35957585220434485,17,10,7,23,0.5181060133666769,0.2437875512762136
농산물/NNG;가격/NNG;급등~하/VVX,1,0.35957585220434485,17,10,7,5,0.5181060133666769,0.2437875512762136
금리인상/NNG;가능성/NNG;시사~할/VVX,1,0.35957585220434485,17,10,7,19,0.5181060133666769,0.2437875512762136
달러화/NNG;급락/NNG;따른/VV,1,0.35957585220434485,17,10,7,6,0.5181060133666769,0.2437875512762136
대출/NNG;확대~할/VVX,1,0.35957585220434485,17,10,7,14,0.5181060133666769,0.2437875512762136
달러화가치/NNG;하락~했/VVX,1,0.35957585220434485,17,10,7,5,0.5181060133666769,0.2437875512762136
달러화/NNG;하락세/NNG;이/VV,1,0.35957585220434485,17,10,7,13,0.5181060133666769,0.2437875512762136
미국채가격/NNG;영향/NNG;상승/NNG;출발/NNG;예상~된다/VVX,1,0.35957585220434485,17,10,7,26,0.5181060133666769,0.2437875512762136
경제/NNG;침체~될/VVX,1,0.35957585220434485,17,10,7,7,0.5181060133666769,0.2437875512762136
외환시장/NNG;안정~되/VVX,1,0.35957585220434485,17,10,7,11,0.5181060133666769,0.2437875512762136
저금리/NNG;유지~할/VVX,1,0.35819683517429945,69,39,30,69,0.7435380093307394,0.35097025125061426
콜금리/NNG;인상~될/VVX,1,0.3550457371821507,51,29,22,16,0.6836174784664115,0.3250234087885732
수출/NNG;호조/NNG;지속~하/VVX,1,0.3542327811132284,33,19,14,5,0.604890290095514,0.2881279736934676
안전자산/NNG;선호~하/VVX,1,0.3542327811132284,33,19,14,37,0.604890290095514,0.2881279736934676
초저금리/NNG;유지~할/VVX,1,0.3434108754932752,44,25,19,52,0.651974175553195,0.3182997320134159
경기회복세/NNG;지속~되/VVX,1,0.3432620456011046,93,52,41,67,0.7902394263873473,0.3859322304713075
대출심사/NNG;강화~하/VVX,1,0.342483550346383,26,15,11,30,0.5659767751935154,0.27689612376740147
국채수익률/NNG;오른/VV,1,0.342483550346383,26,15,11,15,0.5659767751935154,0.27689612376740147
지표금리/NNG;오른/VV,1,0.342483550346383,26,15,11,31,0.5659767751935154,0.27689612376740147
기준금리/NNG;수준/NNG;유지~할/VVX,1,0.342483550346383,26,15,11,34,0.5659767751935154,0.27689612376740147
경제지표/NNG;부진~했/VVX,1,0.342483550346383,26,15,11,33,0.5659767751935154,0.27689612376740147
시장/NNG;변동성/NNG;커질/VV,1,0.342483550346383,26,15,11,16,0.5659767751935154,0.27689612376740147
금리인상/NNG;시사~할/VVX,1,0.3409668107955932,35,20,15,32,0.611050584632197,0.2999758697511486
국채가격/NNG;하락압력/NNG;받/VV,1,0.3409668107955932,35,20,15,25,0.611050584632197,0.2999758697511486
경제지표/NNG;호전~되/VVX,1,0.3409668107955932,35,20,15,22,0.611050584632197,0.2999758697511486
완화/NNG;유지~하/VVX,1,0.3409668107955932,35,20,15,23,0.611050584632197,0.2999758697511486
달러화/NNG;약세/NNG;보이/VV,1,0.33929303351993845,104,58,46,80,0.8048333366808293,0.3966051428274013
유가/NNG;하락~하/VVX,1,0.33929303351993845,104,58,46,68,0.8048333366808293,0.3966051428274013
금리인상/NNG;따른/VV,1,0.337090591644168,509,284,225,420,0.8470005307335455,0.4194643899309713
경제/NNG;회복~되/VVX,1,0.3347548856420941,106,59,47,99,0.8054553437160615,0.40099466894648034
금리인상/NNG;가능성/NNG;시사~했/VVX,1,0.33411080597438336,46,26,20,41,0.6572352583774521,0.3276782159762627
경기둔화우려/NNG;지속~되/VVX,1,0.33071307517795434,19,11,8,10,0.5246691886880417,0.26358974646125943
경기침체/NNG;벗어나/VV,1,0.33071307517795434,19,11,8,18,0.5246691886880417,0.26358974646125943
경기회복/NNG;기대심리/NNG;커지/VV,1,0.33071307517795434,19,11,8,22,0.5246691886880417,0.26358974646125943
금리인상/NNG;반영~해/VVX,1,0.33071307517795434,19,11,8,6,0.5246691886880417,0.26358974646125943
변동폭/NNG;확대~될/VVX,1,0.33071307517795434,19,11,8,19,0.5246691886880417,0.26358974646125943
회사채/NNG;금리/NNG;상승~했/VVX,1,0.33071307517795434,19,11,8,19,0.5246691886880417,0.26358974646125943
위험/NNG;커질/VV,1,0.33071307517795434,19,11,8,23,0.5246691886880417,0.26358974646125943
기준금리인상/NNG;가능성/NNG;제기~되/VVX,1,0.33071307517795434,19,11,8,10,0.5246691886880417,0.26358974646125943
국채가격/NNG;내린/VV,1,0.33071307517795434,19,11,8,6,0.5246691886880417,0.26358974646125943
저성장/NNG;지속~되/VVX,1,0.33071307517795434,19,11,8,23,0.5246691886880417,0.26358974646125943
유로화/NNG;약세/NNG;나타냈/VV,1,0.33071307517795434,19,11,8,15,0.5246691886880417,0.26358974646125943
원화/NNG;강세/NNG;보였/VV,1,0.33071307517795434,19,11,8,11,0.5246691886880417,0.26358974646125943
산업생산/NNG;증가~해/VVX,1,0.33071307517795434,19,11,8,18,0.5246691886880417,0.26358974646125943
순이익/NNG;줄어들/VV,1,0.33071307517795434,19,11,8,19,0.5246691886880417,0.26358974646125943
경상수지/NNG;흑자/NNG;기록~하/VVX,1,0.33071307517795434,19,11,8,8,0.5246691886880417,0.26358974646125943
경제성장/NNG;미치/VV,1,0.33071307517795434,19,11,8,17,0.5246691886880417,0.26358974646125943
연방기금금리/NNG;인상~될/VVX,1,0.32922994592645294,37,21,16,14,0.6170637352143266,0.3110411869116838
채권금리/NNG;급등~했/VVX,1,0.32594851181085716,28,16,12,19,0.5725264867831018,0.29071989673305737
금리인하/NNG;나서/VV;않/VX,1,0.32594851181085716,28,16,12,10,0.5725264867831018,0.29071989673305737
자산/NNG;줄이/VV,1,0.32594851181085716,28,16,12,13,0.5725264867831018,0.29071989673305737
시장/NNG;하락~한/VAX;유로달러/NNG;상승~한/VAX;거래~됐/VVX,1,0.32594851181085716,28,16,12,27,0.5725264867831018,0.29071989673305737
위험/NNG;증가~하/VVX,1,0.32594851181085716,28,16,12,10,0.5725264867831018,0.29071989673305737
성장세/NNG;보이/VV,1,0.32387693554136865,130,72,58,111,0.8227484584765474,0.41971740759190257
경제성장/NNG;둔화~되/VVX,1,0.3187553034331374,39,22,17,32,0.6229285884763264,0.3214300593544784
경기선행지수/NNG;하락~하/VVX,1,0.3187553034331374,39,22,17,25,0.6229285884763264,0.3214300593544784
기준금리/NNG;올리/VV;않/VX,1,0.31803674601290566,61,34,27,47,0.7049430448382167,0.36433127270297955
금리/NNG;올리/VV;않/VX,1,0.3152809540807813,181,100,81,173,0.8353626715321647,0.43438675868571747
유가/NNG;상승~하/VVX,1,0.31293604778092354,74,41,33,50,0.7389480755182039,0.3862549136885975
인플레이션/NNG;우려~하/VVX,1,0.3127510059432428,96,53,43,53,0.7822830387674403,0.4090741924488053
수출/NNG;늘어나/VV,1,0.3119292701427654,63,35,28,53,0.7087173506924739,0.3712801614083959
금리동결/NNG;예상~했/VVX,1,0.3118581164376577,30,17,13,22,0.5789819074170426,0.3033626437880719
비용/NNG;줄일/VV,1,0.3118581164376577,30,17,13,22,0.5789819074170426,0.3033626437880719
기준금리인상/NNG;가능성/NNG;열/VV,1,0.3118581164376577,30,17,13,20,0.5789819074170426,0.3033626437880719
대출/NNG;증가~하/VVX,1,0.31041537714571144,52,29,23,42,0.6720186906091792,0.35323621603091293
국제/NNG;유가/NNG;넘어서/VV,1,0.3082231247515419,21,12,9,12,0.5312739941854759,0.2806124896640482
변동폭/NNG;커질/VV,1,0.3082231247515419,21,12,9,17,0.5312739941854759,0.2806124896640482
불확실성/NNG;증가~하/VVX,1,0.3082231247515419,21,12,9,18,0.5312739941854759,0.2806124896640482
금융안정/NNG;위해/VV,1,0.3082231247515419,21,12,9,15,0.5312739941854759,0.2806124896640482
가산금리/NNG;인상~하/VVX,1,0.3082231247515419,21,12,9,12,0.5312739941854759,0.2806124896640482
변동성/NNG;확대~시킬/VVX,1,0.3082231247515419,21,12,9,18,0.5312739941854759,0.2806124896640482
실업률/NNG;하락~했/VVX,1,0.3082231247515419,21,12,9,28,0.5312739941854759,0.2806124896640482
선행지수/NNG;하락~하/VVX,1,0.3082231247515419,21,12,9,12,0.5312739941854759,0.2806124896640482
국고채/NNG;떨어진/VV,1,0.3082231247515419,21,12,9,16,0.5312739941854759,0.2806124896640482
물가/NNG;끌어올리/VV,1,0.3082231247515419,21,12,9,26,0.5312739941854759,0.2806124896640482
금리인하/NNG;가능성/NNG;낮추/VV,1,0.3082231247515419,21,12,9,6,0.5312739941854759,0.2806124896640482
성장/NNG;뒷받침~하/VVX,1,0.3082231247515419,21,12,9,12,0.5312739941854759,0.2806124896640482
통화완화/NNG;따른/VV,1,0.3082231247515419,21,12,9,28,0.5312739941854759,0.2806124896640482
금리/NNG;올라간/VV,1,0.3082231247515419,21,12,9,20,0.5312739941854759,0.2806124896640482
위험/NNG;노출~될/VVX,1,0.3082231247515419,21,12,9,29,0.5312739941854759,0.2806124896640482
금리/NNG;반락~하/VVX,1,0.3082231247515419,21,12,9,16,0.5312739941854759,0.2806124896640482
기준금리/NNG;동결~된/VVX,1,0.3061541111635897,65,36,29,46,0.7123357977501865,0.3779693490054398
성장/NNG;가능~할/VVX,1,0.3061541111635897,65,36,29,41,0.7123357977501865,0.3779693490054398
유동성/NNG;떨어지/VV,1,0.30363293213937026,54,30,24,37,0.6766188006862702,0.3610180780917458
물가상승압력/NNG;작용~할/VVX,1,0.30080113294519495,43,24,19,19,0.6342077259420376,0.34050378405056403
금리/NNG;유지~하/VVX,1,0.2997689649200619,91,50,41,78,0.7685342307957758,0.4135599826204591
재고/NNG;증가~하/VVX,1,0.29968936022946746,32,18,14,19,0.5853358425368939,0.31503321166543796
금리/NNG;올라갔/VV,1,0.29968936022946746,32,18,14,12,0.5853358425368939,0.31503321166543796
경기지표/NNG;개선~되/VVX,1,0.29968936022946746,32,18,14,35,0.5853358425368939,0.31503321166543796
안전자산선호/NNG;강화~됐/VVX,1,0.29968936022946746,32,18,14,17,0.5853358425368939,0.31503321166543796
가계대출/NNG;증가~하/VVX,1,0.29968936022946746,32,18,14,43,0.5853358425368939,0.31503321166543796
금리인상/NNG;중단~하/VVX,1,0.29968936022946746,32,18,14,25,0.5853358425368939,0.31503321166543796
국고채/NNG;내린/VV,1,0.293023820998801,45,25,20,26,0.6396193607819898,0.34931452576671984
물가/NNG;안정~된/VVX,1,0.293023820998801,45,25,20,44,0.6396193607819898,0.34931452576671984
불확실성/NNG;완화~하/VVX,1,0.29020545699422806,23,13,10,12,0.5379011682317387,0.29557770253638754
불안심리/NNG;해소~되/VVX;않/VX,1,0.29020545699422806,23,13,10,9,0.5379011682317387,0.29557770253638754
원화/NNG;강세/NNG;인한/VV,1,0.29020545699422806,23,13,10,19,0.5379011682317387,0.29557770253638754
투자/NNG;감소~하/VVX,1,0.29020545699422806,23,13,10,16,0.5379011682317387,0.29557770253638754
불확실성/NNG;완화~될/VVX,1,0.28905673006531507,34,19,15,17,0.5915807493476152,0.32589056140993433
소비심리/NNG;개선~되/VVX,1,0.28905673006531507,34,19,15,34,0.5915807493476152,0.32589056140993433
지표금리/NNG;내린/VV,1,0.28905673006531507,34,19,15,49,0.5915807493476152,0.32589056140993433
미국채금리/NNG;상승~했/VVX,1,0.28905673006531507,34,19,15,48,0.5915807493476152,0.32589056140993433
집값/NNG;잡/VV,1,0.28905673006531507,34,19,15,27,0.5915807493476152,0.32589056140993433
소비/NNG;줄이/VV,1,0.28589493120286513,47,26,21,37,0.6448776653943568,0.3577068316925161
기준금리/NNG;올려/VV,1,0.28589493120286513,47,26,21,37,0.6448776653943568,0.3577068316925161
실적/NNG;개선~될/VVX,1,0.28589493120286513,47,26,21,41,0.6448776653943568,0.3577068316925161
수출/NNG;늘/VV,1,0.2857873677869065,60,33,27,31,0.6894621525688133,0.38252693220969375
금리상승/NNG;따른/VV,1,0.28552102327648643,238,130,108,231,0.8252177079043413,0.4581122358067682
성장/NNG;둔화~되/VVX,1,0.2805287190075658,62,34,28,46,0.6934313961736557,0.3891510807825829
유동성/NNG;늘어나/VV,1,0.2796705269241728,36,20,16,18,0.5977093683348675,0.3360572368395999
금리/NNG;올라도/VV,1,0.2796705269241728,36,20,16,34,0.5977093683348675,0.3360572368395999
대출/NNG;늘/VV,1,0.27697944724602674,77,42,35,62,0.7309636499922856,0.4133817920788774
이익/NNG;내/VV,1,0.27697944724602674,77,42,35,52,0.7309636499922856,0.4133817920788774
달러화/NNG;떨어질/VV,1,0.2754349063606827,25,14,11,11,0.5445277268190831,0.30897771864596535
금리인상/NNG;따른/VV;부담/NNG,1,0.2754349063606827,25,14,11,6,0.5445277268190831,0.30897771864596535
위험/NNG;줄어들/VV,1,0.2754349063606827,25,14,11,24,0.5445277268190831,0.30897771864596535
금리인하/NNG;가능~하/VVX,1,0.2754349063606827,25,14,11,11,0.5445277268190831,0.30897771864596535
물가/NNG;상승~할/VVX,1,0.2732467940697323,51,28,23,35,0.6549320873294331,0.3733856220612184
투자심리/NNG;개선~될/VVX,1,0.27130921686542253,38,21,17,22,0.6037150514014098,0.34562891470487644
금리인상/NNG;될/VV,1,0.2708475114217965,66,36,30,47,0.7009163602319142,0.4016769101312832
달러화/NNG;하락압력/NNG;받/VV,1,0.26649035489515405,96,52,44,58,0.761792528650058,0.4406808759505945
기대심리/NNG;높이/VV,1,0.26637370834373986,68,37,31,48,0.7044372970204631,0.4076043757871565
국채금리/NNG;하락~한/VAX;마감~함/VVX,1,0.26380070054304294,40,22,18,43,0.6095919155766243,0.3546812234372489
엔화/NNG;강세/NNG;나타냈/VV,1,0.26380070054304294,40,22,18,15,0.6095919155766243,0.3546812234372489
금리하락/NNG;제한~되/VVX,1,0.26380070054304294,40,22,18,56,0.6095919155766243,0.3546812234372489
금리/NNG;올린다면/VV,1,0.26380070054304294,40,22,18,38,0.6095919155766243,0.3546812234372489
불확실성/NNG;커지/VV,1,0.2633422496375726,172,93,79,158,0.8112473108131942,0.4724762369746143
성장세/NNG;보였/VV,1,0.2630912990702239,27,15,12,35,0.5511309047903581,0.3211556279273256
금리/NNG;올린다고/VV,1,0.2630912990702239,27,15,12,36,0.5511309047903581,0.3211556279273256
양적완화/NNG;축소~될/VVX,1,0.2630912990702239,27,15,12,17,0.5511309047903581,0.3211556279273256
금리인상/NNG;선반영~하/VVX,1,0.2630912990702239,27,15,12,21,0.5511309047903581,0.3211556279273256
콜금리/NNG;인하~할/VVX,1,0.2630912990702239,27,15,12,11,0.5511309047903581,0.3211556279273256
채권/NNG;시장/NNG;국채가격/NNG;올랐/VV,1,0.2630912990702239,27,15,12,33,0.5511309047903581,0.3211556279273256
금리인상/NNG;주장~했/VVX,1,0.2630912990702239,27,15,12,23,0.5511309047903581,0.3211556279273256
신용스프레드/NNG;축소~될/VVX,1,0.26232037024562804,55,30,25,24,0.6643700825435843,0.38778384069459587
미국채금리/NNG;하락~하/VVX,1,0.26211563162574647,70,38,32,57,0.7078142036738053,0.4133231910965336
금리인상/NNG;부담/NNG;덜/VV,1,0.2618485782040012,16,9,7,12,0.4939646669143465,0.2886126106016702
이익/NNG;늘/VV,1,0.2618485782040012,16,9,7,14,0.4939646669143465,0.2886126106016702
물가상승률/NNG;낮추/VV,1,0.2618485782040012,16,9,7,13,0.4939646669143465,0.2886126106016702
글로벌경기/NNG;회복~되/VVX,1,0.2618485782040012,16,9,7,14,0.4939646669143465,0.2886126106016702
엔화/NNG;약세/NNG;유도~하/VVX,1,0.2618485782040012,16,9,7,22,0.4939646669143465,0.2886126106016702
인플레이션압력/NNG;강화~되/VVX,1,0.2618485782040012,16,9,7,7,0.4939646669143465,0.2886126106016702
수익/NNG;늘/VV,1,0.2618485782040012,16,9,7,13,0.4939646669143465,0.2886126106016702
양적완화/NNG;종료/NNG;앞두/VV,1,0.2618485782040012,16,9,7,15,0.4939646669143465,0.2886126106016702
수요/NNG;부진~했/VVX,1,0.2618485782040012,16,9,7,10,0.4939646669143465,0.2886126106016702
안전자산선호/NNG;심화~되/VVX,1,0.2618485782040012,16,9,7,9,0.4939646669143465,0.2886126106016702
안전자산선호/NNG;부각~되/VVX,1,0.2618485782040012,16,9,7,15,0.4939646669143465,0.2886126106016702
금리차확대/NNG;따른/VV,1,0.2618485782040012,16,9,7,4,0.4939646669143465,0.2886126106016702
실적/NNG;증가~했/VVX,1,0.2618485782040012,16,9,7,13,0.4939646669143465,0.2886126106016702
투자심리/NNG;회복~될/VVX,1,0.2618485782040012,16,9,7,23,0.4939646669143465,0.2886126106016702
기준금리인상/NNG;앞당겨질/VV,1,0.2618485782040012,16,9,7,31,0.4939646669143465,0.2886126106016702
경기회복세/NNG;진행~되/VVX,1,0.2618485782040012,16,9,7,11,0.4939646669143465,0.2886126106016702
투자/NNG;감소~했/VVX,1,0.2618485782040012,16,9,7,7,0.4939646669143465,0.2886126106016702
집값/NNG;올랐/VV,1,0.2618485782040012,16,9,7,20,0.4939646669143465,0.2886126106016702
달러강세/NNG;나타날/VV,1,0.2618485782040012,16,9,7,19,0.4939646669143465,0.2886126106016702
경기/NNG;부담/NNG;줄/VV,1,0.2618485782040012,16,9,7,9,0.4939646669143465,0.2886126106016702
금리/NNG;수준/NNG;유지~할/VVX,1,0.2618485782040012,16,9,7,7,0.4939646669143465,0.2886126106016702
금리/NNG;상승~했으며/VVX,1,0.2618485782040012,16,9,7,22,0.4939646669143465,0.2886126106016702
위험/NNG;도사리/VV,1,0.2618485782040012,16,9,7,13,0.4939646669143465,0.2886126106016702
회사채/NNG;금리/NNG;하락~하/VVX,1,0.2618485782040012,16,9,7,12,0.4939646669143465,0.2886126106016702
통화가치/NNG;급락~하/VVX,1,0.2618485782040012,16,9,7,13,0.4939646669143465,0.2886126106016702
기준금리인상/NNG;고려~하/VVX,1,0.2618485782040012,16,9,7,9,0.4939646669143465,0.2886126106016702
전세가격/NNG;상승~하/VVX,1,0.2618485782040012,16,9,7,27,0.4939646669143465,0.2886126106016702
달러화/NNG;약세/NNG;나타냈/VV,1,0.2618485782040012,16,9,7,13,0.4939646669143465,0.2886126106016702
인플레이션기대/NNG;심리/NNG;억제~하/VVX,1,0.2618485782040012,16,9,7,15,0.4939646669143465,0.2886126106016702
소비/NNG;줄일/VV,1,0.2618485782040012,16,9,7,8,0.4939646669143465,0.2886126106016702
수출/NNG;부진~했/VVX,1,0.2618485782040012,16,9,7,13,0.4939646669143465,0.2886126106016702
소비/NNG;증가~할/VVX,1,0.2618485782040012,16,9,7,9,0.4939646669143465,0.2886126106016702
금리/NNG;올라가/VV,1,0.2599635185941185,187,101,86,132,0.8116633111030125,0.476158252547435
유로화/NNG;하락~했/VVX,1,0.2580549602925668,72,39,33,30,0.711049954559021,0.4188432327140012
침체/NNG;겪/VV,1,0.25738061033938964,57,31,26,28,0.6688591260581944,0.3945600472796741
이자/NNG;부담/NNG;커지/VV,1,0.25700936764665117,42,23,19,14,0.615334896756568,0.3632746594295787
경기회복/NNG;이어지/VV,1,0.25700936764665117,42,23,19,17,0.615334896756568,0.3632746594295787
금리/NNG;올려야/VV,1,0.2535598961102081,169,91,78,141,0.8061578095143388,0.47945396015370173
기준금리인상/NNG;나설/VV,1,0.2527392541382216,59,32,27,58,0.673196140835473,0.4010787469354307
경제/NNG;부양~하/VVX,1,0.2508269796783609,44,24,20,23,0.6209397469155955,0.37145817060584124
기준금리/NNG;인상~해야/VVX,1,0.2504630518114428,76,41,35,63,0.7171099005019005,0.4293221345913969
금리/NNG;인상~할/VVX,1,0.2499911698163617,1085,584,501,817,0.8093938752747628,0.4850589046592466
성장/NNG;가능~하/VVX,1,0.24836521441242532,61,33,28,35,0.6773824377133588,0.40735536822583174
금리인상/NNG;가능~할/VVX,1,0.24836521441242532,61,33,28,55,0.6773824377133588,0.40735536822583174
금리/NNG;반등~하/VVX,1,0.24836521441242532,61,33,28,55,0.6773824377133588,0.40735536822583174
금리인상/NNG;나서/VV,1,0.24538742713636674,151,81,70,145,0.7975130750892863,0.48264757973937894
인플레이션억제/NNG;위해/VV,1,0.2448767982205129,95,51,44,80,0.7502484383811868,0.4545367878991386
시장금리/NNG;상승~했/VVX,1,0.24357732367027518,31,17,14,12,0.5641857988839646,0.34275651576726135
안전자산선호/NNG;나타나/VV,1,0.24357732367027518,31,17,14,29,0.5641857988839646,0.34275651576726135
외환시장/NNG;원달러/NNG;내린/VV,1,0.24357732367027518,31,17,14,37,0.5641857988839646,0.34275651576726135
원화/NNG;약세/NNG;보이/VV,1,0.24357732367027518,31,17,14,29,0.5641857988839646,0.34275651576726135
cd/NNG;금리/NNG;상승~하/VVX,1,0.24357732367027518,31,17,14,10,0.5641857988839646,0.34275651576726135
스왑베이시스/NNG;역전폭/NNG;확대~됐/VVX,1,0.24276467954920133,18,10,8,23,0.5004412008115963,0.3045554816864193
주택시장/NNG;냉각~되/VVX,1,0.24276467954920133,18,10,8,10,0.5004412008115963,0.3045554816864193
자금유입/NNG;늘어나/VV,1,0.24276467954920133,18,10,8,9,0.5004412008115963,0.3045554816864193
금융시장변동성/NNG;확대~되/VVX,1,0.24276467954920133,18,10,8,25,0.5004412008115963,0.3045554816864193
소득/NNG;증가~하/VVX,1,0.24276467954920133,18,10,8,28,0.5004412008115963,0.3045554816864193
달러화가치/NNG;오르/VV,1,0.24276467954920133,18,10,8,21,0.5004412008115963,0.3045554816864193
적자/NNG;확대~되/VVX,1,0.24276467954920133,18,10,8,12,0.5004412008115963,0.3045554816864193
시장금리/NNG;올라가/VV,1,0.24276467954920133,18,10,8,10,0.5004412008115963,0.3045554816864193
국채/NNG;매입/NNG;확대~하/VVX,1,0.24276467954920133,18,10,8,11,0.5004412008115963,0.3045554816864193
신용등급/NNG;하락/NNG;따른/VV,1,0.24276467954920133,18,10,8,3,0.5004412008115963,0.3045554816864193
통화긴축/NNG;이어질/VV,1,0.24276467954920133,18,10,8,9,0.5004412008115963,0.3045554816864193
금리하락/NNG;견인~하/VVX,1,0.24276467954920133,18,10,8,15,0.5004412008115963,0.3045554816864193
신용등급/NNG;하향조정~되/VVX,1,0.24276467954920133,18,10,8,16,0.5004412008115963,0.3045554816864193
금리인상/NNG;단행~해야/VVX,1,0.24276467954920133,18,10,8,10,0.5004412008115963,0.3045554816864193
경제성장률/NNG;하향조정~했/VVX,1,0.24276467954920133,18,10,8,16,0.5004412008115963,0.3045554816864193
부동산시장/NNG;안정/NNG;위해/VV,1,0.24276467954920133,18,10,8,5,0.5004412008115963,0.3045554816864193
높/VA;수익/NNG;올릴/VV,1,0.24276467954920133,18,10,8,9,0.5004412008115963,0.3045554816864193
경제/NNG;커지/VV,1,0.24276467954920133,18,10,8,10,0.5004412008115963,0.3045554816864193
위안화/NNG;절상~하/VVX,1,0.24276467954920133,18,10,8,16,0.5004412008115963,0.3045554816864193
기준금리/NNG;인상~될/VVX,1,0.24239716342952966,397,213,184,349,0.805829919222856,0.4907900394842757
경기/NNG;회복~되/VVX,1,0.23847131561111534,239,128,111,161,0.8037445918040873,0.4936140885964797
채권금리/NNG;급등~하/VVX,1,0.23659685730423696,67,36,31,55,0.6890538120067062,0.424861262313256
노동시장/NNG;개선~되/VVX,1,0.23570675751019454,33,18,15,45,0.5706028975128545,0.35248959021953397
금리인상/NNG;주장~하/VVX,1,0.23570675751019454,33,18,15,40,0.5706028975128545,0.35248959021953397
물가안정/NNG;위한/VV,1,0.23400438314343863,86,46,40,66,0.730004312568301,0.4525867566388258
성장세/NNG;보일/VV,1,0.23305773123164442,69,37,32,68,0.6926550890683958,0.4302913641670814
수요/NNG;위축~되/VVX,1,0.23065980151135834,52,28,24,30,0.6419191683250827,0.40079826411753694
부채/NNG;늘어나/VV,1,0.23065980151135834,52,28,24,41,0.6419191683250827,0.40079826411753694
금융시장/NNG;안정/NNG;되찾/VV,1,0.23065980151135834,52,28,24,27,0.6419191683250827,0.40079826411753694
투자/NNG;늘/VV,1,0.23065980151135834,52,28,24,39,0.6419191683250827,0.40079826411753694
금리인상/NNG;점치/VV,1,0.22877432626173966,35,19,16,13,0.5769273095514124,0.3616550479879674
기준금리인상/NNG;있/VV,1,0.22877432626173966,35,19,16,29,0.5769273095514124,0.3616550479879674
경제/NNG;호조/NNG;보이/VV,1,0.22877432626173966,35,19,16,15,0.5769273095514124,0.3616550479879674
달러화/NNG;급등~하/VVX,1,0.22877432626173966,35,19,16,35,0.5769273095514124,0.3616550479879674
위험/NNG;떠안/VV,1,0.22877432626173966,35,19,16,30,0.5769273095514124,0.3616550479879674
시장변동성/NNG;확대~되/VVX,1,0.2279938837325597,20,11,9,17,0.5070956764626674,0.3184037086210091
지급준비금적수/NNG;늘어나/VV,1,0.2279938837325597,20,11,9,13,0.5070956764626674,0.3184037086210091
실업수당청구/NNG;줄어든/VV,1,0.2279938837325597,20,11,9,9,0.5070956764626674,0.3184037086210091
달러약세/NNG;이어지/VV,1,0.2279938837325597,20,11,9,18,0.5070956764626674,0.3184037086210091
기준금리인상/NNG;늦출/VV,1,0.2279938837325597,20,11,9,16,0.5070956764626674,0.3184037086210091
인플레이션/NNG;넘어서/VV,1,0.2279938837325597,20,11,9,2,0.5070956764626674,0.3184037086210091
순이익/NNG;늘어난/VV,1,0.2279938837325597,20,11,9,21,0.5070956764626674,0.3184037086210091
기준금리/NNG;상향조정~할/VVX,1,0.2279938837325597,20,11,9,32,0.5070956764626674,0.3184037086210091
투자/NNG;늘려/VV,1,0.2279938837325597,20,11,9,24,0.5070956764626674,0.3184037086210091
통화정책/NNG;유지~될/VVX,1,0.2279938837325597,20,11,9,10,0.5070956764626674,0.3184037086210091
침체/NNG;지속~되/VVX,1,0.2279938837325597,20,11,9,19,0.5070956764626674,0.3184037086210091
달러화/NNG;반락~했/VVX,1,0.2279938837325597,20,11,9,9,0.5070956764626674,0.3184037086210091
금리/NNG;내릴/VV;없/VA,1,0.2279938837325597,20,11,9,19,0.5070956764626674,0.3184037086210091
금리하락/NNG;이어질/VV,1,0.2279938837325597,20,11,9,18,0.5070956764626674,0.3184037086210091
기준금리/NNG;동결~하/VVX,1,0.22588978354335354,473,252,221,444,0.7979197889302345,0.5032377014194355
콜금리/NNG;인상~할/VVX,1,0.22549628564896862,92,49,43,46,0.736322862983045,0.464774340710082
금리인상/NNG;지연~되/VVX,1,0.22261172836124565,37,20,17,30,0.5831473750843074,0.3703297264153875
콜금리/NNG;인상~되/VVX,1,0.22261172836124565,37,20,17,20,0.5831473750843074,0.3703297264153875
불확실성/NNG;해소~된/VVX,1,0.22257726159494595,56,30,26,47,0.6515220817448615,0.41378130856488815
기준금리/NNG;인상~하/VVX,1,0.22151134739548883,598,318,280,497,0.7957839746953502,0.5065358731511526
원화/NNG;강세/NNG;따른/VV,1,0.21890738321284298,58,31,27,59,0.6560999857329263,0.41991433797585354
물가/NNG;안정~시키/VVX,1,0.21890738321284298,58,31,27,49,0.6560999857329263,0.41991433797585354
높/VA;수익률/NNG;기록~했/VVX,1,0.21890738321284298,58,31,27,26,0.6560999857329263,0.41991433797585354
유로화/NNG;강세/NNG;보이/VV,1,0.2170885488856309,39,21,18,30,0.5892533006532689,0.378573640820649
불확실성/NNG;높이/VV,1,0.2170885488856309,39,21,18,44,0.5892533006532689,0.378573640820649
투자심리/NNG;호전~됐/VVX,1,0.2162201564405022,22,12,10,13,0.5138629326738462,0.33073990656959223
기준금리/NNG;내려가/VV,1,0.2162201564405022,22,12,10,27,0.5138629326738462,0.33073990656959223
달러원/NNG;내린/VV,1,0.2162201564405022,22,12,10,21,0.5138629326738462,0.33073990656959223
금리/NNG;끌어내릴/VV,1,0.2162201564405022,22,12,10,11,0.5138629326738462,0.33073990656959223
성장/NNG;그칠/VV,1,0.2162201564405022,22,12,10,18,0.5138629326738462,0.33073990656959223
기대/NNG;인플레이션/NNG;상승~하/VVX,1,0.2162201564405022,22,12,10,21,0.5138629326738462,0.33073990656959223
달러화/NNG;오/VV,1,0.2162201564405022,22,12,10,14,0.5138629326738462,0.33073990656959223
경제지표/NNG;호조/NNG;나타내/VV,1,0.2162201564405022,22,12,10,30,0.5138629326738462,0.33073990656959223
지급준비율/NNG;인상/NNG;통해/VV,1,0.2162201564405022,22,12,10,10,0.5138629326738462,0.33073990656959223
채권수익률/NNG;상승~하/VVX,1,0.2162201564405022,22,12,10,15,0.5138629326738462,0.33073990656959223
재고/NNG;증가~했/VVX,1,0.2162201564405022,22,12,10,15,0.5138629326738462,0.33073990656959223
차입금/NNG;증가~했/VVX,1,0.2162201564405022,22,12,10,11,0.5138629326738462,0.33073990656959223
국채수익률/NNG;떨어진/VV,1,0.2162201564405022,22,12,10,10,0.5138629326738462,0.33073990656959223
유가상승/NNG;따른/VV,1,0.21539167269441561,100,53,47,58,0.743275202916124,0.47922919919683094
금리인상/NNG;인한/VV,1,0.21305599688742927,102,54,48,44,0.7447718353982062,0.4825495813812877
금리상승/NNG;제한~하/VVX,1,0.21210219713601797,41,22,19,41,0.5952369342730356,0.3864343526009997
장기금리/NNG;하락~했/VVX,1,0.21210219713601797,41,22,19,47,0.5952369342730356,0.3864343526009997
수출/NNG;둔화~되/VVX,1,0.2075708820102058,43,23,20,25,0.6010915608936318,0.39395007134375015
기준금리인상/NNG;앞두/VV,1,0.2075708820102058,43,23,20,40,0.6010915608936318,0.39395007134375015
환율하락/NNG;따른/VV,1,0.207111828203852,144,76,68,81,0.7758713253232041,0.5089869487836016
수신/NNG;늘어나/VV,1,0.2066112646938567,24,13,11,7,0.5206903147151198,0.3419403833716178
수익성/NNG;높이/VV,1,0.2066112646938567,24,13,11,21,0.5206903147151198,0.3419403833716178
시장/NNG;신뢰/NNG;회복~하/VVX,1,0.2066112646938567,24,13,11,27,0.5206903147151198,0.3419403833716178
경기회복세/NNG;지속~될/VVX,1,0.2066112646938567,24,13,11,34,0.5206903147151198,0.3419403833716178
금리인하/NNG;시사~하/VVX,1,0.2066112646938567,24,13,11,26,0.5206903147151198,0.3419403833716178
심리지표/NNG;개선~되/VVX,1,0.2066112646938567,24,13,11,24,0.5206903147151198,0.3419403833716178
경제성장률/NNG;하향조정~하/VVX,1,0.2066112646938567,24,13,11,14,0.5206903147151198,0.3419403833716178
금융위기/NNG;벗어나/VV,1,0.2066112646938567,24,13,11,13,0.5206903147151198,0.3419403833716178
위험/NNG;반영~하/VVX,1,0.2066112646938567,24,13,11,17,0.5206903147151198,0.3419403833716178
성장세/NNG;나타낼/VV,1,0.2066112646938567,24,13,11,18,0.5206903147151198,0.3419403833716178
경기/NNG;침체~되/VVX,1,0.2066112646938567,24,13,11,23,0.5206903147151198,0.3419403833716178
경기둔화/NNG;반영~하/VVX,1,0.2066112646938567,24,13,11,8,0.5206903147151198,0.3419403833716178
금리상승/NNG;예상~되/VVX,1,0.2066112646938567,24,13,11,25,0.5206903147151198,0.3419403833716178
금리/NNG;올리/VV,1,0.2050813224435406,892,471,421,746,0.7876273844966001,0.5188938987040154
금리인상/NNG;시사~하/VVX,1,0.20444817433459916,129,68,61,109,0.7662837424796004,0.5054998577033228
국채금리/NNG;오르/VV,1,0.20342860963161113,45,24,21,47,0.6068117212670602,0.4011518932953512
기준금리/NNG;인상~해/VVX,1,0.2033581463523062,68,36,32,47,0.676782989274145,0.4474743295106193
달러엔/NNG;상승~하/VVX,1,0.19861582174027514,26,14,12,20,0.5275355450210016,0.35225760075978724
경기둔화/NNG;우려~하/VVX,1,0.19861582174027514,26,14,12,14,0.5275355450210016,0.35225760075978724
순이익/NNG;늘/VV,1,0.19861582174027514,26,14,12,26,0.5275355450210016,0.35225760075978724
경기회복/NNG;지원~하/VVX,1,0.19861582174027514,26,14,12,22,0.5275355450210016,0.35225760075978724
통화완화/NNG;유지~하/VVX,1,0.19861582174027514,26,14,12,13,0.5275355450210016,0.35225760075978724
수출/NNG;감소~할/VVX,1,0.19861582174027514,26,14,12,14,0.5275355450210016,0.35225760075978724
소비/NNG;줄/VV,1,0.19861582174027514,26,14,12,15,0.5275355450210016,0.35225760075978724
금융시장/NNG;변동성/NNG;확대~되/VVX,1,0.19861582174027514,26,14,12,23,0.5275355450210016,0.35225760075978724
성장/NNG;이끌/VV,1,0.19610539783381808,49,26,23,39,0.6178321561543073,0.41471207636498897
기준금리/NNG;인상~된/VVX,1,0.19610539783381808,49,26,23,33,0.6178321561543073,0.41471207636498897
지급준비금적수/NNG;감소~했/VVX,1,0.19570823250113922,74,39,35,90,0.6874828985363074,0.4618453730258958
금리인상/NNG;이뤄질/VV,1,0.19223515042063166,101,53,48,77,0.7330267219859301,0.4960063284119104
금리차/NNG;축소~되/VVX,1,0.19185422996454848,28,15,13,36,0.5343646436390079,0.36186655755799585
실적/NNG;부진~했/VVX,1,0.19185422996454848,28,15,13,25,0.5343646436390079,0.36186655755799585
금리/NNG;올릴/VV;없/VA,1,0.19185422996454848,28,15,13,30,0.5343646436390079,0.36186655755799585
금리인상/NNG;앞당겨질/VV,1,0.19185422996454848,28,15,13,37,0.5343646436390079,0.36186655755799585
기준금리/NNG;동결~했으나/VVX,1,0.19185422996454848,28,15,13,28,0.5343646436390079,0.36186655755799585
성장세/NNG;지속~하/VVX,1,0.19112692092922212,78,41,37,53,0.6939390821633747,0.4706385080688597
기준금리/NNG;오르/VV,1,0.18980444667665375,53,28,25,48,0.6282741640254343,0.42727404045746936
금리/NNG;상승~해/VVX,1,0.18896883736039882,80,42,38,60,0.6969716707090043,0.4748153734385738
국고채/NNG;금리/NNG;국고/NNG;지표물/NNG;오른/VV,1,0.18696279767845958,55,29,26,49,0.6332740682970057,0.43321798599317407
경기/NNG;둔화~하/VVX,1,0.18696279767845958,55,29,26,38,0.6332740682970057,0.43321798599317407
기준금리/NNG;인하~하/VVX;않/VX,1,0.18696279767845958,55,29,26,31,0.6332740682970057,0.43321798599317407
금리/NNG;올려도/VV,1,0.18696279767845958,55,29,26,52,0.6332740682970057,0.43321798599317407
달러원/NNG;오른/VV,1,0.18696279767845958,55,29,26,33,0.6332740682970057,0.43321798599317407
원화/NNG;약세/NNG;따른/VV,1,0.18605667140161009,30,16,14,21,0.5411501976034011,0.3708920363943819
금리/NNG;하락세/NNG;보이/VV,1,0.18605667140161009,30,16,14,35,0.5411501976034011,0.3708920363943819
엔화/NNG;약세/NNG;지속~될/VVX,1,0.18605667140161009,30,16,14,8,0.5411501976034011,0.3708920363943819
모기지/NNG;금리/NNG;상승~하/VVX,1,0.18605667140161009,30,16,14,17,0.5411501976034011,0.3708920363943819
금리인상/NNG;시작~되/VVX,1,0.18605667140161009,30,16,14,24,0.5411501976034011,0.3708920363943819
수요/NNG;커지/VV,1,0.18605667140161009,30,16,14,25,0.5411501976034011,0.3708920363943819
신용스프레드/NNG;축소~되/VVX,1,0.1817990347340952,136,71,65,118,0.7588106319601329,0.5246725576467659
금리상승/NNG;인한/VV,1,0.18178597225578952,59,31,28,42,0.6428285666940599,0.4444898382996712
수출/NNG;감소~하/VVX,1,0.181084749311188,88,46,42,60,0.7078634790220124,0.4901687156913241
엔화/NNG;유로화/NNG;강세/NNG;나타냈/VV,1,0.1810261197850569,32,17,15,15,0.5478699977134748,0.3794252420216558
글로벌경제/NNG;회복~되/VVX,1,0.1810261197850569,32,17,15,27,0.5478699977134748,0.3794252420216558
기준금리인상/NNG;단행~되/VVX,1,0.1810261197850569,32,17,15,20,0.5478699977134748,0.3794252420216558
재할인율/NNG;인하~하/VVX,1,0.1810261197850569,32,17,15,25,0.5478699977134748,0.3794252420216558
서부텍사스산원유/NNG;내린/VV,1,0.1810261197850569,32,17,15,23,0.5478699977134748,0.3794252420216558
금리/NNG;오르/VV;않/VX,1,0.17717141136693093,63,33,30,57,0.6517907392931702,0.45500256163645525
금리인하/NNG;기대/NNG;약화~되/VVX,1,0.17661535794639982,34,18,16,33,0.5545059855687317,0.38753431560473756
금리/NNG;인상~하/VVX;어려울/VA,1,0.17661535794639982,34,18,16,31,0.5545059855687317,0.38753431560473756
시장/NNG;국고채/NNG;금리/NNG;하락~한/VAX;거래/NNG;마쳤/VV,1,0.17661535794639982,34,18,16,35,0.5545059855687317,0.38753431560473756
금리/NNG;안정~되/VVX,1,0.17661535794639982,34,18,16,41,0.5545059855687317,0.38753431560473756
금리/NNG;동결~하/VVX,1,0.17450604068987707,309,161,148,217,0.7718436629638129,0.5417793839992497
가계대출/NNG;늘/VV,1,0.17271218716289227,36,19,17,23,0.5610434437762498,0.3952711825118842
금리/NNG;상승세/NNG;이/VV,1,0.17271218716289227,36,19,17,24,0.5610434437762498,0.3952711825118842
적자/NNG;기록~했/VVX,1,0.17271218716289227,36,19,17,43,0.5610434437762498,0.3952711825118842
성장/NNG;둔화~될/VVX,1,0.17271218716289227,36,19,17,16,0.5610434437762498,0.3952711825118842
지급준비금적수/NNG;줄/VV,1,0.16922961431424355,38,20,18,35,0.5674703712173186,0.40267613233426547
달러화/NNG;강세/NNG;보이/VV,1,0.16807014225926897,104,54,50,116,0.7243165987097622,0.5152014345078394
위험/NNG;감수~하/VVX,1,0.1674640324342227,73,38,35,56,0.671662284196615,0.47834468149987835
금리/NNG;상승~할/VVX,1,0.16687316583725598,337,175,162,277,0.7677855810397155,0.5474665347932655
비용/NNG;줄이/VV,1,0.16609916608596387,40,21,19,41,0.5737769976669872,0.40978095493195044
기준금리동결/NNG;예상~했/VVX,1,0.16609916608596387,40,21,19,23,0.5737769976669872,0.40978095493195044
금리인상/NNG;가능성/NNG;부각~되/VVX,1,0.16609916608596387,40,21,19,34,0.5737769976669872,0.40978095493195044
경기둔화우려/NNG;따른/VV,1,0.16609916608596387,40,21,19,30,0.5737769976669872,0.40978095493195044
양적완화/NNG;인한/VV,1,0.163266225824112,42,22,20,15,0.5799554032041992,0.41661113287382556
저금리/NNG;유지~될/VVX,1,0.163266225824112,42,22,20,26,0.5799554032041992,0.41661113287382556
경기부진/NNG;따른/VV,1,0.163266225824112,42,22,20,44,0.5799554032041992,0.41661113287382556
경제지표/NNG;하회~하/VVX,1,0.16191366914558092,15,8,7,14,0.4647866926518294,0.33480805456346086
실적/NNG;호조/NNG;보이/VV,1,0.16191366914558092,15,8,7,7,0.4647866926518294,0.33480805456346086
달러원/NNG;떨어질/VV,1,0.16191366914558092,15,8,7,7,0.4647866926518294,0.33480805456346086
투자/NNG;늘린/VV,1,0.16191366914558092,15,8,7,10,0.4647866926518294,0.33480805456346086
금리/NNG;하락세/NNG;돌아섰/VV,1,0.16191366914558092,15,8,7,16,0.4647866926518294,0.33480805456346086
금리차/NNG;줄/VV,1,0.16191366914558092,15,8,7,18,0.4647866926518294,0.33480805456346086
유가/NNG;안정~될/VVX,1,0.16191366914558092,15,8,7,7,0.4647866926518294,0.33480805456346086
경상수지/NNG;악화~되/VVX,1,0.16191366914558092,15,8,7,12,0.4647866926518294,0.33480805456346086
신용경색/NNG;해소/NNG;위해/VV,1,0.16191366914558092,15,8,7,4,0.4647866926518294,0.33480805456346086
달러화/NNG;상승폭/NNG;제한~됐/VVX,1,0.16191366914558092,15,8,7,8,0.4647866926518294,0.33480805456346086
금리/NNG;하락세/NNG;보임/VV,1,0.16191366914558092,15,8,7,16,0.4647866926518294,0.33480805456346086
금리인하/NNG;중단~할/VVX,1,0.16191366914558092,15,8,7,7,0.4647866926518294,0.33480805456346086
금리/NNG;낙폭/NNG;확대~되/VVX,1,0.16191366914558092,15,8,7,12,0.4647866926518294,0.33480805456346086
고용지표/NNG;개선~된/VVX,1,0.16191366914558092,15,8,7,15,0.4647866926518294,0.33480805456346086
금리인하/NNG;가능성/NNG;높이/VV,1,0.16191366914558092,15,8,7,11,0.4647866926518294,0.33480805456346086
인플레이션/NNG;우려/NNG;인해/VV,1,0.16191366914558092,15,8,7,13,0.4647866926518294,0.33480805456346086
안전자산선호/NNG;심리/NNG;자극~하/VVX,1,0.16191366914558092,15,8,7,12,0.4647866926518294,0.33480805456346086
국채선물시장/NNG;국채선물/NNG;상승~한/VAX;거래~되/VVX,1,0.16191366914558092,15,8,7,20,0.4647866926518294,0.33480805456346086
금리인상/NNG;우려~하/VVX,1,0.16191366914558092,15,8,7,3,0.4647866926518294,0.33480805456346086
주택시장/NNG;둔화~되/VVX,1,0.16191366914558092,15,8,7,8,0.4647866926518294,0.33480805456346086
수급상황/NNG;개선~될/VVX,1,0.16191366914558092,15,8,7,3,0.4647866926518294,0.33480805456346086
소비자심리지수/NNG;상승~했/VVX,1,0.16191366914558092,15,8,7,9,0.4647866926518294,0.33480805456346086
조달금리/NNG;낮추/VV,1,0.16191366914558092,15,8,7,20,0.4647866926518294,0.33480805456346086
금리상승/NNG;과도~했/VVX,1,0.16191366914558092,15,8,7,6,0.4647866926518294,0.33480805456346086
소득/NNG;심사/NNG;강화~하/VVX,1,0.16191366914558092,15,8,7,13,0.4647866926518294,0.33480805456346086
경제/NNG;성장세/NNG;나타내/VV,1,0.16191366914558092,15,8,7,14,0.4647866926518294,0.33480805456346086
금리동결/NNG;지속~될/VVX,1,0.16191366914558092,15,8,7,9,0.4647866926518294,0.33480805456346086
성장모멘텀/NNG;둔화~될/VVX,1,0.16191366914558092,15,8,7,7,0.4647866926518294,0.33480805456346086
성장/NNG;저해~하/VVX,1,0.16191366914558092,15,8,7,9,0.4647866926518294,0.33480805456346086
물가안정/NNG;위해서/VV,1,0.16191366914558092,15,8,7,11,0.4647866926518294,0.33480805456346086
순이익/NNG;늘어날/VV,1,0.16191366914558092,15,8,7,12,0.4647866926518294,0.33480805456346086
성장/NNG;이어지/VV,1,0.16191366914558092,15,8,7,10,0.4647866926518294,0.33480805456346086
단기자금/NNG;시장/NNG;안정~되/VVX,1,0.16191366914558092,15,8,7,5,0.4647866926518294,0.33480805456346086
기준금리인상/NNG;빨라질/VA;있/VV,1,0.16191366914558092,15,8,7,11,0.4647866926518294,0.33480805456346086
위험/NNG;분산~하/VVX,1,0.16191366914558092,15,8,7,15,0.4647866926518294,0.33480805456346086
기준금리인상/NNG;주장~하/VVX,1,0.16191366914558092,15,8,7,10,0.4647866926518294,0.33480805456346086
cd금리/NNG;올라갈/VV,1,0.16191366914558092,15,8,7,4,0.4647866926518294,0.33480805456346086
원화/NNG;약세/NNG;보일/VV,1,0.16191366914558092,15,8,7,15,0.4647866926518294,0.33480805456346086
기준금리인상/NNG;늦추/VV,1,0.16191366914558092,15,8,7,12,0.4647866926518294,0.33480805456346086
위험/NNG;요인/NNG;될/VV,1,0.16191366914558092,15,8,7,16,0.4647866926518294,0.33480805456346086
내외금리차확대/NNG;따른/VV,1,0.16191366914558092,15,8,7,5,0.4647866926518294,0.33480805456346086
유가/NNG;떨어져/VV,1,0.16191366914558092,15,8,7,14,0.4647866926518294,0.33480805456346086
원자재/NNG;가격/NNG;급등~하/VVX,1,0.16191366914558092,15,8,7,14,0.4647866926518294,0.33480805456346086
완화정책/NNG;펴/VV,1,0.16191366914558092,15,8,7,7,0.4647866926518294,0.33480805456346086
달러강세/NNG;지지~하/VVX,1,0.16068671294325032,44,23,21,26,0.5859992166995225,0.42318740274298716
기준금리/NNG;낮췄/VV,1,0.15832467419982144,46,24,22,28,0.5919033743521978,0.42952688539113953
경기/NNG;회복세/NNG;보이/VV,1,0.15832467419982144,46,24,22,22,0.5919033743521978,0.42952688539113953
국제/NNG;유가/NNG;급등~하/VVX,1,0.15832467419982144,46,24,22,32,0.5919033743521978,0.42952688539113953
금리/NNG;오른/VV,1,0.1581897215059631,232,120,112,265,0.7627843416260343,0.5536833424896157
금리/NNG;올라갈/VV,1,0.15818868133608155,85,44,41,55,0.6910131910084599,0.5015877860445467
기준금리/NNG;동결~됐/VVX,1,0.15615050718998225,48,25,23,56,0.5976639241884776,0.4356439161990602
달러화/NNG;반등~하/VVX,1,0.15615050718998225,48,25,23,27,0.5976639241884776,0.4356439161990602
금리인상/NNG;계속~될/VVX,1,0.15413963038536505,50,26,24,16,0.6032778660523992,0.4415506629729239
금리/NNG;국고/NNG;지표물/NNG;하락~한/VAX;거래/NNG;시작~했/VVX,1,0.15413963038536505,50,26,24,85,0.6032778660523992,0.4415506629729239
금리/NNG;떨어질/VV,1,0.15298430914225536,93,48,45,71,0.7014468620782734,0.5146180201382136
금리/NNG;상승세/NNG;출발~했/VVX,1,0.15287293982506034,17,9,8,13,0.4718266602076146,0.3462355644693504
금리인상/NNG;두/VV,1,0.15287293982506034,17,9,8,31,0.4718266602076146,0.3462355644693504
인플레이션압력/NNG;증가~할/VVX,1,0.15287293982506034,17,9,8,8,0.4718266602076146,0.3462355644693504
국채선물/NNG;하락~한/VAX;마쳤/VV,1,0.15287293982506034,17,9,8,8,0.4718266602076146,0.3462355644693504
가산금리/NNG;확대~되/VVX,1,0.15287293982506034,17,9,8,1,0.4718266602076146,0.3462355644693504
기준금리/NNG;동결~한다고/VVX,1,0.15287293982506034,17,9,8,20,0.4718266602076146,0.3462355644693504
금리하락압력/NNG;작용~할/VVX,1,0.15287293982506034,17,9,8,16,0.4718266602076146,0.3462355644693504
금리인상/NNG;가능성/NNG;커졌/VV,1,0.15287293982506034,17,9,8,20,0.4718266602076146,0.3462355644693504
금리인하/NNG;기대/NNG;약화~될/VVX,1,0.15287293982506034,17,9,8,13,0.4718266602076146,0.3462355644693504
투자/NNG;선호~하/VVX,1,0.15287293982506034,17,9,8,14,0.4718266602076146,0.3462355644693504
기대심리/NNG;확산~하/VVX,1,0.15287293982506034,17,9,8,12,0.4718266602076146,0.3462355644693504
성장세/NNG;나타냈/VV,1,0.15287293982506034,17,9,8,9,0.4718266602076146,0.3462355644693504
저평가/NNG;줄어들/VV,1,0.15287293982506034,17,9,8,6,0.4718266602076146,0.3462355644693504
금리인상/NNG;신중~해야/VVX,1,0.15287293982506034,17,9,8,21,0.4718266602076146,0.3462355644693504
달러엔/NNG;올랐/VV,1,0.15287293982506034,17,9,8,8,0.4718266602076146,0.3462355644693504
안전자산선호/NNG;강화~된/VVX,1,0.15287293982506034,17,9,8,14,0.4718266602076146,0.3462355644693504
물가오름세/NNG;확대~되/VVX,1,0.15287293982506034,17,9,8,8,0.4718266602076146,0.3462355644693504
유로화/NNG;강세/NNG;견인~했/VVX,1,0.15287293982506034,17,9,8,7,0.4718266602076146,0.3462355644693504
자본/NNG;빠져나가/VV,1,0.15287293982506034,17,9,8,10,0.4718266602076146,0.3462355644693504
달러화/NNG;하락압력/NNG;가하/VV,1,0.15287293982506034,17,9,8,10,0.4718266602076146,0.3462355644693504
경제성장/NNG;이루/VV,1,0.15287293982506034,17,9,8,7,0.4718266602076146,0.3462355644693504
금리인상/NNG;준비~하/VVX,1,0.15287293982506034,17,9,8,14,0.4718266602076146,0.3462355644693504
수요/NNG;감소~할/VVX,1,0.15227147388607576,52,27,25,52,0.608743019266362,0.44725759117836966
투자심리/NNG;위축~되/VVX,1,0.1522290397805368,161,83,78,93,0.7527275592885226,0.5530943870518665
국채금리/NNG;상승~하/VVX,1,0.1483591296657052,101,52,49,89,0.710123379974406,0.5259349530188419
경기/NNG;위축~되/VVX,1,0.1473626861550943,58,30,28,18,0.6242340286591989,0.4632654625956309
투자/NNG;늘리/VV,1,0.14727938019819375,103,53,50,94,0.7120403401068023,0.5285194791856314
금리인상/NNG;오/VV,1,0.14595686791859208,19,10,9,16,0.4790673035120407,0.35655465479272336
완화/NNG;유지~할/VVX,1,0.14595686791859208,19,10,9,16,0.4790673035120407,0.35655465479272336
원유/NNG;재고/NNG;감소~했/VVX,1,0.14595686791859208,19,10,9,20,0.4790673035120407,0.35655465479272336
고용지표/NNG;상회~하/VVX,1,0.14595686791859208,19,10,9,10,0.4790673035120407,0.35655465479272336
기준금리동결/NNG;따른/VV,1,0.14595686791859208,19,10,9,26,0.4790673035120407,0.35655465479272336
유가/NNG;안정~되/VVX,1,0.14595686791859208,19,10,9,12,0.4790673035120407,0.35655465479272336
금리인상/NNG;해야/VV,1,0.14595686791859208,19,10,9,9,0.4790673035120407,0.35655465479272336
성장모멘텀/NNG;둔화~되/VVX,1,0.14595686791859208,19,10,9,11,0.4790673035120407,0.35655465479272336
기대심리/NNG;약화~되/VVX,1,0.14595686791859208,19,10,9,19,0.4790673035120407,0.35655465479272336
금리/NNG;떨어뜨리/VV,1,0.14595686791859208,19,10,9,11,0.4790673035120407,0.35655465479272336
금리/NNG;인하~된/VVX,1,0.14595686791859208,19,10,9,5,0.4790673035120407,0.35655465479272336
낮/VA;금리/NNG;자금/NNG;조달~할/VVX,1,0.14595686791859208,19,10,9,20,0.4790673035120407,0.35655465479272336
기준금리인상/NNG;가능성/NNG;있/VV,1,0.14595686791859208,19,10,9,3,0.4790673035120407,0.35655465479272336
성장세/NNG;둔화~됐/VVX,1,0.14595686791859208,19,10,9,9,0.4790673035120407,0.35655465479272336
대출/NNG;늘렸/VV,1,0.14595686791859208,19,10,9,15,0.4790673035120407,0.35655465479272336
대외불확실성/NNG;커지/VV,1,0.14595686791859208,19,10,9,14,0.4790673035120407,0.35655465479272336
소비/NNG;부진~하/VVX,1,0.14595686791859208,19,10,9,15,0.4790673035120407,0.35655465479272336
금리인상/NNG;우려/NNG;따른/VV,1,0.14595686791859208,19,10,9,16,0.4790673035120407,0.35655465479272336
국고채/NNG;하락~하/VVX,1,0.14595686791859208,19,10,9,14,0.4790673035120407,0.35655465479272336
경기회복세/NNG;이어질/VV,1,0.14595686791859208,19,10,9,10,0.4790673035120407,0.35655465479272336
단기물/NNG;금리/NNG;하락~하/VVX,1,0.14595686791859208,19,10,9,14,0.4790673035120407,0.35655465479272336
경기회복/NNG;지속~될/VVX,1,0.14595686791859208,19,10,9,10,0.4790673035120407,0.35655465479272336
집값/NNG;하락~하/VVX,1,0.14595686791859208,19,10,9,19,0.4790673035120407,0.35655465479272336
수출/NNG;개선~될/VVX,1,0.14595686791859208,19,10,9,11,0.4790673035120407,0.35655465479272336
금리인상/NNG;단행~한다면/VVX,1,0.14595686791859208,19,10,9,8,0.4790673035120407,0.35655465479272336
임금상승/NNG;따른/VV,1,0.14595686791859208,19,10,9,9,0.4790673035120407,0.35655465479272336
지출/NNG;늘/VV,1,0.14595686791859208,19,10,9,17,0.4790673035120407,0.35655465479272336
부양책/NNG;필요~하/VVX,1,0.14595686791859208,19,10,9,18,0.4790673035120407,0.35655465479272336
서부텍사스산원유/NNG;오른/VV,1,0.144547736089083,62,32,30,47,0.6338054052953989,0.4730804768278525
위험/NNG;커지/VV,1,0.1442013916002549,109,56,53,73,0.7172335860649546,0.5357309494015354
경기회복/NNG;지연~되/VVX,1,0.14324943378934618,64,33,31,38,0.6383659170257169,0.4777487392777284
금리/NNG;인상~했/VVX,1,0.14069017098660064,191,98,93,113,0.7513074765537803,0.5652163701171429
기대심리/NNG;상승~하/VVX,1,0.14051860056793686,21,11,10,10,0.4864184061676564,0.3660656255442203
원화/NNG;절상/NNG;따른/VV,1,0.14051860056793686,21,11,10,29,0.4864184061676564,0.3660656255442203
달러원/NNG;상승~했/VVX,1,0.14051860056793686,21,11,10,14,0.4864184061676564,0.3660656255442203
기준금리인상/NNG;가능성/NNG;커지/VV,1,0.14051860056793686,21,11,10,12,0.4864184061676564,0.3660656255442203
금리/NNG;수준/NNG;유지~하/VVX,1,0.14051860056793686,21,11,10,22,0.4864184061676564,0.3660656255442203
경기/NNG;낙관~하/VVX,1,0.14051860056793686,21,11,10,13,0.4864184061676564,0.3660656255442203
금리인상/NNG;앞둔/VV,1,0.14051860056793686,21,11,10,31,0.4864184061676564,0.3660656255442203
금리/NNG;올라서/VV,1,0.14051860056793686,21,11,10,21,0.4864184061676564,0.3660656255442203
실적호조/NNG;힘입/VV,1,0.14051860056793686,21,11,10,13,0.4864184061676564,0.3660656255442203
경기회복모멘텀/NNG;둔화~될/VVX,1,0.14051860056793686,21,11,10,14,0.4864184061676564,0.3660656255442203
집값/NNG;떨어질/VV,1,0.14051860056793686,21,11,10,5,0.4864184061676564,0.3660656255442203
연방기금금리/NNG;인상~하/VVX,1,0.14051860056793686,21,11,10,17,0.4864184061676564,0.3660656255442203
금리/NNG;동결~됐/VVX,1,0.14051860056793686,21,11,10,26,0.4864184061676564,0.3660656255442203
고용지표/NNG;부진~할/VVX,1,0.14051860056793686,21,11,10,9,0.4864184061676564,0.3660656255442203
기준금리/NNG;인하~될/VVX,1,0.1400059668656939,343,176,167,210,0.7531006834964917,0.5673563122040495
투자심리/NNG;개선~되/VVX,1,0.1397097671198262,70,36,34,76,0.6511622273059331,0.49085620160368587
채권/NNG;시장/NNG;국고채/NNG;지표금리/NNG;내린/VV,1,0.1397097671198262,70,36,34,106,0.6511622273059331,0.49085620160368587
불확실성/NNG;완화~되/VVX,1,0.1386304271527654,72,37,35,77,0.6551383770506427,0.4949410803578097
채권가격/NNG;하락~하/VVX,1,0.13614779320747394,23,12,11,26,0.4938157072020172,0.37495725488878484
성장/NNG;견인~하/VVX,1,0.13614779320747394,23,12,11,21,0.4938157072020172,0.37495725488878484
경기/NNG;하강~할/VVX,1,0.13614779320747394,23,12,11,6,0.4938157072020172,0.37495725488878484
대출/NNG;증가~했/VVX,1,0.13614779320747394,23,12,11,23,0.4938157072020172,0.37495725488878484
낮/VA;금리/NNG;대출/NNG;받/VV,1,0.13614779320747394,23,12,11,33,0.4938157072020172,0.37495725488878484
경제성장률/NNG;높이/VV,1,0.13614779320747394,23,12,11,10,0.4938157072020172,0.37495725488878484
경기부양/NNG;따른/VV,1,0.13614779320747394,23,12,11,21,0.4938157072020172,0.37495725488878484
수출/NNG;회복~되/VVX,1,0.13614779320747394,23,12,11,16,0.4938157072020172,0.37495725488878484
금리인하/NNG;필요~하/VVX,1,0.13614779320747394,23,12,11,27,0.4938157072020172,0.37495725488878484
경제지표/NNG;호조/NNG;보여/VV,1,0.13614779320747394,23,12,11,15,0.4938157072020172,0.37495725488878484
경제활동/NNG;위축~되/VVX,1,0.13614779320747394,23,12,11,8,0.4938157072020172,0.37495725488878484
채권금리/NNG;하락~했/VVX,1,0.13381067665039104,82,42,40,62,0.6729483737748226,0.5134106587108538
금리인상/NNG;통해/VV,1,0.13311836221948936,135,69,66,70,0.7317430705870747,0.5590537687037008
금리/NNG;내려갈/VV,1,0.1329418088082739,84,43,41,64,0.6761139557714257,0.516738560251042
기대심리/NNG;상승~했/VVX,1,0.13257146320591784,25,13,12,32,0.5012120953198124,0.38335377196381637
잠재/NNG;성장률/NNG;상회~하/VVX,1,0.13257146320591784,25,13,12,9,0.5012120953198124,0.38335377196381637
금리/NNG;상회~하/VVX,1,0.13257146320591784,25,13,12,22,0.5012120953198124,0.38335377196381637
금리인하/NNG;베팅/NNG;하/VV,1,0.13257146320591784,25,13,12,18,0.5012120953198124,0.38335377196381637
국고채/NNG;금리/NNG;떨어진/VV,1,0.13257146320591784,25,13,12,12,0.5012120953198124,0.38335377196381637
금리/NNG;올리/VV;어려울/VA,1,0.13257146320591784,25,13,12,10,0.5012120953198124,0.38335377196381637
위안화/NNG;절상~될/VVX,1,0.13257146320591784,25,13,12,21,0.5012120953198124,0.38335377196381637
금리동결/NNG;결정~하/VVX,1,0.13257146320591784,25,13,12,18,0.5012120953198124,0.38335377196381637
달러화/NNG;하락~했/VVX,1,0.13128129203563232,88,45,43,73,0.6820706061003302,0.5230548537969966
글로벌경제/NNG;회복세/NNG;이/VV,1,0.12960092335844386,27,14,13,8,0.5085721824817481,0.3913400614052054
경상수지흑자/NNG;지속~되/VVX,1,0.12960092335844386,27,14,13,40,0.5085721824817481,0.3913400614052054
전세가격/NNG;오르/VV,1,0.12960092335844386,27,14,13,27,0.5085721824817481,0.3913400614052054
국채금리/NNG;상승~할/VVX,1,0.12960092335844386,27,14,13,20,0.5085721824817481,0.3913400614052054
달러엔/NNG;하락~했/VVX,1,0.12960092335844386,27,14,13,18,0.5085721824817481,0.3913400614052054
금리/NNG;하락~할/VVX,1,0.12960092335844386,27,14,13,26,0.5085721824817481,0.3913400614052054
채권가격/NNG;상승/NNG;채권강세/NNG;한/XSA;의미~한다/VVX,1,0.12960092335844386,27,14,13,26,0.5085721824817481,0.3913400614052054
경제지표/NNG;부진~한/VAX;보이/VV,1,0.12960092335844386,27,14,13,22,0.5085721824817481,0.3913400614052054
금리/NNG;하락~했으나/VVX,1,0.12710158574066366,29,15,14,27,0.5158688491582003,0.3989759939849515
채권금리/NNG;오를/VV,1,0.12710158574066366,29,15,14,34,0.5158688491582003,0.3989759939849515
수출호조/NNG;따른/VV,1,0.12710158574066366,29,15,14,15,0.5158688491582003,0.3989759939849515
불안심리/NNG;해소~되/VVX,1,0.12710158574066366,29,15,14,26,0.5158688491582003,0.3989759939849515
스왑베이시스/NNG;축소~되/VVX,1,0.12710158574066366,29,15,14,16,0.5158688491582003,0.3989759939849515
cd금리/NNG;오른/VV,1,0.12710158574066366,29,15,14,11,0.5158688491582003,0.3989759939849515
경기둔화/NNG;인해/VV,1,0.12710158574066366,29,15,14,21,0.5158688491582003,0.3989759939849515
성장세/NNG;이/VV,1,0.12652091482919348,155,79,76,142,0.7366046326137825,0.5703667032887383
불안심리/NNG;커지/VV,1,0.12612461113694207,102,52,50,78,0.6992935174810206,0.54191202538038
경기/NNG;둔화~될/VVX,1,0.12612461113694207,102,52,50,60,0.6992935174810206,0.54191202538038
수요/NNG;억제~하/VVX,1,0.12497489610587875,31,16,15,14,0.5230809771374183,0.4063049747849332
유로화/NNG;강세/NNG;보였/VV,1,0.12497489610587875,31,16,15,27,0.5230809771374183,0.4063049747849332
실적/NNG;내/VV,1,0.12497489610587875,31,16,15,30,0.5230809771374183,0.4063049747849332
유가/NNG;떨어졌/VV,1,0.12497489610587875,31,16,15,15,0.5230809771374183,0.4063049747849332
금리/NNG;하락~했/VVX,1,0.12323332235289586,324,165,159,259,0.7436267320549323,0.5796602582461504
금리/NNG;상승~함/VVX,1,0.12314706416283738,33,17,16,37,0.5301919195343824,0.4133592514467041
금리/NNG;인상~한다고/VVX,1,0.12314706416283738,33,17,16,22,0.5301919195343824,0.4133592514467041
달러화가치/NNG;떨어지/VV,1,0.12314706416283738,33,17,16,26,0.5301919195343824,0.4133592514467041
달러강세/NNG;인해/VV,1,0.12314706416283738,33,17,16,26,0.5301919195343824,0.4133592514467041
신용스프레드/NNG;확대~되/VVX,1,0.12173362431019386,116,59,57,114,0.7116532672678256,0.5564274281467341
지급준비금적수/NNG;감소~한다/VVX,1,0.12156177976097315,35,18,17,21,0.5371884413520294,0.42016332490741726
소비심리/NNG;위축~되/VVX,1,0.12017535989040806,37,19,18,15,0.544059968126923,0.42673620582048
원화/NNG;절상~되/VVX,1,0.12017535989040806,37,19,18,16,0.544059968126923,0.42673620582048
경기/NNG;부진~하/VVX,1,0.12017535989040806,37,19,18,23,0.544059968126923,0.42673620582048
불안심리/NNG;완화~되/VVX,1,0.11895342878790438,39,20,19,20,0.55079804102033,0.43309294529125375
달러강세/NNG;지속~되/VVX,1,0.11895342878790438,39,20,19,33,0.55079804102033,0.43309294529125375
물가/NNG;안정~될/VVX,1,0.11895342878790438,39,20,19,22,0.55079804102033,0.43309294529125375
원달러/NNG;상승~하/VVX,1,0.11895342878790438,39,20,19,39,0.55079804102033,0.43309294529125375
인플레이션/NNG;억제~되/VVX,1,0.11786859368152691,41,21,20,18,0.5573959132190194,0.4392456960976537
국채가격/NNG;올랐/VV,1,0.11602604270803885,45,23,22,22,0.5701508687895389,0.45097763783120276
엔화/NNG;약세/NNG;따른/VV,1,0.1145153654273503,49,25,24,67,0.5822951163827839,0.46199498815014717
변동성/NNG;줄어들/VV,1,0.1145153654273503,49,25,24,31,0.5822951163827839,0.46199498815014717
물가안정/NNG;유지~될/VVX,1,0.1145153654273503,49,25,24,23,0.5822951163827839,0.46199498815014717
미국채금리/NNG;오른/VV,1,0.1145153654273503,49,25,24,57,0.5822951163827839,0.46199498815014717
수요/NNG;확대~되/VVX,1,0.11385509105310376,51,26,25,40,0.5881327864005986,0.4672509402100572
투자/NNG;늘어나/VV,1,0.11385509105310376,51,26,25,50,0.5881327864005986,0.4672509402100572
소비/NNG;증가~하/VVX,1,0.11268184299409767,55,28,27,30,0.5993341814249816,0.47728241363486246
국고채/NNG;금리/NNG;상승~하/VVX,1,0.11215563908242032,57,29,28,38,0.604697484102802,0.48206669396342805
엔화/NNG;약세/NNG;보이/VV,1,0.11215563908242032,57,29,28,50,0.604697484102802,0.48206669396342805
달러화/NNG;약세/NNG;보였/VV,1,0.11119813244892329,61,31,30,42,0.6149514551700538,0.491192119496251
콜금리/NNG;동결~하/VVX,1,0.1103408759657285,65,33,32,31,0.6245821837214289,0.4997507696440227
금리/NNG;인하~해/VVX,1,0.10994199760110401,67,34,33,54,0.6291674950477775,0.5038260586857677
안전자산선호/NNG;강화~되/VVX,1,0.10883631589976916,73,37,36,76,0.6420261975397857,0.5152742346811314
금리/NNG;하락~하/VVX,1,0.10765679151058771,441,223,218,360,0.7346224194442468,0.5909977015124476
금리인상/NNG;할/VV,1,0.10351750954106254,109,55,54,83,0.6945497019858801,0.5634537020449308
변동성/NNG;확대~되/VVX,1,0.0834832910872898,190,95,95,172,0.7179734065301722,0.6064655265426501
채권금리/NNG;상승~하/VVX,1,0.08315907019085489,108,54,54,95,0.681769796127168,0.5762605534233122
시장금리/NNG;상승~할/VVX,1,0.0823897278157466,96,48,48,53,0.6670012053049579,0.5646510092521043
달러약세/NNG;따른/VV,1,0.08119863408878158,84,42,42,57,0.648084147404396,0.549953102694229
기준금리/NNG;인상~할/VVX,1,0.08058520432907668,857,428,429,665,0.7185019226088609,0.6104612798044745
기준금리/NNG;낮추/VV,1,0.08041032491784539,78,39,39,66,0.6368611941319637,0.5412871917058456
물가/NNG;안정~되/VVX,1,0.08011530056561988,76,38,38,38,0.6328386273584913,0.5381875769450116
국고채/NNG;금리/NNG;내린/VV,1,0.08011530056561988,76,38,38,65,0.6328386273584913,0.5381875769450116
기준금리/NNG;인하~해/VVX,1,0.07980317564171058,74,37,37,63,0.628670411501915,0.5349785379961999
콜금리/NNG;동결~할/VVX,1,0.07947335017818857,72,36,36,23,0.6243537268774876,0.5316577443461313
장단기금리차/NNG;확대~되/VVX,1,0.07875814505821199,68,34,34,69,0.6152640773665224,0.5246717274483225
금리/NNG;오를/VV,1,0.07743295223523239,381,190,191,313,0.7165867437952033,0.6127059830687461
성장/NNG;예상~되/VVX,1,0.0766163881396209,58,29,29,33,0.5897626410317366,0.5050955806696757
지급준비금적수/NNG;증가~했/VVX,1,0.07612213647722688,56,28,28,78,0.584168847914726,0.5008021689590764
기준금리인상/NNG;단행~될/VVX,1,0.07560433953453005,54,27,27,39,0.5784063577935885,0.49637840971296054
금리인상/NNG;가능성/NNG;제기~되/VVX,1,0.07560433953453005,54,27,27,51,0.5784063577935885,0.49637840971296054
성장세/NNG;지속~할/VVX,1,0.07506230633559152,52,26,26,31,0.5724737780586172,0.49182268983332084
금리하락/NNG;이끌/VV,1,0.07506230633559152,52,26,26,46,0.5724737780586172,0.49182268983332084
매수/NNG;심리/NNG;위축~됐/VVX,1,0.07506230633559152,52,26,26,39,0.5724737780586172,0.49182268983332084
국채선물/NNG;떨어진/VV,1,0.07449534020345094,50,25,25,66,0.5663699533274966,0.48713353255211056
금리인상/NNG;관련~해/VVX,1,0.07449534020345094,50,25,25,62,0.5663699533274966,0.48713353255211056
경기/NNG;개선~될/VVX,1,0.0739027398158314,48,24,24,41,0.5600939859795389,0.48230961218833523
국채선물/NNG;오른/VV,1,0.07367421433088062,227,113,114,182,0.713880268532281,0.615020819583717
시중금리/NNG;상승~하/VVX,1,0.07328380039477489,46,23,23,36,0.5536452573824541,0.47734976963686965
국채금리/NNG;오른/VV,1,0.07196407618779466,42,21,21,34,0.54022856834877,0.467018612220008
시장/NNG;국고채/NNG;금리/NNG;상승~한/VAX;거래/NNG;마쳤/VV,1,0.07196407618779466,42,21,21,39,0.54022856834877,0.467018612220008
유로화/NNG;엔화/NNG;상승~했/VVX,1,0.07196407618779466,42,21,21,16,0.54022856834877,0.467018612220008
경제성장률/NNG;둔화~되/VVX,1,0.0712618772714444,40,20,20,36,0.5332609644578064,0.4616459609515438
수익성/NNG;악화~되/VVX,1,0.07053051446771397,38,19,19,54,0.5261213580532841,0.4561347501118136
기준금리인상/NNG;시사~하/VVX,1,0.07053051446771397,38,19,19,28,0.5261213580532841,0.4561347501118136
수익/NNG;올렸/VV,1,0.07053051446771397,38,19,19,36,0.5261213580532841,0.4561347501118136
cd금리/NNG;하락~하/VVX,1,0.06976928865042398,36,18,18,16,0.5188108609318377,0.450484908514766
변동성/NNG;확대~하/VVX,1,0.06976928865042398,36,18,18,19,0.5188108609318377,0.450484908514766
국채금리/NNG;급등~하/VVX,1,0.06976928865042398,36,18,18,48,0.5188108609318377,0.450484908514766
수익성/NNG;악화~될/VVX,1,0.06976928865042398,36,18,18,17,0.5188108609318377,0.450484908514766
원자재/NNG;가격하락/NNG;따른/VV,1,0.06976928865042398,36,18,18,19,0.5188108609318377,0.450484908514766
외환시장/NNG;원달러/NNG;오른/VV,1,0.06897750748024523,34,17,17,65,0.5113309995531167,0.4446966371926069
달러화/NNG;강세/NNG;보일/VV,1,0.06897750748024523,34,17,17,42,0.5113309995531167,0.4446966371926069
금리/NNG;인상~한다면/VVX,1,0.0681544876531821,32,16,16,23,0.5036837375646324,0.4387704283842097
경기/NNG;부양~하/VVX,1,0.06794636812157706,139,69,70,151,0.6956784488292613,0.6062746983576749
금리/NNG;인상~해도/VVX,1,0.0672995573009807,30,15,15,32,0.4958714977477088,0.43270708461119084
경기/NNG;호전~되/VVX,1,0.0672995573009807,30,15,15,24,0.4958714977477088,0.43270708461119084
자산/NNG;늘리/VV,1,0.0672995573009807,30,15,15,36,0.4958714977477088,0.43270708461119084
비용/NNG;증가~하/VVX,1,0.0672995573009807,30,15,15,28,0.4958714977477088,0.43270708461119084
달러원/NNG;올랐/VV,1,0.0672995573009807,30,15,15,19,0.4958714977477088,0.43270708461119084
경제지표/NNG;부진~할/VVX,1,0.06641205853781917,28,14,14,21,0.4878971831262993,0.42650773768665934
안전자산선호/NNG;심리/NNG;강화~되/VVX,1,0.06641205853781917,28,14,14,46,0.4878971831262993,0.42650773768665934
금리인상/NNG;지속~하/VVX,1,0.06641205853781917,28,14,14,11,0.4878971831262993,0.42650773768665934
기준금리/NNG;동결~한/VAX;가진/VV,1,0.06641205853781917,28,14,14,25,0.4878971831262993,0.42650773768665934
수출/NNG;둔화~될/VVX,1,0.06641205853781917,28,14,14,14,0.4878971831262993,0.42650773768665934
경기둔화/NNG;지속~되/VVX,1,0.06641205853781917,28,14,14,16,0.4878971831262993,0.42650773768665934
금리/NNG;상승~하/VVX;않/VX,1,0.06549135014514751,26,13,13,23,0.47976419695918554,0.42017386748299573
높/VA;수익/NNG;기대~할/VVX,1,0.06549135014514751,26,13,13,12,0.47976419695918554,0.42017386748299573
손실/NNG;커지/VV,1,0.06549135014514751,26,13,13,12,0.47976419695918554,0.42017386748299573
성장/NNG;달성~할/VVX,1,0.06549135014514751,26,13,13,14,0.47976419695918554,0.42017386748299573
금리인상/NNG;미루/VV,1,0.06549135014514751,26,13,13,24,0.47976419695918554,0.42017386748299573
기준금리동결/NNG;예상~되/VVX,1,0.06549135014514751,26,13,13,25,0.47976419695918554,0.42017386748299573
수입/NNG;감소~하/VVX,1,0.06549135014514751,26,13,13,17,0.47976419695918554,0.42017386748299573
원유/NNG;재고/NNG;증가~했/VVX,1,0.06453681038385728,24,12,12,22,0.4714764613164104,0.41370732026637796
경제/NNG;부담/NNG;작용~할/VVX,1,0.06453681038385728,24,12,12,16,0.4714764613164104,0.41370732026637796
대출/NNG;축소~하/VVX,1,0.06453681038385728,24,12,12,7,0.4714764613164104,0.41370732026637796
성장/NNG;기록~하/VVX,1,0.06453681038385728,24,12,12,17,0.4714764613164104,0.41370732026637796
금리차/NNG;확대~됐/VVX,1,0.06453681038385728,24,12,12,9,0.4714764613164104,0.41370732026637796
금리인상/NNG;마무리~되/VVX,1,0.06453681038385728,24,12,12,18,0.4714764613164104,0.41370732026637796
달러인덱스/NNG;하락~했/VVX,1,0.06453681038385728,24,12,12,22,0.4714764613164104,0.41370732026637796
달러강세/NNG;지지~했/VVX,1,0.06453681038385728,24,12,12,9,0.4714764613164104,0.41370732026637796
유동성/NNG;증가~하/VVX,1,0.06453681038385728,24,12,12,26,0.4714764613164104,0.41370732026637796
수익/NNG;내/VV,1,0.06404966048754424,226,112,114,179,0.7079360710227772,0.6218015443872056
재정지출/NNG;확대~하/VVX,1,0.06354783992006197,22,11,11,13,0.46303843392332567,0.40711032638753397
시장금리/NNG;급락~하/VVX,1,0.06354783992006197,22,11,11,9,0.46303843392332567,0.40711032638753397
경기회복/NNG;기대~하/VVX,1,0.06354783992006197,22,11,11,9,0.46303843392332567,0.40711032638753397
투자/NNG;확대~될/VVX,1,0.06354783992006197,22,11,11,24,0.46303843392332567,0.40711032638753397
채권/NNG;시장/NNG;강세/NNG;보일/VV,1,0.06354783992006197,22,11,11,20,0.46303843392332567,0.40711032638753397
국채수익률/NNG;하락~하/VVX,1,0.06354783992006197,22,11,11,12,0.46303843392332567,0.40711032638753397
채권가격/NNG;하락~했/VVX,1,0.06354783992006197,22,11,11,30,0.46303843392332567,0.40711032638753397
경제성장세/NNG;둔화~되/VVX,1,0.06354783992006197,22,11,11,18,0.46303843392332567,0.40711032638753397
수요/NNG;약화~될/VVX,1,0.06354783992006197,22,11,11,21,0.46303843392332567,0.40711032638753397
양적완화/NNG;확대~하/VVX,1,0.06354783992006197,22,11,11,29,0.46303843392332567,0.40711032638753397
주택가격/NNG;급락~하/VVX,1,0.06354783992006197,22,11,11,4,0.46303843392332567,0.40711032638753397
채권금리/NNG;급락~하/VVX,1,0.06354783992006197,22,11,11,22,0.46303843392332567,0.40711032638753397
대출/NNG;늘려/VV,1,0.06354783992006197,22,11,11,16,0.46303843392332567,0.40711032638753397
금리인상/NNG;관련~해서/VVX,1,0.06354783992006197,22,11,11,12,0.46303843392332567,0.40711032638753397
금리인상/NNG;가능성/NNG;높였/VV,1,0.0625238648477544,20,10,10,17,0.454455122941048,0.40038551710076187
회사채/NNG;금리/NNG;내렸/VV,1,0.0625238648477544,20,10,10,18,0.454455122941048,0.40038551710076187
경기회복/NNG;발목/NNG;잡/VV,1,0.0625238648477544,20,10,10,17,0.454455122941048,0.40038551710076187
경기침체/NNG;인해/VV,1,0.0625238648477544,20,10,10,16,0.454455122941048,0.40038551710076187
인플레이션위험/NNG;상존~해/VVX,1,0.0625238648477544,20,10,10,17,0.454455122941048,0.40038551710076187
침체/NNG;빠지/VV,1,0.0625238648477544,20,10,10,20,0.454455122941048,0.40038551710076187
달러화/NNG;강세/NNG;나타내/VV,1,0.0625238648477544,20,10,10,38,0.454455122941048,0.40038551710076187
경기회복/NNG;찬물/NNG;끼얹/VV,1,0.0625238648477544,20,10,10,11,0.454455122941048,0.40038551710076187
금리/NNG;하락~한/VAX;따른/VV,1,0.0625238648477544,20,10,10,8,0.454455122941048,0.40038551710076187
금리상승/NNG;영향/NNG;받/VV,1,0.0625238648477544,20,10,10,17,0.454455122941048,0.40038551710076187
수요/NNG;유지~되/VVX,1,0.0625238648477544,20,10,10,22,0.454455122941048,0.40038551710076187
경제성장/NNG;차지~하/VVX,1,0.06146433978843313,18,9,9,5,0.44573209934111574,0.39353594026709
금리/NNG;오른다면/VV,1,0.06146433978843313,18,9,9,16,0.44573209934111574,0.39353594026709
수입/NNG;늘어나/VV,1,0.06146433978843313,18,9,9,19,0.44573209934111574,0.39353594026709
금리하락/NNG;나타나/VV,1,0.06146433978843313,18,9,9,4,0.44573209934111574,0.39353594026709
모기지/NNG;금리/NNG;하락~하/VVX,1,0.06146433978843313,18,9,9,13,0.44573209934111574,0.39353594026709
높/VA;수익률/NNG;기대~할/VVX,1,0.06146433978843313,18,9,9,17,0.44573209934111574,0.39353594026709
일자리/NNG;늘/VV,1,0.06146433978843313,18,9,9,9,0.44573209934111574,0.39353594026709
경기침체/NNG;이어지/VV,1,0.06146433978843313,18,9,9,13,0.44573209934111574,0.39353594026709
변동성/NNG;축소~될/VVX,1,0.06146433978843313,18,9,9,15,0.44573209934111574,0.39353594026709
금가격/NNG;하락~했/VVX,1,0.06146433978843313,18,9,9,10,0.44573209934111574,0.39353594026709
금리인상/NNG;대응~하/VVX,1,0.06146433978843313,18,9,9,14,0.44573209934111574,0.39353594026709
금리/NNG;상승세/NNG;이어질/VV,1,0.06146433978843313,18,9,9,19,0.44573209934111574,0.39353594026709
금리인상/NNG;감안~할/VVX,1,0.06146433978843313,18,9,9,2,0.44573209934111574,0.39353594026709
금리상승/NNG;제한~됐/VVX,1,0.06146433978843313,18,9,9,20,0.44573209934111574,0.39353594026709
손실/NNG;내/VV,1,0.06146433978843313,18,9,9,13,0.44573209934111574,0.39353594026709
금가격/NNG;올랐/VV,1,0.06146433978843313,18,9,9,10,0.44573209934111574,0.39353594026709
금리인상/NNG;염두/NNG;두/VV,1,0.06146433978843313,18,9,9,4,0.44573209934111574,0.39353594026709
기준금리/NNG;인하~되/VVX;않/VX,1,0.06146433978843313,18,9,9,9,0.44573209934111574,0.39353594026709
달러강세/NNG;진행~되/VVX,1,0.06146433978843313,18,9,9,22,0.44573209934111574,0.39353594026709
시중금리/NNG;상승~할/VVX,1,0.06146433978843313,18,9,9,16,0.44573209934111574,0.39353594026709
경제/NNG;개선~될/VVX,1,0.06146433978843313,18,9,9,17,0.44573209934111574,0.39353594026709
유동성/NNG;확보~할/VVX,1,0.06146433978843313,18,9,9,11,0.44573209934111574,0.39353594026709
경기/NNG;둔화~할/VVX,1,0.06146433978843313,18,9,9,13,0.44573209934111574,0.39353594026709
침체/NNG;따른/VV,1,0.06146433978843313,18,9,9,9,0.44573209934111574,0.39353594026709
고용/NNG;늘리/VV,1,0.06146433978843313,18,9,9,16,0.44573209934111574,0.39353594026709
채권수익률/NNG;하락~하/VVX,1,0.06146433978843313,18,9,9,22,0.44573209934111574,0.39353594026709
경제지표/NNG;개선~되/VVX,1,0.06093566843482656,101,50,51,120,0.660905102159115,0.5841308795283608
금리인상/NNG;이어질/VV,1,0.06038483681126694,99,49,50,55,0.6581412458380997,0.5823311393079457
양적완화/NNG;실시~하/VVX,1,0.06036875104457873,16,8,8,27,0.4368755065254731,0.38656507468306345
성장/NNG;미치/VV,1,0.06036875104457873,16,8,8,24,0.4368755065254731,0.38656507468306345
금리/NNG;인하~할/VVX;없/VA,1,0.06036875104457873,16,8,8,7,0.4368755065254731,0.38656507468306345
기준금리/NNG;인하~했으며/VVX,1,0.06036875104457873,16,8,8,4,0.4368755065254731,0.38656507468306345
경상수지흑자/NNG;유지~하/VVX,1,0.06036875104457873,16,8,8,11,0.4368755065254731,0.38656507468306345
유가하락/NNG;힘입/VV,1,0.06036875104457873,16,8,8,6,0.4368755065254731,0.38656507468306345
성장/NNG;주도~하/VVX,1,0.06036875104457873,16,8,8,16,0.4368755065254731,0.38656507468306345
금리인상/NNG;지지~할/VVX,1,0.06036875104457873,16,8,8,15,0.4368755065254731,0.38656507468306345
베이시스/NNG;축소~될/VVX,1,0.06036875104457873,16,8,8,0,0.4368755065254731,0.38656507468306345
수요/NNG;위축~된/VVX,1,0.06036875104457873,16,8,8,5,0.4368755065254731,0.38656507468306345
금리인하/NNG;기대심리/NNG;형성~되/VVX,1,0.06036875104457873,16,8,8,6,0.4368755065254731,0.38656507468306345
기준금리인상/NNG;가능~하/VVX,1,0.06036875104457873,16,8,8,12,0.4368755065254731,0.38656507468306345
성장동력/NNG;찾/VV,1,0.06036875104457873,16,8,8,27,0.4368755065254731,0.38656507468306345
금리인상/NNG;미뤄질/VV,1,0.06036875104457873,16,8,8,30,0.4368755065254731,0.38656507468306345
국고/NNG;스프레드/NNG;축소~되/VVX,1,0.06036875104457873,16,8,8,17,0.4368755065254731,0.38656507468306345
cd/NNG;유통수익률/NNG;오른/VV,1,0.06036875104457873,16,8,8,10,0.4368755065254731,0.38656507468306345
근원/NNG;인플레이션/NNG;상승~하/VVX,1,0.06036875104457873,16,8,8,13,0.4368755065254731,0.38656507468306345
유동성/NNG;확대~되/VVX,1,0.06036875104457873,16,8,8,15,0.4368755065254731,0.38656507468306345
원/NNG;환율/NNG;급등~하/VVX,1,0.06036875104457873,16,8,8,8,0.4368755065254731,0.38656507468306345
수요부진/NNG;따른/VV,1,0.06036875104457873,16,8,8,6,0.4368755065254731,0.38656507468306345
이익/NNG;증가~했/VVX,1,0.06036875104457873,16,8,8,9,0.4368755065254731,0.38656507468306345
기준금리/NNG;내려도/VV,1,0.06036875104457873,16,8,8,8,0.4368755065254731,0.38656507468306345
양적완화/NNG;인해/VV,1,0.06036875104457873,16,8,8,21,0.4368755065254731,0.38656507468306345
금리인상/NNG;이루어지/VV,1,0.06036875104457873,16,8,8,2,0.4368755065254731,0.38656507468306345
집값/NNG;오른/VV,1,0.06036875104457873,16,8,8,5,0.4368755065254731,0.38656507468306345
위험/NNG;완화~될/VVX,1,0.06036875104457873,16,8,8,16,0.4368755065254731,0.38656507468306345
금리인하/NNG;중단~될/VVX,1,0.06036875104457873,16,8,8,2,0.4368755065254731,0.38656507468306345
유로화/NNG;상승~하/VVX,1,0.06036875104457873,16,8,8,12,0.4368755065254731,0.38656507468306345
내수부양/NNG;위해/VV,1,0.06036875104457873,16,8,8,15,0.4368755065254731,0.38656507468306345
금리/NNG;하향안정~될/VVX,1,0.06036875104457873,16,8,8,3,0.4368755065254731,0.38656507468306345
금리하락/NNG;예상~되/VVX,1,0.06036875104457873,16,8,8,1,0.4368755065254731,0.38656507468306345
경제/NNG;펀더멘털/NNG;개선~되/VVX,1,0.06036875104457873,16,8,8,4,0.4368755065254731,0.38656507468306345
변동성/NNG;확대~시키/VVX,1,0.06036875104457873,16,8,8,12,0.4368755065254731,0.38656507468306345
원달러/NNG;상승~할/VVX,1,0.06036875104457873,16,8,8,9,0.4368755065254731,0.38656507468306345
변동성/NNG;높일/VV,1,0.06036875104457873,16,8,8,11,0.4368755065254731,0.38656507468306345
경기침체/NNG;따른/VV,1,0.059809530711723236,97,48,49,38,0.6552627613792004,0.5804536182527529
금리/NNG;떨어지/VV,1,0.05930107523365136,180,89,91,115,0.7019964033269781,0.6224862912260444
기준금리/NNG;동결~될/VVX,1,0.05768430012318859,340,168,172,287,0.7044113192945274,0.6266561092621971
주택가격/NNG;하락~하/VVX,1,0.053318387394615696,79,39,40,50,0.623664047472471,0.559699111441553
기준금리/NNG;동결~할/VVX,1,0.0520935145443413,418,206,212,290,0.7009103869780527,0.6305687553799211
금리/NNG;인상~되/VVX,1,0.05079642492590586,134,66,68,128,0.6825681455223783,0.6156653518114964
금리인상/NNG;지속~할/VVX,1,0.04947757807102615,71,35,36,49,0.6059355425748532,0.5479900184430501
시장금리/NNG;급등~하/VVX,1,0.04840098693467709,69,34,35,28,0.6011113002725275,0.544800800613706
금리/NNG;동결~될/VVX,1,0.047961176001274364,124,61,63,89,0.6745731894631143,0.611919825530228
금리인상/NNG;나설/VV,1,0.04745856349517252,303,149,154,257,0.6979851147884236,0.633795022544038
성장/NNG;할/VV,1,0.04608824253524846,65,32,33,27,0.5909700412155959,0.5380963474913365
위험/NNG;있/VV,1,0.04521013136484142,285,140,145,234,0.6965519888507405,0.6353482273812568
소비자물가/NNG;상승~해/VVX,1,0.044845288419615326,63,31,32,32,0.5856467619643948,0.5345782978424207
금리인상/NNG;지속~될/VVX,1,0.0445764843673524,114,56,58,71,0.6645618072557489,0.6069385444550686
금리인상/NNG;단행~할/VVX,1,0.044433928555816626,391,192,199,294,0.6960752081549758,0.6359009536024163
금리/NNG;급등~했/VVX,1,0.042228383164991,108,53,55,72,0.6574364581293476,0.603260500258236
대출/NNG;줄이/VV,1,0.04072128109705897,57,28,29,51,0.5686290988772656,0.5233478583392089
금리하락/NNG;따른/VV,1,0.04051036062295155,104,51,53,99,0.652169068399029,0.6004888220161884
채권/NNG;시장/NNG;강세/NNG;보였/VV,1,0.03919848630743439,55,27,28,34,0.5625969431079639,0.5193767217612603
인플레이션압력/NNG;커지/VV,1,0.03759184266482696,53,26,27,37,0.5563797640229969,0.51529140024466
금리인하/NNG;할/VV,1,0.03759184266482696,53,26,27,38,0.5563797640229969,0.51529140024466
시장금리/NNG;상승~하/VVX,1,0.036145631539984624,139,68,71,115,0.6759924708082395,0.6278852655589925
소비/NNG;위축~되/VVX,1,0.035894274713720975,51,25,26,40,0.5499743343537047,0.5110922428394088
콜금리/NNG;올리/VV,1,0.035894274713720975,51,25,26,37,0.5499743343537047,0.5110922428394088
금리인상/NNG;가능성/NNG;커지/VV,1,0.035894274713720975,51,25,26,35,0.5499743343537047,0.5110922428394088
금리인상/NNG;단행~하/VVX;않/VX,1,0.034097678174158874,49,24,25,30,0.5433773050468941,0.5067800649957165
달러원/NNG;오르/VV,1,0.032192702944787266,47,23,24,49,0.5365851417849913,0.5023562311592972
이자/NNG;내/VV,1,0.03214771941580907,88,43,45,90,0.6263993698537069,0.5864939601525173
국제/NNG;유가하락/NNG;따른/VV,1,0.030168477843028896,45,22,23,38,0.5295940386953208,0.49782275517250923
시중금리/NNG;오르/VV,1,0.030168477843028896,45,22,23,30,0.5295940386953208,0.49782275517250923
달러약세/NNG;지속~되/VVX,1,0.030168477843028896,45,22,23,28,0.5295940386953208,0.49782275517250923
장단기금리차/NNG;축소~되/VVX,1,0.02825569339934031,82,40,42,63,0.6145545503770318,0.579900637021591
침체/NNG;벗어나/VV,1,0.028012257985752687,43,21,22,35,0.522399801207133,0.49318242367355486
유가/NNG;급등~하/VVX,1,0.028012257985752687,43,21,22,21,0.522399801207133,0.49318242367355486
달러강세/NNG;이끌/VV,1,0.028012257985752687,43,21,22,23,0.522399801207133,0.49318242367355486
금리/NNG;떨어져/VV,1,0.025708968208725036,41,20,21,35,0.5149976867609017,0.4884389495845416
유가하락/NNG;따른/VV,1,0.024632576281623297,113,55,58,94,0.6513994264751167,0.6191375594387916
경기/NNG;둔화~되/VVX,1,0.024590709316881565,185,90,95,107,0.6806038957262881,0.6469497763740267
경제지표/NNG;부진~하/VVX,1,0.02384299863811279,76,37,39,75,0.6013720780314616,0.5724910445796251
불확실성/NNG;증대~되/VVX,1,0.023240604921256347,39,19,20,31,0.5073821872581394,0.4835971654984752
물가상승/NNG;억제~하/VVX,1,0.023240604921256347,39,19,20,30,0.5073821872581394,0.4835971654984752
금리인상/NNG;멈출/VV,1,0.023240604921256347,39,19,20,26,0.5073821872581394,0.4835971654984752
위험/NNG;부각~되/VVX,1,0.023240604921256347,39,19,20,24,0.5073821872581394,0.4835971654984752
완화/NNG;따른/VV,1,0.022240617755912462,74,36,38,64,0.596663627330925,0.5698314392059304
금리/NNG;올려/VV,1,0.020726349469234684,140,68,72,127,0.6666788492743783,0.6386285345412331
인플레이션/NNG;상승~하/VVX,1,0.020585442379126073,37,18,19,38,0.499546729878388,0.47866327072633846
금리/NNG;하락~함/VVX,1,0.020585442379126073,37,18,19,29,0.499546729878388,0.47866327072633846
경기부양/NNG;나서/VV,1,0.018814141851434263,70,34,36,49,0.5867527865287578,0.5642180832310651
기준금리/NNG;내려야/VV,1,0.017716964395816603,35,17,18,26,0.49148326171820267,0.473645151596566
금리/NNG;하락세/NNG;보였/VV,1,0.017716964395816603,35,17,18,35,0.49148326171820267,0.473645151596566
경제지표/NNG;호조/NNG;보인/VV,1,0.017716964395816603,35,17,18,35,0.49148326171820267,0.473645151596566
양적완화/NNG;통해/VV,1,0.016980487150752843,68,33,35,59,0.5815426905823843,0.5612615907504818
물가/NNG;잡/VV,1,0.015442393252429465,192,93,99,143,0.6753486897465593,0.6538031272623833
금리상승/NNG;제한~되/VVX,1,0.015059360658339793,66,32,34,60,0.5761575422633329,0.5582036619096606
성장/NNG;보일/VV,1,0.014602403728711355,33,16,17,21,0.48318166613402647,0.46855280335229926
금리인상/NNG;그칠/VV,1,0.014602403728711355,33,16,17,28,0.48318166613402647,0.46855280335229926
미국채수익률/NNG;하락~하/VVX,1,0.01120070967966913,31,15,16,18,0.4746289303447734,0.4633988953764001
성장/NNG;달성~하/VVX,1,0.01120070967966913,31,15,16,20,0.4746289303447734,0.4633988953764001
양적완화/NNG;종료~하/VVX,1,0.01120070967966913,31,15,16,40,0.4746289303447734,0.4633988953764001
호황/NNG;누리/VV,1,0.01120070967966913,31,15,16,25,0.4746289303447734,0.4633988953764001
채권/NNG;시장/NNG;약세/NNG;보임/VV,1,0.01120070967966913,31,15,16,35,0.4746289303447734,0.4633988953764001
대출/NNG;억제~하/VVX,1,0.01120070967966913,31,15,16,23,0.4746289303447734,0.4633988953764001
경기/NNG;부양~할/VVX,1,0.01120070967966913,31,15,16,29,0.4746289303447734,0.4633988953764001
콜금리/NNG;동결~되/VVX,1,0.01120070967966913,31,15,16,8,0.4746289303447734,0.4633988953764001
국고채/NNG;금리/NNG;하락~했/VVX,1,0.011046545221911952,122,59,63,82,0.6500806460669561,0.6348948933364292
달러화/NNG;상승~하/VVX,1,0.008706331801908496,60,29,31,51,0.5589103067096952,0.5484131841318024
지급준비금적수/NNG;줄어든다/VV,1,0.008706331801908496,60,29,31,68,0.5589103067096952,0.5484131841318024
채권/NNG;시장/NNG;부담/NNG;작용~할/VVX,1,0.007459663671015804,29,14,15,21,0.46580793693292977,0.4581995423595443
유가/NNG;넘어서/VV,1,0.007459663671015804,29,14,15,20,0.46580793693292977,0.4581995423595443
금리인하/NNG;가능성/NNG;있/VV,1,0.007459663671015804,29,14,15,25,0.46580793693292977,0.4581995423595443
달러엔/NNG;하락~하/VVX,1,0.007459663671015804,29,14,15,13,0.46580793693292977,0.4581995423595443
위험/NNG;노출~되/VVX,1,0.007459663671015804,29,14,15,45,0.46580793693292977,0.4581995423595443
인플레이션/NNG;우려/NNG;제기~되/VVX,1,0.007459663671015804,29,14,15,15,0.46580793693292977,0.4581995423595443
금리인상/NNG;반영~하/VVX,1,0.007459663671015804,29,14,15,20,0.46580793693292977,0.4581995423595443
매수/NNG;심리/NNG;위축~시켰/VVX,1,0.007459663671015804,29,14,15,22,0.46580793693292977,0.4581995423595443
수요/NNG;늘어났/VV,1,0.007459663671015804,29,14,15,37,0.46580793693292977,0.4581995423595443
유가/NNG;반등~하/VVX,1,0.007459663671015804,29,14,15,24,0.46580793693292977,0.4581995423595443
금리/NNG;하락~해/VVX,1,0.006366551947080357,58,28,30,55,0.5527826644473968,0.5449427615439948
금융시장/NNG;안정~되/VVX,1,0.004767157259347732,85,41,44,56,0.6055517001789782,0.5988744461653582
위험/NNG;노출~돼/VVX,1,0.003311692970089597,27,13,14,16,0.45669567177481224,0.45297537734714005
경기후퇴/NNG;막/VV,1,0.003311692970089597,27,13,14,12,0.45669567177481224,0.45297537734714005
소비/NNG;줄어들/VV,1,0.003311692970089597,27,13,14,18,0.45669567177481224,0.45297537734714005
금리인상/NNG;결정~할/VVX,1,0.003311692970089597,27,13,14,24,0.45669567177481224,0.45297537734714005
제로금리/NNG;유지~할/VVX,1,0.003311692970089597,27,13,14,20,0.45669567177481224,0.45297537734714005
수익/NNG;줄어들/VV,1,0.003311692970089597,27,13,14,20,0.45669567177481224,0.45297537734714005
국채가격/NNG;떨어진/VV,1,0.003311692970089597,27,13,14,9,0.45669567177481224,0.45297537734714005
소득/NNG;줄어들/VV,1,0.003311692970089597,27,13,14,11,0.45669567177481224,0.45297537734714005
물가안정/NNG;강조~하/VVX,1,0.003311692970089597,27,13,14,11,0.45669567177481224,0.45297537734714005
금리인하/NNG;단행~하/VVX,1,0.0019296904723542507,135,65,70,74,0.652155647703415,0.6486319481198988
투자심리/NNG;위축~될/VVX,1,0.0012971102863215123,54,26,28,30,0.5399306934957087,0.5376926213728627
기대심리/NNG;커졌/VV,1,0.0012971102863215123,54,26,28,45,0.5399306934957087,0.5376926213728627
국제/NNG;유가/NNG;상승~하/VVX,1,0.0012971102863215123,54,26,28,51,0.5399306934957087,0.5376926213728627
기준금리/NNG;동결~함/VVX,-1,-0.0013323624478503993,25,12,13,33,0.44726049938086304,0.44775307706966777
안전자산선호/NNG;강해/VV,-1,-0.0013323624478503993,25,12,13,20,0.44726049938086304,0.44775307706966777
재정/NNG;집행~하/VVX,-1,-0.0013323624478503993,25,12,13,13,0.44726049938086304,0.44775307706966777
달러원/NNG;하락~했/VVX,-1,-0.0013323624478503993,25,12,13,19,0.44726049938086304,0.44775307706966777
자산가격/NNG;상승~하/VVX,-1,-0.0013323624478503993,25,12,13,15,0.44726049938086304,0.44775307706966777
국고채/NNG;수익률/NNG;내린/VV,-1,-0.0013323624478503993,25,12,13,16,0.44726049938086304,0.44775307706966777
금리/NNG;동결~해/VVX,-1,-0.0013323624478503993,25,12,13,14,0.44726049938086304,0.44775307706966777
금리/NNG;낮춘/VV,-1,-0.004373739539700772,50,24,26,38,0.5262461427598357,0.5300372770547862
투자/NNG;확대~하/VVX,-1,-0.0053200990532021875,100,48,52,93,0.6195462552473731,0.6251907313781594
성장/NNG;하/VV,-1,-0.0053200990532021875,100,48,52,60,0.6195462552473731,0.6251907313781594
인플레이션/NNG;우려/NNG;부각~되/VVX,-1,-0.006592808972373687,23,11,12,5,0.43745789656827605,0.4425675814107359
금리/NNG;하락세/NNG;이어질/VV,-1,-0.006592808972373687,23,11,12,35,0.43745789656827605,0.4425675814107359
국제금융시장/NNG;안정~되/VVX,-1,-0.006592808972373687,23,11,12,6,0.43745789656827605,0.4425675814107359
이익/NNG;증가~하/VVX,-1,-0.006592808972373687,23,11,12,24,0.43745789656827605,0.4425675814107359
금리/NNG;올린다는/VV,-1,-0.006592808972373687,23,11,12,20,0.43745789656827605,0.4425675814107359
낮/VA;금리/NNG;받/VV,-1,-0.006592808972373687,23,11,12,33,0.43745789656827605,0.4425675814107359
연방기금/NNG;금리/NNG;인상~될/VVX,-1,-0.006592808972373687,23,11,12,12,0.43745789656827605,0.4425675814107359
경제성장률/NNG;전망/NNG;하향조정~하/VVX,-1,-0.006592808972373687,23,11,12,24,0.43745789656827605,0.4425675814107359
금리/NNG;끌어올렸/VV,-1,-0.006592808972373687,23,11,12,9,0.43745789656827605,0.4425675814107359
경기/NNG;부양책/NNG;힘입/VV,-1,-0.006592808972373687,23,11,12,25,0.43745789656827605,0.4425675814107359
경기/NNG;부양책/NNG;따른/VV,-1,-0.006592808972373687,23,11,12,23,0.43745789656827605,0.4425675814107359
기대심리/NNG;강세/NNG;보였/VV,-1,-0.006592808972373687,23,11,12,7,0.43745789656827605,0.4425675814107359
유가/NNG;상승~할/VVX,-1,-0.006592808972373687,23,11,12,22,0.43745789656827605,0.4425675814107359
실적개선/NNG;기대~되/VVX,-1,-0.006592808972373687,23,11,12,28,0.43745789656827605,0.4425675814107359
채권금리/NNG;상승압력/NNG;받/VV,-1,-0.006592808972373687,23,11,12,23,0.43745789656827605,0.4425675814107359
경쟁력/NNG;확보~할/VVX,-1,-0.006592808972373687,23,11,12,12,0.43745789656827605,0.4425675814107359
달러강세/NNG;이어질/VV,-1,-0.00747246385398892,48,23,25,42,0.5190756142705086,0.526062563934542
금리/NNG;올랐/VV,-1,-0.008278860632451868,307,147,160,233,0.6616505069451117,0.6716380345104536
국고채/NNG;금리/NNG;내렸/VV,-1,-0.010771880310870618,46,22,24,30,0.5116760557445699,0.5219939205000165
금리인하/NNG;배경/NNG;설명~했/VVX,-1,-0.012636273977642776,21,10,11,3,0.4272235357275102,0.43746540695888025
침체/NNG;이어질/VV,-1,-0.012636273977642776,21,10,11,13,0.4272235357275102,0.43746540695888025
수요/NNG;증가~해/VVX,-1,-0.012636273977642776,21,10,11,14,0.4272235357275102,0.43746540695888025
채권스왑/NNG;스프레드/NNG;확대~되/VVX,-1,-0.012636273977642776,21,10,11,8,0.4272235357275102,0.43746540695888025
물가상승/NNG;막/VV,-1,-0.012636273977642776,21,10,11,13,0.4272235357275102,0.43746540695888025
원달러/NNG;급등~하/VVX,-1,-0.012636273977642776,21,10,11,17,0.4272235357275102,0.43746540695888025
투자/NNG;줄어들/VV,-1,-0.012636273977642776,21,10,11,16,0.4272235357275102,0.43746540695888025
외환시장/NNG;현물환/NNG;하락~했/VVX,-1,-0.012636273977642776,21,10,11,25,0.4272235357275102,0.43746540695888025
달러화/NNG;레벨/NNG;높일/VV,-1,-0.012636273977642776,21,10,11,18,0.4272235357275102,0.43746540695888025
금리인상/NNG;기대~하/VVX,-1,-0.012636273977642776,21,10,11,21,0.4272235357275102,0.43746540695888025
위험/NNG;완화~하/VVX,-1,-0.012636273977642776,21,10,11,11,0.4272235357275102,0.43746540695888025
성장/NNG;예상~된다/VVX,-1,-0.012636273977642776,21,10,11,14,0.4272235357275102,0.43746540695888025
달러화/NNG;약세/NNG;돌아서/VV,-1,-0.012636273977642776,21,10,11,5,0.4272235357275102,0.43746540695888025
국고채/NNG;금리/NNG;올랐으며/VV,-1,-0.012636273977642776,21,10,11,8,0.4272235357275102,0.43746540695888025
엔화/NNG;강세/NNG;보일/VV,-1,-0.012636273977642776,21,10,11,21,0.4272235357275102,0.43746540695888025
국고채/NNG;금리/NNG;떨어지/VV,-1,-0.012636273977642776,21,10,11,18,0.4272235357275102,0.43746540695888025
달러화/NNG;약세/NNG;보인/VV,-1,-0.012636273977642776,21,10,11,26,0.4272235357275102,0.43746540695888025
원화/NNG;강세/NNG;보일/VV,-1,-0.012636273977642776,21,10,11,22,0.4272235357275102,0.43746540695888025
유가/NNG;급등~했/VVX,-1,-0.012636273977642776,21,10,11,6,0.4272235357275102,0.43746540695888025
금리/NNG;상승~하/VVX,-1,-0.012802678769856746,630,301,329,486,0.6586119427626432,0.6746252344711848
엔화/NNG;상승~했/VVX,-1,-0.014295008745319082,44,21,23,36,0.5040383567994355,0.517835581024174
cd금리/NNG;상승~하/VVX,-1,-0.015183797127456877,67,32,35,32,0.5611611353155724,0.5775470444755798
금리/NNG;올릴/VV,-1,-0.015786716625778352,851,406,445,678,0.6565980120861702,0.676585517029948
원자재/NNG;가격상승/NNG;따른/VV,-1,-0.018069160732255285,42,20,22,36,0.49615180230849437,0.5135929203350116
기준금리/NNG;동결~했/VVX,-1,-0.018083184593086665,256,122,134,256,0.6549585579366587,0.6780011813108868
수요/NNG;줄이/VV,-1,-0.01970080084792325,19,9,10,19,0.41646159769987834,0.43250973670472254
유로달러/NNG;상승~한/VAX;거래~됐/VVX,-1,-0.01970080084792325,19,9,10,16,0.41646159769987834,0.43250973670472254
경기회복세/NNG;지원~하/VVX,-1,-0.01970080084792325,19,9,10,16,0.41646159769987834,0.43250973670472254
금리/NNG;상승세/NNG;지속~될/VVX,-1,-0.01970080084792325,19,9,10,19,0.41646159769987834,0.43250973670472254
금리인하/NNG;기정사실화~하/VVX,-1,-0.01970080084792325,19,9,10,17,0.41646159769987834,0.43250973670472254
성장/NNG;힘입/VV,-1,-0.01970080084792325,19,9,10,14,0.41646159769987834,0.43250973670472254
금리상승/NNG;커지/VV,-1,-0.01970080084792325,19,9,10,10,0.41646159769987834,0.43250973670472254
경기회복세/NNG;따른/VV,-1,-0.01970080084792325,19,9,10,14,0.41646159769987834,0.43250973670472254
금리인상/NNG;고려~하/VVX,-1,-0.01970080084792325,19,9,10,18,0.41646159769987834,0.43250973670472254
금리인상기대/NNG;따른/VV,-1,-0.01970080084792325,19,9,10,12,0.41646159769987834,0.43250973670472254
경제/NNG;성장세/NNG;이/VV,-1,-0.01970080084792325,19,9,10,12,0.41646159769987834,0.43250973670472254
달러원/NNG;상승/NNG;따른/VV,-1,-0.01970080084792325,19,9,10,12,0.41646159769987834,0.43250973670472254
성장잠재력/NNG;높이/VV,-1,-0.01970080084792325,19,9,10,19,0.41646159769987834,0.43250973670472254
성장세/NNG;확대~되/VVX,-1,-0.01970080084792325,19,9,10,20,0.41646159769987834,0.43250973670472254
금리하락/NNG;요인/NNG;작용~하/VVX,-1,-0.01970080084792325,19,9,10,14,0.41646159769987834,0.43250973670472254
실적/NNG;올리/VV,-1,-0.01970080084792325,19,9,10,11,0.41646159769987834,0.43250973670472254
임금/NNG;상승~하/VVX,-1,-0.01970080084792325,19,9,10,23,0.41646159769987834,0.43250973670472254
환율변동성/NNG;확대~되/VVX,-1,-0.01970080084792325,19,9,10,13,0.41646159769987834,0.43250973670472254
경제회복/NNG;위한/VV,-1,-0.01970080084792325,19,9,10,13,0.41646159769987834,0.43250973670472254
경기/NNG;호전~될/VVX,-1,-0.01970080084792325,19,9,10,27,0.41646159769987834,0.43250973670472254
경기회복세/NNG;나타나/VV,-1,-0.01970080084792325,19,9,10,15,0.41646159769987834,0.43250973670472254
변동성/NNG;줄여/VV,-1,-0.01970080084792325,19,9,10,27,0.41646159769987834,0.43250973670472254
금리인하/NNG;기대/NNG;선반영~하/VVX,-1,-0.01970080084792325,19,9,10,27,0.41646159769987834,0.43250973670472254
연방기금/NNG;금리선물/NNG;오/VV,-1,-0.020057258614332274,107,51,56,30,0.6176627355886657,0.6419213063617871
금리/NNG;올렸/VV,-1,-0.020937044682096118,208,99,109,145,0.6521323956185109,0.6789377841138156
투자심리/NNG;악화~되/VVX,-1,-0.022127043001240243,40,19,21,14,0.48800356719423504,0.5092726779674922
금리인상/NNG;늦추/VV,-1,-0.022127043001240243,40,19,21,44,0.48800356719423504,0.5092726779674922
원자재/NNG;가격/NNG;하락~하/VVX,-1,-0.022127043001240243,40,19,21,31,0.48800356719423504,0.5092726779674922
미국채금리/NNG;상승~하/VVX,-1,-0.022127043001240243,40,19,21,78,0.48800356719423504,0.5092726779674922
경기/NNG;위축~될/VVX,-1,-0.022127043001240243,40,19,21,17,0.48800356719423504,0.5092726779674922
금리/NNG;국고/NNG;지표물/NNG;상승~한/VAX;거래/NNG;시작~했/VVX,-1,-0.023849838678410507,61,29,32,75,0.5431177391904173,0.5687445172186609
수요/NNG;늘어나/VV,-1,-0.02549341802984817,219,104,115,158,0.6494263611864288,0.6823077940052972
경제/NNG;둔화~하/VVX,-1,-0.026508223753912374,38,18,20,26,0.47957803121168646,0.5048832374263684
채권/NNG;시장/NNG;국채선물/NNG;오른/VV,-1,-0.026508223753912374,38,18,20,38,0.47957803121168646,0.5048832374263684
금리인하/NNG;예상~하/VVX,-1,-0.026508223753912374,38,18,20,28,0.47957803121168646,0.5048832374263684
금리인상/NNG;서두르/VV;않/VX,-1,-0.026508223753912374,38,18,20,54,0.47957803121168646,0.5048832374263684
유가/NNG;오르/VV,-1,-0.026911752627663876,80,38,42,43,0.5784878207661818,0.6095036724178061
기준금리/NNG;올리/VV,-1,-0.026982527249151844,392,186,206,331,0.6489920461408523,0.6838847891579736
높/VA;수익/NNG;낼/VV,-1,-0.028139447486056235,17,8,9,15,0.4050240186050891,0.4277884887270049
유로화/NNG;낙폭/NNG;확대~했/VVX,-1,-0.028139447486056235,17,8,9,3,0.4050240186050891,0.4277884887270049
양적완화/NNG;펴/VV,-1,-0.028139447486056235,17,8,9,16,0.4050240186050891,0.4277884887270049
국고채/NNG;지표금리/NNG;하락~한/VAX;내린/VV,-1,-0.028139447486056235,17,8,9,15,0.4050240186050891,0.4277884887270049
완화/NNG;될/VV,-1,-0.028139447486056235,17,8,9,6,0.4050240186050891,0.4277884887270049
기준금리인하/NNG;단행~하/VVX,-1,-0.028139447486056235,17,8,9,20,0.4050240186050891,0.4277884887270049
지급준비율/NNG;인상/NNG;이/VV,-1,-0.028139447486056235,17,8,9,4,0.4050240186050891,0.4277884887270049
기준금리/NNG;인하~해도/VVX,-1,-0.028139447486056235,17,8,9,8,0.4050240186050891,0.4277884887270049
금리인상/NNG;나선/VV,-1,-0.028139447486056235,17,8,9,10,0.4050240186050891,0.4277884887270049
채권/NNG;시장/NNG;안정/NNG;되찾/VV,-1,-0.028139447486056235,17,8,9,4,0.4050240186050891,0.4277884887270049
장기물/NNG;하락~하/VVX,-1,-0.028139447486056235,17,8,9,25,0.4050240186050891,0.4277884887270049
단기물/NNG;강세/NNG;보이/VV,-1,-0.028139447486056235,17,8,9,8,0.4050240186050891,0.4277884887270049
금리/NNG;하락~한/VAX;마쳤/VV,-1,-0.028139447486056235,17,8,9,11,0.4050240186050891,0.4277884887270049
달러화/NNG;상승폭/NNG;확대~했/VVX,-1,-0.028139447486056235,17,8,9,8,0.4050240186050891,0.4277884887270049
자산매입/NNG;축소~하/VVX,-1,-0.028139447486056235,17,8,9,17,0.4050240186050891,0.4277884887270049
신용등급/NNG;하락~하/VVX,-1,-0.028139447486056235,17,8,9,36,0.4050240186050891,0.4277884887270049
인플레이션/NNG;밑돌/VV,-1,-0.028139447486056235,17,8,9,11,0.4050240186050891,0.4277884887270049
경기지표/NNG;부진~하/VVX,-1,-0.028139447486056235,17,8,9,16,0.4050240186050891,0.4277884887270049
금리인상/NNG;단행~하/VVX;어려울/VA,-1,-0.028139447486056235,17,8,9,9,0.4050240186050891,0.4277884887270049
경기/NNG;위축~시킬/VVX,-1,-0.028139447486056235,17,8,9,3,0.4050240186050891,0.4277884887270049
금리상승/NNG;대비~하/VVX,-1,-0.028139447486056235,17,8,9,18,0.4050240186050891,0.4277884887270049
금리인상/NNG;속도/NNG;빨라질/VA;있/VV,-1,-0.028139447486056235,17,8,9,25,0.4050240186050891,0.4277884887270049
금리인상/NNG;고려~해야/VVX,-1,-0.028139447486056235,17,8,9,6,0.4050240186050891,0.4277884887270049
모기지/NNG;금리/NNG;상승~했/VVX,-1,-0.028139447486056235,17,8,9,8,0.4050240186050891,0.4277884887270049
순이익/NNG;증가~했/VVX,-1,-0.030398518523991114,57,27,30,54,0.530062486884876,0.5623898797580181
국고채/NNG;금리/NNG;떨어졌/VV,-1,-0.030398518523991114,57,27,30,29,0.530062486884876,0.5623898797580181
달러원/NNG;하락~하/VVX,-1,-0.030683936594456007,97,46,51,88,0.6001368328979397,0.637101498668513
매수/NNG;심리/NNG;위축~된/VVX,-1,-0.031261110275530024,36,17,19,36,0.47085583780870166,0.500434977568368
금리/NNG;끌어올릴/VV,-1,-0.031261110275530024,36,17,19,20,0.47085583780870166,0.500434977568368
경제성장/NNG;이끌/VV,-1,-0.031261110275530024,36,17,19,21,0.47085583780870166,0.500434977568368
유가상승/NNG;인한/VV,-1,-0.031261110275530024,36,17,19,19,0.47085583780870166,0.500434977568368
금리/NNG;인상~될/VVX,-1,-0.032228456565036034,262,124,138,195,0.6453406330163923,0.6872092841162107
금리/NNG;오르/VV,-1,-0.03282946074515525,670,317,353,586,0.6449893052885175,0.6876613635962644
금리/NNG;인하~해야/VVX,-1,-0.033945120296804965,55,26,29,33,0.5232065383312207,0.5590678525382586
경제/NNG;둔화~되/VVX,-1,-0.03510905370598871,112,53,59,42,0.6125441738678894,0.6560546731396186
국채가격/NNG;상승~했/VVX,-1,-0.03548318326439681,93,44,49,39,0.5921839134716653,0.6347230912103642
유로화/NNG;약세/NNG;보이/VV,-1,-0.036445660449748396,34,16,18,31,0.4618125826016763,0.49594071926865047
달러약세/NNG;인한/VV,-1,-0.036445660449748396,34,16,18,21,0.4618125826016763,0.49594071926865047
채권가격/NNG;상승~했/VVX,-1,-0.036445660449748396,34,16,18,29,0.4618125826016763,0.49594071926865047
물가/NNG;오르/VV;않/VX,-1,-0.036445660449748396,34,16,18,25,0.4618125826016763,0.49594071926865047
고용지표/NNG;개선~되/VVX,-1,-0.036445660449748396,34,16,18,40,0.4618125826016763,0.49594071926865047
달러원/NNG;상승~할/VVX,-1,-0.036445660449748396,34,16,18,38,0.4618125826016763,0.49594071926865047
기준금리/NNG;낮춘/VV,-1,-0.036445660449748396,34,16,18,24,0.4618125826016763,0.49594071926865047
불확실성/NNG;해소~될/VVX,-1,-0.0376959866052754,53,25,28,35,0.5161209707458175,0.5556509073587108
경제/NNG;둔화~될/VVX,-1,-0.0376959866052754,53,25,28,34,0.5161209707458175,0.5556509073587108
엔화/NNG;강세/NNG;보였/VV,-1,-0.0376959866052754,53,25,28,28,0.5161209707458175,0.5556509073587108
경기침체/NNG;막/VV,-1,-0.03801614563717726,91,43,48,45,0.5879893621898916,0.633429406381566
금리인상/NNG;지연~될/VVX,-1,-0.038244499817775335,72,34,38,88,0.5575906750639783,0.6009560429072641
경기하강/NNG;따른/VV,-1,-0.03850076879369457,15,7,8,5,0.39267133932786397,0.423427561818873
유로달러/NNG;하락~하/VVX,-1,-0.03850076879369457,15,7,8,8,0.39267133932786397,0.423427561818873
기대심리/NNG;높인/VV,-1,-0.03850076879369457,15,7,8,10,0.39267133932786397,0.423427561818873
금리동결/NNG;이/VV,-1,-0.03850076879369457,15,7,8,15,0.39267133932786397,0.423427561818873
경제/NNG;부정적/NNG;영향/NNG;줄/VV,-1,-0.03850076879369457,15,7,8,20,0.39267133932786397,0.423427561818873
건전성/NNG;유지~하/VVX,-1,-0.03850076879369457,15,7,8,10,0.39267133932786397,0.423427561818873
신용스프레드/NNG;줄어들/VV,-1,-0.03850076879369457,15,7,8,12,0.39267133932786397,0.423427561818873
조달비용/NNG;낮추/VV,-1,-0.03850076879369457,15,7,8,7,0.39267133932786397,0.423427561818873
국채선물/NNG;하락~한/VAX;거래~되/VVX,-1,-0.03850076879369457,15,7,8,13,0.39267133932786397,0.423427561818873
인플레이션/NNG;안정~될/VVX,-1,-0.03850076879369457,15,7,8,8,0.39267133932786397,0.423427561818873
금리/NNG;급등세/NNG;진정~될/VVX,-1,-0.03850076879369457,15,7,8,6,0.39267133932786397,0.423427561818873
달러원/NNG;하락압력/NNG;받/VV,-1,-0.03850076879369457,15,7,8,29,0.39267133932786397,0.423427561818873
유로엔/NNG;오른/VV,-1,-0.03850076879369457,15,7,8,4,0.39267133932786397,0.423427561818873
기준금리/NNG;인상~한다면/VVX,-1,-0.03850076879369457,15,7,8,19,0.39267133932786397,0.423427561818873
수출/NNG;증가~할/VVX,-1,-0.03850076879369457,15,7,8,12,0.39267133932786397,0.423427561818873
인플레이션/NNG;완화~하/VVX,-1,-0.03850076879369457,15,7,8,9,0.39267133932786397,0.423427561818873
금리/NNG;떨어뜨릴/VV,-1,-0.03850076879369457,15,7,8,5,0.39267133932786397,0.423427561818873
금리인상/NNG;검토~하/VVX,-1,-0.03850076879369457,15,7,8,11,0.39267133932786397,0.423427561818873
경기/NNG;반등~할/VVX,-1,-0.03850076879369457,15,7,8,10,0.39267133932786397,0.423427561818873
물가상승률/NNG;둔화~될/VVX,-1,-0.03850076879369457,15,7,8,2,0.39267133932786397,0.423427561818873
위험/NNG;감안~하/VVX,-1,-0.03850076879369457,15,7,8,10,0.39267133932786397,0.423427561818873
유동성함정/NNG;빠질/VV,-1,-0.03850076879369457,15,7,8,3,0.39267133932786397,0.423427561818873
경기/NNG;반등~하/VVX,-1,-0.03850076879369457,15,7,8,24,0.39267133932786397,0.423427561818873
달러원/NNG;상승~한/VAX;거래~되/VVX,-1,-0.03850076879369457,15,7,8,5,0.39267133932786397,0.423427561818873
경기과열/NNG;억제~하/VVX,-1,-0.03850076879369457,15,7,8,13,0.39267133932786397,0.423427561818873
통화완화/NNG;이/VV,-1,-0.03850076879369457,15,7,8,18,0.39267133932786397,0.423427561818873
물가상승률/NNG;상승~할/VVX,-1,-0.03850076879369457,15,7,8,6,0.39267133932786397,0.423427561818873
금리인하/NNG;기대/NNG;따른/VV,-1,-0.03850076879369457,15,7,8,11,0.39267133932786397,0.423427561818873
마이너스성장/NNG;할/VV,-1,-0.03850076879369457,15,7,8,1,0.39267133932786397,0.423427561818873
위험/NNG;부담~하/VVX,-1,-0.03850076879369457,15,7,8,11,0.39267133932786397,0.423427561818873
물가상승/NNG;인한/VV,-1,-0.03850076879369457,15,7,8,16,0.39267133932786397,0.423427561818873
매수/NNG;심리/NNG;위축~될/VVX,-1,-0.03850076879369457,15,7,8,16,0.39267133932786397,0.423427561818873
재무/NNG;안정성/NNG;개선~되/VVX,-1,-0.03850076879369457,15,7,8,6,0.39267133932786397,0.423427561818873
금리인하/NNG;효과/NNG;나타나/VV,-1,-0.03850076879369457,15,7,8,2,0.39267133932786397,0.423427561818873
금리인하/NNG;단행~했으나/VVX,-1,-0.03850076879369457,15,7,8,5,0.39267133932786397,0.423427561818873
채산성/NNG;악화~되/VVX,-1,-0.03850076879369457,15,7,8,5,0.39267133932786397,0.423427561818873
경쟁력/NNG;유지~하/VVX,-1,-0.03850076879369457,15,7,8,7,0.39267133932786397,0.423427561818873
지급준비율/NNG;인하~할/VVX,-1,-0.03850076879369457,15,7,8,14,0.39267133932786397,0.423427561818873
물가상승률/NNG;고려~할/VVX,-1,-0.03850076879369457,15,7,8,11,0.39267133932786397,0.423427561818873
경제성장률/NNG;전망/NNG;하향조정~했/VVX,-1,-0.03850076879369457,15,7,8,17,0.39267133932786397,0.423427561818873
지표금리/NNG;국고채/NNG;수익률/NNG;오른/VV,-1,-0.03850076879369457,15,7,8,7,0.39267133932786397,0.423427561818873
장단기금리차/NNG;축소~된/VVX,-1,-0.03850076879369457,15,7,8,5,0.39267133932786397,0.423427561818873
경제/NNG;회복세/NNG;나타내/VV,-1,-0.03850076879369457,15,7,8,15,0.39267133932786397,0.423427561818873
금리인상/NNG;뒷받침~하/VVX,-1,-0.03850076879369457,15,7,8,8,0.39267133932786397,0.423427561818873
외국인/NNG;자금/NNG;빠져/VV,-1,-0.03850076879369457,15,7,8,8,0.39267133932786397,0.423427561818873
경제/NNG;과열~되/VVX,-1,-0.03850076879369457,15,7,8,13,0.39267133932786397,0.423427561818873
건전성/NNG;높이/VV,-1,-0.03850076879369457,15,7,8,17,0.39267133932786397,0.423427561818873
기준금리/NNG;인상~하/VVX;않/VX,-1,-0.04064415290069656,89,42,47,55,0.5836437192162867,0.6320634222588098
경제/NNG;성장~하/VVX,-1,-0.04064415290069656,89,42,47,71,0.5836437192162867,0.6320634222588098
금리/NNG;급등~할/VVX,-1,-0.041671445996770196,51,24,27,44,0.5087964792839954,0.5521409051161302
경제/NNG;발목/NNG;잡/VV,-1,-0.041671445996770196,51,24,27,39,0.5087964792839954,0.5521409051161302
경기/NNG;회복~하/VVX,-1,-0.04213716987173288,32,15,17,28,0.4524169550587415,0.49141629915228163
원화/NNG;강세/NNG;지속~될/VVX,-1,-0.04213716987173288,32,15,17,29,0.4524169550587415,0.49141629915228163
경쟁력/NNG;높이/VV,-1,-0.04589510261383378,49,23,26,50,0.5012224452141685,0.5485403701847799
국고채/NNG;지표금리/NNG;내린/VV,-1,-0.04589510261383378,49,23,26,66,0.5012224452141685,0.5485403701847799
금리변동성/NNG;확대~될/VVX,-1,-0.048431672707757056,30,14,16,26,0.4426280548263363,0.486881314242619
금리/NNG;낮/VA;수준/NNG;유지~하/VVX,-1,-0.048431672707757056,30,14,16,19,0.4426280548263363,0.486881314242619
투자심리/NNG;개선~됐/VVX,-1,-0.048431672707757056,30,14,16,36,0.4426280548263363,0.486881314242619
성장/NNG;위해서/VV,-1,-0.048431672707757056,30,14,16,36,0.4426280548263363,0.486881314242619
통화정책/NNG;완화~할/VVX,-1,-0.048431672707757056,30,14,16,22,0.4426280548263363,0.486881314242619
위험/NNG;상존~하/VVX,-1,-0.048431672707757056,30,14,16,24,0.4426280548263363,0.486881314242619
금리/NNG;인상~하/VVX,-1,-0.048583086540704645,639,300,339,466,0.6341043144335567,0.697712624765246
지급준비율/NNG;인상~하/VVX,-1,-0.049151240796268425,83,39,44,62,0.569655141575069,0.6275121004439426
금리/NNG;인상~하/VVX;않/VX,-1,-0.051122221066665086,147,69,78,84,0.6219677896184655,0.6878482722798391
유로화/NNG;엔화/NNG;하락~했/VVX,-1,-0.05520240082931038,45,21,24,26,0.48527449408295736,0.5410817820799986
금리인하/NNG;가능성/NNG;배제~할/VVX;없/VA,-1,-0.05545382879701122,28,13,15,20,0.43239143076165953,0.4823600982054601
유동성/NNG;축소~되/VVX,-1,-0.05545382879701122,28,13,15,15,0.43239143076165953,0.4823600982054601
인플레이션기대/NNG;심리/NNG;낮추/VV,-1,-0.05545382879701122,28,13,15,29,0.43239143076165953,0.4823600982054601
채권가격/NNG;오르/VV,-1,-0.05545382879701122,28,13,15,32,0.43239143076165953,0.4823600982054601
달러엔/NNG;오르/VV,-1,-0.05545382879701122,28,13,15,27,0.43239143076165953,0.4823600982054601
대출/NNG;늘릴/VV,-1,-0.05545382879701122,28,13,15,20,0.43239143076165953,0.4823600982054601
달러강세/NNG;인한/VV,-1,-0.05545382879701122,28,13,15,22,0.43239143076165953,0.4823600982054601
금융시장/NNG;안정/NNG;찾/VV,-1,-0.05545382879701122,28,13,15,35,0.43239143076165953,0.4823600982054601
대출/NNG;확대~하/VVX,-1,-0.05557451089426024,62,29,33,41,0.5271631323862638,0.58822621269107
금리/NNG;급등~하/VVX,-1,-0.05711578350754165,216,101,115,152,0.6274998659357295,0.7023518015490381
금리/NNG;인하~하/VVX;않/VX,-1,-0.057533058582049046,94,44,50,37,0.5794743087582077,0.6491402502070293
기대심리/NNG;높였/VV,-1,-0.059574642427607793,60,28,32,37,0.5204389700350059,0.5853988447509968
금리/NNG;떨어졌/VV,-1,-0.061298741852205185,107,50,57,80,0.5909712824140488,0.6670371370699603
투자심리/NNG;회복~되/VVX,-1,-0.06218622797109641,75,35,40,67,0.5486001201590984,0.6203154559185123
경기침체/NNG;인한/VV,-1,-0.0633687589574724,26,12,14,19,0.4216330869109004,0.47788301292722274
채권/NNG;시장/NNG;약세/NNG;보이/VV,-1,-0.0633687589574724,26,12,14,25,0.4216330869109004,0.47788301292722274
고용/NNG;늘어나/VV,-1,-0.0633687589574724,26,12,14,17,0.4216330869109004,0.47788301292722274
금리/NNG;인상~할/VVX;없/VA,-1,-0.0633687589574724,26,12,14,17,0.4216330869109004,0.47788301292722274
장기금리/NNG;오르/VV,-1,-0.0633687589574724,26,12,14,30,0.4216330869109004,0.47788301292722274
금리인하/NNG;카드/NNG;꺼내/VV,-1,-0.0633687589574724,26,12,14,21,0.4216330869109004,0.47788301292722274
구조/NNG;개선~하/VVX,-1,-0.06590586439666835,41,19,22,23,0.46814956046858197,0.5333132098319076
성장세/NNG;유지~할/VVX,-1,-0.06823559924373501,56,26,30,23,0.5062863306861274,0.5794616229558582
물가상승/NNG;따른/VV,-1,-0.06957293985713009,71,33,38,58,0.5369436697055043,0.6162021481817176
변동성/NNG;커지/VV,-1,-0.07084951857166533,170,79,91,143,0.6140483315293709,0.7064969077262667
변동성/NNG;확대~됐/VVX,-1,-0.07190443744760477,39,18,21,24,0.45909078248742735,0.5293298256018131
국채수익률/NNG;상승~할/VVX,-1,-0.07190443744760477,39,18,21,17,0.45909078248742735,0.5293298256018131
투자심리/NNG;악화~시키/VVX,-1,-0.07240037233426755,24,11,13,8,0.4102501477520377,0.4734881694401903
환율하락/NNG;막/VV,-1,-0.07240037233426755,24,11,13,19,0.4102501477520377,0.4734881694401903
엔화/NNG;올랐/VV,-1,-0.07240037233426755,24,11,13,9,0.4102501477520377,0.4734881694401903
인플레이션기대/NNG;심리/NNG;확산~되/VVX,-1,-0.07240037233426755,24,11,13,6,0.4102501477520377,0.4734881694401903
위험/NNG;대비~하/VVX,-1,-0.07240037233426755,24,11,13,15,0.4102501477520377,0.4734881694401903
금리/NNG;상승~시키/VVX,-1,-0.07240037233426755,24,11,13,10,0.4102501477520377,0.4734881694401903
시장/NNG;금리/NNG;인상~할/VVX,-1,-0.07240037233426755,24,11,13,23,0.4102501477520377,0.4734881694401903
변동폭/NNG;확대~되/VVX,-1,-0.07240037233426755,24,11,13,13,0.4102501477520377,0.4734881694401903
달러원/NNG;오를/VV,-1,-0.07240037233426755,24,11,13,23,0.4102501477520377,0.4734881694401903
금리차/NNG;줄어들/VV,-1,-0.07240037233426755,24,11,13,15,0.4102501477520377,0.4734881694401903
투자심리/NNG;위축~시켰/VVX,-1,-0.07279963536750234,99,46,53,67,0.5754038005266389,0.6646322388895041
인플레이션/NNG;우려/NNG;커지/VV,-1,-0.07293846196044496,54,25,29,31,0.49883717910437686,0.5763530558676054
안전자산선호/NNG;따른/VV,-1,-0.07293846196044496,54,25,29,41,0.49883717910437686,0.5763530558676054
인플레이션/NNG;상승~할/VVX,-1,-0.07842232166865526,37,17,20,30,0.4496613428721764,0.5252926056179527
환율급등/NNG;따른/VV,-1,-0.07842232166865526,37,17,20,21,0.4496613428721764,0.5252926056179527
소비/NNG;늘리/VV,-1,-0.07842232166865526,37,17,20,25,0.4496613428721764,0.5252926056179527
원화가치/NNG;상승~하/VVX,-1,-0.08286080905516857,22,10,12,17,0.39809583090081446,0.46922372783481464
내수/NNG;부진~하/VVX,-1,-0.08286080905516857,22,10,12,11,0.39809583090081446,0.46922372783481464
금리인하/NNG;이뤄질/VV,-1,-0.08286080905516857,22,10,12,23,0.39809583090081446,0.46922372783481464
가계부채/NNG;증가~하/VVX,-1,-0.08286080905516857,22,10,12,28,0.39809583090081446,0.46922372783481464
금리인상/NNG;기정사실화~하/VVX,-1,-0.08286080905516857,22,10,12,10,0.39809583090081446,0.46922372783481464
달러약세/NNG;인해/VV,-1,-0.08286080905516857,22,10,12,16,0.39809583090081446,0.46922372783481464
엔화/NNG;강세/NNG;따른/VV,-1,-0.08286080905516857,22,10,12,13,0.39809583090081446,0.46922372783481464
높/VA;변동성/NNG;보일/VV,-1,-0.08286080905516857,22,10,12,17,0.39809583090081446,0.46922372783481464
금리인하/NNG;주장~했/VVX,-1,-0.08286080905516857,22,10,12,21,0.39809583090081446,0.46922372783481464
채권/NNG;시장/NNG;부담/NNG;되/VV,-1,-0.08286080905516857,22,10,12,10,0.39809583090081446,0.46922372783481464
산업생산/NNG;증가~했/VVX,-1,-0.08286080905516857,22,10,12,25,0.39809583090081446,0.46922372783481464
기준금리/NNG;동결~해/VVX,-1,-0.08286080905516857,22,10,12,22,0.39809583090081446,0.46922372783481464
신용등급/NNG;떨어지/VV,-1,-0.08286080905516857,22,10,12,9,0.39809583090081446,0.46922372783481464
성장/NNG;통해/VV,-1,-0.08286080905516857,22,10,12,21,0.39809583090081446,0.46922372783481464
금리인하/NNG;결정~하/VVX,-1,-0.08286080905516857,22,10,12,10,0.39809583090081446,0.46922372783481464
기준금리/NNG;올렸/VV,-1,-0.0834726772004567,106,49,57,84,0.5754144606265631,0.6790593548153239
금리/NNG;동결~되/VVX,-1,-0.0845451057251071,78,36,42,57,0.5398431543079532,0.6384571343670042
양적완화/NNG;유지~하/VVX,-1,-0.08554564009085841,35,16,19,49,0.4398217468728174,0.5212131345063712
달러엔/NNG;오른/VV,-1,-0.08554564009085841,35,16,19,26,0.4398217468728174,0.5212131345063712
수출/NNG;감소~했/VVX,-1,-0.08554564009085841,35,16,19,21,0.4398217468728174,0.5212131345063712
안전자산선호/NNG;약화~되/VVX,-1,-0.08554564009085841,35,16,19,38,0.4398217468728174,0.5212131345063712
국제/NNG;유가/NNG;하락~했/VVX,-1,-0.08554564009085841,35,16,19,24,0.4398217468728174,0.5212131345063712
물가/NNG;급등~하/VVX,-1,-0.08554564009085841,35,16,19,16,0.4398217468728174,0.5212131345063712
금리/NNG;안정~될/VVX,-1,-0.08554564009085841,35,16,19,15,0.4398217468728174,0.5212131345063712
유가/NNG;떨어지/VV,-1,-0.08554564009085841,35,16,19,26,0.4398217468728174,0.5212131345063712
금리인상/NNG;늦춰질/VV,-1,-0.08652737535943322,63,29,34,67,0.5111064909660461,0.6068876068119762
수출/NNG;호조/NNG;보이/VV,-1,-0.08856082380849484,76,35,41,56,0.5340783779193291,0.6367661181228983
초저금리/NNG;유지~하/VVX,-1,-0.08990081715708509,102,47,55,118,0.567313800778526,0.6782196341912862
위험/NNG;회피~하/VVX,-1,-0.09338300600464777,33,15,18,30,0.4295214950372974,0.5171053421676822
저금리/NNG;유지~되/VVX,-1,-0.09338300600464777,33,15,18,39,0.4295214950372974,0.5171053421676822
고용지표/NNG;부진~하/VVX,-1,-0.0948966196700225,46,21,25,35,0.4662376404649534,0.5630235544923392
소비위축/NNG;따른/VV,-1,-0.09519983766333784,20,9,11,5,0.38495430734101016,0.4651509546159934
장기물/NNG;강세/NNG;보이/VV,-1,-0.09519983766333784,20,9,11,27,0.38495430734101016,0.4651509546159934
장기물/NNG;금리/NNG;하락~했/VVX,-1,-0.09519983766333784,20,9,11,12,0.38495430734101016,0.4651509546159934
높/VA;수익률/NNG;제공~하/VVX,-1,-0.09519983766333784,20,9,11,11,0.38495430734101016,0.4651509546159934
유로화/NNG;상승~할/VVX,-1,-0.09519983766333784,20,9,11,14,0.38495430734101016,0.4651509546159934
실적/NNG;악화~될/VVX,-1,-0.09519983766333784,20,9,11,8,0.38495430734101016,0.4651509546159934
재무구조/NNG;개선~하/VVX,-1,-0.09519983766333784,20,9,11,16,0.38495430734101016,0.4651509546159934
순이익/NNG;내/VV,-1,-0.09519983766333784,20,9,11,8,0.38495430734101016,0.4651509546159934
이익/NNG;줄/VV,-1,-0.09519983766333784,20,9,11,22,0.38495430734101016,0.4651509546159934
소득/NNG;감소~하/VVX,-1,-0.09519983766333784,20,9,11,7,0.38495430734101016,0.4651509546159934
기준금리인하/NNG;나서/VV,-1,-0.09519983766333784,20,9,11,13,0.38495430734101016,0.4651509546159934
금리/NNG;인하~됐/VVX,-1,-0.09519983766333784,20,9,11,9,0.38495430734101016,0.4651509546159934
국제/NNG;유가/NNG;상승~했/VVX,-1,-0.09519983766333784,20,9,11,13,0.38495430734101016,0.4651509546159934
경기둔화/NNG;이어지/VV,-1,-0.09519983766333784,20,9,11,12,0.38495430734101016,0.4651509546159934
고용개선/NNG;따른/VV,-1,-0.09519983766333784,20,9,11,13,0.38495430734101016,0.4651509546159934
높/VA;수익/NNG;얻/VV,-1,-0.09519983766333784,20,9,11,31,0.38495430734101016,0.4651509546159934
완화/NNG;위해/VV,-1,-0.09712298241877004,72,33,39,64,0.5219400911274582,0.6331253115527137
채권금리/NNG;떨어지/VV,-1,-0.10136906203448226,44,20,24,17,0.45729438696212815,0.5594816459353078
투자/NNG;확대~되/VVX,-1,-0.10165428644633046,57,26,31,35,0.4892472548850233,0.598919473213161
수요/NNG;늘어난/VV,-1,-0.10169466339114064,70,32,38,52,0.5155516622631889,0.6311718604301462
채권/NNG;시장/NNG;약세/NNG;보였/VV,-1,-0.1020736183920028,31,14,17,30,0.4186949702724789,0.5129859199342492
양적완화/NNG;축소~할/VVX,-1,-0.1020736183920028,31,14,17,59,0.4186949702724789,0.5129859199342492
투자/NNG;위축~되/VVX,-1,-0.1020736183920028,31,14,17,21,0.4186949702724789,0.5129859199342492
달러화/NNG;상승~했/VVX,-1,-0.10727210860426961,55,25,30,48,0.48142863123694757,0.5960740909153213
채권/NNG;시장/NNG;국채가격/NNG;오른/VV,-1,-0.10727969343845434,116,53,63,68,0.567547209106407,0.7027113699199397
고용/NNG;개선~되/VVX,-1,-0.10834098061729802,42,19,23,34,0.44798361964429406,0.5558643331849527
금리차/NNG;확대~되/VVX,-1,-0.10834098061729802,42,19,23,42,0.44798361964429406,0.5558643331849527
금리/NNG;내려/VV,-1,-0.10982667221521436,79,36,43,91,0.525547320974209,0.6540683367012655
수익성/NNG;하락~하/VVX,-1,-0.11009214630263475,18,8,10,21,0.37049671341963275,0.4613481924205711
금리인상/NNG;놓/VV,-1,-0.11009214630263475,18,8,10,19,0.37049671341963275,0.4613481924205711
엔화가치/NNG;떨어지/VV,-1,-0.11009214630263475,18,8,10,17,0.37049671341963275,0.4613481924205711
성장/NNG;해/VV,-1,-0.11009214630263475,18,8,10,10,0.37049671341963275,0.4613481924205711
위험/NNG;줄여/VV,-1,-0.11009214630263475,18,8,10,8,0.37049671341963275,0.4613481924205711
소비심리/NNG;회복~되/VVX,-1,-0.11009214630263475,18,8,10,17,0.37049671341963275,0.4613481924205711
경기하강/NNG;막/VV,-1,-0.11009214630263475,18,8,10,7,0.37049671341963275,0.4613481924205711
높/VA;수익률/NNG;기록~하/VVX,-1,-0.11009214630263475,18,8,10,20,0.37049671341963275,0.4613481924205711
금리/NNG;상승세/NNG;이어지/VV,-1,-0.11009214630263475,18,8,10,9,0.37049671341963275,0.4613481924205711
경기회복세/NNG;유지~되/VVX,-1,-0.11009214630263475,18,8,10,12,0.37049671341963275,0.4613481924205711
장기물/NNG;하락~했/VVX,-1,-0.11009214630263475,18,8,10,12,0.37049671341963275,0.4613481924205711
미국채금리/NNG;떨어졌/VV,-1,-0.11009214630263475,18,8,10,15,0.37049671341963275,0.4613481924205711
재고/NNG;늘어나/VV,-1,-0.11009214630263475,18,8,10,12,0.37049671341963275,0.4613481924205711
금리/NNG;빠질/VV,-1,-0.11009214630263475,18,8,10,10,0.37049671341963275,0.4613481924205711
유로화/NNG;달러화/NNG;상승~했/VVX,-1,-0.11009214630263475,18,8,10,12,0.37049671341963275,0.4613481924205711
성장/NNG;기록~했/VVX,-1,-0.11009214630263475,18,8,10,12,0.37049671341963275,0.4613481924205711
물가/NNG;떨어지/VV,-1,-0.11009214630263475,18,8,10,14,0.37049671341963275,0.4613481924205711
금리인하/NNG;요구~하/VVX,-1,-0.11009214630263475,18,8,10,18,0.37049671341963275,0.4613481924205711
금리인상/NNG;가능성/NNG;열려/VV,-1,-0.11009214630263475,18,8,10,23,0.37049671341963275,0.4613481924205711
엔화/NNG;약세/NNG;지속~되/VVX,-1,-0.11009214630263475,18,8,10,17,0.37049671341963275,0.4613481924205711
국고채/NNG;금리/NNG;하락/NNG;마감~했/VVX,-1,-0.11009214630263475,18,8,10,9,0.37049671341963275,0.4613481924205711
엔화/NNG;약세/NNG;인한/VV,-1,-0.11009214630263475,18,8,10,18,0.37049671341963275,0.4613481924205711
채권/NNG;시장/NNG;강세/NNG;보인/VV,-1,-0.11009214630263475,18,8,10,17,0.37049671341963275,0.4613481924205711
금리/NNG;인상~할지/VVX,-1,-0.11009214630263475,18,8,10,17,0.37049671341963275,0.4613481924205711
기준금리동결/NNG;점쳤/VV,-1,-0.11009214630263475,18,8,10,7,0.37049671341963275,0.4613481924205711
금리인상/NNG;중단~될/VVX,-1,-0.11149366123897309,66,30,36,34,0.502094162511712,0.6269902780373506
고용/NNG;늘/VV,-1,-0.11179916655581457,29,13,16,23,0.40725542955384486,0.5088747970495608
유로달러/NNG;하락~한/VAX;거래~됐/VVX,-1,-0.11179916655581457,29,13,16,31,0.40725542955384486,0.5088747970495608
펀더멘털/NNG;개선~되/VVX,-1,-0.11179916655581457,29,13,16,33,0.40725542955384486,0.5088747970495608
달러화/NNG;강세/NNG;나타냈/VV,-1,-0.11179916655581457,29,13,16,15,0.40725542955384486,0.5088747970495608
채권/NNG;시장/NNG;강세/NNG;이/VV,-1,-0.11179916655581457,29,13,16,19,0.40725542955384486,0.5088747970495608
투자/NNG;줄/VV,-1,-0.11179916655581457,29,13,16,14,0.40725542955384486,0.5088747970495608
물가/NNG;오를/VV,-1,-0.11203964514948772,90,41,49,61,0.5393683502213383,0.6742808431728431
양적완화축소/NNG;따른/VV,-1,-0.11322678002028974,53,24,29,88,0.4733195714818473,0.593134386792068
금리동결/NNG;따른/VV,-1,-0.11588567400081151,40,18,22,34,0.43827057031997596,0.5521774471831478
금리인상/NNG;시사~했/VVX,-1,-0.11588567400081151,40,18,22,51,0.43827057031997596,0.5521774471831478
소비/NNG;늘어나/VV,-1,-0.11955508130183168,51,23,28,33,0.46490210012658784,0.5901010860897044
서부텍사스산원유/NNG;가격/NNG;오른/VV,-1,-0.11955508130183168,51,23,28,32,0.46490210012658784,0.5901010860897044
금리인하/NNG;통해/VV,-1,-0.1212253857501343,97,44,53,54,0.5413954964383313,0.6895251490027474
국채선물/NNG;내린/VV,-1,-0.12228869254777164,62,28,34,64,0.48766327896906697,0.6224321152810549
수익/NNG;올릴/VV,-1,-0.12228869254777164,62,28,34,51,0.48766327896906697,0.6224321152810549
유로화/NNG;급락~했/VVX,-1,-0.12280182138548701,27,12,15,11,0.395086026747551,0.5047956618828682
금리/NNG;오/VV,-1,-0.12280182138548701,27,12,15,13,0.395086026747551,0.5047956618828682
침체/NNG;이어지/VV,-1,-0.12280182138548701,27,12,15,12,0.395086026747551,0.5047956618828682
국채가격/NNG;하락/NNG;부추겼/VV,-1,-0.12280182138548701,27,12,15,14,0.395086026747551,0.5047956618828682
성장/NNG;지속~될/VVX,-1,-0.12280182138548701,27,12,15,12,0.395086026747551,0.5047956618828682
금리인상/NNG;가능성/NNG;높이/VV,-1,-0.12280182138548701,27,12,15,22,0.395086026747551,0.5047956618828682
투자심리/NNG;위축~돼/VVX,-1,-0.12280182138548701,27,12,15,12,0.395086026747551,0.5047956618828682
금리인상/NNG;나서/VV;않/VX,-1,-0.1240934297427736,38,17,21,27,0.42811219851621096,0.5484279190830548
수출/NNG;늘리/VV,-1,-0.1240934297427736,38,17,21,25,0.42811219851621096,0.5484279190830548
변동성/NNG;커졌/VV,-1,-0.1240934297427736,38,17,21,42,0.42811219851621096,0.5484279190830548
투자/NNG;늘릴/VV,-1,-0.1240934297427736,38,17,21,24,0.42811219851621096,0.5484279190830548
신뢰/NNG;회복~하/VVX,-1,-0.12630024338122492,49,22,27,32,0.456155219344699,0.5869753058063225
금리인상/NNG;하/VV;않/VX,-1,-0.12630024338122492,49,22,27,44,0.456155219344699,0.5869753058063225
경기회복/NNG;뒷받침~하/VVX,-1,-0.12630024338122492,49,22,27,32,0.456155219344699,0.5869753058063225
수요/NNG;증가~하/VVX,-1,-0.12769430353392253,166,75,91,138,0.5729058738878011,0.7392985170253623
금리/NNG;인하~해도/VVX,-1,-0.12860160543861066,16,7,9,5,0.35420002482398594,0.457915669627416
금리인하/NNG;단행~된/VVX,-1,-0.12860160543861066,16,7,9,12,0.35420002482398594,0.457915669627416
자산가격/NNG;하락~하/VVX,-1,-0.12860160543861066,16,7,9,9,0.35420002482398594,0.457915669627416
금리인하/NNG;기대/NNG;남/VV,-1,-0.12860160543861066,16,7,9,13,0.35420002482398594,0.457915669627416
기준금리인하/NNG;기대~하/VVX,-1,-0.12860160543861066,16,7,9,20,0.35420002482398594,0.457915669627416
기준금리인상/NNG;인한/VV,-1,-0.12860160543861066,16,7,9,20,0.35420002482398594,0.457915669627416
스왑베이시스/NNG;역전폭/NNG;확대~되/VVX,-1,-0.12860160543861066,16,7,9,6,0.35420002482398594,0.457915669627416
금리인상/NNG;앞당길/VV,-1,-0.12860160543861066,16,7,9,13,0.35420002482398594,0.457915669627416
신용스프레드/NNG;축소~됐/VVX,-1,-0.12860160543861066,16,7,9,10,0.35420002482398594,0.457915669627416
완화/NNG;나설/VV,-1,-0.12860160543861066,16,7,9,31,0.35420002482398594,0.457915669627416
달러약세/NNG;심화~되/VVX,-1,-0.12860160543861066,16,7,9,9,0.35420002482398594,0.457915669627416
기준금리인상/NNG;다가오/VV,-1,-0.12860160543861066,16,7,9,11,0.35420002482398594,0.457915669627416
채권/NNG;매수/NNG;심리/NNG;위축~됐/VVX,-1,-0.12860160543861066,16,7,9,15,0.35420002482398594,0.457915669627416
금리인상/NNG;더불/VV,-1,-0.12860160543861066,16,7,9,24,0.35420002482398594,0.457915669627416
엔화/NNG;상승~할/VVX,-1,-0.12860160543861066,16,7,9,8,0.35420002482398594,0.457915669627416
금리/NNG;낮추/VV;않/VX,-1,-0.12860160543861066,16,7,9,15,0.35420002482398594,0.457915669627416
경기회복/NNG;될/VV,-1,-0.12860160543861066,16,7,9,7,0.35420002482398594,0.457915669627416
금리하락/NNG;기대~하/VVX,-1,-0.12860160543861066,16,7,9,12,0.35420002482398594,0.457915669627416
채권금리/NNG;내렸/VV,-1,-0.12860160543861066,16,7,9,9,0.35420002482398594,0.457915669627416
인플레이션/NNG;우려~해/VVX,-1,-0.12860160543861066,16,7,9,6,0.35420002482398594,0.457915669627416
유가/NNG;급등~할/VVX,-1,-0.12860160543861066,16,7,9,10,0.35420002482398594,0.457915669627416
기준금리인하/NNG;기대심리/NNG;커지/VV,-1,-0.12860160543861066,16,7,9,12,0.35420002482398594,0.457915669627416
유로화/NNG;오/VV,-1,-0.12860160543861066,16,7,9,11,0.35420002482398594,0.457915669627416
금리인상/NNG;가능성/NNG;배제~하/VVX,-1,-0.12860160543861066,16,7,9,3,0.35420002482398594,0.457915669627416
경제/NNG;성장세/NNG;둔화~되/VVX,-1,-0.12860160543861066,16,7,9,4,0.35420002482398594,0.457915669627416
경제/NNG;악화~되/VVX,-1,-0.12860160543861066,16,7,9,12,0.35420002482398594,0.457915669627416
물가/NNG;오르/VV,-1,-0.13145168315112088,173,78,95,144,0.5712554710864257,0.7428184122712483
금리인상/NNG;가능성/NNG;반영~하/VVX,-1,-0.1330769163233969,36,16,20,40,0.4174545287562045,0.5446238834601188
신용스프레드/NNG;확대~될/VVX,-1,-0.1330769163233969,36,16,20,44,0.4174545287562045,0.5446238834601188
금리/NNG;높이/VV,-1,-0.13351350037223597,47,21,26,27,0.4470541475349945,0.5837585859362059
금리/NNG;인하~할/VVX,-1,-0.13443446958128857,576,259,317,329,0.5726021966652748,0.7491000569210171
완화적/VAX;통화정책/NNG;유지~할/VVX,-1,-0.13541228579439313,25,11,14,21,0.38202605758486147,0.5007764776713216
불안심리/NNG;해소~하/VVX,-1,-0.13541228579439313,25,11,14,10,0.38202605758486147,0.5007764776713216
불확실성/NNG;줄/VV,-1,-0.13541228579439313,25,11,14,12,0.38202605758486147,0.5007764776713216
완화/NNG;통해/VV,-1,-0.13541228579439313,25,11,14,21,0.38202605758486147,0.5007764776713216
침체/NNG;벗어나/VV;못하/VX,-1,-0.13541228579439313,25,11,14,17,0.38202605758486147,0.5007764776713216
매수/NNG;심리/NNG;위축~시킬/VVX,-1,-0.13541228579439313,25,11,14,14,0.38202605758486147,0.5007764776713216
양적완화/NNG;지속~하/VVX,-1,-0.13541228579439313,25,11,14,16,0.38202605758486147,0.5007764776713216
국고채/NNG;금리/NNG;국고/NNG;지표물/NNG;내린/VV,-1,-0.13541228579439313,25,11,14,32,0.38202605758486147,0.5007764776713216
국고채/NNG;오른/VV,-1,-0.13733725852264977,100,45,55,33,0.5336949617457247,0.7023374861713644
엔화/NNG;강세/NNG;보이/VV,-1,-0.13965764479152976,78,35,43,78,0.5050670932545119,0.6678123031086004
금리인하/NNG;통한/VV,-1,-0.14034363760592705,67,30,37,25,0.4862957423174679,0.6438917938050346
경기부양/NNG;위한/VV,-1,-0.1404253833808361,319,143,176,275,0.5681960800226454,0.7524592864316375
금리인상/NNG;통한/VV,-1,-0.14125611754589362,45,20,25,43,0.4375693317114295,0.5804529152248158
제로금리/NNG;유지~하/VVX,-1,-0.14125611754589362,45,20,25,42,0.4375693317114295,0.5804529152248158
기준금리/NNG;동결~되/VVX,-1,-0.1412775651506477,147,66,81,157,0.5587366655411337,0.7412185507050578
기준금리/NNG;올릴/VV,-1,-0.14226367730821443,326,146,180,332,0.5668433662560058,0.7534861854756157
금리/NNG;인상~함/VVX,-1,-0.1429787795329427,34,15,19,13,0.40622895148472327,0.5407747613782999
지표물/NNG;국고채/NNG;금리/NNG;내린/VV,-1,-0.1429787795329427,34,15,19,16,0.40622895148472327,0.5407747613782999
국채금리/NNG;상승~한/VAX;마감~함/VVX,-1,-0.1429787795329427,34,15,19,47,0.40622895148472327,0.5407747613782999
달러엔/NNG;상승~할/VVX,-1,-0.1429787795329427,34,15,19,29,0.40622895148472327,0.5407747613782999
금리/NNG;동결~할/VVX,-1,-0.14436829219590497,342,153,189,254,0.5652934271038508,0.7546584679533976
수요/NNG;줄어들/VV,-1,-0.14529888578713002,163,73,90,107,0.5596251153801446,0.7485113750409522
채권금리/NNG;상승~할/VVX,-1,-0.1462988308543477,65,29,36,54,0.47891678196867865,0.6418708733522269
금리인상/NNG;예상~하/VVX,-1,-0.1462988308543477,65,29,36,45,0.47891678196867865,0.6418708733522269
금리/NNG;내려야/VV,-1,-0.147655091629058,54,24,30,44,0.4554745605909989,0.6121451635572878
소비자물가/NNG;상승~할/VVX,-1,-0.14960207252907776,43,19,24,31,0.4276651551471161,0.5770607464701857
금리인상/NNG;한/VV,-1,-0.15009511789077723,23,10,13,15,0.36784928556846114,0.4968498658523951
경제/NNG;부담/NNG;될/VV,-1,-0.15009511789077723,23,10,13,22,0.36784928556846114,0.4968498658523951
가산금리/NNG;올려/VV,-1,-0.15009511789077723,23,10,13,9,0.36784928556846114,0.4968498658523951
마이너스/NNG;수익률/NNG;기록~했/VVX,-1,-0.15009511789077723,23,10,13,25,0.36784928556846114,0.4968498658523951
국채가격/NNG;하락압력/NNG;가했/VV,-1,-0.15009511789077723,23,10,13,13,0.36784928556846114,0.4968498658523951
하향압력/NNG;받/VV,-1,-0.15009511789077723,23,10,13,16,0.36784928556846114,0.4968498658523951
수급여건/NNG;개선~되/VVX,-1,-0.15009511789077723,23,10,13,22,0.36784928556846114,0.4968498658523951
고용/NNG;감소~하/VVX,-1,-0.15009511789077723,23,10,13,13,0.36784928556846114,0.4968498658523951
금리인상/NNG;가능~하/VVX,-1,-0.15009511789077723,23,10,13,43,0.36784928556846114,0.4968498658523951
금리/NNG;급락~하/VVX,-1,-0.15045566879172056,74,33,41,43,0.4919777978678163,0.6649987153001876
기대심리/NNG;커지/VV,-1,-0.1511282827965078,186,83,103,171,0.558271388250001,0.7556449965732859
유가/NNG;오를/VV,-1,-0.15398256677774047,32,14,18,20,0.39434700364203634,0.5368912964432138
채권금리/NNG;올랐/VV,-1,-0.15398256677774047,32,14,18,32,0.39434700364203634,0.5368912964432138
변동성/NNG;줄/VV,-1,-0.15398256677774047,32,14,18,33,0.39434700364203634,0.5368912964432138
달러화가치/NNG;상승~하/VVX,-1,-0.15398256677774047,32,14,18,28,0.39434700364203634,0.5368912964432138
국채금리/NNG;상승~했/VVX,-1,-0.15398256677774047,32,14,18,15,0.39434700364203634,0.5368912964432138
달러화/NNG;상승압력/NNG;받/VV,-1,-0.15498039011906262,52,23,29,42,0.4466358349840154,0.60932395661309
경기회복/NNG;위한/VV,-1,-0.15621686543051294,72,32,40,59,0.4850855771900186,0.6634564542543813
금리인상/NNG;단행~하/VVX,-1,-0.1568925299156958,173,77,96,116,0.5526992203965347,0.7569790168551987
투자심리/NNG;위축~됐/VVX,-1,-0.15707386284607894,101,45,56,81,0.5213192572984295,0.7142661264173205
재정적자/NNG;줄이/VV,-1,-0.15864164767383704,41,18,23,44,0.4172982300214021,0.5735849936255302
투자심리/NNG;위축~시키/VVX,-1,-0.16224391307093633,70,31,39,43,0.47794825310750827,0.6618201071279561
순이익/NNG;감소~했/VVX,-1,-0.16279039133090278,50,22,28,39,0.43743580031750323,0.606401653472937
수출/NNG;부진~하/VVX,-1,-0.16279039133090278,50,22,28,29,0.43743580031750323,0.606401653472937
금리인상/NNG;인해/VV,-1,-0.16279039133090278,50,22,28,36,0.43743580031750323,0.606401653472937
금리/NNG;내리/VV,-1,-0.1635963925986088,447,198,249,336,0.551064307768308,0.7651855089645276
성장/NNG;지속~하/VVX,-1,-0.16582730245054067,88,39,49,50,0.5016042799897307,0.6997052637850638
위험/NNG;줄이/VV,-1,-0.16582730245054067,88,39,49,88,0.5016042799897307,0.6997052637850638
완화적/VAX;통화정책/NNG;유지~하/VVX,-1,-0.1663287994960979,30,13,17,34,0.38169287914484834,0.5329854956581154
채권금리/NNG;하락~하/VVX,-1,-0.16680171478300743,115,51,64,101,0.5257507989707372,0.7348577336413108
유로화/NNG;엔화/NNG;강세/NNG;나타냈/VV,-1,-0.16752503215480097,21,9,12,9,0.3522287201428431,0.4930530612302107
금리/NNG;반등~했/VVX,-1,-0.16752503215480097,21,9,12,32,0.3522287201428431,0.4930530612302107
고용사정/NNG;개선~되/VVX,-1,-0.16752503215480097,21,9,12,12,0.3522287201428431,0.4930530612302107
연방기금/NNG;금리/NNG;인하~될/VVX,-1,-0.16752503215480097,21,9,12,1,0.3522287201428431,0.4930530612302107
인플레이션/NNG;하락~하/VVX,-1,-0.16752503215480097,21,9,12,9,0.3522287201428431,0.4930530612302107
crs금리/NNG;하락~하/VVX,-1,-0.16752503215480097,21,9,12,10,0.3522287201428431,0.4930530612302107
금리인상/NNG;유지~하/VVX,-1,-0.16752503215480097,21,9,12,12,0.3522287201428431,0.4930530612302107
국고채/NNG;금리/NNG;국고/NNG;지표물/NNG;하락~한/VAX;출발~했/VVX,-1,-0.16752503215480097,21,9,12,18,0.3522287201428431,0.4930530612302107
대외여건/NNG;개선~되/VVX,-1,-0.16752503215480097,21,9,12,8,0.3522287201428431,0.4930530612302107
달러화/NNG;강세/NNG;이/VV,-1,-0.16752503215480097,21,9,12,20,0.3522287201428431,0.4930530612302107
달러약세/NNG;진행~되/VVX,-1,-0.16752503215480097,21,9,12,15,0.3522287201428431,0.4930530612302107
기준금리/NNG;인상~했으며/VVX,-1,-0.16752503215480097,21,9,12,16,0.3522287201428431,0.4930530612302107
금리/NNG;올라/VV,-1,-0.1726182112596688,138,61,77,86,0.5332310104056965,0.7542834378124724
소비자물가/NNG;상승~하/VVX,-1,-0.1768031810209929,84,37,47,79,0.4893895376285616,0.6982627234471329
경기부양/NNG;위해/VV,-1,-0.17897045724725547,421,185,236,323,0.5396180302204739,0.7733788412156333
시중금리/NNG;하락~하/VVX,-1,-0.1792754713428235,37,16,21,14,0.3949492590049042,0.5663964491872252
소비/NNG;늘/VV,-1,-0.1792754713428235,37,16,21,32,0.3949492590049042,0.5663964491872252
연체율/NNG;상승~하/VVX,-1,-0.1792754713428235,37,16,21,28,0.3949492590049042,0.5663964491872252
장단기금리차/NNG;축소~될/VVX,-1,-0.18033922580495587,28,12,16,19,0.3681124876724244,0.529070388930392
환율급락/NNG;따른/VV,-1,-0.18033922580495587,28,12,16,7,0.3681124876724244,0.529070388930392
유동성/NNG;줄이/VV,-1,-0.18033922580495587,28,12,16,32,0.3681124876724244,0.529070388930392
채권/NNG;시장/NNG;국채가격/NNG;떨어진/VV,-1,-0.18033922580495587,28,12,16,11,0.3681124876724244,0.529070388930392
양적완화/NNG;따른/VV,-1,-0.18046869022151357,109,48,61,114,0.5119916113653636,0.7360576735324156
인플레이션/NNG;억제~하/VVX,-1,-0.18089080204293706,150,66,84,83,0.530908033239543,0.7639181939246918
경기부양/NNG;나설/VV,-1,-0.18125819571314483,55,24,31,37,0.43767327926295585,0.6302416833303944
물가/NNG;안정~돼/VVX,-1,-0.18125819571314483,55,24,31,16,0.43767327926295585,0.6302416833303944
국채금리/NNG;하락~하/VVX,-1,-0.18261969425740454,82,36,46,90,0.48296599089743114,0.6974213373370102
금리인하/NNG;나설/VV,-1,-0.18272527970282415,141,62,79,122,0.5269765133271885,0.7611402725028872
신뢰/NNG;높이/VV,-1,-0.18872157263785927,19,8,11,12,0.33467744574350566,0.4894267685266649
성장세/NNG;기록~하/VVX,-1,-0.18872157263785927,19,8,11,10,0.33467744574350566,0.4894267685266649
신용경색/NNG;해소~하/VVX,-1,-0.18872157263785927,19,8,11,12,0.33467744574350566,0.4894267685266649
경제지표부진/NNG;따른/VV,-1,-0.18872157263785927,19,8,11,17,0.33467744574350566,0.4894267685266649
경제상황/NNG;악화~되/VVX,-1,-0.18872157263785927,19,8,11,10,0.33467744574350566,0.4894267685266649
경기회복/NNG;되/VV,-1,-0.18872157263785927,19,8,11,10,0.33467744574350566,0.4894267685266649
금리인하/NNG;기대심리/NNG;유지~되/VVX,-1,-0.18872157263785927,19,8,11,24,0.33467744574350566,0.4894267685266649
경제성장/NNG;따른/VV,-1,-0.18872157263785927,19,8,11,16,0.33467744574350566,0.4894267685266649
수요/NNG;유지~될/VVX,-1,-0.18872157263785927,19,8,11,14,0.33467744574350566,0.4894267685266649
금리상승/NNG;확대~됐/VVX,-1,-0.18872157263785927,19,8,11,8,0.33467744574350566,0.4894267685266649
시장/NNG;변동성/NNG;커지/VV,-1,-0.18872157263785927,19,8,11,14,0.33467744574350566,0.4894267685266649
비용/NNG;줄어들/VV,-1,-0.18872157263785927,19,8,11,14,0.33467744574350566,0.4894267685266649
인플레이션압력/NNG;억제~하/VVX,-1,-0.18872157263785927,19,8,11,7,0.33467744574350566,0.4894267685266649
지급준비금적수/NNG;증가~하/VVX,-1,-0.18872157263785927,19,8,11,9,0.33467744574350566,0.4894267685266649
금리/NNG;영향/NNG;줄/VV,-1,-0.18872157263785927,19,8,11,17,0.33467744574350566,0.4894267685266649
달러화/NNG;올라서/VV,-1,-0.18872157263785927,19,8,11,8,0.33467744574350566,0.4894267685266649
순이자마진/NNG;하락~하/VVX,-1,-0.18872157263785927,19,8,11,12,0.33467744574350566,0.4894267685266649
수익성/NNG;악화~하/VVX,-1,-0.18872157263785927,19,8,11,10,0.33467744574350566,0.4894267685266649
가계부채/NNG;늘어난/VV,-1,-0.18872157263785927,19,8,11,14,0.33467744574350566,0.4894267685266649
금리인상/NNG;가능성/NNG;언급~하/VVX,-1,-0.18872157263785927,19,8,11,16,0.33467744574350566,0.4894267685266649
cd/NNG;금리/NNG;오르/VV,-1,-0.18872157263785927,19,8,11,6,0.33467744574350566,0.4894267685266649
매출/NNG;늘어난/VV,-1,-0.18872157263785927,19,8,11,17,0.33467744574350566,0.4894267685266649
성장세/NNG;유지~하/VVX,-1,-0.18922469559013788,71,31,40,68,0.4625722901849028,0.6771634697568706
침체/NNG;빠진/VV,-1,-0.1897963478977288,44,19,25,11,0.4073463603762323,0.5970244870856166
채권/NNG;시장/NNG;우호적/VAX;작용~할/VVX,-1,-0.1911859265234469,35,15,20,41,0.38281676936523323,0.5626912178027474
달러화/NNG;오를/VV,-1,-0.1911859265234469,35,15,20,31,0.38281676936523323,0.5626912178027474
엔화/NNG;약세/NNG;보였/VV,-1,-0.1911859265234469,35,15,20,33,0.38281676936523323,0.5626912178027474
불안심리/NNG;커졌/VV,-1,-0.1911859265234469,35,15,20,24,0.38281676936523323,0.5626912178027474
경기/NNG;부진~할/VVX,-1,-0.1911859265234469,35,15,20,18,0.38281676936523323,0.5626912178027474
장기금리/NNG;상승~하/VVX,-1,-0.19498307194580178,78,34,44,79,0.4694446965829616,0.6954810026430791
회사채/NNG;수익률/NNG;내린/VV,-1,-0.1964544582199067,26,11,15,10,0.35339717018085887,0.5251594525569794
금리인하/NNG;하/VV;않/VX,-1,-0.1964544582199067,26,11,15,15,0.35339717018085887,0.5251594525569794
재무구조/NNG;개선~되/VVX,-1,-0.1964544582199067,26,11,15,13,0.35339717018085887,0.5251594525569794
금리동결/NNG;이어질/VV,-1,-0.1964544582199067,26,11,15,26,0.35339717018085887,0.5251594525569794
금리인상/NNG;시작~할/VVX,-1,-0.1964544582199067,26,11,15,39,0.35339717018085887,0.5251594525569794
금리상승/NNG;대비~해/VVX,-1,-0.1964544582199067,26,11,15,24,0.35339717018085887,0.5251594525569794
금리인하/NNG;하/VV,-1,-0.19721294927135913,60,26,34,22,0.43814393168696236,0.6521228795625194
유가/NNG;하락~했/VVX,-1,-0.19721294927135913,60,26,34,40,0.43814393168696236,0.6521228795625194
금리/NNG;낮췄/VV,-1,-0.19721294927135913,60,26,34,53,0.43814393168696236,0.6521228795625194
국채가격/NNG;오른/VV,-1,-0.19762227996369264,94,41,53,46,0.4870224942600622,0.7254895390086671
불안심리/NNG;확산~되/VVX,-1,-0.19838884378155053,51,22,29,46,0.4187866199825673,0.6248374704391583
달러강세/NNG;지속~될/VVX,-1,-0.20028646030458985,42,18,24,44,0.39634585438356446,0.5936943188506333
국제/NNG;유가/NNG;오르/VV,-1,-0.20028646030458985,42,18,24,29,0.39634585438356446,0.5936943188506333
수출/NNG;증가~하/VVX,-1,-0.2033923331663975,92,40,52,83,0.481055924153642,0.7252586267563742
지급준비율/NNG;인상/NNG;따른/VV,-1,-0.2044454398202339,33,14,19,16,0.36991065733030126,0.5589170757090935
국고채/NNG;금리/NNG;하락~한/VAX;마감~했/VVX,-1,-0.2044454398202339,33,14,19,25,0.36991065733030126,0.5589170757090935
금리/NNG;낮추/VV,-1,-0.20613449661568284,307,133,174,253,0.5192707719419283,0.7873613982793618
변동성/NNG;확대~된/VVX,-1,-0.2078495047634893,49,21,28,36,0.4087250360499764,0.6219648233141355
금융시장/NNG;안정~시키/VVX,-1,-0.2078495047634893,49,21,28,23,0.4087250360499764,0.6219648233141355
대출/NNG;늘어나/VV,-1,-0.20937561263911353,90,39,51,65,0.4748899595311909,0.7249560448268094
유로달러/NNG;내린/VV,-1,-0.21172083212009496,40,17,23,36,0.38476602723385356,0.5902611552595308
높/VA;수익률/NNG;추구~하/VVX,-1,-0.21529422030159362,24,10,14,10,0.3372590087450657,0.5212654163894598
잠재/NNG;성장률/NNG;밑돌/VV,-1,-0.21529422030159362,24,10,14,15,0.3372590087450657,0.5212654163894598
장기금리/NNG;오르/VV;않/VX,-1,-0.21529422030159362,24,10,14,9,0.3372590087450657,0.5212654163894598
실업률/NNG;낮추/VV,-1,-0.21529422030159362,24,10,14,29,0.3372590087450657,0.5212654163894598
완화/NNG;이/VV,-1,-0.21529422030159362,24,10,14,18,0.3372590087450657,0.5212654163894598
금융시장/NNG;충격/NNG;받/VV,-1,-0.21529422030159362,24,10,14,19,0.3372590087450657,0.5212654163894598
금리/NNG;높일/VV,-1,-0.21529422030159362,24,10,14,16,0.3372590087450657,0.5212654163894598
고용자수/NNG;증가~하/VVX,-1,-0.21529422030159362,24,10,14,25,0.3372590087450657,0.5212654163894598
금리/NNG;내려온/VV,-1,-0.21529422030159362,24,10,14,12,0.3372590087450657,0.5212654163894598
성장세/NNG;이어지/VV,-1,-0.21529422030159362,24,10,14,29,0.3372590087450657,0.5212654163894598
국채선물/NNG;상승~한/VAX;마감~했/VVX,-1,-0.21529422030159362,24,10,14,14,0.3372590087450657,0.5212654163894598
경제지표/NNG;양호~하/VVX,-1,-0.21529422030159362,24,10,14,27,0.3372590087450657,0.5212654163894598
금리인하/NNG;반영~하/VVX,-1,-0.21530006464418672,17,7,10,18,0.3144457928091232,0.48601140162047524
유동성증가/NNG;따른/VV,-1,-0.21530006464418672,17,7,10,8,0.3144457928091232,0.48601140162047524
cd금리/NNG;상승~할/VVX,-1,-0.21530006464418672,17,7,10,15,0.3144457928091232,0.48601140162047524
유동성/NNG;줄/VV,-1,-0.21530006464418672,17,7,10,15,0.3144457928091232,0.48601140162047524
경기침체/NNG;심화~되/VVX,-1,-0.21530006464418672,17,7,10,14,0.3144457928091232,0.48601140162047524
gdp/NNG;증가~해/VVX,-1,-0.21530006464418672,17,7,10,11,0.3144457928091232,0.48601140162047524
금리인상/NNG;앞당겨/VV,-1,-0.21530006464418672,17,7,10,14,0.3144457928091232,0.48601140162047524
인플레이션/NNG;우려/NNG;덜/VV,-1,-0.21530006464418672,17,7,10,3,0.3144457928091232,0.48601140162047524
채권금리/NNG;떨어졌/VV,-1,-0.21530006464418672,17,7,10,13,0.3144457928091232,0.48601140162047524
금리인상/NNG;시작~될/VVX,-1,-0.21530006464418672,17,7,10,26,0.3144457928091232,0.48601140162047524
경제활동/NNG;위축~될/VVX,-1,-0.21530006464418672,17,7,10,6,0.3144457928091232,0.48601140162047524
신용등급/NNG;하향조정~했/VVX,-1,-0.21530006464418672,17,7,10,18,0.3144457928091232,0.48601140162047524
금리인상/NNG;막/VV,-1,-0.21530006464418672,17,7,10,17,0.3144457928091232,0.48601140162047524
지출/NNG;늘어나/VV,-1,-0.21530006464418672,17,7,10,18,0.3144457928091232,0.48601140162047524
신용위험/NNG;커지/VV,-1,-0.21530006464418672,17,7,10,7,0.3144457928091232,0.48601140162047524
높/VA;수익률/NNG;얻/VV,-1,-0.21530006464418672,17,7,10,11,0.3144457928091232,0.48601140162047524
금리/NNG;낮/VA;유지~하/VVX,-1,-0.21530006464418672,17,7,10,10,0.3144457928091232,0.48601140162047524
금리/NNG;내려간/VV,-1,-0.21530006464418672,17,7,10,28,0.3144457928091232,0.48601140162047524
소비/NNG;둔화~되/VVX,-1,-0.21530006464418672,17,7,10,10,0.3144457928091232,0.48601140162047524
높/VA;이자/NNG;받/VV,-1,-0.21530006464418672,17,7,10,10,0.3144457928091232,0.48601140162047524
금리인하/NNG;효과/NNG;지켜볼/VV,-1,-0.21530006464418672,17,7,10,23,0.3144457928091232,0.48601140162047524
소비자/NNG;물가상승률/NNG;기록~하/VVX,-1,-0.21530006464418672,17,7,10,23,0.3144457928091232,0.48601140162047524
성장세/NNG;둔화~된/VVX,-1,-0.21530006464418672,17,7,10,4,0.3144457928091232,0.48601140162047524
성장/NNG;견인~했/VVX,-1,-0.21530006464418672,17,7,10,7,0.3144457928091232,0.48601140162047524
듀레이션/NNG;축소~하/VVX,-1,-0.21530006464418672,17,7,10,21,0.3144457928091232,0.48601140162047524
국고채/NNG;금리/NNG;하락~하/VVX,-1,-0.2191161760458491,63,27,36,46,0.43020881729398724,0.6702768608253432
시장/NNG;상승~한/VAX;유로달러/NNG;하락~한/VAX;거래~됐/VVX,-1,-0.219352510264205,31,13,18,39,0.3560927353091025,0.5550772071370803
유가/NNG;상승~했/VVX,-1,-0.219352510264205,31,13,18,24,0.3560927353091025,0.5550772071370803
수요/NNG;감소~하/VVX,-1,-0.22203309231494006,86,37,49,65,0.4619302487565139,0.7241207946460317
적자/NNG;기록~하/VVX,-1,-0.22328977121024074,54,23,31,38,0.4103569956357739,0.644975813909015
매수/NNG;심리/NNG;위축~되/VVX,-1,-0.22328977121024074,54,23,31,38,0.4103569956357739,0.644975813909015
달러강세/NNG;따른/VV,-1,-0.22749686184741957,114,49,65,98,0.4825063089396632,0.7651195959043767
성장세/NNG;나타내/VV,-1,-0.22760527121564367,61,26,35,37,0.4213367716975881,0.6682744632360684
불확실성/NNG;커질/VV,-1,-0.22898078114176224,45,19,26,51,0.38716942124801706,0.6158647170233028
주택시장침체/NNG;따른/VV,-1,-0.22898078114176224,45,19,26,11,0.38716942124801706,0.6158647170233028
금리/NNG;내릴/VV,-1,-0.23264485529056134,309,132,177,224,0.49931870560294406,0.800422519180517
엔화/NNG;강세/NNG;나타내/VV,-1,-0.23630587128224634,29,12,17,16,0.34118221926962394,0.5511734045506081
국고채/NNG;금리/NNG;급등~했/VVX,-1,-0.23630587128224634,29,12,17,10,0.34118221926962394,0.5511734045506081
달러약세/NNG;이어질/VV,-1,-0.23630587128224634,29,12,17,16,0.34118221926962394,0.5511734045506081
성장/NNG;둔화~하/VVX,-1,-0.23630587128224634,29,12,17,13,0.34118221926962394,0.5511734045506081
경제/NNG;부담/NNG;줄/VV,-1,-0.23630587128224634,29,12,17,20,0.34118221926962394,0.5511734045506081
채권/NNG;시장/NNG;국고채/NNG;지표금리/NNG;오른/VV,-1,-0.23712084561474345,89,38,51,107,0.45518648590459565,0.7366142369581982
수요/NNG;늘어날/VV,-1,-0.23773852324654143,131,56,75,116,0.483593133596374,0.7836076468078432
금리동결/NNG;예상~하/VVX,-1,-0.23775709208491835,22,9,13,27,0.3192927693767026,0.5173979398803426
수익/NNG;올린/VV,-1,-0.23775709208491835,22,9,13,14,0.3192927693767026,0.5173979398803426
경제성장률/NNG;떨어지/VV,-1,-0.23775709208491835,22,9,13,13,0.3192927693767026,0.5173979398803426
통화완화/NNG;나서/VV,-1,-0.23775709208491835,22,9,13,14,0.3192927693767026,0.5173979398803426
신용위험/NNG;나타내/VV,-1,-0.23775709208491835,22,9,13,8,0.3192927693767026,0.5173979398803426
통화정책/NNG;완화/NNG;유지~하/VVX,-1,-0.23775709208491835,22,9,13,23,0.3192927693767026,0.5173979398803426
경제상황/NNG;악화~될/VVX,-1,-0.23775709208491835,22,9,13,9,0.3192927693767026,0.5173979398803426
국채선물/NNG;상승~한/VAX;거래/NNG;마쳤/VV,-1,-0.23775709208491835,22,9,13,19,0.3192927693767026,0.5173979398803426
기준금리인하/NNG;나설/VV,-1,-0.23775709208491835,22,9,13,25,0.3192927693767026,0.5173979398803426
이자/NNG;부담/NNG;줄어들/VV,-1,-0.23775709208491835,22,9,13,30,0.3192927693767026,0.5173979398803426
산업생산/NNG;감소~하/VVX,-1,-0.23775709208491835,22,9,13,12,0.3192927693767026,0.5173979398803426
금융시장/NNG;변동성/NNG;커지/VV,-1,-0.23775709208491835,22,9,13,27,0.3192927693767026,0.5173979398803426
경제지표/NNG;호조/NNG;보이/VV,-1,-0.23803610346447146,96,41,55,86,0.4615106306808442,0.7482967477399759
경제/NNG;회복~하/VVX,-1,-0.2381271720169088,36,15,21,43,0.359544824377771,0.5830810547176637
달러화/NNG;오르/VV,-1,-0.2381271720169088,36,15,21,59,0.359544824377771,0.5830810547176637
매출/NNG;증가~했/VVX,-1,-0.2381271720169088,36,15,21,25,0.359544824377771,0.5830810547176637
금리/NNG;하락세/NNG;이/VV,-1,-0.2381271720169088,36,15,21,25,0.359544824377771,0.5830810547176637
금리인상/NNG;중단~할/VVX,-1,-0.2382376112772956,124,53,71,76,0.48025604444362135,0.7790230119192143
금리인상/NNG;늦출/VV,-1,-0.24087447072548873,43,18,25,32,0.37557331302504715,0.6126305659840167
콜금리/NNG;동결~될/VVX,-1,-0.24610001922140623,57,24,33,15,0.4025141681982173,0.6639011534860962
경제/NNG;위축~되/VVX,-1,-0.24996867337898387,15,6,9,21,0.2903373263071304,0.48283721287543574
고용지표/NNG;호조/NNG;보여/VV,-1,-0.24996867337898387,15,6,9,9,0.2903373263071304,0.48283721287543574
양적완화/NNG;실시~할/VVX,-1,-0.24996867337898387,15,6,9,9,0.2903373263071304,0.48283721287543574
인플레이션/NNG;우려/NNG;완화~돼/VVX,-1,-0.24996867337898387,15,6,9,7,0.2903373263071304,0.48283721287543574
위험/NNG;대응~하/VVX,-1,-0.24996867337898387,15,6,9,20,0.2903373263071304,0.48283721287543574
인플레이션/NNG;낮출/VV,-1,-0.24996867337898387,15,6,9,13,0.2903373263071304,0.48283721287543574
대외여건/NNG;악화~되/VVX,-1,-0.24996867337898387,15,6,9,10,0.2903373263071304,0.48283721287543574
불안심리/NNG;완화~됐/VVX,-1,-0.24996867337898387,15,6,9,7,0.2903373263071304,0.48283721287543574
통화긴축/NNG;중단~될/VVX,-1,-0.24996867337898387,15,6,9,13,0.2903373263071304,0.48283721287543574
대출한도/NNG;늘리/VV,-1,-0.24996867337898387,15,6,9,14,0.2903373263071304,0.48283721287543574
위험/NNG;경고~하/VVX,-1,-0.24996867337898387,15,6,9,6,0.2903373263071304,0.48283721287543574
국채선물/NNG;상승~한/VAX;나타내/VV,-1,-0.24996867337898387,15,6,9,12,0.2903373263071304,0.48283721287543574
양적완화/NNG;확대~할/VVX,-1,-0.24996867337898387,15,6,9,15,0.2903373263071304,0.48283721287543574
달러원/NNG;올라서/VV,-1,-0.24996867337898387,15,6,9,3,0.2903373263071304,0.48283721287543574
안정적/VAX;수익/NNG;내/VV,-1,-0.24996867337898387,15,6,9,7,0.2903373263071304,0.48283721287543574
차입금/NNG;늘/VV,-1,-0.24996867337898387,15,6,9,11,0.2903373263071304,0.48283721287543574
고용지표/NNG;호전~되/VVX,-1,-0.24996867337898387,15,6,9,7,0.2903373263071304,0.48283721287543574
금융시장/NNG;영향/NNG;줄/VV,-1,-0.24996867337898387,15,6,9,13,0.2903373263071304,0.48283721287543574
소비/NNG;투자심리/NNG;위축~되/VVX,-1,-0.24996867337898387,15,6,9,10,0.2903373263071304,0.48283721287543574
국고/NNG;스프레드/NNG;확대~되/VVX,-1,-0.24996867337898387,15,6,9,24,0.2903373263071304,0.48283721287543574
성장세/NNG;보인/VV,-1,-0.24996867337898387,15,6,9,14,0.2903373263071304,0.48283721287543574
엔화가치/NNG;하락~하/VVX,-1,-0.24996867337898387,15,6,9,14,0.2903373263071304,0.48283721287543574
고용/NNG;호조/NNG;보이/VV,-1,-0.24996867337898387,15,6,9,5,0.2903373263071304,0.48283721287543574
신용경색/NNG;우려/NNG;부각~되/VVX,-1,-0.24996867337898387,15,6,9,8,0.2903373263071304,0.48283721287543574
통화정책/NNG;유지~해야/VVX,-1,-0.24996867337898387,15,6,9,8,0.2903373263071304,0.48283721287543574
금리인하/NNG;기대/NNG;확산~되/VVX,-1,-0.24996867337898387,15,6,9,3,0.2903373263071304,0.48283721287543574
국고채/NNG;금리/NNG;급등~하/VVX,-1,-0.24996867337898387,15,6,9,12,0.2903373263071304,0.48283721287543574
금리/NNG;급등~한/VAX;따른/VV,-1,-0.24996867337898387,15,6,9,6,0.2903373263071304,0.48283721287543574
경제회복/NNG;따른/VV,-1,-0.24996867337898387,15,6,9,8,0.2903373263071304,0.48283721287543574
은행대출/NNG;늘/VV,-1,-0.24996867337898387,15,6,9,7,0.2903373263071304,0.48283721287543574
물가상승률/NNG;넘/VV,-1,-0.24996867337898387,15,6,9,7,0.2903373263071304,0.48283721287543574
생산자물가/NNG;상승~해/VVX,-1,-0.24996867337898387,15,6,9,14,0.2903373263071304,0.48283721287543574
경제/NNG;둔화~할/VVX,-1,-0.24996867337898387,15,6,9,6,0.2903373263071304,0.48283721287543574
비용/NNG;내/VV,-1,-0.24996867337898387,15,6,9,2,0.2903373263071304,0.48283721287543574
금리/NNG;하락세/NNG;이어지/VV,-1,-0.24996867337898387,15,6,9,17,0.2903373263071304,0.48283721287543574
실적/NNG;개선~됐/VVX,-1,-0.24996867337898387,15,6,9,19,0.2903373263071304,0.48283721287543574
기준금리인하/NNG;인해/VV,-1,-0.24996867337898387,15,6,9,13,0.2903373263071304,0.48283721287543574
가산금리/NNG;낮추/VV,-1,-0.24996867337898387,15,6,9,14,0.2903373263071304,0.48283721287543574
달러화/NNG;강세/NNG;보인/VV,-1,-0.25357727771817606,34,14,20,42,0.34568911674064096,0.5793292337639983
달러화/NNG;엔화/NNG;하락~했/VVX,-1,-0.25357727771817606,34,14,20,21,0.34568911674064096,0.5793292337639983
기준금리인상/NNG;지연~될/VVX,-1,-0.25357727771817606,34,14,20,27,0.34568911674064096,0.5793292337639983
장단기금리차/NNG;확대~될/VVX,-1,-0.25357727771817606,34,14,20,27,0.34568911674064096,0.5793292337639983
경제성장/NNG;둔화~될/VVX,-1,-0.2538455613183329,41,17,24,29,0.36334567087982844,0.6092680990627145
부양책/NNG;나올/VV,-1,-0.2538455613183329,41,17,24,33,0.36334567087982844,0.6092680990627145
인플레이션/NNG;완화~되/VVX,-1,-0.2538455613183329,41,17,24,20,0.36334567087982844,0.6092680990627145
시장금리/NNG;오를/VV,-1,-0.2549649124183392,48,20,28,33,0.3788026094025439,0.6367068078190354
지급준비율/NNG;인상~했/VVX,-1,-0.2549649124183392,48,20,28,14,0.3788026094025439,0.6367068078190354
금융안정/NNG;유의~하/VVX,-1,-0.2549649124183392,48,20,28,39,0.3788026094025439,0.6367068078190354
경기회복세/NNG;이어지/VV,-1,-0.2549649124183392,48,20,28,30,0.3788026094025439,0.6367068078190354
위험/NNG;안/VV,-1,-0.2549649124183392,48,20,28,34,0.3788026094025439,0.6367068078190354
엔화/NNG;하락~했/VVX,-1,-0.2549649124183392,48,20,28,41,0.3788026094025439,0.6367068078190354
자산/NNG;증가~하/VVX,-1,-0.2558494649382046,27,11,16,23,0.3249395319700696,0.5472047502369032
달러화/NNG;반등~했/VVX,-1,-0.2558494649382046,27,11,16,13,0.3249395319700696,0.5472047502369032
금융시장/NNG;안정~된/VVX,-1,-0.2558494649382046,27,11,16,16,0.3249395319700696,0.5472047502369032
금리하락/NNG;제한~될/VVX,-1,-0.2558494649382046,27,11,16,33,0.3249395319700696,0.5472047502369032
기준금리/NNG;인상~하/VVX;어려울/VA,-1,-0.2558494649382046,27,11,16,20,0.3249395319700696,0.5472047502369032
기준금리/NNG;올려야/VV,-1,-0.256218987806764,55,23,32,42,0.39251168581176804,0.6615198748048781
기준금리/NNG;인상~할지/VVX,-1,-0.26519165074205087,20,8,12,8,0.2989166404887509,0.5135591962012549
엔화/NNG;약세/NNG;나타냈/VV,-1,-0.26519165074205087,20,8,12,12,0.2989166404887509,0.5135591962012549
물가상승/NNG;이어질/VV,-1,-0.26519165074205087,20,8,12,5,0.2989166404887509,0.5135591962012549
국채선물/NNG;하락~한/VAX;보이/VV,-1,-0.26519165074205087,20,8,12,23,0.2989166404887509,0.5135591962012549
장기물/NNG;금리/NNG;하락~하/VVX,-1,-0.26519165074205087,20,8,12,27,0.2989166404887509,0.5135591962012549
주택담보대출/NNG;금리/NNG;상승~하/VVX,-1,-0.26519165074205087,20,8,12,9,0.2989166404887509,0.5135591962012549
유가하락/NNG;부추겼/VV,-1,-0.26519165074205087,20,8,12,14,0.2989166404887509,0.5135591962012549
경기부진/NNG;지속~되/VVX,-1,-0.26519165074205087,20,8,12,19,0.2989166404887509,0.5135591962012549
경상수지흑자/NNG;따른/VV,-1,-0.26519165074205087,20,8,12,30,0.2989166404887509,0.5135591962012549
금리인하/NNG;가능성/NNG;반영~하/VVX,-1,-0.26519165074205087,20,8,12,8,0.2989166404887509,0.5135591962012549
투자/NNG;늘렸/VV,-1,-0.26519165074205087,20,8,12,24,0.2989166404887509,0.5135591962012549
성장세/NNG;유지~될/VVX,-1,-0.26519165074205087,20,8,12,11,0.2989166404887509,0.5135591962012549
유로화/NNG;올랐/VV,-1,-0.26519165074205087,20,8,12,16,0.2989166404887509,0.5135591962012549
금리/NNG;상승세/NNG;타/VV,-1,-0.26519165074205087,20,8,12,6,0.2989166404887509,0.5135591962012549
국채금리/NNG;넘어서/VV,-1,-0.26519165074205087,20,8,12,10,0.2989166404887509,0.5135591962012549
기준금리인하/NNG;통한/VV,-1,-0.26519165074205087,20,8,12,21,0.2989166404887509,0.5135591962012549
투자심리/NNG;호전~시켰/VVX,-1,-0.26519165074205087,20,8,12,14,0.2989166404887509,0.5135591962012549
신규/NNG;실업수당청구/NNG;줄어든/VV,-1,-0.26519165074205087,20,8,12,13,0.2989166404887509,0.5135591962012549
기준금리/NNG;동결~했으며/VVX,-1,-0.26519165074205087,20,8,12,31,0.2989166404887509,0.5135591962012549
완화/NNG;위한/VV,-1,-0.2671732999667965,46,19,27,32,0.367264216583581,0.6336783532892982
지표금리/NNG;상승~한/VAX;거래~됐/VVX,-1,-0.2671732999667965,46,19,27,68,0.367264216583581,0.6336783532892982
기준금리/NNG;인하~할/VVX,-1,-0.2697249714267691,597,250,347,397,0.4713413627500402,0.8177317272723134
투자/NNG;증가~하/VVX,-1,-0.27096579268859244,32,13,19,48,0.33081205232010574,0.5754633661205634
신용경색/NNG;완화~하/VVX,-1,-0.27096579268859244,32,13,19,15,0.33081205232010574,0.5754633661205634
물가상승압력/NNG;커지/VV,-1,-0.27096579268859244,32,13,19,19,0.33081205232010574,0.5754633661205634
성장세회복/NNG;이어지/VV,-1,-0.27096579268859244,32,13,19,25,0.33081205232010574,0.5754633661205634
침체/NNG;빠질/VV,-1,-0.27096579268859244,32,13,19,24,0.33081205232010574,0.5754633661205634
인플레이션/NNG;우려/NNG;완화~되/VVX,-1,-0.27096579268859244,32,13,19,19,0.33081205232010574,0.5754633661205634
성장세/NNG;둔화~되/VVX,-1,-0.2769317793916125,98,41,57,62,0.4366203542767323,0.7693689153315324
수요/NNG;늘/VV,-1,-0.27743032765589304,194,81,113,155,0.46448934646945317,0.8193600765382987
소비자물가/NNG;상승~했/VVX,-1,-0.2785615475014691,51,21,30,34,0.37116373070304143,0.6563384801267076
성장세/NNG;유지~되/VVX,-1,-0.278742583614619,25,10,15,24,0.3070432682471009,0.543165463913887
위험/NNG;피하/VV,-1,-0.278742583614619,25,10,15,28,0.3070432682471009,0.543165463913887
기대심리/NNG;커질/VV,-1,-0.278742583614619,25,10,15,29,0.3070432682471009,0.543165463913887
고용/NNG;증가~하/VVX,-1,-0.278742583614619,25,10,15,17,0.3070432682471009,0.543165463913887
높/VA;변동성/NNG;보이/VV,-1,-0.278742583614619,25,10,15,28,0.3070432682471009,0.543165463913887
장기시장금리/NNG;하락~하/VVX,-1,-0.278742583614619,25,10,15,16,0.3070432682471009,0.543165463913887
기업/NNG;실적/NNG;개선~되/VVX,-1,-0.278742583614619,25,10,15,19,0.3070432682471009,0.543165463913887
불확실성/NNG;계속~되/VVX,-1,-0.278742583614619,25,10,15,19,0.3070432682471009,0.543165463913887
안정적/VAX;수익/NNG;추구~하/VVX,-1,-0.278742583614619,25,10,15,24,0.3070432682471009,0.543165463913887
내수부진/NNG;따른/VV,-1,-0.278742583614619,25,10,15,19,0.3070432682471009,0.543165463913887
국채선물/NNG;하락~한/VAX;마감~했/VVX,-1,-0.278742583614619,25,10,15,19,0.3070432682471009,0.543165463913887
금리/NNG;상승~했/VVX,-1,-0.27903651997148293,288,120,168,248,0.4642948615987987,0.8218695312399977
소비/NNG;위축~될/VVX,-1,-0.2804145782007994,44,18,26,24,0.3551254308325452,0.6305034047260958
기준금리인상/NNG;단행~할/VVX,-1,-0.2804145782007994,44,18,26,40,0.3551254308325452,0.6305034047260958
부채/NNG;줄이/VV,-1,-0.28382292379946816,37,15,22,49,0.33664821495883224,0.6021347140920122
신용등급/NNG;하향조정~하/VVX,-1,-0.28382292379946816,37,15,22,33,0.33664821495883224,0.6021347140920122
cd금리/NNG;오를/VV,-1,-0.28382292379946816,37,15,22,9,0.33664821495883224,0.6021347140920122
성장세/NNG;지속~되/VVX,-1,-0.28382292379946816,37,15,22,30,0.33664821495883224,0.6021347140920122
금리/NNG;인하~하/VVX,-1,-0.28511560747386033,419,174,245,316,0.459726202586828,0.8245869529710209
달러화/NNG;강세/NNG;보였/VV,-1,-0.2862738849093843,63,26,37,51,0.3884138591021367,0.6984346298222368
불확실성/NNG;확대~되/VVX,-1,-0.2865341286806956,89,37,52,71,0.4219641754170584,0.7591935381784256
유로화/NNG;약세/NNG;보였/VV,-1,-0.290758012796837,30,12,18,11,0.31471982323996267,0.5714750672016736
가산금리/NNG;상승~하/VVX,-1,-0.290758012796837,30,12,18,13,0.31471982323996267,0.5714750672016736
금리상승/NNG;이어지/VV,-1,-0.290758012796837,30,12,18,22,0.31471982323996267,0.5714750672016736
금리인하/NNG;단행~되/VVX,-1,-0.2909715059846155,49,20,29,22,0.3597381099563029,0.6535245512474551
불확실성/NNG;커졌/VV,-1,-0.2939622815819236,68,28,40,66,0.3913903116953032,0.7156850921663103
투자/NNG;줄이/VV,-1,-0.29485616540310444,42,17,25,28,0.342316136030636,0.6271740478335373
금리인상/NNG;지지~하/VVX,-1,-0.29485616540310444,42,17,25,43,0.342316136030636,0.6271740478335373
기준금리동결/NNG;예상~하/VVX,-1,-0.29485616540310444,42,17,25,21,0.342316136030636,0.6271740478335373
시장금리/NNG;오르/VV,-1,-0.29918729595503135,92,38,54,77,0.4162651637711443,0.7699285856926812
경기회복/NNG;힘입/VV,-1,-0.2997005820086126,18,7,11,19,0.27528055998694106,0.5097355408287769
잠재/NNG;성장률/NNG;높이/VV,-1,-0.2997005820086126,18,7,11,14,0.27528055998694106,0.5097355408287769
국채수익률/NNG;급등~하/VVX,-1,-0.2997005820086126,18,7,11,11,0.27528055998694106,0.5097355408287769
금리인하/NNG;기대/NNG;강화~되/VVX,-1,-0.2997005820086126,18,7,11,6,0.27528055998694106,0.5097355408287769
국채선물/NNG;낮/VA;개장~된/VVX,-1,-0.2997005820086126,18,7,11,5,0.27528055998694106,0.5097355408287769
경제/NNG;부담/NNG;주/VV,-1,-0.2997005820086126,18,7,11,17,0.27528055998694106,0.5097355408287769
시장금리/NNG;반등~하/VVX,-1,-0.2997005820086126,18,7,11,8,0.27528055998694106,0.5097355408287769
투자/NNG;확대~해/VVX,-1,-0.2997005820086126,18,7,11,11,0.27528055998694106,0.5097355408287769
기준금리인상/NNG;하/VV,-1,-0.2997005820086126,18,7,11,12,0.27528055998694106,0.5097355408287769
스왑베이시스/NNG;역전폭/NNG;축소~됐/VVX,-1,-0.2997005820086126,18,7,11,20,0.27528055998694106,0.5097355408287769
달러화/NNG;레벨/NNG;낮췄/VV,-1,-0.2997005820086126,18,7,11,19,0.27528055998694106,0.5097355408287769
환율방어/NNG;위한/VV,-1,-0.2997005820086126,18,7,11,17,0.27528055998694106,0.5097355408287769
채권수익률/NNG;급등~하/VVX,-1,-0.2997005820086126,18,7,11,2,0.27528055998694106,0.5097355408287769
통화완화/NNG;종료~하/VVX,-1,-0.2997005820086126,18,7,11,11,0.27528055998694106,0.5097355408287769
신뢰/NNG;회복~되/VVX,-1,-0.2997005820086126,18,7,11,7,0.27528055998694106,0.5097355408287769
금리상승/NNG;요인/NNG;작용~했/VVX,-1,-0.2997005820086126,18,7,11,18,0.27528055998694106,0.5097355408287769
투자심리/NNG;냉각~시켰/VVX,-1,-0.2997005820086126,18,7,11,14,0.27528055998694106,0.5097355408287769
금리/NNG;하락~한/VAX;고시~됐/VVX,-1,-0.2997005820086126,18,7,11,8,0.27528055998694106,0.5097355408287769
시장변동성/NNG;커질/VV,-1,-0.2997005820086126,18,7,11,24,0.27528055998694106,0.5097355408287769
금리인상/NNG;멈추/VV,-1,-0.2997005820086126,18,7,11,19,0.27528055998694106,0.5097355408287769
가계부채/NNG;증가/NNG;따른/VV,-1,-0.2997005820086126,18,7,11,17,0.27528055998694106,0.5097355408287769
금가격/NNG;오르/VV,-1,-0.2997005820086126,18,7,11,14,0.27528055998694106,0.5097355408287769
금리인상/NNG;결정~하/VVX,-1,-0.3000407103560391,54,22,32,37,0.36417628243606,0.6748467386004361
높/VA;금리/NNG;받/VV,-1,-0.3000407103560391,54,22,32,43,0.36417628243606,0.6748467386004361
성장세/NNG;지속~될/VVX,-1,-0.3000407103560391,54,22,32,35,0.36417628243606,0.6748467386004361
금리/NNG;내렸/VV,-1,-0.30548748875390186,241,99,142,190,0.4442298732590317,0.8331086738801494
안전자산선호/NNG;강화~돼/VVX,-1,-0.30607158918249033,23,9,14,13,0.2870578393600051,0.5390413832465566
국고채/NNG;수익률/NNG;오른/VV,-1,-0.30607158918249033,23,9,14,19,0.2870578393600051,0.5390413832465566
gdp/NNG;증가~했/VVX,-1,-0.30607158918249033,23,9,14,20,0.2870578393600051,0.5390413832465566
채권가격/NNG;떨어지/VV,-1,-0.30607158918249033,23,9,14,23,0.2870578393600051,0.5390413832465566
안전자산선호/NNG;심리/NNG;강해/VV,-1,-0.30607158918249033,23,9,14,22,0.2870578393600051,0.5390413832465566
금리인하/NNG;예상~했/VVX,-1,-0.30607158918249033,23,9,14,12,0.2870578393600051,0.5390413832465566
손실/NNG;커질/VV,-1,-0.30607158918249033,23,9,14,9,0.2870578393600051,0.5390413832465566
장기물/NNG;강세/NNG;보였/VV,-1,-0.30607158918249033,23,9,14,18,0.2870578393600051,0.5390413832465566
부동산가격상승/NNG;따른/VV,-1,-0.30607158918249033,23,9,14,10,0.2870578393600051,0.5390413832465566
경쟁력강화/NNG;위한/VV,-1,-0.30607158918249033,23,9,14,14,0.2870578393600051,0.5390413832465566
적자/NNG;내/VV,-1,-0.30607158918249033,23,9,14,17,0.2870578393600051,0.5390413832465566
달러강세/NNG;이어지/VV,-1,-0.30784155321598394,59,24,35,55,0.3684023475510635,0.6944959654789777
기준금리/NNG;낮출/VV,-1,-0.30784155321598394,59,24,35,40,0.3684023475510635,0.6944959654789777
경제/NNG;회복세/NNG;보이/VV,-1,-0.30784155321598394,59,24,35,38,0.3684023475510635,0.6944959654789777
성장세/NNG;둔화~될/VVX,-1,-0.3107055703230074,40,16,24,34,0.3287521184501497,0.6236807567685475
금리/NNG;끌어내렸/VV,-1,-0.3107055703230074,40,16,24,31,0.3287521184501497,0.6236807567685475
금리/NNG;떨어진/VV,-1,-0.31102439486106936,95,39,56,58,0.4108288782215351,0.7799393218225237
금리인하/NNG;단행~될/VVX,-1,-0.3112209313400892,83,34,49,61,0.39930931213269455,0.7583994294213632
금리/NNG;낮출/VV,-1,-0.31250513127444346,112,46,66,86,0.4213798880085451,0.8025942186368232
국채가격/NNG;떨어졌/VV,-1,-0.31256362107283586,52,21,31,27,0.3529036490156213,0.6722558446745437
기준금리/NNG;수준/NNG;유지~해/VVX,-1,-0.31358173738762074,28,11,17,27,0.29716286795954316,0.5673510279692008
경제지표/NNG;호조/NNG;보였/VV,-1,-0.31358173738762074,28,11,17,22,0.29716286795954316,0.5673510279692008
기준금리/NNG;내려갈/VV,-1,-0.31358173738762074,28,11,17,17,0.29716286795954316,0.5673510279692008
물가안정/NNG;목표/NNG;달성~하/VVX,-1,-0.31358173738762074,28,11,17,14,0.29716286795954316,0.5673510279692008
지급준비율/NNG;올리/VV,-1,-0.31358173738762074,28,11,17,13,0.29716286795954316,0.5673510279692008
금리/NNG;폭등~하/VVX,-1,-0.31358173738762074,28,11,17,17,0.29716286795954316,0.5673510279692008
장기금리/NNG;낮추/VV,-1,-0.31358173738762074,28,11,17,23,0.29716286795954316,0.5673510279692008
금리상승/NNG;확대~되/VVX,-1,-0.31358173738762074,28,11,17,26,0.29716286795954316,0.5673510279692008
국채수익률/NNG;상승~하/VVX,-1,-0.31358173738762074,28,11,17,20,0.29716286795954316,0.5673510279692008
엔화/NNG;약세/NNG;나타내/VV,-1,-0.31358173738762074,28,11,17,19,0.29716286795954316,0.5673510279692008
유로화/NNG;급등~했/VVX,-1,-0.31358173738762074,28,11,17,16,0.29716286795954316,0.5673510279692008
국고채/NNG;금리/NNG;올랐/VV,-1,-0.31454845697287015,64,26,38,60,0.37239619404772656,0.7125127319375841
장기금리/NNG;하락~하/VVX,-1,-0.3155554691294553,76,31,45,62,0.38839932525425086,0.7447926515361146
국고채/NNG;금리/NNG;상승~했/VVX,-1,-0.3171741826914981,105,43,62,75,0.4139474079023845,0.7966397287549957
금융시장안정/NNG;위한/VV,-1,-0.3188828576270447,45,18,27,30,0.3351299218231169,0.6474086410053642
금리/NNG;유지~할/VVX,-1,-0.31963237268709366,57,23,34,72,0.3577705054644996,0.6922987769322289
달러화가치/NNG;하락~하/VVX,-1,-0.32111678546481726,33,13,20,29,0.3061636081623307,0.5943976793323742
수요/NNG;위축~될/VVX,-1,-0.32111678546481726,33,13,20,22,0.3061636081623307,0.5943976793323742
경제성장/NNG;지속~되/VVX,-1,-0.32111678546481726,33,13,20,18,0.3061636081623307,0.5943976793323742
환율상승/NNG;따른/VV,-1,-0.322107119535487,98,40,58,51,0.4056402554857732,0.7892643172332141
위험/NNG;남/VV,-1,-0.3257114435135178,62,25,37,50,0.3623418067981858,0.7107090405268486
기준금리/NNG;인하~된/VVX,-1,-0.32822248723984415,38,15,23,30,0.3143318883568459,0.6200118643426122
기준금리/NNG;내려/VV,-1,-0.32822248723984415,38,15,23,30,0.3143318883568459,0.6200118643426122
국채금리/NNG;하락~했/VVX,-1,-0.32822248723984415,38,15,23,45,0.3143318883568459,0.6200118643426122
경제/NNG;성장~할/VVX,-1,-0.3309207523021368,67,27,40,46,0.36661936713095855,0.7275316908515506
금리상승/NNG;제한~될/VVX,-1,-0.33219888234477224,55,22,33,47,0.34667958747429517,0.6899379171919255
비용/NNG;늘어나/VV,-1,-0.3347114331769926,43,17,26,33,0.32181839808403245,0.6440861235791245
불확실성/NNG;해소~되/VVX,-1,-0.33635943155335435,173,70,103,176,0.4192814096572386,0.8422655420376756
금리인상/NNG;결정~했/VVX,-1,-0.3394306012901471,21,8,13,7,0.26438998172049993,0.5348041838094717
국제금융시장/NNG;불안/NNG;완화~되/VVX,-1,-0.3394306012901471,21,8,13,2,0.26438998172049993,0.5348041838094717
금리/NNG;상승~한/VAX;마감~했/VVX,-1,-0.3394306012901471,21,8,13,14,0.26438998172049993,0.5348041838094717
금리인하/NNG;힘입/VV,-1,-0.3394306012901471,21,8,13,6,0.26438998172049993,0.5348041838094717
매출/NNG;줄/VV,-1,-0.3394306012901471,21,8,13,17,0.26438998172049993,0.5348041838094717
금리변동성/NNG;커지/VV,-1,-0.3394306012901471,21,8,13,14,0.26438998172049993,0.5348041838094717
인플레이션압력/NNG;완화~하/VVX,-1,-0.3394306012901471,21,8,13,3,0.26438998172049993,0.5348041838094717
금리인하/NNG;지속~될/VVX,-1,-0.3394306012901471,21,8,13,14,0.26438998172049993,0.5348041838094717
연방기금금리/NNG;선물/NNG;오/VV,-1,-0.3394306012901471,21,8,13,13,0.26438998172049993,0.5348041838094717
채권/NNG;시장/NNG;강세/NNG;나타냈/VV,-1,-0.3394306012901471,21,8,13,10,0.26438998172049993,0.5348041838094717
부채/NNG;늘/VV,-1,-0.3394306012901471,21,8,13,14,0.26438998172049993,0.5348041838094717
달러화가치/NNG;떨어질/VV,-1,-0.3394306012901471,21,8,13,7,0.26438998172049993,0.5348041838094717
투자심리/NNG;개선~된/VVX,-1,-0.3402988583475107,26,10,16,25,0.27781885945676404,0.563070454521232
금리/NNG;하락세/NNG;지속~되/VVX,-1,-0.3402988583475107,26,10,16,31,0.27781885945676404,0.563070454521232
양적완화/NNG;통한/VV,-1,-0.3402988583475107,26,10,16,15,0.27781885945676404,0.563070454521232
변동폭/NNG;커지/VV,-1,-0.3402988583475107,26,10,16,8,0.27781885945676404,0.563070454521232
변동성/NNG;줄이/VV,-1,-0.34051803251907353,48,19,29,43,0.32871716757868036,0.6665586415526418
금리급락/NNG;따른/VV,-1,-0.3435760917547386,31,12,19,20,0.2890883379262138,0.5902685096563799
지출/NNG;늘리/VV,-1,-0.3435760917547386,31,12,19,29,0.2890883379262138,0.5902685096563799
장기물/NNG;금리/NNG;상승~하/VVX,-1,-0.3435760917547386,31,12,19,21,0.2890883379262138,0.5902685096563799
미국채금리/NNG;올랐/VV,-1,-0.3435760917547386,31,12,19,28,0.2890883379262138,0.5902685096563799
성장/NNG;중시~하/VVX,-1,-0.3446958076521275,16,6,10,11,0.24713179209383182,0.5058817573298163
금리인하/NNG;이어지/VV,-1,-0.3446958076521275,16,6,10,13,0.24713179209383182,0.5058817573298163
투자/NNG;증가~했/VVX,-1,-0.3446958076521275,16,6,10,9,0.24713179209383182,0.5058817573298163
하방위험/NNG;커지/VV,-1,-0.3446958076521275,16,6,10,27,0.24713179209383182,0.5058817573298163
유로화/NNG;내려앉/VV,-1,-0.3446958076521275,16,6,10,12,0.24713179209383182,0.5058817573298163
투자심리/NNG;안정~되/VVX,-1,-0.3446958076521275,16,6,10,11,0.24713179209383182,0.5058817573298163
실물/NNG;경제/NNG;개선~되/VVX,-1,-0.3446958076521275,16,6,10,5,0.24713179209383182,0.5058817573298163
irs/NNG;금리/NNG;하락~하/VVX,-1,-0.3446958076521275,16,6,10,8,0.24713179209383182,0.5058817573298163
투자매력/NNG;높이/VV,-1,-0.3446958076521275,16,6,10,16,0.24713179209383182,0.5058817573298163
미국채가격/NNG;영향/NNG;하락/NNG;출발/NNG;예상~된다/VVX,-1,-0.3446958076521275,16,6,10,29,0.24713179209383182,0.5058817573298163
이익/NNG;늘어날/VV,-1,-0.3446958076521275,16,6,10,13,0.24713179209383182,0.5058817573298163
수출/NNG;감소세/NNG;지속~하/VVX,-1,-0.3446958076521275,16,6,10,19,0.24713179209383182,0.5058817573298163
원자재/NNG;가격/NNG;급락~하/VVX,-1,-0.3446958076521275,16,6,10,14,0.24713179209383182,0.5058817573298163
교역조건/NNG;악화~되/VVX,-1,-0.3446958076521275,16,6,10,8,0.24713179209383182,0.5058817573298163
원화/NNG;강세/NNG;이어지/VV,-1,-0.3446958076521275,16,6,10,22,0.24713179209383182,0.5058817573298163
디플레이션/NNG;벗어나/VV,-1,-0.3446958076521275,16,6,10,24,0.24713179209383182,0.5058817573298163
양적완화/NNG;줄어들/VV,-1,-0.3446958076521275,16,6,10,9,0.24713179209383182,0.5058817573298163
인플레이션기대/NNG;심리/NNG;잡/VV,-1,-0.3446958076521275,16,6,10,12,0.24713179209383182,0.5058817573298163
소비자물가/NNG;오를/VV,-1,-0.3446958076521275,16,6,10,14,0.24713179209383182,0.5058817573298163
수요/NNG;증가~함/VVX,-1,-0.3446958076521275,16,6,10,9,0.24713179209383182,0.5058817573298163
기준금리/NNG;동결~됨/VVX,-1,-0.3446958076521275,16,6,10,15,0.24713179209383182,0.5058817573298163
달러화/NNG;낙폭/NNG;확대~하/VVX,-1,-0.3446958076521275,16,6,10,16,0.24713179209383182,0.5058817573298163
침체/NNG;보이/VV,-1,-0.3446958076521275,16,6,10,10,0.24713179209383182,0.5058817573298163
통화긴축/NNG;지속~될/VVX,-1,-0.3446958076521275,16,6,10,8,0.24713179209383182,0.5058817573298163
경기둔화/NNG;대응~하/VVX,-1,-0.3446958076521275,16,6,10,13,0.24713179209383182,0.5058817573298163
기준금리/NNG;올려도/VV,-1,-0.3446958076521275,16,6,10,22,0.24713179209383182,0.5058817573298163
금리인상/NNG;신호/NNG;나올/VV,-1,-0.3446958076521275,16,6,10,13,0.24713179209383182,0.5058817573298163
소매판매/NNG;감소~하/VVX,-1,-0.3446958076521275,16,6,10,12,0.24713179209383182,0.5058817573298163
단기물/NNG;강세/NNG;보였/VV,-1,-0.3446958076521275,16,6,10,9,0.24713179209383182,0.5058817573298163
기준금리/NNG;수준/NNG;유지~될/VVX,-1,-0.3446958076521275,16,6,10,10,0.24713179209383182,0.5058817573298163
변동성/NNG;확대~될/VVX,-1,-0.3459788049983702,204,82,122,184,0.4134351106663895,0.8487717165984976
금리상승/NNG;이어질/VV,-1,-0.34773505265177007,36,14,22,30,0.2989329521107369,0.616152850902446
집값/NNG;떨어지/VV,-1,-0.34773505265177007,36,14,22,27,0.2989329521107369,0.616152850902446
성장/NNG;위해/VV,-1,-0.34927303810619725,75,30,45,45,0.365420909758849,0.7558332968708212
물가안정/NNG;유지~하/VVX,-1,-0.3500908055322167,58,23,35,19,0.34099449480017996,0.7066231510686365
단기금리/NNG;하락~하/VVX,-1,-0.3562335587025195,46,18,28,21,0.3156961145185462,0.6634299022973256
수익/NNG;올리/VV,-1,-0.3571720583769219,68,27,41,60,0.35152365369511,0.7403085106683448
경기회복/NNG;위해/VV,-1,-0.3594074300419825,105,42,63,64,0.38469791941850623,0.8143323862100673
수요/NNG;줄어든/VV,-1,-0.3600573764875762,51,20,31,24,0.32296920580308724,0.6846841868585808
금리/NNG;내리/VV;않/VX,-1,-0.3634632329787335,56,22,34,28,0.32964295325901316,0.7043211361329816
금리/NNG;인하~될/VVX,-1,-0.36770389189367825,103,41,62,68,0.37778435932791016,0.8151076595854244
원자재/NNG;가격/NNG;상승~하/VVX,-1,-0.3694287031308513,29,11,18,16,0.2704887953399379,0.5859368748389859
순이익/NNG;감소~할/VVX,-1,-0.3694287031308513,29,11,18,15,0.2704887953399379,0.5859368748389859
신용스프레드/NNG;축소~된/VVX,-1,-0.3694287031308513,29,11,18,17,0.2704887953399379,0.5859368748389859
달러강세/NNG;나타나/VV,-1,-0.3694287031308513,29,11,18,39,0.2704887953399379,0.5859368748389859
경제/NNG;위축~될/VVX,-1,-0.3694287031308513,29,11,18,12,0.2704887953399379,0.5859368748389859
금리인상/NNG;지속~되/VVX,-1,-0.369661670178438,34,13,21,16,0.2824076939842619,0.6120853880691075
경기침체/NNG;겪/VV,-1,-0.369661670178438,34,13,21,27,0.2824076939842619,0.6120853880691075
이중침체/NNG;빠질/VV,-1,-0.369661670178438,34,13,21,23,0.2824076939842619,0.6120853880691075
소비/NNG;회복~되/VVX,-1,-0.369661670178438,34,13,21,29,0.2824076939842619,0.6120853880691075
금리인하/NNG;인해/VV,-1,-0.37123050985287187,39,15,24,19,0.2927673121805344,0.6368463365968948
듀레이션/NNG;줄여/VV,-1,-0.37211200677273404,24,9,15,10,0.2562731049508104,0.5586012163148782
금리/NNG;올리/VV;어렵/VA,-1,-0.37211200677273404,24,9,15,15,0.2562731049508104,0.5586012163148782
소비자물가/NNG;올랐/VV,-1,-0.37211200677273404,24,9,15,13,0.2562731049508104,0.5586012163148782
인플레이션압력/NNG;높일/VV,-1,-0.37211200677273404,24,9,15,10,0.2562731049508104,0.5586012163148782
소매판매/NNG;증가~하/VVX,-1,-0.37211200677273404,24,9,15,32,0.2562731049508104,0.5586012163148782
안전자산선호/NNG;강화~될/VVX,-1,-0.37211200677273404,24,9,15,16,0.2562731049508104,0.5586012163148782
금리인상/NNG;고려~할/VVX,-1,-0.37334704676829844,44,17,27,24,0.3019709382986179,0.6600967033610565
경제성장/NNG;촉진~하/VVX,-1,-0.37334704676829844,44,17,27,14,0.3019709382986179,0.6600967033610565
금리인하/NNG;단행~할/VVX,-1,-0.37479280233549184,215,85,130,115,0.3922001009189073,0.8602160525354025
금리급등/NNG;따른/VV,-1,-0.37570080903425895,91,36,55,63,0.36391292954649634,0.7998593003155335
유로화/NNG;상승~했/VVX,-1,-0.37774993608698115,54,21,33,25,0.31779446354055757,0.7018315466918786
물가/NNG;하락~하/VVX,-1,-0.3796912628246629,59,23,36,48,0.32468072779216717,0.7202910663859312
금리/NNG;올리/VV;못할/VX,-1,-0.3812135514420716,19,7,12,16,0.23823761426086212,0.5304018445498645
성장모멘텀/NNG;약화~되/VVX,-1,-0.3812135514420716,19,7,12,9,0.23823761426086212,0.5304018445498645
시장변동성/NNG;커지/VV,-1,-0.3812135514420716,19,7,12,15,0.23823761426086212,0.5304018445498645
인플레이션압력/NNG;강화~될/VVX,-1,-0.3812135514420716,19,7,12,6,0.23823761426086212,0.5304018445498645
기준금리인상/NNG;앞당길/VV,-1,-0.3812135514420716,19,7,12,9,0.23823761426086212,0.5304018445498645
국채/NNG;매입/NNG;늘리/VV,-1,-0.3812135514420716,19,7,12,20,0.23823761426086212,0.5304018445498645
수익/NNG;확보~하/VVX,-1,-0.3812135514420716,19,7,12,27,0.23823761426086212,0.5304018445498645
엔화/NNG;강세/NNG;보인/VV,-1,-0.3812135514420716,19,7,12,12,0.23823761426086212,0.5304018445498645
국고채/NNG;금리/NNG;내렸으며/VV,-1,-0.3812135514420716,19,7,12,9,0.23823761426086212,0.5304018445498645
수요/NNG;줄어드/VV,-1,-0.3812135514420716,19,7,12,18,0.23823761426086212,0.5304018445498645
비용/NNG;늘/VV,-1,-0.3812135514420716,19,7,12,13,0.23823761426086212,0.5304018445498645
금리인하/NNG;가능성/NNG;열/VV,-1,-0.38423762392787153,109,43,66,57,0.36973098363124696,0.8289957668743636
금리인하/NNG;단행~했/VVX,-1,-0.38531528264533954,89,35,54,37,0.35588462380479685,0.7999675299589669
경기둔화/NNG;따른/VV,-1,-0.3915151177760271,140,55,85,96,0.3748454097019469,0.8549591727951557
지표물/NNG;국고채/NNG;금리/NNG;오른/VV,-1,-0.3925351829103453,37,14,23,32,0.27681740585387604,0.6328947692541336
경쟁력/NNG;확보~하/VVX,-1,-0.3925351829103453,37,14,23,28,0.27681740585387604,0.6328947692541336
경기회복/NNG;지속~되/VVX,-1,-0.3945400264683584,32,12,20,34,0.2645793982488126,0.6077860519302939
듀레이션/NNG;확대~하/VVX,-1,-0.3945400264683584,32,12,20,21,0.2645793982488126,0.6077860519302939
금리/NNG;내려갔/VV,-1,-0.3945400264683584,32,12,20,38,0.2645793982488126,0.6077860519302939
기준금리/NNG;낮춰/VV,-1,-0.3945400264683584,32,12,20,19,0.2645793982488126,0.6077860519302939
수익성/NNG;떨어지/VV,-1,-0.3995851718739427,27,10,17,25,0.25007261739284076,0.5813708826364247
실업률/NNG;하락~하/VVX,-1,-0.4064332045312835,80,31,49,66,0.3340129459212687,0.7892930182571867
미국채금리/NNG;오르/VV,-1,-0.41068714586829347,45,17,28,39,0.28286937823820657,0.6752855701649314
금리/NNG;급락~했/VVX,-1,-0.41068714586829347,45,17,28,27,0.28286937823820657,0.6752855701649314
국채가격/NNG;상승~하/VVX,-1,-0.41071982955943287,22,8,14,16,0.23200165450291516,0.5538940465426261
물가상승률/NNG;하락~하/VVX,-1,-0.41071982955943287,22,8,14,17,0.23200165450291516,0.5538940465426261
달러화/NNG;상승압력/NNG;가했/VV,-1,-0.41071982955943287,22,8,14,14,0.23200165450291516,0.5538940465426261
투자심리/NNG;약화~되/VVX,-1,-0.41071982955943287,22,8,14,6,0.23200165450291516,0.5538940465426261
금리인하/NNG;그칠/VV,-1,-0.41071982955943287,22,8,14,8,0.23200165450291516,0.5538940465426261
미국채금리/NNG;급등~하/VVX,-1,-0.41071982955943287,22,8,14,28,0.23200165450291516,0.5538940465426261
물가상승압력/NNG;지속~될/VVX,-1,-0.41071982955943287,22,8,14,14,0.23200165450291516,0.5538940465426261
투자심리/NNG;악화~됐/VVX,-1,-0.41071982955943287,22,8,14,17,0.23200165450291516,0.5538940465426261
금리인하/NNG;따른/VV,-1,-0.4129152467421211,199,77,122,135,0.36390844858556853,0.8734128462451596
달러화/NNG;강세/NNG;지지/NNG;받/VV,-1,-0.41640987133083807,35,13,22,24,0.25974831633254697,0.6286929244876382
시장변동성/NNG;확대~될/VVX,-1,-0.41640987133083807,35,13,22,34,0.25974831633254697,0.6286929244876382
경기/NNG;회복~될/VVX,-1,-0.4203829734259157,68,26,42,49,0.31216562913848056,0.7628617184438915
달러엔/NNG;상승~했/VVX,-1,-0.42306465460628695,30,11,19,17,0.24523975816483845,0.6032245942302938
하방위험/NNG;상존~하/VVX,-1,-0.42306465460628695,30,11,19,29,0.24523975816483845,0.6032245942302938
기준금리/NNG;인하~해야/VVX,-1,-0.4232043296123107,58,22,36,35,0.29713813799046035,0.731129044449205
양적완화/NNG;시행~하/VVX,-1,-0.4306584085874744,43,16,27,33,0.26805802485660996,0.671685518459991
금리인상/NNG;단행~했/VVX,-1,-0.43190129664360755,94,36,58,51,0.3287154287297317,0.8261915610578727
기준금리/NNG;내릴/VV,-1,-0.4334332027759261,154,59,95,131,0.3468222960070999,0.8749864456172957
경기/NNG;뚜렷~한/VAX;회복세/NNG;보이/VV,-1,-0.435065297494466,17,6,11,5,0.2075561945105339,0.5257429251437817
금리인상/NNG;나타날/VV,-1,-0.435065297494466,17,6,11,11,0.2075561945105339,0.5257429251437817
crs금리/NNG;급락~하/VVX,-1,-0.435065297494466,17,6,11,7,0.2075561945105339,0.5257429251437817
금리/NNG;하락~했으며/VVX,-1,-0.435065297494466,17,6,11,10,0.2075561945105339,0.5257429251437817
채권금리/NNG;급락~했/VVX,-1,-0.435065297494466,17,6,11,5,0.2075561945105339,0.5257429251437817
위험/NNG;대비~해야/VVX,-1,-0.435065297494466,17,6,11,16,0.2075561945105339,0.5257429251437817
원화/NNG;강세/NNG;베팅/NNG;하/VV,-1,-0.435065297494466,17,6,11,11,0.2075561945105339,0.5257429251437817
자산매입/NNG;줄이/VV,-1,-0.435065297494466,17,6,11,20,0.2075561945105339,0.5257429251437817
수익/NNG;증가~하/VVX,-1,-0.435065297494466,17,6,11,19,0.2075561945105339,0.5257429251437817
양적완화/NNG;할/VV,-1,-0.435065297494466,17,6,11,14,0.2075561945105339,0.5257429251437817
경기/NNG;회복~되/VVX;않/VX,-1,-0.435065297494466,17,6,11,7,0.2075561945105339,0.5257429251437817
금리/NNG;상승~한/VAX;마쳤/VV,-1,-0.435065297494466,17,6,11,7,0.2075561945105339,0.5257429251437817
금리/NNG;낮/VA;수준/NNG;유지~할/VVX,-1,-0.435065297494466,17,6,11,13,0.2075561945105339,0.5257429251437817
성장/NNG;이어질/VV,-1,-0.435065297494466,17,6,11,10,0.2075561945105339,0.5257429251437817
매출/NNG;증가~할/VVX,-1,-0.435065297494466,17,6,11,8,0.2075561945105339,0.5257429251437817
주택시장/NNG;안정~되/VVX,-1,-0.435065297494466,17,6,11,2,0.2075561945105339,0.5257429251437817
cd금리/NNG;상승~했/VVX,-1,-0.435065297494466,17,6,11,9,0.2075561945105339,0.5257429251437817
연방기금/NNG;금리선물/NNG;시장/NNG;오/VV,-1,-0.435065297494466,17,6,11,20,0.2075561945105339,0.5257429251437817
시장/NNG;변동성/NNG;확대~될/VVX,-1,-0.435065297494466,17,6,11,25,0.2075561945105339,0.5257429251437817
경기회복/NNG;이끌/VV,-1,-0.4352697795007572,25,9,16,12,0.22749019498250794,0.5765262214419854
임금/NNG;오르/VV,-1,-0.4352697795007572,25,9,16,12,0.22749019498250794,0.5765262214419854
수입/NNG;증가~하/VVX,-1,-0.4352697795007572,25,9,16,21,0.22749019498250794,0.5765262214419854
금리/NNG;빠지/VV,-1,-0.43561503411273594,38,14,24,36,0.2557502768418902,0.6486968195505013
금리인상/NNG;가능성/NNG;있/VV,-1,-0.43561503411273594,38,14,24,40,0.2557502768418902,0.6486968195505013
수입/NNG;줄/VV,-1,-0.4433891021690547,33,12,21,21,0.24141007781264584,0.62421256625439
금리/NNG;상승세/NNG;보였/VV,-1,-0.4433891021690547,33,12,21,25,0.24141007781264584,0.62421256625439
차입금/NNG;증가~하/VVX,-1,-0.44665374413429393,46,17,29,31,0.2645870127754841,0.6897218071779709
가계부채/NNG;늘어나/VV,-1,-0.448089230105982,64,24,40,45,0.2903598991596571,0.7596220194741209
채권금리/NNG;오르/VV,-1,-0.448089230105982,64,24,40,81,0.2903598991596571,0.7596220194741209
금리/NNG;끌어올리/VV,-1,-0.4525946981654648,41,15,26,30,0.2524059250961313,0.6678190332415794
금리인하/NNG;될/VV,-1,-0.4561325669091719,28,10,18,20,0.22415094855563295,0.5983616336795455
소비자물가/NNG;올라/VV,-1,-0.4561325669091719,28,10,18,18,0.22415094855563295,0.5983616336795455
금리인하/NNG;있/VV,-1,-0.4561325669091719,28,10,18,14,0.22415094855563295,0.5983616336795455
수요/NNG;회복~되/VVX,-1,-0.4561325669091719,28,10,18,26,0.22415094855563295,0.5983616336795455
투자심리/NNG;위축~된/VVX,-1,-0.4567368228679438,119,45,74,72,0.3237638390871328,0.8655915446766514
경기회복세/NNG;보이/VV,-1,-0.45852538874116633,20,7,13,24,0.20437471528219983,0.5488738618222242
국고/NNG;금리/NNG;상승~하/VVX,-1,-0.45852538874116633,20,7,13,24,0.20437471528219983,0.5488738618222242
수급부담/NNG;덜/VV,-1,-0.45852538874116633,20,7,13,4,0.20437471528219983,0.5488738618222242
경제성장률/NNG;하락~하/VVX,-1,-0.45852538874116633,20,7,13,14,0.20437471528219983,0.5488738618222242
물가상승압력/NNG;완화~되/VVX,-1,-0.45852538874116633,20,7,13,10,0.20437471528219983,0.5488738618222242
경쟁력강화/NNG;위해/VV,-1,-0.45852538874116633,20,7,13,10,0.20437471528219983,0.5488738618222242
원화/NNG;강세/NNG;지속~되/VVX,-1,-0.45852538874116633,20,7,13,23,0.20437471528219983,0.5488738618222242
물가상승압력/NNG;완화~될/VVX,-1,-0.45852538874116633,20,7,13,10,0.20437471528219983,0.5488738618222242
금리/NNG;내려왔/VV,-1,-0.45852538874116633,20,7,13,11,0.20437471528219983,0.5488738618222242
양적완화/NNG;시행~할/VVX,-1,-0.45852538874116633,20,7,13,17,0.20437471528219983,0.5488738618222242
스왑베이시스/NNG;확대~됐/VVX,-1,-0.45852538874116633,20,7,13,10,0.20437471528219983,0.5488738618222242
물가/NNG;올라/VV,-1,-0.45852538874116633,20,7,13,24,0.20437471528219983,0.5488738618222242
국채가격/NNG;하락~하/VVX,-1,-0.45852538874116633,20,7,13,8,0.20437471528219983,0.5488738618222242
비용/NNG;낮추/VV,-1,-0.45852538874116633,20,7,13,9,0.20437471528219983,0.5488738618222242
시장/NNG;불확실성/NNG;커지/VV,-1,-0.45852538874116633,20,7,13,8,0.20437471528219983,0.5488738618222242
채권/NNG;시장/NNG;강세/NNG;이어질/VV,-1,-0.45852538874116633,20,7,13,16,0.20437471528219983,0.5488738618222242
콜금리/NNG;동결~했/VVX,-1,-0.45852538874116633,20,7,13,14,0.20437471528219983,0.5488738618222242
침체/NNG;인해/VV,-1,-0.45852538874116633,20,7,13,11,0.20437471528219983,0.5488738618222242
설비투자/NNG;감소~하/VVX,-1,-0.45852538874116633,20,7,13,15,0.20437471528219983,0.5488738618222242
기준금리인상/NNG;가능~할/VVX,-1,-0.45852538874116633,20,7,13,25,0.20437471528219983,0.5488738618222242
소매판매/NNG;증가~했/VVX,-1,-0.45852538874116633,20,7,13,27,0.20437471528219983,0.5488738618222242
금리인하/NNG;인한/VV,-1,-0.4611597537600942,36,13,23,25,0.23833346810092018,0.6443558038841344
금리인하/NNG;가능성/NNG;시사~했/VVX,-1,-0.4611597537600942,36,13,23,18,0.23833346810092018,0.6443558038841344
기준금리인하/NNG;단행~될/VVX,-1,-0.4611597537600942,36,13,23,19,0.23833346810092018,0.6443558038841344
수요/NNG;줄/VV,-1,-0.46711292276710026,96,36,60,65,0.3067255763399989,0.8419117421538435
회사채/NNG;수익률/NNG;오른/VV,-1,-0.47682160987701094,39,14,25,25,0.23583331343925176,0.6636616751584848
부채/NNG;늘리/VV,-1,-0.478119054867189,23,8,15,9,0.20234737025178887,0.5713411317073442
기대심리/NNG;확대~되/VVX,-1,-0.478119054867189,23,8,15,25,0.20234737025178887,0.5713411317073442
재정지출확대/NNG;따른/VV,-1,-0.478119054867189,23,8,15,6,0.20234737025178887,0.5713411317073442
기준금리인하/NNG;단행~되/VVX,-1,-0.478119054867189,23,8,15,10,0.20234737025178887,0.5713411317073442
통화긴축/NNG;중단~할/VVX,-1,-0.478119054867189,23,8,15,17,0.20234737025178887,0.5713411317073442
국채가격/NNG;하락~했/VVX,-1,-0.48404454598377666,97,36,61,52,0.2961844079595951,0.8492609542682206
시장금리/NNG;하락~하/VVX,-1,-0.48451263675350353,105,39,66,90,0.29978497927547737,0.8606344436313894
유가급등/NNG;따른/VV,-1,-0.48546909153030415,55,20,35,32,0.25663484903562767,0.7385980985282938
집값/NNG;오르/VV,-1,-0.4890819964634343,63,23,40,43,0.26471147020642033,0.7690786551324865
집값/NNG;오를/VV,-1,-0.4898674745507384,34,12,22,29,0.21972554668624864,0.6396959754433327
경기과열/NNG;막/VV,-1,-0.49489021619484175,26,9,17,28,0.20105889034984586,0.5931456169230973
대출/NNG;줄어들/VV,-1,-0.49489021619484175,26,9,17,20,0.20105889034984586,0.5931456169230973
기준금리/NNG;하회~하/VVX,-1,-0.49489021619484175,26,9,17,33,0.20105889034984586,0.5931456169230973
기준금리인하/NNG;통해/VV,-1,-0.49489021619484175,26,9,17,19,0.20105889034984586,0.5931456169230973
성장/NNG;위한/VV,-1,-0.4997740163822969,74,27,47,85,0.2697081836751166,0.8060359878731896
유동성/NNG;확보~하/VVX,-1,-0.5008722416553777,90,33,57,65,0.28121217964961637,0.8428760617458187
금리/NNG;인하~되/VVX,-1,-0.5054633087544549,61,22,39,40,0.2527696682323508,0.7669745152465604
순이익/NNG;감소~하/VVX,-1,-0.5064503862560443,15,5,10,17,0.1711425427350827,0.520671048925089
금리인하/NNG;기대/NNG;반영~하/VVX,-1,-0.5064503862560443,15,5,10,13,0.1711425427350827,0.520671048925089
유가하락/NNG;인한/VV,-1,-0.5064503862560443,15,5,10,29,0.1711425427350827,0.520671048925089
금가격/NNG;상승~했/VVX,-1,-0.5064503862560443,15,5,10,7,0.1711425427350827,0.520671048925089
물가안정/NNG;달성~하/VVX,-1,-0.5064503862560443,15,5,10,13,0.1711425427350827,0.520671048925089
디플레이션/NNG;우려/NNG;제기~되/VVX,-1,-0.5064503862560443,15,5,10,12,0.1711425427350827,0.520671048925089
성장세/NNG;예상~되/VVX,-1,-0.5064503862560443,15,5,10,6,0.1711425427350827,0.520671048925089
성장/NNG;무게/NNG;두/VV,-1,-0.5064503862560443,15,5,10,5,0.1711425427350827,0.520671048925089
외환보유액/NNG;증가~하/VVX,-1,-0.5064503862560443,15,5,10,20,0.1711425427350827,0.520671048925089
발행/NNG;금리/NNG;낮추/VV,-1,-0.5064503862560443,15,5,10,13,0.1711425427350827,0.520671048925089
금리인하/NNG;나선/VV,-1,-0.5064503862560443,15,5,10,26,0.1711425427350827,0.520671048925089
증시/NNG;하락압력/NNG;받/VV,-1,-0.5064503862560443,15,5,10,5,0.1711425427350827,0.520671048925089
연체율/NNG;상승~했/VVX,-1,-0.5064503862560443,15,5,10,7,0.1711425427350827,0.520671048925089
재정위기/NNG;확산~될/VVX,-1,-0.5064503862560443,15,5,10,17,0.1711425427350827,0.520671048925089
지급준비율/NNG;낮추/VV,-1,-0.5064503862560443,15,5,10,14,0.1711425427350827,0.520671048925089
성장둔화/NNG;인한/VV,-1,-0.5064503862560443,15,5,10,1,0.1711425427350827,0.520671048925089
경제지표/NNG;상회~하/VVX,-1,-0.5064503862560443,15,5,10,6,0.1711425427350827,0.520671048925089
금리/NNG;내린다고/VV,-1,-0.5064503862560443,15,5,10,15,0.1711425427350827,0.520671048925089
부양책/NNG;발표~할/VVX,-1,-0.5064503862560443,15,5,10,6,0.1711425427350827,0.520671048925089
침체/NNG;빠졌/VV,-1,-0.5064503862560443,15,5,10,12,0.1711425427350827,0.520671048925089
경기/NNG;부양책/NNG;고려~하/VVX,-1,-0.5064503862560443,15,5,10,4,0.1711425427350827,0.520671048925089
금리상승/NNG;커졌/VV,-1,-0.5064503862560443,15,5,10,6,0.1711425427350827,0.520671048925089
단기물/NNG;금리/NNG;오르/VV,-1,-0.5064503862560443,15,5,10,15,0.1711425427350827,0.520671048925089
수요/NNG;약화~되/VVX,-1,-0.5064503862560443,15,5,10,26,0.1711425427350827,0.520671048925089
실적/NNG;올린/VV,-1,-0.5064503862560443,15,5,10,8,0.1711425427350827,0.520671048925089
수요/NNG;부진~하/VVX,-1,-0.5064503862560443,15,5,10,9,0.1711425427350827,0.520671048925089
기준금리/NNG;인하/VV,-1,-0.5064503862560443,15,5,10,18,0.1711425427350827,0.520671048925089
내수부진/NNG;심화~되/VVX,-1,-0.5064503862560443,15,5,10,3,0.1711425427350827,0.520671048925089
대출/NNG;감소~하/VVX,-1,-0.5064503862560443,15,5,10,9,0.1711425427350827,0.520671048925089
국채선물/NNG;하락~한/VAX;기록~하/VVX,-1,-0.5064503862560443,15,5,10,16,0.1711425427350827,0.520671048925089
기준금리/NNG;내리/VV;않/VX,-1,-0.5064503862560443,15,5,10,16,0.1711425427350827,0.520671048925089
달러화/NNG;반등~할/VVX,-1,-0.5094872918833245,29,10,19,26,0.20026528666360696,0.6142672445866553
금리인하/NNG;기대심리/NNG;약화~되/VVX,-1,-0.5094872918833245,29,10,19,18,0.20026528666360696,0.6142672445866553
경기/NNG;부양책/NNG;나올/VV,-1,-0.5094872918833245,29,10,19,13,0.20026528666360696,0.6142672445866553
gdp/NNG;증가~하/VVX,-1,-0.5139465200257625,56,20,36,28,0.2417738547492908,0.7505764820947216
실업률/NNG;상승~하/VVX,-1,-0.5141859772729418,48,17,31,31,0.23066955936216324,0.7165687704906679
인플레이션/NNG;잡/VV,-1,-0.5165681104093172,99,36,63,84,0.2760152173535108,0.863000074442007
엔화/NNG;상승~하/VVX,-1,-0.5188443429891774,18,6,12,11,0.17273064143096475,0.5434270600754815
엔화/NNG;떨어졌/VV,-1,-0.5188443429891774,18,6,12,14,0.17273064143096475,0.5434270600754815
소비/NNG;감소~하/VVX,-1,-0.5188443429891774,18,6,12,22,0.17273064143096475,0.5434270600754815
금리/NNG;강세/NNG;보였/VV,-1,-0.5188443429891774,18,6,12,9,0.17273064143096475,0.5434270600754815
금융시장/NNG;확산~되/VVX,-1,-0.5188443429891774,18,6,12,4,0.17273064143096475,0.5434270600754815
인플레이션/NNG;우려/NNG;완화~된/VVX,-1,-0.5188443429891774,18,6,12,13,0.17273064143096475,0.5434270600754815
대출/NNG;늘어날/VV,-1,-0.5188443429891774,18,6,12,17,0.17273064143096475,0.5434270600754815
투자/NNG;늘어난/VV,-1,-0.5188443429891774,18,6,12,9,0.17273064143096475,0.5434270600754815
스프레드축소/NNG;따른/VV,-1,-0.5188443429891774,18,6,12,16,0.17273064143096475,0.5434270600754815
마이너스성장/NNG;기록~하/VVX,-1,-0.5188443429891774,18,6,12,8,0.17273064143096475,0.5434270600754815
경기/NNG;회복~시키/VVX,-1,-0.5188443429891774,18,6,12,23,0.17273064143096475,0.5434270600754815
성장둔화/NNG;따른/VV,-1,-0.5188443429891774,18,6,12,12,0.17273064143096475,0.5434270600754815
성장/NNG;지지~하/VVX,-1,-0.5188443429891774,18,6,12,7,0.17273064143096475,0.5434270600754815
금리/NNG;빠졌/VV,-1,-0.5188443429891774,18,6,12,19,0.17273064143096475,0.5434270600754815
주택가격/NNG;떨어지/VV,-1,-0.5188443429891774,18,6,12,14,0.17273064143096475,0.5434270600754815
기준금리/NNG;내렸/VV,-1,-0.5210270528919124,102,37,65,59,0.27447114510031134,0.8686805472485696
기준금리/NNG;인하~되/VVX,-1,-0.5210270528919124,102,37,65,106,0.27447114510031134,0.8686805472485696
경기침체/NNG;이어질/VV,-1,-0.5223415149040758,32,11,21,9,0.19981424622992247,0.6346793877265683
주택담보대출/NNG;증가~하/VVX,-1,-0.5223415149040758,32,11,21,22,0.19981424622992247,0.6346793877265683
듀레이션/NNG;줄이/VV,-1,-0.5241464576388077,51,18,33,47,0.22948305605690938,0.7325406130104835
채권금리/NNG;상승~했/VVX,-1,-0.5241464576388077,51,18,33,66,0.22948305605690938,0.7325406130104835
양적완화/NNG;나설/VV,-1,-0.5241464576388077,51,18,33,49,0.22948305605690938,0.7325406130104835
금리/NNG;내려가/VV,-1,-0.5254967652141476,127,46,81,95,0.27898775992963576,0.893883019715726
국채수익률/NNG;오를/VV,-1,-0.530256760994226,21,7,14,13,0.17425968697097366,0.5657295919530603
유로화/NNG;반락~했/VVX,-1,-0.530256760994226,21,7,14,7,0.17425968697097366,0.5657295919530603
경기/NNG;회복/NNG;조짐/NNG;보이/VV,-1,-0.530256760994226,21,7,14,4,0.17425968697097366,0.5657295919530603
기준금리인상/NNG;단행~했/VVX,-1,-0.530256760994226,21,7,14,17,0.17425968697097366,0.5657295919530603
설비투자/NNG;늘어나/VV,-1,-0.530256760994226,21,7,14,16,0.17425968697097366,0.5657295919530603
금리인상/NNG;진행~될/VVX,-1,-0.530256760994226,21,7,14,24,0.17425968697097366,0.5657295919530603
금리/NNG;상승~한/VAX;고시~됐/VVX,-1,-0.530256760994226,21,7,14,16,0.17425968697097366,0.5657295919530603
적자/NNG;지속~되/VVX,-1,-0.530256760994226,21,7,14,11,0.17425968697097366,0.5657295919530603
수신/NNG;늘/VV,-1,-0.530256760994226,21,7,14,16,0.17425968697097366,0.5657295919530603
국고채/NNG;금리/NNG;오른/VV,-1,-0.5305673851245347,89,32,57,70,0.26175098305190136,0.8505007671813458
유동성확보/NNG;위한/VV,-1,-0.5337560681916553,35,12,23,13,0.1996060774631303,0.6543553674072254
수요증가/NNG;따른/VV,-1,-0.5337560681916553,35,12,23,23,0.1996060774631303,0.6543553674072254
경기/NNG;악화~될/VVX,-1,-0.5337560681916553,35,12,23,20,0.1996060774631303,0.6543553674072254
달러화/NNG;올랐/VV,-1,-0.5337560681916553,35,12,23,32,0.1996060774631303,0.6543553674072254
통화정책/NNG;완화~하/VVX,-1,-0.5337560681916553,35,12,23,27,0.1996060774631303,0.6543553674072254
기대심리/NNG;확산~되/VVX,-1,-0.5368121440089474,46,16,30,44,0.2155921537174237,0.7128256033099317
기준금리/NNG;내리/VV,-1,-0.5395658558348154,235,84,151,147,0.2741326283433042,0.9134168014416675
시장금리상승/NNG;따른/VV,-1,-0.5407571841469171,24,8,16,21,0.17573131077103774,0.5875089405341946
기준금리/NNG;인하~한다면/VVX,-1,-0.5407571841469171,24,8,16,17,0.17573131077103774,0.5875089405341946
금리/NNG;상승~했으나/VVX,-1,-0.5407571841469171,24,8,16,28,0.17573131077103774,0.5875089405341946
경제주체/NNG;심리/NNG;개선~되/VVX,-1,-0.5407571841469171,24,8,16,8,0.17573131077103774,0.5875089405341946
내외금리차/NNG;축소~되/VVX,-1,-0.5407571841469171,24,8,16,14,0.17573131077103774,0.5875089405341946
불안심리/NNG;확산~하/VVX,-1,-0.5407571841469171,24,8,16,14,0.17573131077103774,0.5875089405341946
경기침체/NNG;지속~되/VVX,-1,-0.5407571841469171,24,8,16,16,0.17573131077103774,0.5875089405341946
소비자/NNG;물가상승률/NNG;물가안정/NNG;목표/NNG;유지~되/VVX,-1,-0.5407571841469171,24,8,16,29,0.17573131077103774,0.5875089405341946
저축/NNG;늘리/VV,-1,-0.5407571841469171,24,8,16,15,0.17573131077103774,0.5875089405341946
금리상승/NNG;이끌/VV,-1,-0.5439540785305903,38,13,25,32,0.19957302193930646,0.6732715440841497
신용경색/NNG;완화~되/VVX,-1,-0.5456415070622862,49,17,32,13,0.21508337654188753,0.7290776530156873
투자/NNG;늘어날/VV,-1,-0.5504112363926479,27,9,18,26,0.17714716461666924,0.6087035661607436
위험/NNG;완화~되/VVX,-1,-0.5504112363926479,27,9,18,24,0.17714716461666924,0.6087035661607436
달러약세/NNG;부추기/VV,-1,-0.5504112363926479,27,9,18,20,0.17714716461666924,0.6087035661607436
금리상승압력/NNG;작용~할/VVX,-1,-0.553106073783251,41,14,27,32,0.19966759828865666,0.691408773278072
원달러/NNG;하락~하/VVX,-1,-0.553106073783251,41,14,27,26,0.19966759828865666,0.691408773278072
금리/NNG;상승세/NNG;보이/VV,-1,-0.553106073783251,41,14,27,36,0.19966759828865666,0.691408773278072
경기/NNG;하강~하/VVX,-1,-0.5674228893536274,33,11,22,12,0.17981821469934184,0.6491337743506893
금리인하/NNG;이/VV,-1,-0.5674228893536274,33,11,22,30,0.17981821469934184,0.6491337743506893
인플레이션압력/NNG;증가~하/VVX,-1,-0.5674228893536274,33,11,22,19,0.17981821469934184,0.6491337743506893
달러화/NNG;상승~할/VVX,-1,-0.5687841731804366,47,16,31,59,0.20011229140385758,0.7252954457972559
이자/NNG;부담/NNG;덜/VV,-1,-0.5687841731804366,47,16,31,39,0.20011229140385758,0.7252954457972559
국채가격/NNG;상승/NNG;견인~했/VVX,-1,-0.5748920424755746,36,12,24,12,0.18107673496021848,0.6682872312999844
고용지표/NNG;호조/NNG;보이/VV,-1,-0.5755089582582917,50,17,33,51,0.20041873315882283,0.7410323714513338
금리/NNG;인하~했/VVX,-1,-0.5762985603092344,120,42,78,79,0.24396523150295074,0.9041695384395075
경기/NNG;악화~되/VVX,-1,-0.5817381468245546,39,13,26,32,0.1822861191686161,0.6866911879262028
유로달러/NNG;오른/VV,-1,-0.5937440354005024,45,15,30,28,0.18456397546844175,0.7211689448851624
금리/NNG;내린/VV,-1,-0.5937991877774764,241,83,158,191,0.2373492088546539,0.9275805269263714
조달금리/NNG;상승~하/VVX,-1,-0.5942058343758815,19,6,13,7,0.1430041500904007,0.5595726789227268
금리/NNG;하락~한/VAX;마감~했/VVX,-1,-0.5942058343758815,19,6,13,16,0.1430041500904007,0.5595726789227268
양적완화/NNG;발표~하/VVX,-1,-0.5942058343758815,19,6,13,15,0.1430041500904007,0.5595726789227268
수요/NNG;확대~하/VVX,-1,-0.5942058343758815,19,6,13,10,0.1430041500904007,0.5595726789227268
매수/NNG;심리/NNG;위축~시키/VVX,-1,-0.5942058343758815,19,6,13,14,0.1430041500904007,0.5595726789227268
스프레드확대/NNG;따른/VV,-1,-0.5942058343758815,19,6,13,8,0.1430041500904007,0.5595726789227268
고용/NNG;부진~하/VVX,-1,-0.5942058343758815,19,6,13,14,0.1430041500904007,0.5595726789227268
고용지표/NNG;밑돌/VV,-1,-0.5942058343758815,19,6,13,10,0.1430041500904007,0.5595726789227268
금리상승압력/NNG;커질/VV,-1,-0.5942058343758815,19,6,13,23,0.1430041500904007,0.5595726789227268
일자리/NNG;늘어나/VV,-1,-0.5942058343758815,19,6,13,17,0.1430041500904007,0.5595726789227268
금리상승/NNG;막/VV,-1,-0.5942058343758815,19,6,13,15,0.1430041500904007,0.5595726789227268
위험/NNG;내포~하/VVX,-1,-0.5942058343758815,19,6,13,10,0.1430041500904007,0.5595726789227268
기준금리/NNG;떨어지/VV,-1,-0.5953558662000484,22,7,15,22,0.14804680084714086,0.5813633283640399
금리인상/NNG;전망/NNG;따른/VV,-1,-0.5953558662000484,22,7,15,23,0.14804680084714086,0.5813633283640399
채권/NNG;시장강세/NNG;지지~하/VVX,-1,-0.5953558662000484,22,7,15,19,0.14804680084714086,0.5813633283640399
수입/NNG;줄어들/VV,-1,-0.5953558662000484,22,7,15,16,0.14804680084714086,0.5813633283640399
불안심리/NNG;확대~되/VVX,-1,-0.5953558662000484,22,7,15,19,0.14804680084714086,0.5813633283640399
기준금리/NNG;밑돌/VV,-1,-0.5953558662000484,22,7,15,14,0.14804680084714086,0.5813633283640399
완화정책/NNG;나올/VV,-1,-0.5958237239143773,16,5,11,6,0.13664963117235607,0.5373840955373672
유로화/NNG;강세/NNG;지지/NNG;받/VV,-1,-0.5958237239143773,16,5,11,13,0.13664963117235607,0.5373840955373672
유가/NNG;강세/NNG;보였/VV,-1,-0.5958237239143773,16,5,11,4,0.13664963117235607,0.5373840955373672
원화/NNG;강세/NNG;막/VV,-1,-0.5958237239143773,16,5,11,16,0.13664963117235607,0.5373840955373672
물가상승률/NNG;목표/NNG;달성~하/VVX,-1,-0.5958237239143773,16,5,11,7,0.13664963117235607,0.5373840955373672
지급준비율/NNG;내리/VV,-1,-0.5958237239143773,16,5,11,11,0.13664963117235607,0.5373840955373672
가계부채/NNG;늘어날/VV,-1,-0.5958237239143773,16,5,11,24,0.13664963117235607,0.5373840955373672
소득/NNG;줄/VV,-1,-0.5958237239143773,16,5,11,15,0.13664963117235607,0.5373840955373672
금리인하/NNG;시사~했/VVX,-1,-0.5958237239143773,16,5,11,9,0.13664963117235607,0.5373840955373672
달러강세/NNG;영향/NNG;받/VV,-1,-0.5958237239143773,16,5,11,14,0.13664963117235607,0.5373840955373672
소비/NNG;늘릴/VV,-1,-0.5958237239143773,16,5,11,13,0.13664963117235607,0.5373840955373672
환율하락/NNG;인한/VV,-1,-0.5958237239143773,16,5,11,15,0.13664963117235607,0.5373840955373672
고용지표/NNG;오/VV,-1,-0.5958237239143773,16,5,11,2,0.13664963117235607,0.5373840955373672
경제/NNG;성장~했/VVX,-1,-0.5958237239143773,16,5,11,6,0.13664963117235607,0.5373840955373672
국채선물/NNG;상승~한/VAX;거래~되/VVX,-1,-0.5958237239143773,16,5,11,12,0.13664963117235607,0.5373840955373672
채권금리/NNG;올라가/VV,-1,-0.5958237239143773,16,5,11,18,0.13664963117235607,0.5373840955373672
모기지/NNG;금리/NNG;낮추/VV,-1,-0.5958237239143773,16,5,11,3,0.13664963117235607,0.5373840955373672
연체율/NNG;하락~하/VVX,-1,-0.5958237239143773,16,5,11,8,0.13664963117235607,0.5373840955373672
gdp/NNG;하락~하/VVX,-1,-0.5958237239143773,16,5,11,2,0.13664963117235607,0.5373840955373672
금리상승/NNG;요인/NNG;작용~할/VVX,-1,-0.5980014415911137,25,8,17,13,0.15221809150479357,0.6026590090830549
적자/NNG;줄이/VV,-1,-0.5980014415911137,25,8,17,14,0.15221809150479357,0.6026590090830549
금리/NNG;급락~한/VAX;따른/VV,-1,-0.5980014415911137,25,8,17,14,0.15221809150479357,0.6026590090830549
위험/NNG;확대~되/VVX,-1,-0.5980014415911137,25,8,17,22,0.15221809150479357,0.6026590090830549
경제회복/NNG;위해/VV,-1,-0.5980014415911137,25,8,17,21,0.15221809150479357,0.6026590090830549
달러원/NNG;급등~하/VVX,-1,-0.5989869743598195,48,16,32,42,0.18563563486251083,0.7372183794248125
기준금리/NNG;인하~됐/VVX,-1,-0.6014409642182835,28,9,19,15,0.15577556125435602,0.6233831152877698
cds프리미엄/NNG;상승~하/VVX,-1,-0.6014409642182835,28,9,19,21,0.15577556125435602,0.6233831152877698
시장금리/NNG;떨어지/VV,-1,-0.605265692527277,31,10,21,15,0.1588798831104071,0.643474148650219
수요/NNG;둔화~되/VVX,-1,-0.605265692527277,31,10,21,23,0.1588798831104071,0.643474148650219
원화/NNG;강세/NNG;보이/VV,-1,-0.6081380579376411,54,18,36,49,0.18765216298429838,0.766921214570003
인플레이션위험/NNG;남/VV,-1,-0.6092286881708179,34,11,23,5,0.16163663543442894,0.6628828183864035
경제지표/NNG;악화~되/VVX,-1,-0.6092286881708179,34,11,23,18,0.16163663543442894,0.6628828183864035
경기둔화/NNG;막/VV,-1,-0.6170178222049043,40,13,27,29,0.1663760475636747,0.6995067312794399
수익성/NNG;개선~되/VVX,-1,-0.6246569364563609,69,23,46,43,0.1920220717795782,0.8275828711090809
성장세/NNG;이어질/VV,-1,-0.6274147132659245,49,16,33,23,0.17214014634328853,0.74863090754732
채권/NNG;시장/NNG;강세/NNG;보이/VV,-1,-0.6274147132659245,49,16,33,35,0.17214014634328853,0.74863090754732
통화정책/NNG;유지~할/VVX,-1,-0.6332289339802114,55,18,37,38,0.1753542388136431,0.7774116953038216
기준금리/NNG;인하~하/VVX,-1,-0.6426289815111597,488,162,326,377,0.20529080836232794,0.9393371351708427
기준금리인하/NNG;따른/VV,-1,-0.6468405130963402,76,25,51,85,0.18404093780824143,0.8542858790436545
마이너스금리/NNG;도입~했/VVX,-1,-0.6473284816468512,32,10,22,20,0.14130552595388515,0.6570135204646704
양적완화/NNG;하/VV,-1,-0.6473284816468512,32,10,22,21,0.14130552595388515,0.6570135204646704
수요/NNG;확대~될/VVX,-1,-0.6473284816468512,32,10,22,34,0.14130552595388515,0.6570135204646704
유동성공급/NNG;확대~하/VVX,-1,-0.6473284816468512,32,10,22,12,0.14130552595388515,0.6570135204646704
소비/NNG;늘어날/VV,-1,-0.6473284816468512,32,10,22,17,0.14130552595388515,0.6570135204646704
장기금리/NNG;상승~할/VVX,-1,-0.6473284816468512,32,10,22,24,0.14130552595388515,0.6570135204646704
달러화/NNG;급등~했/VVX,-1,-0.647784408769362,29,9,20,32,0.13685635461471127,0.637322885592067
공적자금/NNG;투입~하/VVX,-1,-0.647784408769362,29,9,20,18,0.13685635461471127,0.637322885592067
가계부채/NNG;늘/VV,-1,-0.647784408769362,29,9,20,38,0.13685635461471127,0.637322885592067
채권가격/NNG;상승~하/VVX,-1,-0.6495228409209328,26,8,18,26,0.13169859135710446,0.6169819679751836
금리인하/NNG;위한/VV,-1,-0.6495228409209328,26,8,18,12,0.13169859135710446,0.6169819679751836
경제성장/NNG;위해/VV,-1,-0.6495228409209328,26,8,18,25,0.13169859135710446,0.6169819679751836
달러화/NNG;엔화/NNG;오른/VV,-1,-0.6495228409209328,26,8,18,20,0.13169859135710446,0.6169819679751836
금리하락/NNG;제한~하/VVX,-1,-0.653262651095992,23,7,16,28,0.12559424161732163,0.5960488073207917
위험/NNG;관리~하/VVX,-1,-0.6540816467126667,50,16,34,35,0.159593673416607,0.7595651380122393
금융시장/NNG;충격/NNG;줄/VV,-1,-0.6601694080114522,20,6,14,23,0.11817968308959903,0.574595189069211
금리인하/NNG;가능성/NNG;시사~하/VVX,-1,-0.6601694080114522,20,6,14,15,0.11817968308959903,0.574595189069211
안전자산선호/NNG;심리/NNG;부각~되/VVX,-1,-0.6601694080114522,20,6,14,9,0.11817968308959903,0.574595189069211
경기침체/NNG;빠질/VV,-1,-0.6601694080114522,20,6,14,15,0.11817968308959903,0.574595189069211
수출부진/NNG;따른/VV,-1,-0.6601694080114522,20,6,14,17,0.11817968308959903,0.574595189069211
채권/NNG;시장/NNG;국고채/NNG;금리/NNG;오른/VV,-1,-0.6601694080114522,20,6,14,18,0.11817968308959903,0.574595189069211
엔화/NNG;유로화/NNG;상승~했/VVX,-1,-0.6601694080114522,20,6,14,22,0.11817968308959903,0.574595189069211
경제성장률/NNG;유지~하/VVX,-1,-0.6722248809304667,17,5,12,8,0.10887440646423706,0.552709425113117
경기침체/NNG;지속~될/VVX,-1,-0.6722248809304667,17,5,12,9,0.10887440646423706,0.552709425113117
금리인하/NNG;기대/NNG;커지/VV,-1,-0.6722248809304667,17,5,12,23,0.10887440646423706,0.552709425113117
민간/NNG;소비/NNG;증가~하/VVX,-1,-0.6722248809304667,17,5,12,8,0.10887440646423706,0.552709425113117
고성장/NNG;종목/NNG;종목수/NNG;매매/NNG;보/VV,-1,-0.6722248809304667,17,5,12,1,0.10887440646423706,0.552709425113117
수출감소세/NNG;확대~되/VVX,-1,-0.6722248809304667,17,5,12,3,0.10887440646423706,0.552709425113117
지급준비율/NNG;인상~해/VVX,-1,-0.6722248809304667,17,5,12,3,0.10887440646423706,0.552709425113117
고용지표/NNG;양호~하/VVX,-1,-0.6722248809304667,17,5,12,19,0.10887440646423706,0.552709425113117
성장/NNG;보/VV,-1,-0.6722248809304667,17,5,12,7,0.10887440646423706,0.552709425113117
수출증가율/NNG;둔화~되/VVX,-1,-0.6722248809304667,17,5,12,15,0.10887440646423706,0.552709425113117
금리인하/NNG;결정~했/VVX,-1,-0.6722248809304667,17,5,12,9,0.10887440646423706,0.552709425113117
서부텍사스산원유/NNG;가격/NNG;떨어진/VV,-1,-0.6722248809304667,17,5,12,10,0.10887440646423706,0.552709425113117
금융시장안정/NNG;위해/VV,-1,-0.6792816952977341,60,19,41,21,0.15537581405963033,0.8094461080694497
달러화/NNG;약세/NNG;보일/VV,-1,-0.6811279732898106,39,12,27,29,0.13467812688631792,0.7064368101047055
높/VA;금리/NNG;제공~하/VVX,-1,-0.6811279732898106,39,12,27,36,0.13467812688631792,0.7064368101047055
달러약세/NNG;부추겼/VV,-1,-0.6828423331630495,36,11,25,22,0.13043742881630888,0.6885735112989045
경제/NNG;회복~될/VVX,-1,-0.6828423331630495,36,11,25,29,0.13043742881630888,0.6885735112989045
수요/NNG;늘리/VV,-1,-0.6854786083683044,33,10,23,26,0.1256652095373356,0.6699605441429172
재정지출/NNG;늘리/VV,-1,-0.6894332889091639,30,9,21,11,0.12023053606907136,0.6506288332671974
양적완화/NNG;나서/VV,-1,-0.6894332889091639,30,9,21,38,0.12023053606907136,0.6506288332671974
수출/NNG;줄/VV,-1,-0.6894332889091639,30,9,21,38,0.12023053606907136,0.6506288332671974
침체/NNG;빠져/VV,-1,-0.6952859570998564,27,8,19,12,0.11395349317883176,0.6306183884887345
금리/NNG;밑돌/VV,-1,-0.6952859570998564,27,8,19,26,0.11395349317883176,0.6306183884887345
경제지표호조/NNG;따른/VV,-1,-0.6952859570998564,27,8,19,34,0.11395349317883176,0.6306183884887345
지급준비율/NNG;인상~할/VVX,-1,-0.6952859570998564,27,8,19,23,0.11395349317883176,0.6306183884887345
기준금리/NNG;내린/VV,-1,-0.6979815896803214,135,43,92,117,0.16872925364675254,0.9435342194095263
스왑베이시스/NNG;확대~되/VVX,-1,-0.7000387370275993,58,18,40,37,0.14304277016521394,0.8063269140020787
높/VA;금리/NNG;주/VV,-1,-0.7000387370275993,58,18,40,38,0.14304277016521394,0.8063269140020787
금리/NNG;인하~한다면/VVX,-1,-0.7039041236087606,24,7,17,17,0.10658138821869131,0.6099790149487825
경기후퇴/NNG;따른/VV,-1,-0.7039041236087606,24,7,17,11,0.10658138821869131,0.6099790149487825
금리변동성/NNG;확대~되/VVX,-1,-0.7147636132715183,37,11,26,25,0.11720935092348388,0.7006338687180633
소비/NNG;회복~될/VVX,-1,-0.7166218296288882,21,6,15,10,0.09775179795426808,0.5887707481166505
경제/NNG;확산~되/VVX,-1,-0.7166218296288882,21,6,15,13,0.09775179795426808,0.5887707481166505
금리인하/NNG;기대~하/VVX;어렵/VA,-1,-0.7166218296288882,21,6,15,14,0.09775179795426808,0.5887707481166505
금리인하/NNG;단행~하/VVX;않/VX,-1,-0.7166218296288882,21,6,15,23,0.09775179795426808,0.5887707481166505
기준금리인상/NNG;위한/VV,-1,-0.7166218296288882,21,6,15,39,0.09775179795426808,0.5887707481166505
경제지표/NNG;개선~된/VVX,-1,-0.7166218296288882,21,6,15,13,0.09775179795426808,0.5887707481166505
침체/NNG;지속~될/VVX,-1,-0.7166218296288882,21,6,15,7,0.09775179795426808,0.5887707481166505
재무구조개선/NNG;위해/VV,-1,-0.7166218296288882,21,6,15,13,0.09775179795426808,0.5887707481166505
환율방어/NNG;위해/VV,-1,-0.7198293940155773,34,10,24,36,0.1118096256763177,0.6823804520010439
금리인하/NNG;가능성/NNG;열려/VV,-1,-0.7198293940155773,34,10,24,25,0.1118096256763177,0.6823804520010439
금리/NNG;상승압력/NNG;받/VV,-1,-0.7216223805496567,56,17,39,69,0.1305783035000643,0.8028656766602466
기준금리/NNG;인하~함/VVX,-1,-0.7297078343216096,47,14,33,20,0.11966081496624946,0.7611729796323999
달러화/NNG;하락압력/NNG;가할/VV,-1,-0.7354945726745614,28,8,20,23,0.09870561752833036,0.6436729968392609
자금사정/NNG;개선~되/VVX,-1,-0.7355491024065138,18,5,13,12,0.08693717660439805,0.5670633604982454
채권/NNG;시장/NNG;강세/NNG;이끌/VV,-1,-0.7355491024065138,18,5,13,17,0.08693717660439805,0.5670633604982454
재무구조개선/NNG;위한/VV,-1,-0.7355491024065138,18,5,13,6,0.08693717660439805,0.5670633604982454
가계부채/NNG;줄이/VV,-1,-0.7355491024065138,18,5,13,15,0.08693717660439805,0.5670633604982454
금리하락/NNG;확대~되/VVX,-1,-0.7355491024065138,18,5,13,16,0.08693717660439805,0.5670633604982454
국채/NNG;가격상승폭/NNG;제한~됐/VVX,-1,-0.7355491024065138,18,5,13,11,0.08693717660439805,0.5670633604982454
금융안정/NNG;위한/VV,-1,-0.7355491024065138,18,5,13,12,0.08693717660439805,0.5670633604982454
자금사정/NNG;악화~되/VVX,-1,-0.7355491024065138,18,5,13,10,0.08693717660439805,0.5670633604982454
금리인하/NNG;보/VV,-1,-0.7355491024065138,18,5,13,15,0.08693717660439805,0.5670633604982454
채권/NNG;시장/NNG;변동성/NNG;확대~되/VVX,-1,-0.7355491024065138,18,5,13,6,0.08693717660439805,0.5670633604982454
금리인하/NNG;단행~함/VVX,-1,-0.7355491024065138,18,5,13,6,0.08693717660439805,0.5670633604982454
소비자/NNG;물가상승률/NNG;물가안정/NNG;목표/NNG;안정~되/VVX,-1,-0.747594055151805,25,7,18,26,0.09060331745158214,0.6232918132959389
기준금리/NNG;인하~한다고/VVX,-1,-0.747594055151805,25,7,18,11,0.09060331745158214,0.6232918132959389
금리인하/NNG;예상~되/VVX,-1,-0.7505726095502718,35,10,25,23,0.09957589306267718,0.6943253598652518
물가/NNG;올랐/VV,-1,-0.7593462533138279,32,9,23,13,0.09304484605100066,0.6756477500745101
금리인하/NNG;주장~하/VVX,-1,-0.7593462533138279,32,9,23,35,0.09304484605100066,0.6756477500745101
기준금리동결/NNG;결정~했/VVX,-1,-0.764094371468003,15,4,11,10,0.07337520883439759,0.544932822341765
국채금리/NNG;급등~했/VVX,-1,-0.764094371468003,15,4,11,16,0.07337520883439759,0.544932822341765
주택가격/NNG;상승~했/VVX,-1,-0.764094371468003,15,4,11,12,0.07337520883439759,0.544932822341765
금가격/NNG;하락~하/VVX,-1,-0.764094371468003,15,4,11,6,0.07337520883439759,0.544932822341765
실적/NNG;감소~했/VVX,-1,-0.764094371468003,15,4,11,9,0.07337520883439759,0.544932822341765
위험/NNG;되/VV,-1,-0.764094371468003,15,4,11,14,0.07337520883439759,0.544932822341765
베이시스/NNG;축소~되/VVX,-1,-0.764094371468003,15,4,11,10,0.07337520883439759,0.544932822341765
국고채/NNG;스프레드/NNG;확대~되/VVX,-1,-0.764094371468003,15,4,11,12,0.07337520883439759,0.544932822341765
높/VA;이자/NNG;주/VV,-1,-0.764094371468003,15,4,11,7,0.07337520883439759,0.544932822341765
선행지수/NNG;상승~하/VVX,-1,-0.764094371468003,15,4,11,10,0.07337520883439759,0.544932822341765
장기물/NNG;약세/NNG;보이/VV,-1,-0.764094371468003,15,4,11,14,0.07337520883439759,0.544932822341765
국채선물/NNG;올라/VV,-1,-0.764094371468003,15,4,11,20,0.07337520883439759,0.544932822341765
소비자/NNG;물가상승률/NNG;머물/VV,-1,-0.764094371468003,15,4,11,8,0.07337520883439759,0.544932822341765
금리인상/NNG;반대~하/VVX,-1,-0.7641095209296711,22,6,16,20,0.08109198424653631,0.6022862819062602
손실/NNG;줄이/VV,-1,-0.7641095209296711,22,6,16,15,0.08109198424653631,0.6022862819062602
수급상황/NNG;개선~되/VVX,-1,-0.7641095209296711,22,6,16,11,0.08109198424653631,0.6022862819062602
물가상승압력/NNG;작용~하/VVX,-1,-0.7641095209296711,22,6,16,15,0.08109198424653631,0.6022862819062602
부동산가격/NNG;하락~하/VVX,-1,-0.7695582309621128,39,11,28,13,0.09487211658924695,0.7234045002233619
매출/NNG;증가~하/VVX,-1,-0.7695582309621128,39,11,28,19,0.09487211658924695,0.7234045002233619
수출/NNG;증가~했/VVX,-1,-0.7705206007706811,29,8,21,19,0.08565823072645709,0.65622452540145
내수/NNG;위축~되/VVX,-1,-0.7705206007706811,29,8,21,15,0.08565823072645709,0.65622452540145
인플레이션압력/NNG;높이/VV,-1,-0.7705206007706811,29,8,21,13,0.08565823072645709,0.65622452540145
경기/NNG;상승세/NNG;이/VV,-1,-0.7705206007706811,29,8,21,6,0.08565823072645709,0.65622452540145
경제지표/NNG;둔화~되/VVX,-1,-0.7779530711224385,36,10,26,30,0.08879860888647191,0.7058371936886901
주택가격하락/NNG;따른/VV,-1,-0.7849008481457461,26,7,19,18,0.0772362251271076,0.636086794892758
달러원/NNG;급락~하/VVX,-1,-0.786889554391389,19,5,14,28,0.06978715962850104,0.5807079221082784
이자/NNG;부담/NNG;줄여/VV,-1,-0.786889554391389,19,5,14,13,0.06978715962850104,0.5807079221082784
통화완화/NNG;지속~될/VVX,-1,-0.786889554391389,19,5,14,13,0.06978715962850104,0.5807079221082784
기준금리/NNG;인하~했/VVX,-1,-0.7957688526578413,205,59,146,147,0.1111348499403146,0.9694461962544635
지급준비율/NNG;인하~하/VVX,-1,-0.8008351471582879,30,8,22,6,0.07452028099331585,0.6683326470105047
금리인하/NNG;단행~해/VVX,-1,-0.8008351471582879,30,8,22,13,0.07452028099331585,0.6683326470105047
채권/NNG;시장/NNG;부담/NNG;작용~하/VVX,-1,-0.8035701217072186,23,6,17,4,0.06756672635060755,0.6152702033803251
인플레이션압력/NNG;커질/VV,-1,-0.8035701217072186,23,6,17,13,0.06756672635060755,0.6152702033803251
성장/NNG;도모~하/VVX,-1,-0.8035701217072186,23,6,17,14,0.06756672635060755,0.6152702033803251
유로화/NNG;달러화/NNG;낮/VA;진/VX;나타냈/VV,-1,-0.8035701217072186,23,6,17,12,0.06756672635060755,0.6152702033803251
매출/NNG;감소~하/VVX,-1,-0.8134731977126084,34,9,25,7,0.07251513058920069,0.6989000481231514
위험/NNG;될/VV,-1,-0.8136422094035518,41,11,30,47,0.07717864739598916,0.7445850820343575
국제/NNG;유가/NNG;반등~하/VVX,-1,-0.8165249238039618,27,7,20,21,0.06607690274073258,0.6484365936932285
금융위기/NNG;확산~되/VVX,-1,-0.8165249238039618,27,7,20,14,0.06607690274073258,0.6484365936932285
가계부채/NNG;늘리/VV,-1,-0.8185199910166717,16,4,12,12,0.056247704866873624,0.5586056577554502
환율변동성/NNG;커지/VV,-1,-0.8185199910166717,16,4,12,30,0.056247704866873624,0.5586056577554502
기대심리/NNG;줄어든/VV,-1,-0.8185199910166717,16,4,12,11,0.056247704866873624,0.5586056577554502
달러강세/NNG;지지~할/VVX,-1,-0.8185199910166717,16,4,12,7,0.056247704866873624,0.5586056577554502
저성장/NNG;지속~될/VVX,-1,-0.8185199910166717,16,4,12,7,0.056247704866873624,0.5586056577554502
디플레이션/NNG;우려/NNG;커지/VV,-1,-0.8185199910166717,16,4,12,20,0.056247704866873624,0.5586056577554502
기준금리/NNG;밑도/VV,-1,-0.8185199910166717,16,4,12,12,0.056247704866873624,0.5586056577554502
인플레이션/NNG;억제~할/VVX,-1,-0.8279300895477588,20,5,15,8,0.05642810792263279,0.5938115171135234
고용지표/NNG;호조/NNG;보인/VV,-1,-0.8279300895477588,20,5,15,12,0.05642810792263279,0.5938115171135234
베이시스/NNG;확대~되/VVX,-1,-0.8279300895477588,20,5,15,19,0.05642810792263279,0.5938115171135234
수익/NNG;줄/VV,-1,-0.8279300895477588,20,5,15,16,0.05642810792263279,0.5938115171135234
달러엔/NNG;오를/VV,-1,-0.8279300895477588,20,5,15,15,0.05642810792263279,0.5938115171135234
경기회복/NNG;지연/NNG;따른/VV,-1,-0.8279300895477588,20,5,15,4,0.05642810792263279,0.5938115171135234
수출/NNG;위축~될/VVX,-1,-0.8279300895477588,20,5,15,11,0.05642810792263279,0.5938115171135234
성장세회복/NNG;지원~하/VVX,-1,-0.8355374305299503,35,9,26,16,0.06424322995172314,0.7099574526068797
엔화/NNG;유로화/NNG;하락~했/VVX,-1,-0.8361014055222585,24,6,18,31,0.05659968514258167,0.6278117923890048
인플레이션압력/NNG;완화~될/VVX,-1,-0.8375069406192643,53,14,39,12,0.07290050603541001,0.81617164987163
유동성확보/NNG;위해/VV,-1,-0.8432045086840049,28,7,21,19,0.056762889826144684,0.6603946152592173
변동성/NNG;확대~할/VVX,-1,-0.8432045086840049,28,7,21,24,0.056762889826144684,0.6603946152592173
금리/NNG;끌어내리/VV,-1,-0.8453126921780089,50,13,37,42,0.06801461527260165,0.8028886521994096
금리/NNG;반등~할/VVX,-1,-0.8487828907461719,43,11,32,39,0.06319463520081532,0.7643607861839865
금리인하/NNG;가능성/NNG;제기~되/VVX,-1,-0.8493846361979365,32,8,24,18,0.05691815212583288,0.6913904010088294
글로벌경제/NNG;완만~한/VAX;회복세/NNG;지속~할/VVX,-1,-0.8595796715394513,17,4,13,25,0.043675688282578215,0.5717412559107379
유가급등/NNG;인해/VV,-1,-0.8595796715394513,17,4,13,3,0.043675688282578215,0.5717412559107379
경기침체/NNG;대응~하/VVX,-1,-0.8595796715394513,17,4,13,10,0.043675688282578215,0.5717412559107379
스프레드축소/NNG;지속~될/VVX,-1,-0.8595796715394513,17,4,13,9,0.043675688282578215,0.5717412559107379
달러화가치/NNG;상승~했/VVX,-1,-0.8595796715394513,17,4,13,16,0.043675688282578215,0.5717412559107379
금리하락/NNG;베팅/NNG;하/VV,-1,-0.8595796715394513,17,4,13,13,0.043675688282578215,0.5717412559107379
금리인하/NNG;이어질/VV,-1,-0.8604853727333763,21,5,16,11,0.04601193969026088,0.6064841709962346
금리/NNG;하락세/NNG;지속~될/VVX,-1,-0.8604853727333763,21,5,16,29,0.04601193969026088,0.6064841709962346
하방경직성/NNG;유지~될/VVX,-1,-0.8604853727333763,21,5,16,14,0.04601193969026088,0.6064841709962346
하방위험/NNG;커졌/VV,-1,-0.8628020885340226,25,6,19,16,0.04769641425392576,0.6399737159179689
수출/NNG;증가세/NNG;둔화~되/VVX,-1,-0.8628020885340226,25,6,19,19,0.04769641425392576,0.6399737159179689
위험/NNG;헤지~하/VVX,-1,-0.8656530572076195,29,7,22,21,0.04897992662326998,0.6720004060458178
고용지표/NNG;호조/NNG;보일/VV,-1,-0.868622155979501,33,8,25,17,0.049998454078867376,0.7024022022738237
소비/NNG;위축~시키/VVX,-1,-0.8846810680403634,26,6,20,12,0.04044758101123876,0.65180028654323
침체/NNG;막/VV,-1,-0.8846810680403634,26,6,20,12,0.04044758101123876,0.65180028654323
성장세/NNG;약화~되/VVX,-1,-0.8846810680403634,26,6,20,32,0.04044758101123876,0.65180028654323
이익/NNG;늘어나/VV,-1,-0.8862371478972807,22,5,17,10,0.037857514905986524,0.6187986465044318
시중금리/NNG;떨어지/VV,-1,-0.8904041431978805,18,4,14,10,0.03439040954814624,0.5844732751967242
지급준비율/NNG;올린/VV,-1,-0.8904041431978805,18,4,14,8,0.03439040954814624,0.5844732751967242
침체/NNG;심화~되/VVX,-1,-0.8904041431978805,18,4,14,4,0.03439040954814624,0.5844732751967242
경상수지흑자/NNG;줄어들/VV,-1,-0.8904041431978805,18,4,14,18,0.03439040954814624,0.5844732751967242
유가상승/NNG;인해/VV,-1,-0.8904041431978805,18,4,14,4,0.03439040954814624,0.5844732751967242
위험/NNG;처했/VV,-1,-0.8904041431978805,18,4,14,8,0.03439040954814624,0.5844732751967242
수요증가/NNG;힘입/VV,-1,-0.9066220838518001,23,5,18,19,0.03143530530700222,0.6308034555943351
국고/NNG;금리/NNG;하락~하/VVX,-1,-0.9066220838518001,23,5,18,26,0.03143530530700222,0.6308034555943351
침체국면/NNG;접어들/VV,-1,-0.9066220838518001,23,5,18,20,0.03143530530700222,0.6308034555943351
경기하강위험/NNG;남/VV,-1,-0.9135840278742448,19,4,15,2,0.027465245734398125,0.596883245808961
수급/NNG;악화~될/VVX,-1,-0.9135840278742448,19,4,15,4,0.027465245734398125,0.596883245808961
잠재/NNG;성장률/NNG;하회~하/VVX,-1,-0.9135840278742448,19,4,15,13,0.027465245734398125,0.596883245808961
금리/NNG;상승세/NNG;지속~되/VVX,-1,-0.9137556926972663,32,7,25,25,0.032372385621156005,0.7049641672205197
금리인상/NNG;마무리~될/VVX,-1,-0.9255120127408678,15,3,12,16,0.02221001547399658,0.5617819347430153
비용/NNG;감소~하/VVX,-1,-0.9255120127408678,15,3,12,4,0.02221001547399658,0.5617819347430153
안전자산/NNG;선호~되/VVX,-1,-0.9255120127408678,15,3,12,14,0.02221001547399658,0.5617819347430153
금리인하/NNG;나섰/VV,-1,-0.9255120127408678,15,3,12,15,0.02221001547399658,0.5617819347430153
금리인하/NNG;여력/NNG;있/VV,-1,-0.9255120127408678,15,3,12,7,0.02221001547399658,0.5617819347430153
수익성/NNG;악화~할/VVX,-1,-0.9255120127408678,15,3,12,9,0.02221001547399658,0.5617819347430153
투자심리/NNG;회복~시키/VVX,-1,-0.9311182846007291,20,4,16,9,0.022239733343964983,0.6090213672248243
성장세/NNG;보여/VV,-1,-0.9311182846007291,20,4,16,26,0.022239733343964983,0.6090213672248243
신용등급/NNG;하향조정~할/VVX,-1,-0.9437128294965532,16,3,13,7,0.01711276542188952,0.5742311348680367
금리인상/NNG;이루어질/VV,-1,-0.9437128294965532,16,3,13,11,0.01711276542188952,0.5742311348680367
근원/NNG;소비자물가/NNG;상승~했/VVX,-1,-0.9437128294965532,16,3,13,8,0.01711276542188952,0.5742311348680367
경기/NNG;악화~되/VVX;않/VX,-1,-0.9437128294965532,16,3,13,6,0.01711276542188952,0.5742311348680367
금리상승압력/NNG;작용~하/VVX,-1,-0.9437128294965532,16,3,13,20,0.01711276542188952,0.5742311348680367
원화가치/NNG;떨어지/VV,-1,-0.9444939052891062,21,4,17,14,0.018247268799309203,0.6209185572187481
달러약세/NNG;유도~하/VVX,-1,-0.9444939052891062,21,4,17,13,0.018247268799309203,0.6209185572187481
주택시장/NNG;회복~되/VVX,-1,-0.9444939052891062,21,4,17,12,0.018247268799309203,0.6209185572187481
지급준비율/NNG;인하/VV,-1,-0.9460985068997516,26,5,21,8,0.01898500265218276,0.6652343159384648
유가/NNG;올라/VV,-1,-0.9544773937519455,27,5,22,5,0.016317270374722463,0.6762338726052949
물가/NNG;억제~하/VVX,-1,-0.9566926813246285,17,3,14,11,0.013471138333882767,0.5864616755757754
경상수지흑자/NNG;줄이/VV,-1,-0.9566926813246285,17,3,14,6,0.013471138333882767,0.5864616755757754
물가상승률/NNG;기록~하/VVX,-1,-0.965615369311845,34,6,28,18,0.013502191435529354,0.7367489939219857
재무/NNG;안정성/NNG;유지~하/VVX,-1,-0.9661169126747853,18,3,15,6,0.010813041168850542,0.5984980859581189
물가안정/NNG;목표/NNG;하회~하/VVX,-1,-0.9661169126747853,18,3,15,10,0.010813041168850542,0.5984980859581189
성장잠재력/NNG;확충~하/VVX,-1,-0.9661169126747853,18,3,15,22,0.010813041168850542,0.5984980859581189
높/VA;금리/NNG;적용~하/VVX,-1,-0.9823310325946969,21,3,18,10,0.006170758834858012,0.6335358898572179
변동성확대/NNG;따른/VV,-1,-0.9848120659787661,15,2,13,10,0.0048773532629342855,0.5752916915429583
기준금리/NNG;하향조정~할/VVX,-1,-0.9848120659787661,15,2,13,7,0.0048773532629342855,0.5752916915429583
주택담보대출/NNG;금리/NNG;오르/VV,-1,-0.9854419088721614,22,3,19,11,0.005260896801996331,0.6448643414704919
인플레이션압력/NNG;완화~됐/VVX,-1,-0.9882600812641698,16,2,14,7,0.003952166244730408,0.5873132415388712
차입금/NNG;확대~되/VVX,-1,-0.9882600812641698,16,2,14,3,0.003952166244730408,0.5873132415388712
경쟁력/NNG;강화~하/VVX,-1,-0.9885236619653478,37,5,32,27,0.005105959155733995,0.7741236362301382
금리/NNG;내려도/VV,-1,-0.9907738000893258,17,2,15,22,0.003270467800212511,0.5991954435690013
불확실성/NNG;증대/NNG;따른/VV,-1,-0.9907738000893258,17,2,15,11,0.003270467800212511,0.5991954435690013
경제성장률/NNG;상회~하/VVX,-1,-0.9967854382395349,22,2,20,10,0.0015956333154781243,0.6563354238900946
수출/NNG;증가세/NNG;보이/VV,-1,-0.9992774850618052,16,1,15,8,0.0007083248870075478,0.5994275645351146
유로화/NNG;달러화/NNG;하락~했/VVX,-1,-0.9992774850618052,16,1,15,14,0.0007083248870075478,0.5994275645351146
원화/NNG;강세/NNG;이어졌/VV,-1,-0.999561318241659,17,1,16,1,0.0006353091504853057,0.6111334022435995
국제/NNG;유가/NNG;오른/VV,-1,-0.999561318241659,17,1,16,6,0.0006353091504853057,0.6111334022435995
기준금리/NNG;하향조정~하/VVX,-1,-1.0,34,2,32,6,0.0006353363990930032,0.7748019720389775
