word,label,polarity,count,pos_count,neg_count,neu_count,pos_score,neg_score
원유/NNG;가격/NNG;올랐/VV,1,1.0,21,21,0,3,0.6713864646008733,3.1442309331896925e-05
고성장/NNG;아니/VCN;성장능력/NNG;비해서/VV,1,0.999996944666103,19,19,0,0,0.6501802496824606,3.1442309331896925e-05
경제/NNG;본/VV;상승세/NNG;빨랐/VA,1,0.999996944666103,19,19,0,0,0.6501802496824606,3.1442309331896925e-05
규제/NNG;하/XSV;다르/VA;금리인상/NNG;부동산가격/NNG,1,0.9999917775309577,16,16,0,0,0.6172104163749155,3.1442309331896925e-05
금리인상/NNG;부동산가격/NNG;영향/NNG;주/VV;아니/VCN,1,0.9999917775309577,16,16,0,0,0.6172104163749155,3.1442309331896925e-05
상환능력/NNG;유지/NNG;할/XSV,1,0.9999898818093704,15,15,0,5,0.6059374798104726,3.1442309331896925e-05
기준금리/NNG;수준/NNG;유지/NNG;한다고/XSV,1,0.9996953915406126,23,22,1,4,0.6817279276323079,0.00013575858698781362
금리/NNG;낮/VA;아니/VCN,1,0.9995787583857985,20,19,1,5,0.6501658751085237,0.00016739748883183998
성장/NNG;안/MAG;될/VV,1,0.9994581014031692,18,17,1,0,0.6283299646684009,0.0001996948040497758
플러스/NNG;성장세/NNG;이/VV,1,0.9993765335121718,17,16,1,1,0.6171923211226883,0.00022133789559942657
성장경로/NNG;불확실성/NNG;상존/NNG;하/XSV,1,0.9980440824770718,21,19,2,10,0.650113006666145,0.000666766868578741
경기회복세/NNG;되/VV,1,0.9966912250110909,18,16,2,18,0.617113054515708,0.0010513994191804388
통화정책/NNG;금융완화/NNG;유지/NNG;하/XSV,1,0.9961454916288821,25,22,3,21,0.6815866605187985,0.0013478707235264268
순자산/NNG;증가/NNG;한/XSA,1,0.9936440418047445,22,19,3,13,0.649960430137655,0.0021023063706466973
지정학적리스크/NNG;커지/VV,1,0.9934628701923132,15,13,2,19,0.5828496832787305,0.0019383684475184945
경제성장/NNG;가능/NNG;할/XSV,1,0.9934628701923132,15,13,2,3,0.5828496832787305,0.0019383684475184945
인플레이션/NNG;완화/NNG;되/XSV;않/VX,1,0.9923098529056444,21,18,3,5,0.6390855628467507,0.0024964139363075535
콜금리/NNG;목표/NNG;인상/NNG;하/XSV,1,0.9916447040404488,39,33,6,5,0.7829370587049136,0.0033207816701106337
인플레이션/NNG;낮/VA;지/VX,1,0.9905624705989506,20,17,3,9,0.6280510620503873,0.0030066880478435577
금리인상/NNG;나타나/VV,1,0.988232837475671,19,16,3,8,0.6168603363830322,0.003679224279114041
인플레이션/NNG;우려/NNG;상존/NNG;해/XSV,1,0.987277479476921,30,25,5,28,0.7111635012293183,0.004585548812697041
기준금리/NNG;상향/NNG;조정/NNG;하/XSV,1,0.9864024366605815,35,29,6,22,0.7484264561176465,0.0051575782214144175
잠재/NNG;성장률/NNG;밑도/VV,1,0.9850656475613007,18,15,3,13,0.6055156553450391,0.004583250697230497
경기회복모멘텀/NNG;둔화/NNG;되/XSV,1,0.9850656475613007,18,15,3,11,0.6055156553450391,0.004583250697230497
금융완화/NNG;라는/VCP,1,0.9833683769679902,23,19,4,5,0.6495983588115711,0.005476920624064105
경기상승세/NNG;되/XSV,1,0.9833683769679902,23,19,4,8,0.6495983588115711,0.005476920624064105
금리/NNG;올려서/VV,1,0.9825032970995224,28,23,5,29,0.6911817150123084,0.00613160962256007
수요측면/NNG;물가상승압력/NNG;않/VX,1,0.9820896093157012,33,27,6,28,0.7299385466857486,0.006629100266087404
인플레이션기대/NNG;심리/NNG;확산/NNG;될/XSV,1,0.9806666884560371,17,14,3,2,0.5940171833340603,0.005825241950419485
경기회복세/NNG;둔화/NNG;될/XSV,1,0.9795567385224448,22,18,4,12,0.6386559559596445,0.006624537142494233
내수/NNG;증가/NNG;하/XSV,1,0.9795567385224448,22,18,4,10,0.6386559559596445,0.006624537142494233
경제/NNG;호조/NNG;하/XSV,1,0.9758212481651045,31,25,6,11,0.7106256340636282,0.008728248796931412
시장금리/NNG;하락/NNG;했/XSV,1,0.9751125813577857,26,21,5,18,0.670418699869992,0.00847786269533926
적자/NNG;나/VV,1,0.9745344041243105,21,17,4,7,0.6275348086247898,0.008121611624799475
콜금리/NNG;인상/NNG;해야/XSV,1,0.9744132193499684,16,13,3,6,0.5823613100185784,0.007573172090875483
기준금리인상/NNG;이어질/VV,1,0.9744132193499684,16,13,3,13,0.5823613100185784,0.007573172090875483
국채선물/NNG;높/VA;된/XSV,1,0.9744132193499684,16,13,3,14,0.5823613100185784,0.007573172090875483
물가상승압력/NNG;이어질/VV,1,0.9744132193499684,16,13,3,6,0.5823613100185784,0.007573172090875483
금리/NNG;올라야/VV,1,0.9744132193499684,16,13,3,12,0.5823613100185784,0.007573172090875483
경제/NNG;물가안정/NNG;견조/NNG;한/XSA,1,0.9744132193499684,16,13,3,0,0.5823613100185784,0.007573172090875483
인플레이션/NNG;우려/NNG;상존/NNG;하/XSV,1,0.9652991958585726,15,12,3,4,0.570537667980319,0.010099182687178
성장세/NNG;미약하/VAX,1,0.9652991958585726,15,12,3,22,0.570537667980319,0.010099182687178
달러화/NNG;엔화/NNG;움직여/VV;인/VCP;낮/VA;졌/VX,1,0.9652991958585726,15,12,3,13,0.570537667980319,0.010099182687178
임금상승압력/NNG;높/VA,1,0.9652991958585726,15,12,3,5,0.570537667980319,0.010099182687178
이자/NNG;부담/NNG;커질/VA,1,0.9652991958585726,15,12,3,5,0.570537667980319,0.010099182687178
경제회복/NNG;지연/NNG;되/XSV,1,0.9652991958585726,15,12,3,11,0.570537667980319,0.010099182687178
이자/NNG;부담/NNG;늘어날/VV,1,0.9600629268044916,28,22,6,18,0.6800868455440802,0.013886988873347423
단기금리/NNG;올리/VV,1,0.9587062287769459,19,15,4,3,0.6047368579514728,0.012775730048420956
경기둔화우려/NNG;부각/NNG;되/XSV,1,0.9587062287769459,19,15,4,21,0.6047368579514728,0.012775730048420956
불확실성/NNG;해소/NNG;되/XSV;않/VX,1,0.9586213792651448,49,38,11,38,0.8188265162439806,0.017334824251532637
경기/NNG;해외/NNG;위험요인/NNG;상존/NNG;하/XSV,1,0.9546068112177506,23,18,5,9,0.6377805422370963,0.014839444396013245
부동산가격/NNG;잡/VV,1,0.9533702496248475,56,43,13,12,0.8514528847507447,0.020362470264618744
유동성위험/NNG;낮/VA,1,0.9520818004351976,27,21,6,20,0.6694754185065709,0.01646284798625534
경기선행지수/NNG;상승/NNG;하/XSV,1,0.949148031104428,39,30,9,18,0.7550920795464983,0.019732481541835285
연체율/NNG;낮/VA;수준/NNG,1,0.9461502768231063,18,14,4,13,0.5930363622441537,0.016434734172947118
건설투자/NNG;부진/NNG;한/XSA,1,0.9461502768231063,18,14,4,11,0.5930363622441537,0.016434734172947118
엔화/NNG;급락/NNG;했/XSV,1,0.9461502768231063,18,14,4,7,0.5930363622441537,0.016434734172947118
금리인상/NNG;않/VX,1,0.9420571021351316,26,20,6,21,0.6586366524165773,0.01967908570670072
경기상승/NNG;이어지/VV,1,0.941605205689253,30,23,7,7,0.689341262985427,0.02076169672718987
성장/NNG;될/VV,1,0.9306354638349241,29,22,7,9,0.6787738635936236,0.024415588664862334
비용/NNG;상승/NNG;하/XSV,1,0.9286032923260132,17,13,4,10,0.5811021848238248,0.02153653906624601
비용/NNG;줄여/VV,1,0.9286032923260132,17,13,4,16,0.5811021848238248,0.02153653906624601
지급준비율/NNG;인상/NNG;될/XSV,1,0.9286032923260132,17,13,4,6,0.5811021848238248,0.02153653906624601
경기/NNG;회복세/NNG;하/XSV,1,0.928534742424532,21,16,5,10,0.6149396810045825,0.02281327254310381
부동산/NNG;잡/VV,1,0.925943402301276,40,30,10,19,0.7536452224776297,0.029010469403532697
성장세/NNG;둔화/NNG;하/XSV,1,0.917128082208436,28,21,7,14,0.6679506977321,0.028900775397593666
물가상승압력/NNG;않/VX,1,0.917128082208436,28,21,7,26,0.6679506977321,0.028900775397593666
기준금리인상/NNG;나서/VV,1,0.915681742846256,39,29,10,27,0.744287322427998,0.03278983532136259
국제/NNG;원자재/NNG;가격/NNG;오르/VV,1,0.9132859204222346,24,18,6,7,0.6362224168455134,0.028860619144349443
통화정책/NNG;완화/NNG;유지/NNG;해/XSV,1,0.9132859204222346,24,18,6,14,0.6362224168455134,0.028860619144349443
투자매력/NNG;높/VA;질/VX,1,0.9132859204222346,24,18,6,18,0.6362224168455134,0.028860619144349443
기준금리인상/NNG;결정/NNG;하/XSV,1,0.9132859204222346,24,18,6,13,0.6362224168455134,0.028860619144349443
기준금리인상/NNG;필요/NNG;하/XSV,1,0.9088687865076259,20,15,5,7,0.6031375260152602,0.028818505397242702
양적완화/NNG;이/VCP,1,0.9088687865076259,20,15,5,24,0.6031375260152602,0.028818505397242702
성장경로/NNG;벗어나/VV;않/VX,1,0.9088687865076259,20,15,5,26,0.6031375260152602,0.028818505397242702
금리인상/NNG;필요/NNG;하/XSA,1,0.9088099173037651,42,31,11,23,0.7610122932811857,0.03638650436216093
금리/NNG;높여/VV,1,0.9065554569655254,31,23,8,39,0.687628725917513,0.033729616161317304
수출주/NNG;상승/NNG;했/XSV,1,0.9037819748026814,16,12,4,9,0.5688866511338473,0.028774328651786613
부도위험/NNG;나타내/VV,1,0.9037819748026814,16,12,4,9,0.5688866511338473,0.028774328651786613
재정위기/NNG;확산/NNG;되/XSV,1,0.9037819748026814,16,12,4,33,0.5688866511338473,0.028774328651786613
소비자물가/NNG;상회/NNG;하/XSV,1,0.9037819748026814,16,12,4,12,0.5688866511338473,0.028774328651786613
금리인상/NNG;이르/VV,1,0.9037819748026814,16,12,4,7,0.5688866511338473,0.028774328651786613
집값안정/NNG;위해/VV,1,0.9037819748026814,16,12,4,5,0.5688866511338473,0.028774328651786613
유가/NNG;급락/NNG;하/XSV,1,0.9004435315862593,27,20,7,23,0.6568541785324522,0.034435738174689506
국제/NNG;원자재/NNG;가격/NNG;상승/NNG;하/XSV,1,0.8927443499712613,23,17,6,13,0.6246022447172539,0.03541832629635027
국채선물/NNG;하락/NNG;하/XSV,1,0.8927443499712613,23,17,6,21,0.6246022447172539,0.03541832629635027
경제/NNG;회복세/NNG;하/XSV,1,0.8927443499712613,23,17,6,19,0.6246022447172539,0.03541832629635027
유동성/NNG;늘/VV,1,0.882630736405112,19,14,5,10,0.5910272798865089,0.03686887879488349
양적완화/NNG;될/XSV,1,0.882630736405112,19,14,5,19,0.5910272798865089,0.03686887879488349
경제/NNG;악화/NNG;될/XSV,1,0.882630736405112,19,14,5,4,0.5910272798865089,0.03686887879488349
성장/NNG;이룰/VV,1,0.882630736405112,19,14,5,12,0.5910272798865089,0.03686887879488349
위안화절상/NNG;따른/VV,1,0.882630736405112,19,14,5,10,0.5910272798865089,0.03686887879488349
이자/NNG;부담/NNG;커질/VV,1,0.882630736405112,19,14,5,17,0.5910272798865089,0.03686887879488349
금리인상/NNG;다가오/VV,1,0.8797954100297241,26,19,7,22,0.6454598364331128,0.04129852713241624
경제성장률/NNG;낮/VA;질/VX,1,0.8774460374494517,43,31,12,32,0.7587871901772277,0.04955964315306475
국채선물시장/NNG;국채선물/NNG;상승/NNG;한/XSA,1,0.8694423709843253,29,21,8,43,0.6656723838821682,0.046513423326498805
수출/NNG;높/VA;증가세/NNG,1,0.8694423709843253,29,21,8,13,0.6656723838821682,0.046513423326498805
기준금리/NNG;유지/NNG;했/XSV,1,0.8683943303614183,15,11,4,20,0.55630745866188,0.039205410517076995
금리/NNG;하향안정/NNG;되/XSV,1,0.8683943303614183,15,11,4,6,0.55630745866188,0.039205410517076995
금융시장/NNG;높/VA;변동성/NNG,1,0.8683943303614183,15,11,4,21,0.55630745866188,0.039205410517076995
금리인상/NNG;미룰/VV,1,0.8683943303614183,15,11,4,22,0.55630745866188,0.039205410517076995
채권/NNG;시장/NNG;따르/VV;통안/NNG;하락/NNG;한/XSA,1,0.8683943303614183,15,11,4,13,0.55630745866188,0.039205410517076995
재고/NNG;감소/NNG;했/XSV,1,0.8683943303614183,15,11,4,12,0.55630745866188,0.039205410517076995
조달금리/NNG;낮출/VV,1,0.8683943303614183,15,11,4,13,0.55630745866188,0.039205410517076995
경제성장률/NNG;전망/NNG;상향/NNG;조정/NNG;하/XSV,1,0.8683943303614183,15,11,4,8,0.55630745866188,0.039205410517076995
기준금리인상/NNG;인해/VV,1,0.8683943303614183,15,11,4,12,0.55630745866188,0.039205410517076995
기대심리/NNG;유지/NNG;되/XSV,1,0.8664871010247943,22,16,6,32,0.6126586333752673,0.04384674476375562
자금유입/NNG;증가/NNG;하/XSV,1,0.8664871010247943,22,16,6,21,0.6126586333752673,0.04384674476375562
기준금리/NNG;동결/NNG;된다면/XSV,1,0.8664871010247943,22,16,6,9,0.6126586333752673,0.04384674476375562
국제/NNG;유가/NNG;하락/NNG;하/XSV,1,0.8492518372770206,102,71,31,72,0.9455412997787547,0.07711190588277923
국제/NNG;유가/NNG;급락/NNG;하/XSV,1,0.8490736409270425,38,27,11,23,0.7221123113022297,0.0589658109535006
경제/NNG;확산/NNG;될/XSV,1,0.8475689424532915,18,13,5,6,0.5785391691182862,0.04775155155649992
콜금리/NNG;올렸/VV,1,0.8475689424532915,18,13,5,7,0.5785391691182862,0.04775155155649992
금리인상/NNG;일시적/VAX,1,0.8475689424532915,18,13,5,13,0.5785391691182862,0.04775155155649992
금융완화/NNG;줄여/VV,1,0.8475689424532915,18,13,5,21,0.5785391691182862,0.04775155155649992
물가/NNG;올리/VV,1,0.8475689424532915,18,13,5,10,0.5785391691182862,0.04775155155649992
금리인상/NNG;단행/NNG;된/XSV,1,0.8475689424532915,18,13,5,17,0.5785391691182862,0.04775155155649992
채권가격/NNG;급락/NNG;하/XSV,1,0.8475689424532915,18,13,5,8,0.5785391691182862,0.04775155155649992
통화가치/NNG;하락/NNG;하/XSV,1,0.8475689424532915,18,13,5,35,0.5785391691182862,0.04775155155649992
실업률/NNG;떨어질/VV,1,0.8475689424532915,18,13,5,20,0.5785391691182862,0.04775155155649992
고용부진/NNG;따른/VV,1,0.8449251331492065,28,20,8,33,0.6542046266495758,0.05501150441614267
가산금리/NNG;올리/VV,1,0.8449251331492065,28,20,8,17,0.6542046266495758,0.05501150441614267
매수/NNG;심리/NNG;회복/NNG;되/XSV,1,0.8378081160817576,31,22,9,21,0.6740288304094567,0.05950765445635111
기준금리/NNG;인상/NNG;함/XSV,1,0.8378081160817576,31,22,9,39,0.6740288304094567,0.05950765445635111
호주달러/NNG;강세/NNG;보이/VV,1,0.8329610894295305,21,15,6,6,0.6003337574761223,0.054728692636621154
부동산가격/NNG;급등/NNG;하/XSV,1,0.8329610894295305,21,15,6,12,0.6003337574761223,0.054728692636621154
물가상승률/NNG;이/VCP,1,0.8329610894295305,21,15,6,14,0.6003337574761223,0.054728692636621154
기준금리동결/NNG;한/XSA,1,0.8329610894295305,21,15,6,16,0.6003337574761223,0.054728692636621154
국채수익률/NNG;오르/VV,1,0.8323362448731395,34,24,10,13,0.6931690546463651,0.0634497845723947
금리인상/NNG;남/VV,1,0.822674775392235,24,17,7,16,0.621627420081693,0.0604971338844434
경기/NNG;상승세/NNG;하/XSV,1,0.822674775392235,24,17,7,3,0.621627420081693,0.0604971338844434
기준금리인상/NNG;했/XSV,1,0.822674775392235,24,17,7,16,0.621627420081693,0.0604971338844434
달러화/NNG;약세/NNG;나타내/VV,1,0.822674775392235,24,17,7,13,0.621627420081693,0.0604971338844434
기준금리/NNG;수준/NNG;동결/NNG;하/XSV,1,0.822217036104451,43,30,13,52,0.7462140378260117,0.07282762444405615
부동산가격/NNG;안정/NNG;위해/VV,1,0.8153997515373603,27,19,8,11,0.6423607240483139,0.06533906386178713
물가/NNG;안정세/NNG;유지/NNG;하/XSV,1,0.8102448588152555,30,21,9,6,0.6624815122692291,0.06946366294505005
금리인하/NNG;주장/NNG;한/XSA,1,0.8065991564755413,33,23,10,39,0.6819456110177201,0.07302469872122001
달러화/NNG;엔화/NNG;상승/NNG;했/XSV,1,0.8040376089169037,36,25,11,25,0.7007167597823816,0.0761360340663499
금리인상/NNG;일/VCP,1,0.8009126973630873,17,12,5,20,0.5655624311074745,0.06253867124951369
유가/NNG;떨어질/VV,1,0.8009126973630873,17,12,5,16,0.5655624311074745,0.06253867124951369
변동성/NNG;높이/VV,1,0.8009126973630873,17,12,5,18,0.5655624311074745,0.06253867124951369
낙찰/NNG;금리/NNG;낮/VA;수준/NNG,1,0.8009126973630873,17,12,5,6,0.5655624311074745,0.06253867124951369
경기회복세/NNG;찬물/NNG;끼얹/VV,1,0.8009126973630873,17,12,5,15,0.5655624311074745,0.06253867124951369
경제성장률/NNG;밑돌/VV,1,0.8009126973630873,17,12,5,9,0.5655624311074745,0.06253867124951369
금리/NNG;낮/VA;자금/NNG,1,0.8009126973630873,17,12,5,8,0.5655624311074745,0.06253867124951369
성장세/NNG;회복/NNG;하/XSV,1,0.8009126973630873,17,12,5,14,0.5655624311074745,0.06253867124951369
성장/NNG;어렵/VA,1,0.8009126973630873,17,12,5,14,0.5655624311074745,0.06253867124951369
경기침체/NNG;우려/NNG;커지/VV,1,0.8009126973630873,17,12,5,3,0.5655624311074745,0.06253867124951369
경제/NNG;부담/NNG;되/VV,1,0.8009126973630873,17,12,5,15,0.5655624311074745,0.06253867124951369
가계대출/NNG;증가/NNG;했/XSV,1,0.7903815406574795,20,14,6,7,0.587541820026868,0.06880644777536551
비농업/NNG;고용/NNG;감소/NNG;했/XSV,1,0.7903815406574795,20,14,6,6,0.587541820026868,0.06880644777536551
경제/NNG;회복세/NNG;이/VV,1,0.7903815406574795,20,14,6,16,0.587541820026868,0.06880644777536551
구조/NNG;개선/NNG;되/XSV,1,0.7903815406574795,20,14,6,16,0.587541820026868,0.06880644777536551
금리인하/NNG;한/XSA,1,0.7838992229141362,23,16,7,25,0.6090741402373488,0.07380001586382949
금리인상/NNG;카드/NNG;꺼내/VV,1,0.7838992229141362,23,16,7,10,0.6090741402373488,0.07380001586382949
통화정책/NNG;경제/NNG;견조/NNG;한/XSA;성장/NNG;하/XSV,1,0.7838992229141362,23,16,7,8,0.6090741402373488,0.07380001586382949
금리인상/NNG;가능성/NNG;시사/NNG;하/XSV,1,0.7837001299987134,62,42,20,45,0.8280816254748047,0.10044022144874694
호황/NNG;누렸/VV,1,0.7800159527733375,26,18,8,12,0.6300868409466437,0.0778869094227899
부동산가격/NNG;상승/NNG;하/XSV,1,0.7800159527733375,26,18,8,22,0.6300868409466437,0.0778869094227899
금리인상/NNG;필요/NNG;할/XSV,1,0.7780673312025943,44,30,14,14,0.7424998900672057,0.09269674304295145
금융완화/NNG;유지/NNG;하/XSV,1,0.7772982622090197,41,28,13,47,0.7255595684007395,0.09093493087093103
경제/NNG;영향/NNG;줄/VV,1,0.7772982622090197,41,28,13,18,0.7255595684007395,0.09093493087093103
이자/NNG;부담/NNG;늘어나/VV,1,0.7772982622090197,41,28,13,31,0.7255595684007395,0.09093493087093103
장기금리/NNG;낮/VA;수준/NNG,1,0.7767967377756393,32,22,10,13,0.6703196026829531,0.08422454079622414
경기회복/NNG;기대심리/NNG;높/VA,1,0.7767403021261476,38,26,12,27,0.7078692400227229,0.08896789459910591
기준금리인상/NNG;단행/NNG;하/XSV,1,0.7560124247699485,46,31,15,37,0.7485819063407351,0.104029575968701
실업수당청구/NNG;증가/NNG;한/XSA,1,0.7534273855132336,43,29,14,21,0.7319938914597071,0.1029532376053937
수출/NNG;높/VA;신장세/NNG,1,0.750732327931265,40,27,13,12,0.7146481152495391,0.10176818637828922
경제성장/NNG;둔화/NNG;하/XSV,1,0.7424719615072923,31,21,10,16,0.6582447643788951,0.09730027159218102
양적완화/NNG;줄이/VV,1,0.7399820182916719,28,19,9,41,0.6380835251884944,0.09536794639692764
산업생산/NNG;증가/NNG;할/XSV,1,0.7399820182916719,28,19,9,14,0.6380835251884944,0.09536794639692764
매입/NNG;하/XSV;양적완화/NNG;조치/NNG,1,0.739606761069973,16,11,5,4,0.5519190651441195,0.08262663087886707
재고/NNG;줄어들/VV,1,0.739606761069973,16,11,5,14,0.5519190651441195,0.08262663087886707
연체율/NNG;상승/NNG;한/XSA,1,0.739606761069973,16,11,5,8,0.5519190651441195,0.08262663087886707
금리변동성/NNG;축소/NNG;되/XSV,1,0.739606761069973,16,11,5,12,0.5519190651441195,0.08262663087886707
엔화/NNG;강세/NNG;저지/NNG;하/XSV,1,0.739606761069973,16,11,5,13,0.5519190651441195,0.08262663087886707
유로화/NNG;강세/NNG;나타내/VV,1,0.739606761069973,16,11,5,12,0.5519190651441195,0.08262663087886707
유로화/NNG;오르/VV,1,0.739606761069973,16,11,5,12,0.5519190651441195,0.08262663087886707
하방경직성/NNG;강화/NNG;되/XSV,1,0.739606761069973,16,11,5,21,0.5519190651441195,0.08262663087886707
외환보유액/NNG;감소/NNG;한/XSA,1,0.739606761069973,16,11,5,8,0.5519190651441195,0.08262663087886707
국제/NNG;유가급등/NNG;따른/VV,1,0.739606761069973,16,11,5,9,0.5519190651441195,0.08262663087886707
경기개선/NNG;기대심리/NNG;높/VA,1,0.739606761069973,16,11,5,11,0.5519190651441195,0.08262663087886707
금리인상/NNG;된다/XSV,1,0.739606761069973,16,11,5,12,0.5519190651441195,0.08262663087886707
외환시장안정/NNG;위한/VV,1,0.739606761069973,16,11,5,11,0.5519190651441195,0.08262663087886707
단기금리/NNG;올라가/VV,1,0.739606761069973,16,11,5,5,0.5519190651441195,0.08262663087886707
경제성장률/NNG;전망/NNG;낮추/VV,1,0.739606761069973,16,11,5,9,0.5519190651441195,0.08262663087886707
안전자산선호/NNG;되/XSV,1,0.739606761069973,16,11,5,22,0.5519190651441195,0.08262663087886707
시장금리/NNG;급등/NNG;한/XSA,1,0.7368941590325564,19,13,6,8,0.5741544095376417,0.08698615209893794
불확실성해소/NNG;따른/VV,1,0.7368941590325564,19,13,6,23,0.5741544095376417,0.08698615209893794
자산매입/NNG;축소/NNG;할/XSV,1,0.7368941590325564,19,13,6,27,0.5741544095376417,0.08698615209893794
회사채/NNG;신용스프레드/NNG;확대/NNG;되/XSV,1,0.7368941590325564,19,13,6,23,0.5741544095376417,0.08698615209893794
기업/NNG;실적호조/NNG;힘입/VV,1,0.7368941590325564,19,13,6,8,0.5741544095376417,0.08698615209893794
금리인상/NNG;진행/NNG;되/XSV,1,0.7367013400158242,22,15,7,20,0.5959781304963182,0.09036869072891118
불확실성/NNG;줄이/VV,1,0.7367013400158242,22,15,7,19,0.5959781304963182,0.09036869072891118
중소기업대출/NNG;늘어나/VV,1,0.7367013400158242,22,15,7,6,0.5959781304963182,0.09036869072891118
신용경색/NNG;우려/NNG;완화/NNG;되/XSV,1,0.7367013400158242,22,15,7,19,0.5959781304963182,0.09036869072891118
금리인상/NNG;보/VV,1,0.7367013400158242,22,15,7,23,0.5959781304963182,0.09036869072891118
경제성장률/NNG;떨어질/VV,1,0.7367013400158242,22,15,7,16,0.5959781304963182,0.09036869072891118
경제/NNG;완만한/VAX;회복세/NNG;이/VV,1,0.7367013400158242,22,15,7,6,0.5959781304963182,0.09036869072891118
주택가격/NNG;상승/NNG;하/XSV,1,0.7307551561678876,45,30,15,41,0.7380878145453114,0.11483657520645837
인플레이션억제/NNG;위한/VV,1,0.7261567663429085,42,28,14,25,0.7210743307316856,0.11440881111523088
금리/NNG;인상/NNG;해야/XSV,1,0.7241858337877898,112,73,39,89,0.9282335256544044,0.1485067652117348
경제/NNG;충격/NNG;줄/VV,1,0.7097144504294672,33,22,11,28,0.6655732722980847,0.1130175997049419
채권/NNG;시장/NNG;오/VV,1,0.7032209821512212,30,20,10,19,0.6456618446538784,0.11251547888187312
성장/NNG;이루/VV,1,0.7032209821512212,30,20,10,14,0.6456618446538784,0.11251547888187312
인플레이션/NNG;억제/NNG;될/XSV,1,0.7032209821512212,30,20,10,12,0.6456618446538784,0.11251547888187312
금리인상/NNG;단행/NNG;해/XSV,1,0.7032209821512212,30,20,10,16,0.6456618446538784,0.11251547888187312
성장/NNG;보였/VV,1,0.6961470251691557,27,18,9,10,0.6250994576774643,0.11199290261327319
견조/NNG;한/XSA;성장세/NNG;유지/NNG,1,0.6961470251691557,27,18,9,17,0.6250994576774643,0.11199290261327319
cd금리/NNG;오르/VV,1,0.6941260951193058,71,46,25,34,0.8377281795582265,0.151265611097309
불확실성해소/NNG;라는/VCP,1,0.688442100047093,24,16,8,19,0.6039294907331639,0.11144907837219147
달러화/NNG;강세/NNG;나타낼/VV,1,0.688442100047093,24,16,8,16,0.6039294907331639,0.11144907837219147
실적/NNG;올렸/VV,1,0.688442100047093,24,16,8,22,0.6039294907331639,0.11144907837219147
gdp/NNG;증가/NNG;한/XSA,1,0.688442100047093,24,16,8,13,0.6039294907331639,0.11144907837219147
불확실성/NNG;줄어들/VV,1,0.6883471368861818,38,25,13,25,0.6914924097795705,0.12765399077525874
성장/NNG;유지/NNG;하/XSV,1,0.6814123049353844,46,30,16,38,0.7329466927318113,0.13888698355665333
cd금리/NNG;급등/NNG;하/XSV,1,0.6800513229083038,21,14,7,4,0.5822026614949363,0.11088319145140257
물가/NNG;오른/VV,1,0.6800513229083038,21,14,7,12,0.5822026614949363,0.11088319145140257
금리인상/NNG;가능성/NNG;남/VV,1,0.6800513229083038,21,14,7,20,0.5822026614949363,0.11088319145140257
달러원/NNG;떨어지/VV,1,0.6800513229083038,21,14,7,26,0.5822026614949363,0.11088319145140257
외환시장안정/NNG;위해/VV,1,0.6800513229083038,21,14,7,9,0.5822026614949363,0.11088319145140257
경제/NNG;침체/NNG;될/XSV,1,0.6800513229083038,21,14,7,7,0.5822026614949363,0.11088319145140257
성장/NNG;견인/NNG;할/XSV,1,0.6800513229083038,21,14,7,15,0.5822026614949363,0.11088319145140257
달러화/NNG;엔화/NNG;움직여/VV;인/VCP;높/VA;졌/VX,1,0.6800513229083038,21,14,7,15,0.5822026614949363,0.11088319145140257
불확실성/NNG;해소/NNG;하/XSV,1,0.6796601088267651,35,23,12,32,0.6725362176132951,0.12827407061878046
인플레이션압력/NNG;완화/NNG;되/XSV,1,0.6763030109900929,62,40,22,27,0.8019776725283545,0.15487470502667022
기준금리인상/NNG;통해/VV,1,0.6728097313517192,43,28,15,34,0.7157888943522357,0.14001331273773726
실적/NNG;악화/NNG;되/XSV,1,0.6709151230727033,18,12,6,11,0.5599770507402523,0.11029440575859427
산업생산/NNG;감소/NNG;했/XSV,1,0.6709151230727033,18,12,6,17,0.5599770507402523,0.11029440575859427
금리/NNG;상승/NNG;한다면/XSV,1,0.6709151230727033,18,12,6,17,0.5599770507402523,0.11029440575859427
아파트가격/NNG;오르/VV,1,0.6709151230727033,18,12,6,19,0.5599770507402523,0.11029440575859427
금리/NNG;낮/VA;대출/NNG,1,0.6709151230727033,18,12,6,11,0.5599770507402523,0.11029440575859427
이자/NNG;낮추/VV,1,0.6709151230727033,18,12,6,11,0.5599770507402523,0.11029440575859427
원화/NNG;약세/NNG;될/XSV,1,0.6709151230727033,18,12,6,9,0.5599770507402523,0.11029440575859427
안전자산선호/NNG;될/XSV,1,0.6709151230727033,18,12,6,18,0.5599770507402523,0.11029440575859427
유로화/NNG;달러화/NNG;오른/VV,1,0.6709151230727033,18,12,6,17,0.5599770507402523,0.11029440575859427
경제성장률/NNG;전망/NNG;상향/NNG;조정/NNG;했/XSV,1,0.6709151230727033,18,12,6,18,0.5599770507402523,0.11029440575859427
소비자물가/NNG;안정/NNG;되/XSV,1,0.6709151230727033,18,12,6,8,0.5599770507402523,0.11029440575859427
금리인상/NNG;속도/NNG;늦출/VV,1,0.6709151230727033,18,12,6,10,0.5599770507402523,0.11029440575859427
대외불확실성/NNG;완화/NNG;되/XSV,1,0.6709151230727033,18,12,6,10,0.5599770507402523,0.11029440575859427
회사채/NNG;수익률/NNG;상승/NNG;한/XSA,1,0.6709151230727033,18,12,6,8,0.5599770507402523,0.11029440575859427
양적완화/NNG;축소/NNG;하/XSV,1,0.6700721353665937,51,33,18,65,0.7544995855162475,0.1490637799128496
실적/NNG;부진/NNG;할/XSV,1,0.669869140519292,32,21,11,12,0.6528614210305046,0.12907851501121453
금리인상/NNG;단행/NNG;되/XSV,1,0.6610688849805277,56,36,20,50,0.7743743473338268,0.15801573262544966
금리인하/NNG;선반영/NNG;한/XSA,1,0.6609689800651439,15,10,5,12,0.5373179861141196,0.10968186484953171
금/NNG;가격/NNG;오른/VV,1,0.6609689800651439,15,10,5,4,0.5373179861141196,0.10968186484953171
제로금리정책/NNG;유지/NNG;할/XSV,1,0.6609689800651439,15,10,5,9,0.5373179861141196,0.10968186484953171
채권/NNG;가격/NNG;올랐/VV,1,0.6609689800651439,15,10,5,13,0.5373179861141196,0.10968186484953171
급성장/NNG;했/XSV,1,0.6609689800651439,15,10,5,7,0.5373179861141196,0.10968186484953171
높/VA;수익률/NNG;보였/VV,1,0.6609689800651439,15,10,5,7,0.5373179861141196,0.10968186484953171
불확실성/NNG;확대/NNG;따른/VV,1,0.6609689800651439,15,10,5,10,0.5373179861141196,0.10968186484953171
기준금리인상/NNG;이어지/VV,1,0.6609689800651439,15,10,5,10,0.5373179861141196,0.10968186484953171
금리동결/NNG;전망/NNG;했/XSV,1,0.6609689800651439,15,10,5,5,0.5373179861141196,0.10968186484953171
irs/NNG;스프레드/NNG;확대/NNG;됐/XSV;스왑레이트/NNG;나타냈/VV,1,0.6609689800651439,15,10,5,7,0.5373179861141196,0.10968186484953171
채권스왑/NNG;스프레드/NNG;역전폭/NNG;확대/NNG;되/XSV,1,0.6609689800651439,15,10,5,32,0.5373179861141196,0.10968186484953171
가격변수/NNG;변동성/NNG;확대/NNG;되/XSV,1,0.6609689800651439,15,10,5,10,0.5373179861141196,0.10968186484953171
성장세/NNG;힘입/VV,1,0.6609689800651439,15,10,5,18,0.5373179861141196,0.10968186484953171
금리인상/NNG;강력하/VAX,1,0.6609689800651439,15,10,5,4,0.5373179861141196,0.10968186484953171
국가부도위험/NNG;나타내/VV,1,0.6609689800651439,15,10,5,12,0.5373179861141196,0.10968186484953171
미국채/NNG;irs/NNG;스프레드/NNG;확대/NNG;됐/XSV,1,0.6609689800651439,15,10,5,7,0.5373179861141196,0.10968186484953171
국제금융시장/NNG;변동성/NNG;확대/NNG;될/XSV,1,0.6609689800651439,15,10,5,17,0.5373179861141196,0.10968186484953171
민간/NNG;채권/NNG;수익률/NNG;민평/NNG;하락/NNG;한/XSA,1,0.6609689800651439,15,10,5,16,0.5373179861141196,0.10968186484953171
물가상승압력/NNG;완화/NNG;하/XSV,1,0.6609689800651439,15,10,5,7,0.5373179861141196,0.10968186484953171
채권/NNG;시장/NNG;국채가격/NNG;상승/NNG;한/XSA,1,0.6609689800651439,15,10,5,6,0.5373179861141196,0.10968186484953171
고용호조/NNG;불구하/VAX,1,0.6609689800651439,15,10,5,9,0.5373179861141196,0.10968186484953171
연방기금/NNG;금리/NNG;인하/NNG;할/XSV,1,0.6609689800651439,15,10,5,10,0.5373179861141196,0.10968186484953171
소비/NNG;개선/NNG;되/XSV,1,0.6587449276892308,29,19,10,26,0.6324944766750054,0.13013103063690823
원자재/NNG;가격/NNG;오르/VV,1,0.6587449276892308,29,19,10,17,0.6324944766750054,0.13013103063690823
단기금리/NNG;상승/NNG;하/XSV,1,0.6552222953796354,69,44,25,54,0.8212754989450983,0.17107829713748046
기준금리인상/NNG;어려울/VA,1,0.6522192687656461,37,24,13,18,0.6791617410011391,0.14296609703111257
수익성/NNG;개선/NNG;될/XSV,1,0.6522192687656461,37,24,13,32,0.6791617410011391,0.14296609703111257
듀레이션/NNG;늘리/VV,1,0.6521623122521722,53,34,19,36,0.7593990872566454,0.15988804315597693
역외/NNG;환율상승/NNG;반영/NNG;해/XSV,1,0.6459694023127625,26,17,9,11,0.6114657748604765,0.13152574901754924
유가/NNG;하락/NNG;한/XSA,1,0.6459694023127625,26,17,9,33,0.6114657748604765,0.13152574901754924
금리동결/NNG;유지/NNG;할/XSV,1,0.6459694023127625,26,17,9,14,0.6114657748604765,0.13152574901754924
신용스프레드/NNG;확대/NNG;된/XSV,1,0.6459694023127625,26,17,9,15,0.6114657748604765,0.13152574901754924
경기모멘텀/NNG;둔화/NNG;되/XSV,1,0.6459694023127625,26,17,9,38,0.6114657748604765,0.13152574901754924
소비자물가/NNG;급등/NNG;하/XSV,1,0.6310807280641406,23,15,8,11,0.5898076260060453,0.13340753291949434
금리/NNG;안정적/VAX;인/VCP,1,0.6310807280641406,23,15,8,22,0.5898076260060453,0.13340753291949434
인플레이션압력/NNG;줄어들/VV,1,0.6310807280641406,23,15,8,11,0.5898076260060453,0.13340753291949434
경제/NNG;안정/NNG;되/XSV,1,0.6310807280641406,23,15,8,17,0.5898076260060453,0.13340753291949434
기준금리인상/NNG;반영/NNG;하/XSV,1,0.6310807280641406,23,15,8,20,0.5898076260060453,0.13340753291949434
대출/NNG;줄/VV,1,0.6310807280641406,23,15,8,10,0.5898076260060453,0.13340753291949434
금리상승압력/NNG;제한적/VAX,1,0.6310807280641406,23,15,8,21,0.5898076260060453,0.13340753291949434
미국채금리/NNG;하락/NNG;했/XSV,1,0.6260412910817232,78,49,29,72,0.8401913439412404,0.1932335728495545
매출/NNG;늘/VV,1,0.625502130380762,31,20,11,24,0.6395379845371515,0.1473466488059525
콜금리/NNG;인상/NNG;했/XSV,1,0.625502130380762,31,20,11,23,0.6395379845371515,0.1473466488059525
주택가격/NNG;오르/VV,1,0.625502130380762,31,20,11,26,0.6395379845371515,0.1473466488059525
금리상승/NNG;한/XSA,1,0.6185734036511708,44,28,16,56,0.7096793652454874,0.16724397257879411
물가안정/NNG;이/VCP,1,0.6156943626375464,119,74,45,82,0.9072918173243346,0.21581085848580353
국고채/NNG;지표금리/NNG;오른/VV,1,0.6148974773853033,80,50,30,78,0.8423534232770362,0.20087886152324103
금리인상/NNG;결정/NNG;되/XSV,1,0.613369865385121,20,13,7,8,0.5675499572544385,0.13601093671144798
경제성장/NNG;뒷받침/NNG;하/XSV,1,0.613369865385121,20,13,7,11,0.5675499572544385,0.13601093671144798
투자심리/NNG;안정/NNG;시키/XSV,1,0.613369865385121,20,13,7,10,0.5675499572544385,0.13601093671144798
기준금리인하/NNG;없/VA,1,0.613369865385121,20,13,7,29,0.5675499572544385,0.13601093671144798
기준금리/NNG;인상/NNG;되/XSV;않/VX,1,0.613369865385121,20,13,7,28,0.5675499572544385,0.13601093671144798
금리인상/NNG;가능성/NNG;따른/VV,1,0.613369865385121,20,13,7,35,0.5675499572544385,0.13601093671144798
마이너스금리/NNG;하/XSV,1,0.613369865385121,20,13,7,11,0.5675499572544385,0.13601093671144798
국채수익률/NNG;상승/NNG;했/XSV,1,0.613369865385121,20,13,7,18,0.5675499572544385,0.13601093671144798
물가상승률/NNG;둔화/NNG;되/XSV,1,0.613369865385121,20,13,7,24,0.5675499572544385,0.13601093671144798
금리/NNG;상승세/NNG;하/XSV,1,0.613369865385121,20,13,7,18,0.5675499572544385,0.13601093671144798
고용자수/NNG;감소/NNG;하/XSV,1,0.613369865385121,20,13,7,12,0.5675499572544385,0.13601093671144798
금리/NNG;인상/NNG;된/XSV,1,0.613369865385121,20,13,7,23,0.5675499572544385,0.13601093671144798
경제/NNG;견조/NNG;한/XSA;성장/NNG;하/XSV,1,0.6126950323265388,36,23,13,14,0.6662560681688786,0.1600109668276179
수출/NNG;개선/NNG;되/XSV,1,0.6126950323265388,36,23,13,33,0.6662560681688786,0.1600109668276179
유가급락/NNG;따른/VV,1,0.6089092903750286,28,18,10,22,0.6186435638203658,0.15038099224061188
금리인상/NNG;필요/NNG;하/XSV,1,0.6044661694805504,59,37,22,46,0.7725751690551989,0.19045785341444935
기준금리인상/NNG;인/VCP,1,0.6044085528506351,41,26,15,27,0.691495573784987,0.17050078379422337
달러화/NNG;급락/NNG;했/XSV,1,0.5960057047544822,33,21,12,22,0.6462653599270016,0.1635889889408086
통화정책/NNG;완화적/VAX;이/VCP,1,0.5960057047544822,33,21,12,27,0.6462653599270016,0.1635889889408086
기준금리/NNG;오를/VV,1,0.5950837763390127,51,32,19,69,0.7372393054358212,0.18715105178210295
실적/NNG;개선/NNG;되/XSV,1,0.5923708076664151,56,35,21,63,0.757678654888714,0.19395786658640282
수입물가/NNG;상승/NNG;하/XSV,1,0.5916704299591209,17,11,6,12,0.5447107131415009,0.13974126181658636
금리/NNG;상승세/NNG;돌아섰/VV,1,0.5916704299591209,17,11,6,16,0.5447107131415009,0.13974126181658636
국채발행/NNG;증가/NNG;따른/VV,1,0.5916704299591209,17,11,6,3,0.5447107131415009,0.13974126181658636
장기금리/NNG;상승/NNG;한/XSA,1,0.5916704299591209,17,11,6,12,0.5447107131415009,0.13974126181658636
경제/NNG;호조/NNG;나타내/VV,1,0.5916704299591209,17,11,6,10,0.5447107131415009,0.13974126181658636
금리인상/NNG;압력/NNG;높/VA,1,0.5916704299591209,17,11,6,17,0.5447107131415009,0.13974126181658636
국제/NNG;유가/NNG;급등/NNG;한/XSA,1,0.5916704299591209,17,11,6,15,0.5447107131415009,0.13974126181658636
경제지표/NNG;호조/NNG;보일/VV,1,0.5916704299591209,17,11,6,11,0.5447107131415009,0.13974126181658636
경기선행지수/NNG;상승/NNG;했/XSV,1,0.5916704299591209,17,11,6,7,0.5447107131415009,0.13974126181658636
경제여건/NNG;악화/NNG;되/XSV,1,0.5916704299591209,17,11,6,9,0.5447107131415009,0.13974126181658636
낙찰/NNG;금리/NNG;높/VA;수준/NNG,1,0.5916704299591209,17,11,6,20,0.5447107131415009,0.13974126181658636
수출호조/NNG;되/XSV,1,0.5916704299591209,17,11,6,13,0.5447107131415009,0.13974126181658636
경기지표/NNG;호조/NNG;보이/VV,1,0.5916704299591209,17,11,6,17,0.5447107131415009,0.13974126181658636
실적/NNG;줄/VV,1,0.5916704299591209,17,11,6,13,0.5447107131415009,0.13974126181658636
물가안정/NNG;하/VV,1,0.5916704299591209,17,11,6,14,0.5447107131415009,0.13974126181658636
소비자물가/NNG;오른/VV,1,0.5916704299591209,17,11,6,11,0.5447107131415009,0.13974126181658636
주택담보대출/NNG;금리/NNG;올랐/VV,1,0.5916704299591209,17,11,6,11,0.5447107131415009,0.13974126181658636
변동성/NNG;줄어드/VV,1,0.5916704299591209,17,11,6,7,0.5447107131415009,0.13974126181658636
기준금리/NNG;유지/NNG;하/XSV,1,0.5907608474829107,258,159,99,218,0.9272142453589969,0.23853557637161302
주택/NNG;판매가격/NNG;감소/NNG;한/XSA,1,0.5893462623665797,25,16,9,24,0.5970472060138574,0.1542646001020027
금리인상/NNG;전망/NNG;하/XSV,1,0.5893462623665797,25,16,9,26,0.5970472060138574,0.1542646001020027
기준금리/NNG;동결/NNG;한다고/XSV,1,0.5893462623665797,25,16,9,29,0.5970472060138574,0.1542646001020027
기준금리인상/NNG;해/XSV,1,0.5893462623665797,25,16,9,26,0.5970472060138574,0.1542646001020027
견조/NNG;한/XSA;성장/NNG;할/XSV,1,0.5893462623665797,25,16,9,3,0.5970472060138574,0.1542646001020027
경기둔화/NNG;인한/VV,1,0.5882849253678939,38,24,14,20,0.6725046805124801,0.1743266148781975
금리인상/NNG;둘러싼/VV,1,0.5882849253678939,38,24,14,30,0.6725046805124801,0.1743266148781975
금리인하/NNG;기대심리/NNG;높/VA,1,0.5807065021774298,48,30,18,36,0.7204078180851948,0.19109225131316182
콜금리/NNG;올릴/VV,1,0.5807065021774298,48,30,18,14,0.7204078180851948,0.19109225131316182
물가안정/NNG;위해/VV,1,0.5789590582127686,129,79,50,105,0.9051504002302642,0.2413634286673839
하방위험/NNG;요인/NNG;작용/NNG;할/XSV,1,0.576616300289347,30,19,11,5,0.6255073825742435,0.1679720947856109
경제/NNG;타격/NNG;줄/VV,1,0.576616300289347,30,19,11,21,0.6255073825742435,0.1679720947856109
금리인하/NNG;이/VCP,1,0.576616300289347,30,19,11,17,0.6255073825742435,0.1679720947856109
달러화/NNG;떨어지/VV,1,0.576616300289347,30,19,11,24,0.6255073825742435,0.1679720947856109
금리/NNG;올린/VV,1,0.5724331872889059,149,91,58,102,0.9136379549768523,0.2484284287880373
경기회복세/NNG;둔화/NNG;되/XSV,1,0.5697947808955572,35,22,13,11,0.6527053492028759,0.17887291615797782
주택담보대출/NNG;늘/VV,1,0.5662391145852037,40,25,15,34,0.6784829168527706,0.18789916834594597
금리인상/NNG;이어지/VV,1,0.5662391145852037,40,25,15,31,0.6784829168527706,0.18789916834594597
경상수지적자/NNG;확대/NNG;되/XSV,1,0.5658329904483124,22,14,8,5,0.5747514809576271,0.1593620787372122
금리인하/NNG;가능성/NNG;시사/NNG;한/XSA,1,0.5658329904483124,22,14,8,10,0.5747514809576271,0.1593620787372122
변동성/NNG;줄어든/VV,1,0.5658329904483124,22,14,8,13,0.5747514809576271,0.1593620787372122
낮/VA;금리/NNG;유지/NNG;할/XSV,1,0.5658329904483124,22,14,8,14,0.5747514809576271,0.1593620787372122
금리인상기대/NNG;높/VA,1,0.5658329904483124,22,14,8,17,0.5747514809576271,0.1593620787372122
금리인상/NNG;단행/NNG;되/XSV;않/VX,1,0.5658329904483124,22,14,8,19,0.5747514809576271,0.1593620787372122
투자/NNG;위축/NNG;될/XSV,1,0.5658329904483124,22,14,8,12,0.5747514809576271,0.1593620787372122
금리인상/NNG;인/VCP,1,0.5650919644850063,85,52,33,77,0.8400827690317834,0.23343874835450049
기준금리인상/NNG;되/XSV,1,0.5650762148622406,80,49,31,48,0.8281037017159046,0.23012070086884176
금리인상/NNG;임박했/VAX,1,0.5645374756112929,45,28,17,38,0.7027348928689623,0.19559127501361306
경기회복/NNG;이/VCP,1,0.5638158493867675,55,34,21,38,0.746445057142497,0.208197284275786
내수/NNG;개선/NNG;되/XSV,1,0.5538012133886263,27,17,10,22,0.6039795558548294,0.17343844489718258
금리인상/NNG;신중/NNG;하/XSV,1,0.5538012133886263,27,17,10,14,0.6039795558548294,0.17343844489718258
변동성/NNG;확대/NNG;시킬/XSV,1,0.5538012133886263,27,17,10,23,0.6039795558548294,0.17343844489718258
금리인상/NNG;불가피하/VAX,1,0.5538012133886263,27,17,10,21,0.6039795558548294,0.17343844489718258
마이너스금리/NNG;도입/NNG;하/XSV,1,0.5535027203841605,72,44,28,42,0.8028318711536531,0.23073927701073565
유로화/NNG;하락압력/NNG;받/VV,1,0.5484025073151684,32,20,12,21,0.6320918084672913,0.18434721470161997
금리/NNG;하락압력/NNG;받/VV,1,0.5484025073151684,32,20,12,31,0.6320918084672913,0.18434721470161997
성장/NNG;촉진/NNG;하/XSV,1,0.5484025073151684,32,20,12,19,0.6320918084672913,0.18434721470161997
금리인하/NNG;기대/NNG;하/XSV,1,0.5470503854325179,47,29,18,43,0.7079831681319707,0.20727970092861772
수요/NNG;증가/NNG;했/XSV,1,0.5470503854325179,47,29,18,40,0.7079831681319707,0.20727970092861772
원화/NNG;강세/NNG;이어질/VV,1,0.5464263730335994,37,23,14,18,0.6588812535021182,0.19324752400200954
기준금리/NNG;수준/NNG;인/VCP;유지/NNG;하/XSV,1,0.5464263730335994,37,23,14,33,0.6588812535021182,0.19324752400200954
설비투자/NNG;증가/NNG;하/XSV,1,0.5464263730335994,37,23,14,13,0.6588812535021182,0.19324752400200954
금융시장/NNG;안정/NNG;될/XSV,1,0.5368383107017376,19,12,7,12,0.551730111399716,0.16627114542083865
국고/NNG;채권/NNG;금리/NNG;오른/VV,1,0.5368383107017376,19,12,7,28,0.551730111399716,0.16627114542083865
기준금리인상/NNG;이/VV,1,0.5368383107017376,19,12,7,9,0.551730111399716,0.16627114542083865
금리매력/NNG;높/VA;진/VX,1,0.5368383107017376,19,12,7,9,0.551730111399716,0.16627114542083865
미국채수익률/NNG;상승/NNG;하/XSV,1,0.5368383107017376,19,12,7,17,0.551730111399716,0.16627114542083865
금리하락/NNG;나타날/VV,1,0.5368383107017376,19,12,7,7,0.551730111399716,0.16627114542083865
기준금리/NNG;동결/NNG;키로/XSV,1,0.5368383107017376,19,12,7,15,0.551730111399716,0.16627114542083865
금리/NNG;수준/NNG;유지/NNG;할/XSV,1,0.5368383107017376,19,12,7,8,0.551730111399716,0.16627114542083865
물가상승/NNG;인해/VV,1,0.5368383107017376,19,12,7,6,0.551730111399716,0.16627114542083865
부채/NNG;증가/NNG;하/XSV,1,0.5368383107017376,19,12,7,30,0.551730111399716,0.16627114542083865
금리상승/NNG;과도/NNG;했/XSV,1,0.5368383107017376,19,12,7,8,0.551730111399716,0.16627114542083865
신용등급/NNG;상향/NNG;조정/NNG;되/XSV,1,0.5368383107017376,19,12,7,15,0.551730111399716,0.16627114542083865
전원/NNG;기준금리동결/NNG;했/XSV,1,0.5368383107017376,19,12,7,3,0.551730111399716,0.16627114542083865
대출/NNG;감소/NNG;했/XSV,1,0.5368383107017376,19,12,7,5,0.551730111399716,0.16627114542083865
지급준비율/NNG;인상/NNG;이/VCP,1,0.5368383107017376,19,12,7,13,0.551730111399716,0.16627114542083865
경기선행지수/NNG;하락/NNG;한/XSA,1,0.5368383107017376,19,12,7,12,0.551730111399716,0.16627114542083865
실업수당청구/NNG;늘어난/VV,1,0.5368383107017376,19,12,7,10,0.551730111399716,0.16627114542083865
경제/NNG;충격/NNG;주/VV,1,0.5368383107017376,19,12,7,5,0.551730111399716,0.16627114542083865
금리인상/NNG;신호/NNG;보내/VV,1,0.5368383107017376,19,12,7,10,0.551730111399716,0.16627114542083865
기준금리인상/NNG;반영/NNG;한/XSA,1,0.5368383107017376,19,12,7,16,0.551730111399716,0.16627114542083865
금리인상/NNG;이/VV,1,0.5364484242589402,59,36,23,43,0.7547634701460371,0.22770711390736006
실적/NNG;개선/NNG;될/XSV,1,0.5337823594263091,54,33,21,52,0.7346927618297765,0.22331386932316669
고용호조/NNG;따른/VV,1,0.5337823594263091,54,33,21,49,0.7346927618297765,0.22331386932316669
성장/NNG;이/VV,1,0.5337823594263091,54,33,21,53,0.7346927618297765,0.22331386932316669
기준금리인상/NNG;따른/VV,1,0.5313990599068572,178,107,71,116,0.9086381128315962,0.2780289998938894
수요/NNG;둔화/NNG;될/XSV,1,0.5265248834575775,24,15,9,17,0.5816608093861269,0.18040402504705977
금리인하/NNG;기대/NNG;낮/VA,1,0.5265248834575775,24,15,9,16,0.5816608093861269,0.18040402504705977
물가/NNG;끌어올리/VV,1,0.5265248834575775,24,15,9,27,0.5816608093861269,0.18040402504705977
달러강세/NNG;부추기/VV,1,0.5265248834575775,24,15,9,8,0.5816608093861269,0.18040402504705977
금리/NNG;내릴/VV;없/VA,1,0.5265248834575775,24,15,9,20,0.5816608093861269,0.18040402504705977
금리인상/NNG;가능성/NNG;이/VCP,1,0.5265248834575775,24,15,9,12,0.5816608093861269,0.18040402504705977
국고채/NNG;금리/NNG;오르/VV,1,0.5265248834575775,24,15,9,26,0.5816608093861269,0.18040402504705977
금리인상/NNG;위한/VV,1,0.5240042983778559,61,37,24,91,0.7586141007457744,0.2369301193025571
경기개선/NNG;따른/VV,1,0.5240042983778559,61,37,24,39,0.7586141007457744,0.2369301193025571
하방위험/NNG;작용/NNG;할/XSV,1,0.5236340686743459,34,21,13,22,0.6384235768138081,0.19959578599061983
변동성/NNG;축소/NNG;되/XSV,1,0.5236340686743459,34,21,13,35,0.6384235768138081,0.19959578599061983
수출/NNG;늘어날/VV,1,0.5233894863003778,29,18,11,13,0.6106473050601811,0.19104051516675977
금리상승/NNG;요인/NNG;작용/NNG;하/XSV,1,0.5233894863003778,29,18,11,25,0.6106473050601811,0.19104051516675977
금리상승/NNG;제한/NNG;할/XSV,1,0.5233894863003778,29,18,11,27,0.6106473050601811,0.19104051516675977
물가상승압력/NNG;높/VA,1,0.5160964283487515,139,83,56,120,0.8926348551511517,0.28489605381486827
금리인상/NNG;가능성/NNG;시사/NNG;했/XSV,1,0.5160804388552811,51,31,20,44,0.7177989387629039,0.22910487540250274
경제성장률/NNG;둔화/NNG;될/XSV,1,0.5122854996471999,63,38,25,40,0.7622705040805974,0.2458219544428042
경기선행지수/NNG;하락/NNG;하/XSV,1,0.5115197911061689,46,28,18,26,0.694956564981782,0.22457959045619316
금리/NNG;인상/NNG;해/XSV,1,0.5109273104735641,92,55,37,54,0.8379598482001402,0.27122667343605494
단기금리/NNG;오르/VV,1,0.5066775054094053,41,25,16,22,0.6705131038056851,0.21953118531969412
금리인상/NNG;유지/NNG;할/XSV,1,0.5066775054094053,41,25,16,19,0.6705131038056851,0.21953118531969412
물가상승압력/NNG;커질/VV,1,0.5017627556430961,36,22,14,20,0.6445233876789689,0.21382118128077637
수출/NNG;호조/NNG;하/XSV,1,0.5017627556430961,36,22,14,6,0.6445233876789689,0.21382118128077637
물가안정/NNG;하/XSV,1,0.49982032150775346,16,10,6,13,0.5278867661507447,0.17603714462728437
자금유입/NNG;둔화/NNG;되/XSV,1,0.49982032150775346,16,10,6,18,0.5278867661507447,0.17603714462728437
불안심리/NNG;덜/VV,1,0.49982032150775346,16,10,6,7,0.5278867661507447,0.17603714462728437
물가압력/NNG;완화/NNG;되/XSV,1,0.49982032150775346,16,10,6,1,0.5278867661507447,0.17603714462728437
금리변동위험/NNG;헤지/NNG;하/XSV,1,0.49982032150775346,16,10,6,1,0.5278867661507447,0.17603714462728437
자산건전성/NNG;악화/NNG;될/XSV,1,0.49982032150775346,16,10,6,13,0.5278867661507447,0.17603714462728437
경기회복/NNG;반영/NNG;하/XSV,1,0.49982032150775346,16,10,6,8,0.5278867661507447,0.17603714462728437
장단기금리차/NNG;줄어들/VV,1,0.49982032150775346,16,10,6,11,0.5278867661507447,0.17603714462728437
환율하락/NNG;이/VCP,1,0.49982032150775346,16,10,6,9,0.5278867661507447,0.17603714462728437
달러화가치/NNG;하락/NNG;한/XSA,1,0.49982032150775346,16,10,6,10,0.5278867661507447,0.17603714462728437
내외금리차/NNG;확대/NNG;되/XSV,1,0.49982032150775346,16,10,6,11,0.5278867661507447,0.17603714462728437
기준금리인상/NNG;가능성/NNG;시사/NNG;했/XSV,1,0.49982032150775346,16,10,6,15,0.5278867661507447,0.17603714462728437
가산금리/NNG;하락/NNG;하/XSV,1,0.49982032150775346,16,10,6,14,0.5278867661507447,0.17603714462728437
신용등급/NNG;하향/NNG;조정/NNG;될/XSV,1,0.49982032150775346,16,10,6,6,0.5278867661507447,0.17603714462728437
금리인상/NNG;해야/XSV,1,0.49982032150775346,16,10,6,7,0.5278867661507447,0.17603714462728437
성장세/NNG;회복/NNG;할/XSV,1,0.49982032150775346,16,10,6,18,0.5278867661507447,0.17603714462728437
경기/NNG;부양/NNG;해야/XSV,1,0.49982032150775346,16,10,6,7,0.5278867661507447,0.17603714462728437
실업률/NNG;낮/VA;수준/NNG,1,0.49982032150775346,16,10,6,14,0.5278867661507447,0.17603714462728437
기준금리인상/NNG;가능성/NNG;시사/NNG;하/XSV,1,0.49982032150775346,16,10,6,9,0.5278867661507447,0.17603714462728437
기준금리/NNG;인하/NNG;했으나/XSV,1,0.49982032150775346,16,10,6,9,0.5278867661507447,0.17603714462728437
원달러/NNG;하락/NNG;한/XSA,1,0.49982032150775346,16,10,6,11,0.5278867661507447,0.17603714462728437
통화량/NNG;늘리/VV,1,0.49982032150775346,16,10,6,13,0.5278867661507447,0.17603714462728437
경제/NNG;침체/NNG;빠질/VV,1,0.4971862759656225,31,19,12,29,0.6170814554886066,0.2072286998766205
소득/NNG;늘어나/VV,1,0.4971862759656225,31,19,12,19,0.6170814554886066,0.2072286998766205
달러원/NNG;떨어진/VV,1,0.4971862759656225,31,19,12,22,0.6170814554886066,0.2072286998766205
경제/NNG;안정적/VAX;인/VCP,1,0.4963215789431654,48,29,19,28,0.7000032465020517,0.23561578481396075
채권/NNG;시장/NNG;국채선물/NNG;내린/VV,1,0.4960930094014302,72,43,29,82,0.7856924279889903,0.2646185143167452
민평금리/NNG;높/VA;수준/NNG,1,0.49376869752458696,26,16,10,19,0.5883316889432978,0.19937156521400817
산업생산/NNG;증가/NNG;해/XSV,1,0.49376869752458696,26,16,10,22,0.5883316889432978,0.19937156521400817
금리인하/NNG;가능/NNG;할/XSV,1,0.49376869752458696,26,16,10,21,0.5883316889432978,0.19937156521400817
물가상승률/NNG;했/XSV,1,0.49376869752458696,26,16,10,18,0.5883316889432978,0.19937156521400817
달러화/NNG;떨어졌/VV,1,0.49376869752458696,26,16,10,15,0.5883316889432978,0.19937156521400817
변동폭/NNG;확대/NNG;될/XSV,1,0.4932548499521958,21,13,8,19,0.5584891821624897,0.18951589913572284
수익/NNG;감소/NNG;할/XSV,1,0.4932548499521958,21,13,8,13,0.5584891821624897,0.18951589913572284
높/VA;금리/NNG;제시/NNG;하/XSV,1,0.4932548499521958,21,13,8,24,0.5584891821624897,0.18951589913572284
국채가격/NNG;급락/NNG;했/XSV,1,0.4932548499521958,21,13,8,7,0.5584891821624897,0.18951589913572284
금리인하/NNG;효과/NNG;지켜보/VV,1,0.4932548499521958,21,13,8,9,0.5584891821624897,0.18951589913572284
경기둔화/NNG;심화/NNG;될/XSV,1,0.4932548499521958,21,13,8,3,0.5584891821624897,0.18951589913572284
원유/NNG;재고/NNG;증가/NNG;한/XSA,1,0.4932548499521958,21,13,8,24,0.5584891821624897,0.18951589913572284
경제과열/NNG;막/VV,1,0.4932548499521958,21,13,8,4,0.5584891821624897,0.18951589913572284
채권/NNG;시장/NNG;강세/NNG;보임/VV,1,0.4932548499521958,21,13,8,23,0.5584891821624897,0.18951589913572284
저성장/NNG;되/XSV,1,0.4932548499521958,21,13,8,30,0.5584891821624897,0.18951589913572284
불확실성/NNG;해소/NNG;됐/XSV,1,0.4907680863415298,67,40,27,63,0.7690317268823998,0.2626784435220706
인플레이션/NNG;우려/NNG;따른/VV,1,0.4846241986507194,62,37,25,31,0.7508054773074258,0.26062026581364023
물가/NNG;안정세/NNG;보이/VV,1,0.48232854450682794,38,23,15,14,0.6504073577737893,0.2271265697808779
불확실성/NNG;완화/NNG;될/XSV,1,0.48232854450682794,38,23,15,19,0.6504073577737893,0.2271265697808779
콜금리/NNG;인상/NNG;하/XSV,1,0.47989750966168465,88,52,36,50,0.8198305408834585,0.28810685731368146
금리인상/NNG;가능성/NNG;열/VV,1,0.4797575228114619,124,73,51,142,0.8704988106353228,0.30602408760825317
인플레이션/NNG;완화/NNG;될/XSV,1,0.47442718940943696,33,20,13,29,0.6233045046830553,0.22216765217174833
경제/NNG;낙관적/VAX;인/VCP,1,0.47442718940943696,33,20,13,26,0.6233045046830553,0.22216765217174833
금리동결/NNG;이/VCP,1,0.47442718940943696,33,20,13,20,0.6233045046830553,0.22216765217174833
기대심리/NNG;높여/VV,1,0.47442718940943696,33,20,13,18,0.6233045046830553,0.22216765217174833
성장/NNG;높/VA,1,0.47442718940943696,33,20,13,19,0.6233045046830553,0.22216765217174833
미국채금리/NNG;상승/NNG;했/XSV,1,0.474191917656269,45,27,18,63,0.6812753218795644,0.24297793606487214
수출호조/NNG;힘입/VV,1,0.4694197477992217,52,31,21,42,0.709489429004609,0.2561657404693409
내수/NNG;회복/NNG;되/XSV,1,0.4694197477992217,52,31,21,28,0.709489429004609,0.2561657404693409
경기회복세/NNG;되/XSV,1,0.46717496139732084,104,61,43,68,0.8434575727221474,0.3062918082497048
기준금리/NNG;인상/NNG;되/XSV,1,0.4665342747627219,220,129,91,161,0.8919676538274404,0.32443873016813973
변동성/NNG;높/VA;지/VX,1,0.46618598721966786,28,17,11,33,0.5948000587141244,0.2165414877865639
실업수당청구/NNG;줄어든/VV,1,0.46618598721966786,28,17,11,15,0.5948000587141244,0.2165414877865639
현금/NNG;확보/NNG;하/XSV,1,0.46618598721966786,28,17,11,20,0.5948000587141244,0.2165414877865639
달러화/NNG;하락압력/NNG;가했/VV,1,0.46618598721966786,28,17,11,22,0.5948000587141244,0.2165414877865639
유가/NNG;올랐/VV,1,0.4649509012552495,40,24,16,31,0.6560881497312737,0.23960821468136184
물가안정/NNG;목표/NNG;인/VCP,1,0.46007296130268704,47,28,19,38,0.6863561432995428,0.25379200751399994
위안화/NNG;절상/NNG;하/XSV,1,0.4581490600954117,23,14,9,24,0.5650565966914604,0.20996037822061597
금리인상/NNG;우려/NNG;커지/VV,1,0.4581490600954117,23,14,9,17,0.5650565966914604,0.20996037822061597
실적개선/NNG;되/XSV,1,0.4581490600954117,23,14,9,18,0.5650565966914604,0.20996037822061597
자금난/NNG;덜/VV,1,0.4581490600954117,23,14,9,8,0.5650565966914604,0.20996037822061597
기준금리동결/NNG;전망/NNG;했/XSV,1,0.4581490600954117,23,14,9,19,0.5650565966914604,0.20996037822061597
기준금리/NNG;상향/NNG;조정/NNG;할/XSV,1,0.4581490600954117,23,14,9,35,0.5650565966914604,0.20996037822061597
유로달러/NNG;상승/NNG;했/XSV,1,0.4581490600954117,23,14,9,20,0.5650565966914604,0.20996037822061597
엔화/NNG;오르/VV,1,0.4581490600954117,23,14,9,9,0.5650565966914604,0.20996037822061597
성장/NNG;보이/VV,1,0.4581490600954117,23,14,9,39,0.5650565966914604,0.20996037822061597
엔화/NNG;상승/NNG;할/XSV,1,0.4581490600954117,23,14,9,9,0.5650565966914604,0.20996037822061597
채권/NNG;시장/NNG;국채가격/NNG;높/VA;진/VX,1,0.4544959167154654,35,21,14,20,0.6293328070876452,0.2360111857175904
금리동결/NNG;되/XSV,1,0.4544959167154654,35,21,14,37,0.6293328070876452,0.2360111857175904
금리인상/NNG;맞물려/VV,1,0.4544959167154654,35,21,14,27,0.6293328070876452,0.2360111857175904
투자심리/NNG;위축/NNG;시킬/XSV,1,0.4544959167154654,35,21,14,27,0.6293328070876452,0.2360111857175904
금리인상/NNG;단기적/VAX,1,0.45162745930641157,18,11,7,18,0.5343112644640725,0.2018277911368395
투자심리/NNG;회복/NNG;될/XSV,1,0.45162745930641157,18,11,7,25,0.5343112644640725,0.2018277911368395
실적/NNG;부진/NNG;하/XSV,1,0.45162745930641157,18,11,7,13,0.5343112644640725,0.2018277911368395
기준금리/NNG;올라갈/VV,1,0.45162745930641157,18,11,7,17,0.5343112644640725,0.2018277911368395
금리상승압력/NNG;될/XSV,1,0.45162745930641157,18,11,7,13,0.5343112644640725,0.2018277911368395
달러화/NNG;상승폭/NNG;제한/NNG;됐/XSV,1,0.45162745930641157,18,11,7,12,0.5343112644640725,0.2018277911368395
금리인상/NNG;나섰/VV,1,0.45162745930641157,18,11,7,21,0.5343112644640725,0.2018277911368395
역외/NNG;차액결제선물환/NNG;환율/NNG;반영/NNG;해/XSV;오른/VV,1,0.45162745930641157,18,11,7,12,0.5343112644640725,0.2018277911368395
경제/NNG;안정적/VAX;성장/NNG,1,0.45162745930641157,18,11,7,25,0.5343112644640725,0.2018277911368395
변동성확대/NNG;되/XSV,1,0.45162745930641157,18,11,7,12,0.5343112644640725,0.2018277911368395
수요감소/NNG;따른/VV,1,0.45162745930641157,18,11,7,16,0.5343112644640725,0.2018277911368395
경기둔화/NNG;이어질/VV,1,0.45162745930641157,18,11,7,16,0.5343112644640725,0.2018277911368395
수출증가율/NNG;둔화/NNG;될/XSV,1,0.45162745930641157,18,11,7,14,0.5343112644640725,0.2018277911368395
위험자산/NNG;투자/NNG;하/XSV,1,0.45162745930641157,18,11,7,11,0.5343112644640725,0.2018277911368395
금리인상/NNG;직접적/VAX,1,0.45162745930641157,18,11,7,22,0.5343112644640725,0.2018277911368395
금리인상/NNG;중단/NNG;되/XSV,1,0.45162745930641157,18,11,7,7,0.5343112644640725,0.2018277911368395
소득/NNG;늘/VV,1,0.45162745930641157,18,11,7,26,0.5343112644640725,0.2018277911368395
근원/NNG;소비자물가/NNG;상승/NNG;해/XSV,1,0.45162745930641157,18,11,7,14,0.5343112644640725,0.2018277911368395
경기/NNG;호조/NNG;보이/VV,1,0.45162745930641157,18,11,7,12,0.5343112644640725,0.2018277911368395
자산건전성/NNG;악화/NNG;되/XSV,1,0.45162745930641157,18,11,7,7,0.5343112644640725,0.2018277911368395
회사채/NNG;금리/NNG;올랐/VV,1,0.45162745930641157,18,11,7,28,0.5343112644640725,0.2018277911368395
안전자산선호/NNG;부각/NNG;되/XSV,1,0.45162745930641157,18,11,7,17,0.5343112644640725,0.2018277911368395
금리하락/NNG;요인/NNG;작용/NNG;할/XSV,1,0.45162745930641157,18,11,7,13,0.5343112644640725,0.2018277911368395
환율상승/NNG;요인/NNG;작용/NNG;하/XSV,1,0.45162745930641157,18,11,7,12,0.5343112644640725,0.2018277911368395
연방기금금리/NNG;인상/NNG;할/XSV,1,0.45162745930641157,18,11,7,10,0.5343112644640725,0.2018277911368395
경기둔화우려/NNG;커지/VV,1,0.4471238888385727,49,29,20,37,0.691247532740292,0.2640711022081458
달러화/NNG;엔화/NNG;거래/NNG;돼/XSV;인/VCP;올랐/VV,1,0.4463059282515218,56,33,23,33,0.7182177624617604,0.27493551925464205
국고채/NNG;금리/NNG;떨어진/VV,1,0.44269874422128264,30,18,12,16,0.601089678122492,0.23217630384960738
경제성장/NNG;위한/VV,1,0.44269874422128264,30,18,12,18,0.601089678122492,0.23217630384960738
글로벌경기/NNG;회복/NNG;따른/VV,1,0.44269874422128264,30,18,12,35,0.601089678122492,0.23217630384960738
성장/NNG;해야/XSV,1,0.44269874422128264,30,18,12,13,0.601089678122492,0.23217630384960738
가계부채/NNG;안정적/VAX;관리/NNG,1,0.44269874422128264,30,18,12,11,0.601089678122492,0.23217630384960738
기준금리/NNG;인상/NNG;했/XSV,1,0.43910684139461953,305,177,128,208,0.8838563076565733,0.34445483621352796
기준금리인상/NNG;이뤄질/VV,1,0.4369001379296278,37,22,15,29,0.6351783116068422,0.2488957950321798
실업률/NNG;하락/NNG;했/XSV,1,0.4369001379296278,37,22,15,36,0.6351783116068422,0.2488957950321798
경기상승/NNG;따른/VV,1,0.4369001379296278,37,22,15,19,0.6351783116068422,0.2488957950321798
금리인상/NNG;앞두/VV,1,0.43665609381814074,140,81,59,138,0.8668451043867085,0.33987975530259357
금리상승/NNG;되/XSV,1,0.43519627664636373,51,30,21,48,0.6959562495730259,0.2738614530265427
경제성장/NNG;둔화/NNG;되/XSV,1,0.4351690672073416,44,26,18,32,0.6668785512092661,0.26243688138236154
마이너스금리/NNG;도입/NNG;한/XSA,1,0.4351690672073416,44,26,18,38,0.6668785512092661,0.26243688138236154
기준금리/NNG;수준/NNG;유지/NNG;하/XSV,1,0.4337100380722887,247,143,104,264,0.8818220718282119,0.34827389018197985
금리/NNG;낮춰/VV,1,0.43093996691338043,116,67,49,95,0.845682630850902,0.3362837911576526
금리인상/NNG;단행/NNG;될/XSV,1,0.4295594200689077,206,119,87,129,0.8793422565399938,0.35085503951425817
유로화/NNG;하락/NNG;하/XSV,1,0.42942091298476814,25,15,10,15,0.5714728035536726,0.22809345911871584
투자심리/NNG;호전/NNG;되/XSV,1,0.42942091298476814,25,15,10,21,0.5714728035536726,0.22809345911871584
국채금리/NNG;떨어진/VV,1,0.42942091298476814,25,15,10,17,0.5714728035536726,0.22809345911871584
달러화/NNG;오/VV,1,0.42942091298476814,25,15,10,14,0.5714728035536726,0.22809345911871584
불확실성/NNG;완화/NNG;된/XSV,1,0.42942091298476814,25,15,10,19,0.5714728035536726,0.22809345911871584
달러화/NNG;오른/VV,1,0.42942091298476814,25,15,10,28,0.5714728035536726,0.22809345911871584
성장경로/NNG;불확실성/NNG;높/VA,1,0.426177185508964,60,35,25,66,0.7262404609598128,0.29217675493581785
이익/NNG;내/VV,1,0.42351065777302743,83,48,35,54,0.7896871223141553,0.31977608074103675
금리/NNG;급등/NNG;해/XSV,1,0.4224782435889223,32,19,13,17,0.6072160704143801,0.24650522409637812
인플레이션/NNG;우려/NNG;완화/NNG;됐/XSV,1,0.4224782435889223,32,19,13,9,0.6072160704143801,0.24650522409637812
인플레이션/NNG;우려/NNG;불구하/VAX,1,0.4222957515969581,46,27,19,14,0.6720029898327305,0.2729272951251462
기준금리/NNG;유지/NNG;할/XSV,1,0.4218622150934226,76,44,32,59,0.7723030428577079,0.3139941939503995
경제/NNG;개선/NNG;되/XSV,1,0.4218622150934226,76,44,32,70,0.7723030428577079,0.3139941939503995
금리하락/NNG;기에/XSA,1,0.42124707894803803,39,23,16,40,0.6408498243178599,0.2609394777178668
금융시장/NNG;변동성/NNG;확대/NNG;될/XSV,1,0.42124707894803803,39,23,16,27,0.6408498243178599,0.2609394777178668
주택담보대출/NNG;늘어나/VV,1,0.42124707894803803,39,23,16,22,0.6408498243178599,0.2609394777178668
금리/NNG;동결/NNG;했/XSV,1,0.4202146747576667,186,107,79,132,0.8744823906793174,0.35696365073792885
성장/NNG;되/XSV,1,0.41823245155584776,92,53,39,57,0.8062545309302018,0.3306995100203368
물가안정/NNG;유지/NNG;되/XSV,1,0.4145532330424626,78,45,33,33,0.7747741787810059,0.32062828876320304
기대심리/NNG;올랐/VV,1,0.41451421875458383,20,12,8,20,0.5406319189841368,0.22375321943101353
연방기금금리/NNG;인하/NNG;될/XSV,1,0.41451421875458383,20,12,8,8,0.5406319189841368,0.22375321943101353
금리인상/NNG;필요/NNG;한/XSA,1,0.41451421875458383,20,12,8,11,0.5406319189841368,0.22375321943101353
경쟁력/NNG;떨어지/VV,1,0.41451421875458383,20,12,8,17,0.5406319189841368,0.22375321943101353
경제성장/NNG;미치/VV,1,0.41451421875458383,20,12,8,18,0.5406319189841368,0.22375321943101353
수출/NNG;늘어난/VV,1,0.41451421875458383,20,12,8,14,0.5406319189841368,0.22375321943101353
금리인하/NNG;기대/NNG;약화/NNG;될/XSV,1,0.41451421875458383,20,12,8,13,0.5406319189841368,0.22375321943101353
금리/NNG;올리/VV;쉽/VA;않/VX,1,0.41451421875458383,20,12,8,18,0.5406319189841368,0.22375321943101353
달러강세/NNG;부추겼/VV,1,0.41451421875458383,20,12,8,14,0.5406319189841368,0.22375321943101353
금리하락압력/NNG;작용/NNG;할/XSV,1,0.41451421875458383,20,12,8,16,0.5406319189841368,0.22375321943101353
원화/NNG;강세/NNG;보였/VV,1,0.41451421875458383,20,12,8,13,0.5406319189841368,0.22375321943101353
소비지출/NNG;증가/NNG;하/XSV,1,0.41451421875458383,20,12,8,15,0.5406319189841368,0.22375321943101353
신용등급/NNG;하향/NNG;조정/NNG;되/XSV,1,0.41451421875458383,20,12,8,21,0.5406319189841368,0.22375321943101353
금리/NNG;넘어서/VV,1,0.41451421875458383,20,12,8,15,0.5406319189841368,0.22375321943101353
경기둔화/NNG;감안/NNG;할/XSV,1,0.41451421875458383,20,12,8,8,0.5406319189841368,0.22375321943101353
금리인상/NNG;해/XSV,1,0.41339613925504737,101,58,43,108,0.8197508841667049,0.34018978174637393
물가/NNG;안정/NNG;된/XSV,1,0.41052172436716217,48,28,20,46,0.6769547737309431,0.2828821019862009
경기회복/NNG;따른/VV,1,0.40863774072146164,246,141,105,187,0.873254874979517,0.3665664594881887
금리인상/NNG;시사/NNG;한/XSA,1,0.4084371842190486,64,37,27,57,0.7336019991834177,0.30809260463722365
금리인상/NNG;되/XSV,1,0.40729869488756276,180,103,77,136,0.8691085511414482,0.3659997442290611
금리인상/NNG;우려/NNG;높/VA,1,0.4072224335195924,41,24,17,21,0.6463539211982786,0.27224288782848144
경제지표/NNG;호전/NNG;되/XSV,1,0.4072224335195924,41,24,17,24,0.6463539211982786,0.27224288782848144
금리/NNG;인상/NNG;됐/XSV,1,0.4072224335195924,41,24,17,19,0.6463539211982786,0.27224288782848144
콜금리/NNG;인상/NNG;되/XSV,1,0.4072224335195924,41,24,17,23,0.6463539211982786,0.27224288782848144
금리인상/NNG;하/VV,1,0.4060169591076992,96,55,41,102,0.8089012154035966,0.3416928450216821
금리인상/NNG;시작/NNG;하/XSV,1,0.40553763927372843,27,16,11,38,0.5777606788940081,0.24433556147589644
달러화/NNG;급락/NNG;하/XSV,1,0.40553763927372843,27,16,11,20,0.5777606788940081,0.24433556147589644
경기둔화우려/NNG;불구하/VAX,1,0.40553763927372843,27,16,11,11,0.5777606788940081,0.24433556147589644
달러원/NNG;내린/VV,1,0.40553763927372843,27,16,11,24,0.5777606788940081,0.24433556147589644
금리/NNG;유지/NNG;했/XSV,1,0.40553763927372843,27,16,11,13,0.5777606788940081,0.24433556147589644
연방기금/NNG;금리/NNG;인상/NNG;할/XSV,1,0.40553763927372843,27,16,11,20,0.5777606788940081,0.24433556147589644
금리인하/NNG;시사/NNG;하/XSV,1,0.40553763927372843,27,16,11,28,0.5777606788940081,0.24433556147589644
금리하락/NNG;우호적/VAX,1,0.40553763927372843,27,16,11,18,0.5777606788940081,0.24433556147589644
금리인상/NNG;있/VV,1,0.4054572744507481,147,84,63,102,0.8591016403731992,0.36338481231965303
국제/NNG;유가상승/NNG;따른/VV,1,0.4048889776140743,34,20,14,24,0.6131892300866376,0.2597210790859993
유로화/NNG;강세/NNG;나타냈/VV,1,0.4048889776140743,34,20,14,10,0.6131892300866376,0.2597210790859993
적자/NNG;한/XSA,1,0.4048889776140743,34,20,14,20,0.6131892300866376,0.2597210790859993
경기지표/NNG;개선/NNG;되/XSV,1,0.4048889776140743,34,20,14,41,0.6131892300866376,0.2597210790859993
대출/NNG;늘리/VV,1,0.4021430962168082,105,60,45,69,0.8214021607514588,0.35020061968647176
경기/NNG;꺾이/VV,1,0.39782183350044953,15,9,6,15,0.5087533060328643,0.2191471132436484
안전자산선호/NNG;인해/VV,1,0.39782183350044953,15,9,6,9,0.5087533060328643,0.2191471132436484
금리상승/NNG;기다리/VV,1,0.39782183350044953,15,9,6,6,0.5087533060328643,0.2191471132436484
낮/VA;금리/NNG;인해/VV,1,0.39782183350044953,15,9,6,9,0.5087533060328643,0.2191471132436484
억제/NNG;하/XSV;위해/VV;기준금리/NNG;인상/NNG,1,0.39782183350044953,15,9,6,11,0.5087533060328643,0.2191471132436484
물가안정/NNG;두/VV,1,0.39782183350044953,15,9,6,11,0.5087533060328643,0.2191471132436484
콜금리/NNG;인하/NNG;하/XSV,1,0.39782183350044953,15,9,6,5,0.5087533060328643,0.2191471132436484
금리인상/NNG;신중/NNG;할/XSV,1,0.39782183350044953,15,9,6,20,0.5087533060328643,0.2191471132436484
금리/NNG;부담/NNG;스러운/XSA,1,0.39782183350044953,15,9,6,12,0.5087533060328643,0.2191471132436484
금리/NNG;동결/NNG;함/XSV,1,0.39782183350044953,15,9,6,16,0.5087533060328643,0.2191471132436484
이중침체/NNG;빠지/VV;않/VX,1,0.39782183350044953,15,9,6,8,0.5087533060328643,0.2191471132436484
경제지표/NNG;악화/NNG;될/XSV,1,0.39782183350044953,15,9,6,6,0.5087533060328643,0.2191471132436484
금리인상/NNG;길/VA,1,0.39782183350044953,15,9,6,9,0.5087533060328643,0.2191471132436484
금리인상/NNG;가능성/NNG;낮추/VV,1,0.39782183350044953,15,9,6,10,0.5087533060328643,0.2191471132436484
실적/NNG;증가/NNG;하/XSV,1,0.39782183350044953,15,9,6,23,0.5087533060328643,0.2191471132436484
자산/NNG;늘어나/VV,1,0.39782183350044953,15,9,6,11,0.5087533060328643,0.2191471132436484
실물지표/NNG;개선/NNG;되/XSV,1,0.39782183350044953,15,9,6,15,0.5087533060328643,0.2191471132436484
crs금리/NNG;상승/NNG;하/XSV,1,0.39782183350044953,15,9,6,6,0.5087533060328643,0.2191471132436484
투자심리/NNG;냉각/NNG;되/XSV,1,0.39782183350044953,15,9,6,10,0.5087533060328643,0.2191471132436484
인플레이션/NNG;우려/NNG;완화/NNG;됨/XSV,1,0.39782183350044953,15,9,6,3,0.5087533060328643,0.2191471132436484
고용지표/NNG;악화/NNG;되/XSV,1,0.39782183350044953,15,9,6,4,0.5087533060328643,0.2191471132436484
순이자마진/NNG;하락/NNG;한/XSA,1,0.39782183350044953,15,9,6,9,0.5087533060328643,0.2191471132436484
경제/NNG;낙관적/VAX;전망/NNG,1,0.39782183350044953,15,9,6,9,0.5087533060328643,0.2191471132436484
성장성/NNG;있/VV,1,0.39782183350044953,15,9,6,10,0.5087533060328643,0.2191471132436484
미국채금리/NNG;하락/NNG;불구하/VAX,1,0.39782183350044953,15,9,6,9,0.5087533060328643,0.2191471132436484
기준금리인상/NNG;하/XSV,1,0.39546046890217346,59,34,25,53,0.7130760023973991,0.3088857395470793
콜금리/NNG;인상/NNG;할/XSV,1,0.39461879394306765,100,57,43,53,0.8111451176535461,0.3520681097691748
수출/NNG;줄어들/VV,1,0.3945733399133695,43,25,18,19,0.6516956066760011,0.28289135551153577
실업률/NNG;떨어지/VV,1,0.3945733399133695,43,25,18,38,0.6516956066760011,0.28289135551153577
수출/NNG;늘어나/VV,1,0.3926375470313135,68,39,29,55,0.7403417050251295,0.3228467250532253
인플레이션/NNG;우려/NNG;높/VA,1,0.38971361625249723,52,30,22,45,0.6863591180661378,0.3013793885913577
안전자산/NNG;선호/NNG;하/XSV,1,0.38944139132443545,36,21,15,37,0.6190154682065249,0.2719833687659345
채권금리/NNG;급등/NNG;했/XSV,1,0.38944139132443545,36,21,15,22,0.6190154682065249,0.2719833687659345
기준금리인상/NNG;이/VCP,1,0.38828461670412606,86,49,37,74,0.7833583463928034,0.3451317123898067
금리차/NNG;확대/NNG;될/XSV,1,0.385386989073889,29,17,12,31,0.5839322816977517,0.25902762333602003
투자심리/NNG;호전/NNG;됐/XSV,1,0.385386989073889,29,17,12,15,0.5839322816977517,0.25902762333602003
환율안정/NNG;위해/VV,1,0.385386989073889,29,17,12,26,0.5839322816977517,0.25902762333602003
경기회복세/NNG;될/XSV,1,0.385386989073889,29,17,12,38,0.5839322816977517,0.25902762333602003
금리상승/NNG;되돌리/VV,1,0.385386989073889,29,17,12,29,0.5839322816977517,0.25902762333602003
금리상승/NNG;인해/VV,1,0.385386989073889,29,17,12,33,0.5839322816977517,0.25902762333602003
금리인하/NNG;나서/VV;않/VX,1,0.385386989073889,29,17,12,10,0.5839322816977517,0.25902762333602003
통화증가/NNG;높/VA,1,0.385386989073889,29,17,12,8,0.5839322816977517,0.25902762333602003
국고채/NNG;금리/NNG;급등/NNG;한/XSA,1,0.38522071859520035,22,13,9,17,0.5468889226490414,0.2426902282490172
소비자물가/NNG;하락/NNG;하/XSV,1,0.38522071859520035,22,13,9,25,0.5468889226490414,0.2426902282490172
통화정책/NNG;유지/NNG;될/XSV,1,0.38522071859520035,22,13,9,11,0.5468889226490414,0.2426902282490172
기준금리/NNG;낮/VA;유지/NNG,1,0.38522071859520035,22,13,9,29,0.5468889226490414,0.2426902282490172
금리/NNG;올라간/VV,1,0.38522071859520035,22,13,9,21,0.5468889226490414,0.2426902282490172
지급준비금적수/NNG;늘/VV,1,0.38522071859520035,22,13,9,19,0.5468889226490414,0.2426902282490172
국채수익률/NNG;낮/VA;수준/NNG,1,0.38522071859520035,22,13,9,13,0.5468889226490414,0.2426902282490172
금리하락/NNG;불구하/VAX,1,0.38522071859520035,22,13,9,19,0.5468889226490414,0.2426902282490172
금리인하/NNG;가능성/NNG;낮추/VV,1,0.38522071859520035,22,13,9,6,0.5468889226490414,0.2426902282490172
통화완화/NNG;따른/VV,1,0.38522071859520035,22,13,9,29,0.5468889226490414,0.2426902282490172
금리하락/NNG;쉽/VA;않/VX,1,0.38522071859520035,22,13,9,10,0.5468889226490414,0.2426902282490172
고용지표/NNG;부진/NNG;했/XSV,1,0.38522071859520035,22,13,9,18,0.5468889226490414,0.2426902282490172
불확실성/NNG;확대/NNG;될/XSV,1,0.38522071859520035,22,13,9,21,0.5468889226490414,0.2426902282490172
인플레이션/NNG;낮추/VV,1,0.38522071859520035,22,13,9,10,0.5468889226490414,0.2426902282490172
금리인상/NNG;있/VA,1,0.38522071859520035,22,13,9,13,0.5468889226490414,0.2426902282490172
인플레이션억제/NNG;위해/VV,1,0.38394995758886497,104,59,45,86,0.8130182659831272,0.3618666722400934
기준금리/NNG;동결/NNG;한/XSA,1,0.38116738169313735,485,275,210,371,0.8637121967316658,0.38694397564867206
저금리/NNG;유지/NNG;하/XSV,1,0.3796144591801547,145,82,63,134,0.8483561438085069,0.38144682130393415
성장/NNG;따른/VV,1,0.37923009948285324,63,36,27,46,0.7206727420957381,0.32432752608958165
물가/NNG;안정/NNG;시키/XSV,1,0.37923009948285324,63,36,27,51,0.7206727420957381,0.32432752608958165
변동성/NNG;커질/VV,1,0.379061054521985,219,124,95,200,0.8620242179438955,0.38809373314992096
유로화/NNG;하락/NNG;했/XSV,1,0.37763949096870775,81,46,35,32,0.7684864491825077,0.3471315979442096
금리인상/NNG;가능성/NNG;높/VA,1,0.37591676507221305,304,172,132,239,0.8617456368465852,0.3908234495790999
미국채/NNG;금리/NNG;하락/NNG;한/XSA,1,0.3757553664831039,38,22,16,46,0.6246986683844649,0.28342314885981484
가계대출/NNG;늘어나/VV,1,0.3757553664831039,38,22,16,22,0.6246986683844649,0.28342314885981484
유동성/NNG;늘어나/VV,1,0.3757553664831039,38,22,16,20,0.6246986683844649,0.28342314885981484
재고/NNG;증가/NNG;하/XSV,1,0.3757553664831039,38,22,16,21,0.6246986683844649,0.28342314885981484
글로벌경기/NNG;둔화/NNG;따른/VV,1,0.3718428447285316,56,32,24,30,0.695124153473074,0.318256097791796
순이익/NNG;감소/NNG;한/XSA,1,0.3718428447285316,56,32,24,50,0.695124153473074,0.318256097791796
물가/NNG;상승/NNG;하/XSV,1,0.3691545827832372,110,62,48,91,0.8151981411471065,0.37556365230070615
금리인상/NNG;없/VA,1,0.3685899970965756,227,128,99,158,0.8583608171763571,0.3959658948145046
경제지표/NNG;부진/NNG;했/XSV,1,0.3681561333912853,31,18,13,38,0.5899930850412842,0.27243992592831323
원유/NNG;재고/NNG;감소/NNG;했/XSV,1,0.3681561333912853,31,18,13,29,0.5899930850412842,0.27243992592831323
인플레이션압력/NNG;높/VA;지/VX,1,0.36585859695291467,94,53,41,63,0.790069832400965,0.3667711283483251
불확실성/NNG;해소/NNG;된/XSV,1,0.3648025655665639,67,38,29,58,0.7276712023212009,0.33862825376895334
고용시장/NNG;개선/NNG;되/XSV,1,0.36380081544968235,58,33,25,57,0.6992756228380609,0.3261665829267883
금리인상/NNG;시사/NNG;할/XSV,1,0.3635329615967009,40,23,17,34,0.6302411423851981,0.2941479934345305
성장세/NNG;보이/VV,1,0.36336804404789946,121,68,53,105,0.824917429998471,0.3851541988853826
기준금리/NNG;낮췄/VV,1,0.3630126158733167,49,28,21,30,0.6667817512766773,0.31157559125255035
수요/NNG;증가/NNG;할/XSV,1,0.3620012995139472,130,73,57,111,0.8320630592445544,0.38971497474092853
경기회복/NNG;기대/NNG;커지/VV,1,0.3615683287304008,24,14,10,17,0.5530976705663558,0.25931361075538106
주택/NNG;판매가격/NNG;증가/NNG;한/XSA,1,0.3615683287304008,24,14,10,13,0.5530976705663558,0.25931361075538106
성장/NNG;그칠/VV,1,0.3615683287304008,24,14,10,21,0.5530976705663558,0.25931361075538106
금리수준/NNG;유지/NNG;하/XSV,1,0.3615683287304008,24,14,10,22,0.5530976705663558,0.25931361075538106
기대/NNG;인플레이션/NNG;높/VA;지/VX,1,0.3615683287304008,24,14,10,12,0.5530976705663558,0.25931361075538106
금리동결/NNG;한/XSA,1,0.3615683287304008,24,14,10,14,0.5530976705663558,0.25931361075538106
기준금리/NNG;수준/NNG;유지/NNG;할/XSV,1,0.3615683287304008,24,14,10,37,0.5530976705663558,0.25931361075538106
물가상승압력/NNG;되/XSV,1,0.3615683287304008,24,14,10,21,0.5530976705663558,0.25931361075538106
기준금리/NNG;인상/NNG;됐/XSV,1,0.3615683287304008,24,14,10,19,0.5530976705663558,0.25931361075538106
국고채/NNG;하락/NNG;하/XSV,1,0.3615683287304008,24,14,10,16,0.5530976705663558,0.25931361075538106
수익성/NNG;유지/NNG;하/XSV,1,0.3615683287304008,24,14,10,11,0.5530976705663558,0.25931361075538106
금리/NNG;낮춰야/VV,1,0.3615683287304008,24,14,10,20,0.5530976705663558,0.25931361075538106
위험자산/NNG;인/VCP,1,0.36074244432615665,96,54,42,97,0.7914852777365544,0.37178436982037244
국고/NNG;채권/NNG;금리/NNG;하락/NNG;한/XSA,1,0.35985098381959246,17,10,7,23,0.5146375967793781,0.24223642980366802
침체/NNG;빠지/VV;않/VX,1,0.35985098381959246,17,10,7,8,0.5146375967793781,0.24223642980366802
경기/NNG;부담/NNG;줄/VV,1,0.35985098381959246,17,10,7,9,0.5146375967793781,0.24223642980366802
국고채/NNG;금리/NNG;국고/NNG;지표물/NNG;하락/NNG;한/XSA,1,0.35985098381959246,17,10,7,16,0.5146375967793781,0.24223642980366802
금리인상/NNG;힘/NNG;실/VV,1,0.35985098381959246,17,10,7,23,0.5146375967793781,0.24223642980366802
외환시장/NNG;안정/NNG;되/XSV,1,0.35985098381959246,17,10,7,13,0.5146375967793781,0.24223642980366802
금리인상/NNG;의미/NNG;하/XSV,1,0.35985098381959246,17,10,7,10,0.5146375967793781,0.24223642980366802
달러엔/NNG;내린/VV,1,0.35985098381959246,17,10,7,19,0.5146375967793781,0.24223642980366802
수익/NNG;늘/VV,1,0.35985098381959246,17,10,7,15,0.5146375967793781,0.24223642980366802
투자/NNG;감소/NNG;했/XSV,1,0.35985098381959246,17,10,7,11,0.5146375967793781,0.24223642980366802
금리인상/NNG;가능성/NNG;시사/NNG;할/XSV,1,0.35985098381959246,17,10,7,21,0.5146375967793781,0.24223642980366802
성장/NNG;발목/NNG;잡/VV,1,0.35985098381959246,17,10,7,11,0.5146375967793781,0.24223642980366802
성장세/NNG;높/VA,1,0.35985098381959246,17,10,7,13,0.5146375967793781,0.24223642980366802
달러화/NNG;급락/NNG;따른/VV,1,0.35985098381959246,17,10,7,6,0.5146375967793781,0.24223642980366802
집값/NNG;올랐/VV,1,0.35985098381959246,17,10,7,20,0.5146375967793781,0.24223642980366802
금리인하/NNG;중단/NNG;할/XSV,1,0.35985098381959246,17,10,7,7,0.5146375967793781,0.24223642980366802
고용/NNG;회복/NNG;되/XSV,1,0.35985098381959246,17,10,7,9,0.5146375967793781,0.24223642980366802
소비/NNG;증가/NNG;할/XSV,1,0.35985098381959246,17,10,7,9,0.5146375967793781,0.24223642980366802
금리인하/NNG;지지/NNG;하/XSV,1,0.35985098381959246,17,10,7,5,0.5146375967793781,0.24223642980366802
불확실성/NNG;완화/NNG;됐/XSV,1,0.35985098381959246,17,10,7,14,0.5146375967793781,0.24223642980366802
조달금리/NNG;낮추/VV,1,0.35985098381959246,17,10,7,20,0.5146375967793781,0.24223642980366802
국제/NNG;유가/NNG;급락/NNG;한/XSA,1,0.35985098381959246,17,10,7,7,0.5146375967793781,0.24223642980366802
금리/NNG;인상/NNG;돼/XSV,1,0.35985098381959246,17,10,7,11,0.5146375967793781,0.24223642980366802
농산물/NNG;가격/NNG;급등/NNG;하/XSV,1,0.35985098381959246,17,10,7,5,0.5146375967793781,0.24223642980366802
양적완화/NNG;종료/NNG;앞두/VV,1,0.35985098381959246,17,10,7,15,0.5146375967793781,0.24223642980366802
안전자산선호/NNG;심화/NNG;되/XSV,1,0.35985098381959246,17,10,7,9,0.5146375967793781,0.24223642980366802
달러화/NNG;하락세/NNG;이/VV,1,0.35985098381959246,17,10,7,14,0.5146375967793781,0.24223642980366802
자산/NNG;늘/VV,1,0.35985098381959246,17,10,7,11,0.5146375967793781,0.24223642980366802
국채금리/NNG;높/VA;수준/NNG,1,0.35985098381959246,17,10,7,13,0.5146375967793781,0.24223642980366802
금리인상/NNG;부담/NNG;덜/VV,1,0.35985098381959246,17,10,7,12,0.5146375967793781,0.24223642980366802
투자/NNG;우호적/VAX;인/VCP,1,0.35985098381959246,17,10,7,7,0.5146375967793781,0.24223642980366802
금리인상/NNG;우려/NNG;하/XSV,1,0.35985098381959246,17,10,7,5,0.5146375967793781,0.24223642980366802
미국채가격/NNG;영향/NNG;상승/NNG;출발/NNG;된다/XSV,1,0.35985098381959246,17,10,7,26,0.5146375967793781,0.24223642980366802
금리인하/NNG;나서/VV,1,0.3595705534165945,78,44,34,63,0.7546995667630089,0.35546085055261717
성장/NNG;가능/NNG;할/XSV,1,0.3595705534165945,78,44,34,50,0.7546995667630089,0.35546085055261717
금리인상/NNG;우려/NNG;완화/NNG;되/XSV,1,0.3562676587486959,60,34,26,43,0.7032773076309018,0.33375982034091217
인플레이션/NNG;우려/NNG;하/XSV,1,0.35579947642424314,98,55,43,61,0.7928032630316123,0.37665044102775064
물가/NNG;올라가/VV,1,0.3532436710470783,33,19,14,14,0.5959446224099175,0.28478529432779404
기준금리인상/NNG;늦춰질/VV,1,0.3532436710470783,33,19,14,29,0.5959446224099175,0.28478529432779404
금리/NNG;올라갔/VV,1,0.3532436710470783,33,19,14,15,0.5959446224099175,0.28478529432779404
유동성/NNG;줄어들/VV,1,0.3532436710470783,33,19,14,28,0.5959446224099175,0.28478529432779404
금리인상/NNG;시작/NNG;되/XSV,1,0.3532436710470783,33,19,14,27,0.5959446224099175,0.28478529432779404
위안화/NNG;절상/NNG;되/XSV,1,0.3525383092564742,42,24,18,33,0.6356442136591175,0.30424639622503336
부양책/NNG;이/VCP,1,0.3525383092564742,42,24,18,27,0.6356442136591175,0.30424639622503336
성장/NNG;둔화/NNG;될/XSV,1,0.3525383092564742,42,24,18,18,0.6356442136591175,0.30424639622503336
수출/NNG;늘/VV,1,0.3491899010128592,62,35,27,32,0.7071322512694783,0.3410578725143561
통화정책/NNG;유지/NNG;하/XSV,1,0.3458537362074292,73,41,32,63,0.737111746584411,0.3582250546140296
이자/NNG;부담/NNG;커지/VV,1,0.3425828153501975,44,25,19,14,0.6409086153086528,0.3137914521620766
금리하락/NNG;제한/NNG;되/XSV,1,0.3425828153501975,44,25,19,64,0.6409086153086528,0.3137914521620766
금리인상/NNG;가능성/NNG;배제/NNG;할/XSV;없/VA,1,0.3425828153501975,44,25,19,47,0.6409086153086528,0.3137914521620766
변동성/NNG;높/VA;질/VX,1,0.34208406966829097,26,15,11,51,0.5592604680827494,0.2741256936841992
금리/NNG;수준/NNG;유지/NNG;하/XSV,1,0.34208406966829097,26,15,11,25,0.5592604680827494,0.2741256936841992
채권/NNG;시장/NNG;부담/NNG;될/VV,1,0.34208406966829097,26,15,11,21,0.5592604680827494,0.2741256936841992
부동산가격/NNG;오르/VV,1,0.34208406966829097,26,15,11,20,0.5592604680827494,0.2741256936841992
원달러/NNG;오르/VV,1,0.34208406966829097,26,15,11,28,0.5592604680827494,0.2741256936841992
투자/NNG;감소/NNG;하/XSV,1,0.34208406966829097,26,15,11,22,0.5592604680827494,0.2741256936841992
급등/NNG;따른/VV;이익/NNG;실현/NNG,1,0.34208406966829097,26,15,11,13,0.5592604680827494,0.2741256936841992
불안심리/NNG;해소/NNG;되/XSV,1,0.3401982416788796,35,20,15,29,0.6017861462228011,0.2962314812211121
수출부진/NNG;되/XSV,1,0.3401982416788796,35,20,15,31,0.6017861462228011,0.2962314812211121
신용등급/NNG;유지/NNG;하/XSV,1,0.3401982416788796,35,20,15,27,0.6017861462228011,0.2962314812211121
금리인상/NNG;중단/NNG;하/XSV,1,0.3401982416788796,35,20,15,26,0.6017861462228011,0.2962314812211121
경기둔화/NNG;라는/VCP,1,0.3401982416788796,35,20,15,25,0.6017861462228011,0.2962314812211121
기준금리/NNG;올려/VV,1,0.3383443747799695,55,31,24,42,0.6805131900692505,0.3363914458348512
콜금리/NNG;인상/NNG;될/XSV,1,0.3383443747799695,55,31,24,17,0.6805131900692505,0.3363914458348512
국채금리/NNG;오른/VV,1,0.3383443747799695,55,31,24,42,0.6805131900692505,0.3363914458348512
기준금리/NNG;인상/NNG;한/XSA,1,0.33658518214497746,361,201,160,212,0.8466238743048389,0.42016801049093844
신용스프레드/NNG;축소/NNG;될/XSV,1,0.3362223785570091,66,37,29,34,0.7144137705623755,0.3548440807520658
경기회복/NNG;기대심리/NNG;커지/VV,1,0.3312337810669952,19,11,8,23,0.5206147953741694,0.26150469434814894
유로달러/NNG;하락/NNG;했/XSV,1,0.3312337810669952,19,11,8,14,0.5206147953741694,0.26150469434814894
하방위험/NNG;있/VV,1,0.3312337810669952,19,11,8,18,0.5206147953741694,0.26150469434814894
금리/NNG;오른다/VV,1,0.3312337810669952,19,11,8,17,0.5206147953741694,0.26150469434814894
연방기금/NNG;금리/NNG;재할인율/NNG;인하/NNG;키로/XSV,1,0.3312337810669952,19,11,8,0,0.5206147953741694,0.26150469434814894
근원/NNG;소비자물가/NNG;상승/NNG;하/XSV,1,0.3312337810669952,19,11,8,7,0.5206147953741694,0.26150469434814894
듀레이션/NNG;유지/NNG;하/XSV,1,0.3312337810669952,19,11,8,17,0.5206147953741694,0.26150469434814894
국채가격/NNG;반등/NNG;했/XSV,1,0.3312337810669952,19,11,8,10,0.5206147953741694,0.26150469434814894
금리상승/NNG;될/XSV,1,0.3312337810669952,19,11,8,14,0.5206147953741694,0.26150469434814894
유로화/NNG;약세/NNG;나타냈/VV,1,0.3312337810669952,19,11,8,16,0.5206147953741694,0.26150469434814894
글로벌경기/NNG;둔화/NNG;될/XSV,1,0.3312337810669952,19,11,8,9,0.5206147953741694,0.26150469434814894
유가/NNG;급락/NNG;한/XSA,1,0.3312337810669952,19,11,8,13,0.5206147953741694,0.26150469434814894
수요/NNG;부진/NNG;했/XSV,1,0.3312337810669952,19,11,8,12,0.5206147953741694,0.26150469434814894
성장/NNG;기대/NNG;되/XSV,1,0.3312337810669952,19,11,8,25,0.5206147953741694,0.26150469434814894
수출증가/NNG;힘입/VV,1,0.3312337810669952,19,11,8,14,0.5206147953741694,0.26150469434814894
금융시장/NNG;오/VV,1,0.3312337810669952,19,11,8,12,0.5206147953741694,0.26150469434814894
국고채/NNG;금리/NNG;하락/NNG;해/XSV,1,0.3312337810669952,19,11,8,14,0.5206147953741694,0.26150469434814894
기준금리인상/NNG;가능성/NNG;제기/NNG;되/XSV,1,0.3312337810669952,19,11,8,10,0.5206147953741694,0.26150469434814894
인플레이션압력/NNG;강화/NNG;되/XSV,1,0.3312337810669952,19,11,8,7,0.5206147953741694,0.26150469434814894
금리인상/NNG;두/VV,1,0.3312337810669952,19,11,8,31,0.5206147953741694,0.26150469434814894
글로벌경기/NNG;회복/NNG;되/XSV,1,0.3312337810669952,19,11,8,23,0.5206147953741694,0.26150469434814894
금리하락/NNG;견인/NNG;하/XSV,1,0.3312337810669952,19,11,8,16,0.5206147953741694,0.26150469434814894
달러화가치/NNG;하락/NNG;했/XSV,1,0.3312337810669952,19,11,8,8,0.5206147953741694,0.26150469434814894
기준금리/NNG;올린/VV,1,0.3308101260937599,119,66,53,94,0.8095327634898538,0.4070151766382233
수입/NNG;늘/VV,1,0.32867611823156784,37,21,16,37,0.6075156692440333,0.3069113705505388
금리/NNG;올라도/VV,1,0.32867611823156784,37,21,16,34,0.6075156692440333,0.3069113705505388
국채가격/NNG;하락압력/NNG;받/VV,1,0.32867611823156784,37,21,16,24,0.6075156692440333,0.3069113705505388
투자/NNG;확대/NNG;할/XSV,1,0.32867611823156784,37,21,16,24,0.6075156692440333,0.3069113705505388
대출심사/NNG;강화/NNG;하/XSV,1,0.3257510990252386,28,16,12,30,0.5653729553466402,0.2874983025360065
gdp/NNG;증가/NNG;할/XSV,1,0.3257510990252386,28,16,12,18,0.5653729553466402,0.2874983025360065
기준금리인상/NNG;될/XSV,1,0.3257510990252386,28,16,12,25,0.5653729553466402,0.2874983025360065
금융시장/NNG;변동성/NNG;확대/NNG;되/XSV,1,0.3257510990252386,28,16,12,25,0.5653729553466402,0.2874983025360065
일자리/NNG;늘리/VV,1,0.3257510990252386,28,16,12,13,0.5653729553466402,0.2874983025360065
달러화/NNG;하락/NNG;하/XSV,1,0.32532084305653375,112,62,50,106,0.7995905593749433,0.40699197853430163
기준금리인하/NNG;하/XSV,1,0.32520845466515924,48,27,21,26,0.6510229274434826,0.33145427480603723
기대심리/NNG;높/VA;졌/VX,1,0.32520845466515924,48,27,21,70,0.6510229274434826,0.33145427480603723
매출/NNG;증가/NNG;한/XSA,1,0.32459782630315837,70,39,31,38,0.7211435626447291,0.36765624251604545
경기/NNG;회복/NNG;되/XSV,1,0.31871806841027417,266,147,119,182,0.8392329680453279,0.4335090816012187
기준금리인상/NNG;가능성/NNG;높/VA,1,0.31772993623066736,116,64,52,77,0.800842738594333,0.4145889469308344
경제/NNG;회복/NNG;되/XSV,1,0.31772993623066736,116,64,52,112,0.800842738594333,0.4145889469308344
콜금리/NNG;목표/NNG;수준/NNG;유지/NNG;하/XSV,1,0.31756353938880855,50,28,22,35,0.6558733781961874,0.33966531510171094
국채금리/NNG;하락/NNG;한/XSA,1,0.31660158711560027,297,164,133,335,0.8384615004325503,0.43515411106942387
금리/NNG;올려야/VV,1,0.315108775092922,176,97,79,149,0.8324325975203403,0.4334600863484743
저금리/NNG;유지/NNG;할/XSV,1,0.31408707150521353,74,41,33,75,0.7273447720700453,0.3795990308292207
채권/NNG;시장/NNG;국고채/NNG;금리/NNG;하락/NNG;한/XSA,1,0.3124682999950097,63,35,28,59,0.6968107151131696,0.364971006200978
기준금리/NNG;올리/VV;않/VX,1,0.3124682999950097,63,35,28,49,0.6968107151131696,0.364971006200978
비용/NNG;줄일/VV,1,0.3118511010025713,30,17,13,24,0.5714276394548106,0.2997082164366586
경기/NNG;침체/NNG;되/XSV,1,0.3118511010025713,30,17,13,24,0.5714276394548106,0.2997082164366586
기준금리인상/NNG;가능성/NNG;열/VV,1,0.3118511010025713,30,17,13,20,0.5714276394548106,0.2997082164366586
채권/NNG;시장/NNG;영향/NNG;줄/VV,1,0.3118511010025713,30,17,13,15,0.5714276394548106,0.2997082164366586
성장세/NNG;나타낼/VV,1,0.3118511010025713,30,17,13,29,0.5714276394548106,0.2997082164366586
금리/NNG;올린다면/VV,1,0.30919749751164605,41,23,18,41,0.6186282402096929,0.32637549141405214
인플레이션/NNG;높/VA;질/VX,1,0.30919749751164605,41,23,18,27,0.6186282402096929,0.32637549141405214
대출/NNG;늘어난/VV,1,0.30919749751164605,41,23,18,38,0.6186282402096929,0.32637549141405214
지급준비금적수/NNG;줄/VV,1,0.30919749751164605,41,23,18,38,0.6186282402096929,0.32637549141405214
불확실성/NNG;높이/VV,1,0.30919749751164605,41,23,18,46,0.6186282402096929,0.32637549141405214
경기회복/NNG;진행/NNG;되/XSV,1,0.30893874280299216,21,12,9,23,0.5266736520912881,0.27802114763560165
대출/NNG;확대/NNG;할/XSV,1,0.30893874280299216,21,12,9,15,0.5266736520912881,0.27802114763560165
매출/NNG;늘어나/VV,1,0.30893874280299216,21,12,9,11,0.5266736520912881,0.27802114763560165
경기회복/NNG;불구하/VAX,1,0.30893874280299216,21,12,9,14,0.5266736520912881,0.27802114763560165
낮/VA;금리/NNG;자금/NNG;조달/NNG;할/XSV,1,0.30893874280299216,21,12,9,21,0.5266736520912881,0.27802114763560165
수출/NNG;부진/NNG;했/XSV,1,0.30893874280299216,21,12,9,14,0.5266736520912881,0.27802114763560165
불확실성/NNG;증가/NNG;하/XSV,1,0.30893874280299216,21,12,9,19,0.5266736520912881,0.27802114763560165
가산금리/NNG;인상/NNG;하/XSV,1,0.30893874280299216,21,12,9,13,0.5266736520912881,0.27802114763560165
금리인상/NNG;반영/NNG;해/XSV,1,0.30893874280299216,21,12,9,7,0.5266736520912881,0.27802114763560165
국제/NNG;유가/NNG;넘어서/VV,1,0.30893874280299216,21,12,9,14,0.5266736520912881,0.27802114763560165
고용/NNG;부진/NNG;한/XSA,1,0.30893874280299216,21,12,9,17,0.5266736520912881,0.27802114763560165
실적/NNG;악화/NNG;된/XSV,1,0.30893874280299216,21,12,9,7,0.5266736520912881,0.27802114763560165
금리인상/NNG;단행/NNG;해야/XSV,1,0.30893874280299216,21,12,9,10,0.5266736520912881,0.27802114763560165
기준금리/NNG;인하/NNG;했으며/XSV,1,0.30893874280299216,21,12,9,5,0.5266736520912881,0.27802114763560165
성장세/NNG;둔화/NNG;됐/XSV,1,0.30893874280299216,21,12,9,9,0.5266736520912881,0.27802114763560165
금리/NNG;오른다면/VV,1,0.30893874280299216,21,12,9,16,0.5266736520912881,0.27802114763560165
cd금리/NNG;올랐/VV,1,0.30893874280299216,21,12,9,17,0.5266736520912881,0.27802114763560165
유동성/NNG;확보/NNG;할/XSV,1,0.30893874280299216,21,12,9,13,0.5266736520912881,0.27802114763560165
위험자산/NNG;선호도/NNG;높/VA,1,0.30893874280299216,21,12,9,22,0.5266736520912881,0.27802114763560165
주택담보대출/NNG;증가세/NNG;둔화/NNG;되/XSV,1,0.30893874280299216,21,12,9,9,0.5266736520912881,0.27802114763560165
기대심리/NNG;높/VA;지/VX,1,0.3088226590007146,229,126,103,179,0.8345698631200412,0.4406668491683501
금리인상/NNG;했/XSV,1,0.30166658276076697,67,37,30,53,0.7041338280247158,0.37770785068321805
금리인상/NNG;될/VV,1,0.30166658276076697,67,37,30,50,0.7041338280247158,0.37770785068321805
콜금리/NNG;동결/NNG;한/XSA,1,0.30086845357839254,43,24,19,34,0.6240058557282704,0.33531406829856814
신용스프레드/NNG;축소/NNG;되/XSV,1,0.3000519563473223,168,92,76,140,0.8241222316944511,0.44364355225389673
기준금리/NNG;인상/NNG;해야/XSV,1,0.3000312121187205,80,44,36,65,0.7357061083863159,0.3960652164554014
금리/NNG;하락/NNG;했으나/XSV,1,0.29986507423749487,32,18,14,33,0.5774158345981292,0.3109636129775572
모기지/NNG;금리/NNG;상승/NNG;하/XSV,1,0.29986507423749487,32,18,14,21,0.5774158345981292,0.3109636129775572
엔화/NNG;약세/NNG;될/XSV,1,0.29986507423749487,32,18,14,8,0.5774158345981292,0.3109636129775572
달러화/NNG;약세/NNG;보이/VV,1,0.2997757665056684,104,57,47,79,0.7783168324540064,0.4192398190650913
금리인상/NNG;하/XSV,1,0.29846937191736456,159,87,72,116,0.8207064476703995,0.44334308913081816
대출/NNG;증가/NNG;하/XSV,1,0.29781562673037754,56,31,25,49,0.6696023473544849,0.36223647988234414
금리인상/NNG;따른/VV,1,0.2975901387069264,533,292,241,436,0.8304795896554643,0.44948897492455164
금리/NNG;오르/VV;않/VX,1,0.29668449496957594,69,38,31,60,0.707596451095747,0.38374115439323725
금리/NNG;올리/VV;않/VX,1,0.2955975075818962,192,105,87,190,0.8265490792137269,0.4493203550843486
침체/NNG;겪/VV,1,0.2920952102192236,58,32,26,31,0.6739065404303934,0.36916120813193265
경제지표/NNG;호조/NNG;나타내/VV,1,0.29108715029661547,23,13,10,34,0.5327917923832026,0.2925032474385217
대출/NNG;늘렸/VV,1,0.29108715029661547,23,13,10,15,0.5327917923832026,0.2925032474385217
금리/NNG;끌어내릴/VV,1,0.29108715029661547,23,13,10,13,0.5327917923832026,0.2925032474385217
기대/NNG;인플레이션/NNG;상승/NNG;하/XSV,1,0.29108715029661547,23,13,10,22,0.5327917923832026,0.2925032474385217
높/VA;수익/NNG;올릴/VV,1,0.29108715029661547,23,13,10,17,0.5327917923832026,0.2925032474385217
국제/NNG;유가/NNG;떨어지/VV,1,0.29108715029661547,23,13,10,17,0.5327917923832026,0.2925032474385217
원화/NNG;강세/NNG;인한/VV,1,0.29108715029661547,23,13,10,19,0.5327917923832026,0.2925032474385217
경기둔화우려/NNG;되/XSV,1,0.29108715029661547,23,13,10,14,0.5327917923832026,0.2925032474385217
금리/NNG;반락/NNG;하/XSV,1,0.29108715029661547,23,13,10,19,0.5327917923832026,0.2925032474385217
집값/NNG;하락/NNG;하/XSV,1,0.29108715029661547,23,13,10,21,0.5327917923832026,0.2925032474385217
cd/NNG;금리/NNG;상승/NNG;하/XSV,1,0.2894100530022663,34,19,15,14,0.5833287171796503,0.3214229978880036
금리인상/NNG;가시화/NNG;되/XSV,1,0.2894100530022663,34,19,15,25,0.5833287171796503,0.3214229978880036
집값/NNG;잡/VV,1,0.2894100530022663,34,19,15,30,0.5833287171796503,0.3214229978880036
기준금리인상/NNG;어렵/VA,1,0.2894100530022663,34,19,15,32,0.5833287171796503,0.3214229978880036
미국채금리/NNG;하락/NNG;한/XSA,1,0.28933782945361464,110,60,50,117,0.7815200198377054,0.4306973016642797
기준금리/NNG;인상/NNG;해/XSV,1,0.287640240859631,86,47,39,55,0.7430084438710923,0.41099246588895283
금리/NNG;올라가/VV,1,0.2831370482280069,193,105,88,141,0.8211864524912403,0.45871121142795485
가계대출/NNG;증가/NNG;하/XSV,1,0.28019796347967096,36,20,16,46,0.5891578842537705,0.331208602308163
기준금리인상/NNG;단행/NNG;되/XSV,1,0.28019796347967096,36,20,16,22,0.5891578842537705,0.331208602308163
글로벌경제/NNG;회복/NNG;되/XSV,1,0.28019796347967096,36,20,16,29,0.5891578842537705,0.331208602308163
소비/NNG;줄이/VV,1,0.2799916947189587,49,27,22,37,0.6393956584312361,0.3596118352382831
금리/NNG;인상/NNG;할/XSV,1,0.27951407048045507,1236,672,564,928,0.822597718422466,0.4631288058460382
지표금리/NNG;오른/VV,1,0.27691125874922573,64,35,29,56,0.6860157271635708,0.38841711498923465
달러인덱스/NNG;하락/NNG;한/XSA,1,0.2764660188490702,25,14,11,22,0.5389441242926746,0.30544058423583637
투자/NNG;얻/VV;있/VV;무위험/NNG;차익/NNG,1,0.2764660188490702,25,14,11,24,0.5389441242926746,0.30544058423583637
금리인상/NNG;따른/VV;부담/NNG,1,0.2764660188490702,25,14,11,6,0.5389441242926746,0.30544058423583637
경기회복/NNG;될/XSV,1,0.2764660188490702,25,14,11,14,0.5389441242926746,0.30544058423583637
달러화/NNG;떨어질/VV,1,0.2764660188490702,25,14,11,12,0.5389441242926746,0.30544058423583637
고용지표/NNG;호조/NNG;보였/VV,1,0.2764660188490702,25,14,11,11,0.5389441242926746,0.30544058423583637
순이익/NNG;증가/NNG;하/XSV,1,0.2764660188490702,25,14,11,23,0.5389441242926746,0.30544058423583637
유가하락/NNG;긍정적/VAX,1,0.2764660188490702,25,14,11,7,0.5389441242926746,0.30544058423583637
경상수지/NNG;흑자/NNG;하/XSV,1,0.2764660188490702,25,14,11,14,0.5389441242926746,0.30544058423583637
인플레이션압력/NNG;높/VA;않/VX,1,0.2764660188490702,25,14,11,31,0.5389441242926746,0.30544058423583637
엔화/NNG;대해선/VV;상승/NNG;한/XSA,1,0.2764660188490702,25,14,11,15,0.5389441242926746,0.30544058423583637
금리/NNG;동결/NNG;됐/XSV,1,0.2764660188490702,25,14,11,30,0.5389441242926746,0.30544058423583637
시장금리/NNG;낮/VA;수준/NNG,1,0.2764660188490702,25,14,11,19,0.5389441242926746,0.30544058423583637
금리/NNG;올라서/VV,1,0.2764660188490702,25,14,11,24,0.5389441242926746,0.30544058423583637
대출/NNG;늘/VV,1,0.27508006855649936,79,43,36,66,0.7230132615984476,0.4109906398064584
금융시장/NNG;안정/NNG;되찾/VV,1,0.27410667708027914,51,28,23,27,0.6442719256069643,0.3670025924988613
물가/NNG;낮/VA;수준/NNG,1,0.27410667708027914,51,28,23,44,0.6442719256069643,0.3670025924988613
달러원/NNG;오른/VV,1,0.27240259719765025,66,36,30,42,0.6897885263654316,0.394380268494842
성장/NNG;둔화/NNG;되/XSV,1,0.27240259719765025,66,36,30,48,0.6897885263654316,0.394380268494842
금리인상/NNG;주장/NNG;하/XSV,1,0.2720083042016863,38,21,17,43,0.5948956315174797,0.34041587820154035
국고채/NNG;내린/VV,1,0.26812734921547543,68,37,31,48,0.6934320134500179,0.40013672555066426
유가/NNG;상승/NNG;하/XSV,1,0.267677351275486,83,45,38,54,0.7283409855400199,0.4206881537265189
금리상승/NNG;따른/VV,1,0.26528454131101586,248,134,114,237,0.8158989481412089,0.47369492570017746
투자심리/NNG;개선/NNG;될/XSV,1,0.2646696222786056,40,22,18,23,0.6005350728733038,0.3491202778223941
기준금리인상/NNG;있/VV,1,0.2646696222786056,40,22,18,30,0.6005350728733038,0.3491202778223941
금리/NNG;안정/NNG;되/XSV,1,0.2646696222786056,40,22,18,44,0.6005350728733038,0.3491202778223941
유동성/NNG;증가/NNG;하/XSV,1,0.26426217110272265,27,15,12,28,0.545106396666905,0.31717461983118944
원유/NNG;재고/NNG;감소/NNG;한/XSA,1,0.26426217110272265,27,15,12,18,0.545106396666905,0.31717461983118944
채권/NNG;시장/NNG;국채가격/NNG;올랐/VV,1,0.26426217110272265,27,15,12,33,0.545106396666905,0.31717461983118944
금리/NNG;올린다고/VV,1,0.26426217110272265,27,15,12,37,0.545106396666905,0.31717461983118944
경기둔화/NNG;우려/NNG;하/XSV,1,0.26426217110272265,27,15,12,16,0.545106396666905,0.31717461983118944
금리인하/NNG;가능/NNG;하/XSV,1,0.26426217110272265,27,15,12,11,0.545106396666905,0.31717461983118944
상승폭/NNG;했으며/XSV;장기금리/NNG;하락/NNG,1,0.26426217110272265,27,15,12,30,0.545106396666905,0.31717461983118944
실질금리/NNG;마이너스/NNG;인/VCP,1,0.26426217110272265,27,15,12,16,0.545106396666905,0.31717461983118944
실적호조/NNG;힘입/VV,1,0.26426217110272265,27,15,12,13,0.545106396666905,0.31717461983118944
양적완화/NNG;확대/NNG;하/XSV,1,0.26426217110272265,27,15,12,33,0.545106396666905,0.31717461983118944
금리인하/NNG;베팅/NNG;하/VV,1,0.26426217110272265,27,15,12,18,0.545106396666905,0.31717461983118944
잠재/NNG;성장률/NNG;상회/NNG;하/XSV,1,0.26426217110272265,27,15,12,10,0.545106396666905,0.31717461983118944
미국채금리/NNG;하락/NNG;하/XSV,1,0.2641913595540395,85,46,39,67,0.7308352851134612,0.42530723143347554
금리상승/NNG;하/XSV,1,0.2640646010229839,70,38,32,82,0.6969478899934475,0.405697100335966
기대심리/NNG;높이/VV,1,0.2640646010229839,70,38,32,51,0.6969478899934475,0.405697100335966
금리인상/NNG;가능/NNG;할/XSV,1,0.2640646010229839,70,38,32,71,0.6969478899934475,0.405697100335966
재정/NNG;지급준비금적수/NNG;증가/NNG;하/XSV,1,0.26404573748776206,16,9,7,14,0.49169090169435065,0.2862275133767145
경제성장률/NNG;하향/NNG;조정/NNG;했/XSV,1,0.26404573748776206,16,9,7,13,0.49169090169435065,0.2862275133767145
인플레이션압력/NNG;낮추/VV,1,0.26404573748776206,16,9,7,11,0.49169090169435065,0.2862275133767145
대출증가/NNG;높/VA,1,0.26404573748776206,16,9,7,7,0.49169090169435065,0.2862275133767145
성장/NNG;저해/NNG;하/XSV,1,0.26404573748776206,16,9,7,9,0.49169090169435065,0.2862275133767145
경기/NNG;부양책/NNG;쓰/VV,1,0.26404573748776206,16,9,7,11,0.49169090169435065,0.2862275133767145
성장/NNG;이어지/VV,1,0.26404573748776206,16,9,7,10,0.49169090169435065,0.2862275133767145
기준금리/NNG;올랐/VV,1,0.26404573748776206,16,9,7,6,0.49169090169435065,0.2862275133767145
금리/NNG;높/VA;점/NNG,1,0.26404573748776206,16,9,7,15,0.49169090169435065,0.2862275133767145
안전자산선호/NNG;심리/NNG;자극/NNG;하/XSV,1,0.26404573748776206,16,9,7,12,0.49169090169435065,0.2862275133767145
주택가격/NNG;하락/NNG;할/XSV,1,0.26404573748776206,16,9,7,8,0.49169090169435065,0.2862275133767145
통화가치/NNG;급락/NNG;하/XSV,1,0.26404573748776206,16,9,7,18,0.49169090169435065,0.2862275133767145
수출호조/NNG;불구하/VAX,1,0.26404573748776206,16,9,7,13,0.49169090169435065,0.2862275133767145
경제지표/NNG;호조/NNG;보임/VV,1,0.26404573748776206,16,9,7,11,0.49169090169435065,0.2862275133767145
설비투자/NNG;회복/NNG;되/XSV,1,0.26404573748776206,16,9,7,5,0.49169090169435065,0.2862275133767145
주택시장/NNG;둔화/NNG;되/XSV,1,0.26404573748776206,16,9,7,9,0.49169090169435065,0.2862275133767145
gdp/NNG;부진/NNG;한/XSA,1,0.26404573748776206,16,9,7,6,0.49169090169435065,0.2862275133767145
금리/NNG;하락세/NNG;했/XSV,1,0.26404573748776206,16,9,7,16,0.49169090169435065,0.2862275133767145
기준금리인상/NNG;고려/NNG;하/XSV,1,0.26404573748776206,16,9,7,9,0.49169090169435065,0.2862275133767145
산업생산/NNG;감소/NNG;한/XSA,1,0.26404573748776206,16,9,7,9,0.49169090169435065,0.2862275133767145
실적/NNG;증가/NNG;했/XSV,1,0.26404573748776206,16,9,7,16,0.49169090169435065,0.2862275133767145
경기회복/NNG;촉진/NNG;하/XSV,1,0.26404573748776206,16,9,7,12,0.49169090169435065,0.2862275133767145
금리차/NNG;줄/VV,1,0.26404573748776206,16,9,7,19,0.49169090169435065,0.2862275133767145
금리인상/NNG;현실화/NNG;되/XSV,1,0.26404573748776206,16,9,7,31,0.49169090169435065,0.2862275133767145
금리수준/NNG;경기부양적/VAX;이/VCP,1,0.26404573748776206,16,9,7,2,0.49169090169435065,0.2862275133767145
채권투자/NNG;심리/NNG;위축/NNG;되/XSV,1,0.26404573748776206,16,9,7,12,0.49169090169435065,0.2862275133767145
기준금리인상/NNG;앞당겨질/VV,1,0.26404573748776206,16,9,7,31,0.49169090169435065,0.2862275133767145
날/NNG;외환시장/NNG;현물환/NNG;하락/NNG;한/XSA,1,0.26404573748776206,16,9,7,6,0.49169090169435065,0.2862275133767145
낮/VA;금리/NNG;높/VA,1,0.26404573748776206,16,9,7,18,0.49169090169435065,0.2862275133767145
소비/NNG;줄일/VV,1,0.26404573748776206,16,9,7,9,0.49169090169435065,0.2862275133767145
기준금리인상/NNG;우려/NNG;높/VA,1,0.26404573748776206,16,9,7,8,0.49169090169435065,0.2862275133767145
수익/NNG;감소/NNG;하/XSV,1,0.26404573748776206,16,9,7,21,0.49169090169435065,0.2862275133767145
경상수지/NNG;악화/NNG;되/XSV,1,0.26404573748776206,16,9,7,12,0.49169090169435065,0.2862275133767145
미국채금리/NNG;상승/NNG;할/XSV,1,0.26404573748776206,16,9,7,21,0.49169090169435065,0.2862275133767145
기준금리인상/NNG;반영/NNG;해/XSV,1,0.26404573748776206,16,9,7,11,0.49169090169435065,0.2862275133767145
물가상승률/NNG;낮추/VV,1,0.26404573748776206,16,9,7,13,0.49169090169435065,0.2862275133767145
소득/NNG;심사/NNG;강화/NNG;하/XSV,1,0.26404573748776206,16,9,7,13,0.49169090169435065,0.2862275133767145
유동성/NNG;떨어지/VV,1,0.2635637698172062,55,30,25,38,0.6536369943034233,0.38089536775325195
기준금리/NNG;오르/VV,1,0.2635637698172062,55,30,25,51,0.6536369943034233,0.38089536775325195
부채/NNG;늘어나/VV,1,0.2635637698172062,55,30,25,43,0.6536369943034233,0.38089536775325195
물가안정/NNG;위한/VV,1,0.2608359719297466,87,47,40,69,0.7332200414682453,0.42978096129297305
산업생산/NNG;증가/NNG;하/XSV,1,0.25881254026599576,57,31,26,26,0.6581247092106133,0.3874408970623292
금리/NNG;높/VA;졌/VX,1,0.25881254026599576,57,31,26,44,0.6581247092106133,0.3874408970623292
기준금리/NNG;인상/NNG;하/XSV,1,0.25826534278896074,683,368,315,574,0.8130008131053513,0.4791786780569102
인플레이션/NNG;높/VA;지/VX,1,0.25804669965600957,42,23,19,17,0.6060701712197277,0.3573821428776312
경기회복/NNG;이어지/VV,1,0.25804669965600957,42,23,19,16,0.6060701712197277,0.3573821428776312
소비/NNG;증가/NNG;하/XSV,1,0.25435748895256527,59,32,27,34,0.662482361624985,0.39374327153149374
불안심리/NNG;커지/VV,1,0.25419243275590087,121,65,56,90,0.7772078601451928,0.4620928592304078
달러원/NNG;상승/NNG;했/XSV,1,0.25391203888636715,29,16,13,22,0.5512565770459782,0.3279488856973313
금리동결/NNG;결정/NNG;하/XSV,1,0.25391203888636715,29,16,13,19,0.5512565770459782,0.3279488856973313
금리인상/NNG;앞당겨질/VV,1,0.25391203888636715,29,16,13,42,0.5512565770459782,0.3279488856973313
산업생산/NNG;증가/NNG;했/XSV,1,0.25391203888636715,29,16,13,37,0.5512565770459782,0.3279488856973313
금리인상/NNG;선반영/NNG;하/XSV,1,0.25391203888636715,29,16,13,22,0.5512565770459782,0.3279488856973313
경제/NNG;부양/NNG;하/XSV,1,0.2520315212983997,44,24,20,24,0.6114957205764728,0.36525026991831
경기/NNG;회복세/NNG;보이/VV,1,0.2520315212983997,44,24,20,23,0.6114957205764728,0.36525026991831
물가/NNG;안정/NNG;될/XSV,1,0.2520315212983997,44,24,20,23,0.6114957205764728,0.36525026991831
금리인상/NNG;신중/NNG;한/XSA,1,0.24653679711354948,46,25,21,38,0.6168073027461523,0.37276454015814375
콜금리/NNG;인상/NNG;한/XSA,1,0.24621563764412846,63,34,29,33,0.6708086909507638,0.4056772875433144
시장금리/NNG;올라가/VV,1,0.24507423290739538,18,10,8,11,0.49760282844501547,0.3016613935134882
유가급등/NNG;불구하/VAX,1,0.24507423290739538,18,10,8,7,0.49760282844501547,0.3016613935134882
기대심리/NNG;확산/NNG;하/XSV,1,0.24507423290739538,18,10,8,13,0.49760282844501547,0.3016613935134882
통화긴축/NNG;이어질/VV,1,0.24507423290739538,18,10,8,10,0.49760282844501547,0.3016613935134882
금리/NNG;상승세/NNG;출발/NNG;했/XSV,1,0.24507423290739538,18,10,8,14,0.49760282844501547,0.3016613935134882
유로달러/NNG;하락/NNG;하/XSV,1,0.24507423290739538,18,10,8,12,0.49760282844501547,0.3016613935134882
경제성장률/NNG;높/VA;지/VX,1,0.24507423290739538,18,10,8,13,0.49760282844501547,0.3016613935134882
근원/NNG;인플레이션/NNG;상승/NNG;하/XSV,1,0.24507423290739538,18,10,8,13,0.49760282844501547,0.3016613935134882
유동성/NNG;확대/NNG;되/XSV,1,0.24507423290739538,18,10,8,18,0.49760282844501547,0.3016613935134882
국채금리/NNG;올라/VV,1,0.24507423290739538,18,10,8,13,0.49760282844501547,0.3016613935134882
실적/NNG;밑돌/VV,1,0.24507423290739538,18,10,8,12,0.49760282844501547,0.3016613935134882
유로화/NNG;강세/NNG;견인/NNG;했/XSV,1,0.24507423290739538,18,10,8,9,0.49760282844501547,0.3016613935134882
국채선물시장/NNG;국채선물/NNG;하락/NNG;한/XSA,1,0.24507423290739538,18,10,8,26,0.49760282844501547,0.3016613935134882
견조/NNG;한/XSA;성장세/NNG;보이/VV,1,0.24507423290739538,18,10,8,14,0.49760282844501547,0.3016613935134882
실적/NNG;감소/NNG;하/XSV,1,0.24507423290739538,18,10,8,9,0.49760282844501547,0.3016613935134882
신용등급/NNG;하락/NNG;따른/VV,1,0.24507423290739538,18,10,8,3,0.49760282844501547,0.3016613935134882
국채/NNG;매입/NNG;확대/NNG;하/XSV,1,0.24507423290739538,18,10,8,12,0.49760282844501547,0.3016613935134882
국채가격/NNG;낮/VA;졌/VX,1,0.24507423290739538,18,10,8,19,0.49760282844501547,0.3016613935134882
성장모멘텀/NNG;둔화/NNG;될/XSV,1,0.24507423290739538,18,10,8,7,0.49760282844501547,0.3016613935134882
기준금리인상/NNG;가능성/NNG;반영/NNG;하/XSV,1,0.24507423290739538,18,10,8,11,0.49760282844501547,0.3016613935134882
이익/NNG;증가/NNG;했/XSV,1,0.24507423290739538,18,10,8,10,0.49760282844501547,0.3016613935134882
금융시장/NNG;개선/NNG;되/XSV,1,0.24507423290739538,18,10,8,5,0.49760282844501547,0.3016613935134882
물가/NNG;상승/NNG;해/XSV,1,0.24507423290739538,18,10,8,11,0.49760282844501547,0.3016613935134882
금리상승/NNG;할/XSV,1,0.24507423290739538,18,10,8,31,0.49760282844501547,0.3016613935134882
물가오름세/NNG;확대/NNG;되/XSV,1,0.24507423290739538,18,10,8,9,0.49760282844501547,0.3016613935134882
금리인상/NNG;가능성/NNG;커졌/VV,1,0.24507423290739538,18,10,8,23,0.49760282844501547,0.3016613935134882
금리/NNG;인상/NNG;되/XSV;않/VX,1,0.24507423290739538,18,10,8,19,0.49760282844501547,0.3016613935134882
부동산시장/NNG;안정/NNG;위해/VV,1,0.24507423290739538,18,10,8,5,0.49760282844501547,0.3016613935134882
양적완화/NNG;실시/NNG;하/XSV,1,0.24507423290739538,18,10,8,31,0.49760282844501547,0.3016613935134882
적자/NNG;확대/NNG;되/XSV,1,0.24507423290739538,18,10,8,15,0.49760282844501547,0.3016613935134882
인플레이션/NNG;우려/NNG;표명/NNG;하/XSV,1,0.24507423290739538,18,10,8,5,0.49760282844501547,0.3016613935134882
국고/NNG;금리차/NNG;축소/NNG;됨/XSV,1,0.24507423290739538,18,10,8,13,0.49760282844501547,0.3016613935134882
경기회복세/NNG;진행/NNG;되/XSV,1,0.24507423290739538,18,10,8,12,0.49760282844501547,0.3016613935134882
안전자산선호/NNG;나타나/VV,1,0.24501355587203322,31,17,14,29,0.5573752505998757,0.3379408040300373
수요/NNG;커지/VV,1,0.24501355587203322,31,17,14,27,0.5573752505998757,0.3379408040300373
수입/NNG;감소/NNG;하/XSV,1,0.24501355587203322,31,17,14,17,0.5573752505998757,0.3379408040300373
국채금리/NNG;오르/VV,1,0.24149124007196376,48,26,22,54,0.6220012319263113,0.37995788105694495
기준금리동결/NNG;했/XSV,1,0.24149124007196376,48,26,22,27,0.6220012319263113,0.37995788105694495
유가/NNG;하락/NNG;하/XSV,1,0.23944959400732047,118,63,55,79,0.767246566455806,0.47071821632160943
기준금리/NNG;동결/NNG;하/XSV,1,0.23891828449843233,597,319,278,557,0.8039452591343204,0.49378959197324246
콜금리/NNG;인하/NNG;할/XSV,1,0.23727254498037564,33,18,15,12,0.563445590943815,0.3472822061473104
재고/NNG;증가/NNG;했/XSV,1,0.23727254498037564,33,18,15,20,0.563445590943815,0.3472822061473104
외환시장/NNG;원달러/NNG;내린/VV,1,0.23727254498037564,33,18,15,40,0.563445590943815,0.3472822061473104
유가상승/NNG;따른/VV,1,0.23533277333459712,105,56,49,61,0.7501919739030478,0.464287654779403
금리인상/NNG;이뤄질/VV,1,0.2305777730713463,109,58,51,90,0.7529822561777824,0.47072340602374424
노동시장/NNG;개선/NNG;되/XSV,1,0.23046897601335403,35,19,16,51,0.56945315795572,0.35607283450597904
고성장/NNG;하/XSV,1,0.23039505221345213,20,11,9,9,0.5037235616171627,0.31502201040871264
단기물/NNG;금리/NNG;하락/NNG;하/XSV,1,0.23039505221345213,20,11,9,15,0.5037235616171627,0.31502201040871264
부양책/NNG;필요/NNG;하/XSV,1,0.23039505221345213,20,11,9,19,0.5037235616171627,0.31502201040871264
물가/NNG;높/VA;질/VX,1,0.23039505221345213,20,11,9,14,0.5037235616171627,0.31502201040871264
금리인상/NNG;오/VV,1,0.23039505221345213,20,11,9,18,0.5037235616171627,0.31502201040871264
유로화/NNG;상승/NNG;하/XSV,1,0.23039505221345213,20,11,9,15,0.5037235616171627,0.31502201040871264
인플레이션압력/NNG;증가/NNG;할/XSV,1,0.23039505221345213,20,11,9,10,0.5037235616171627,0.31502201040871264
통화긴축/NNG;할/XSV,1,0.23039505221345213,20,11,9,5,0.5037235616171627,0.31502201040871264
주택시장/NNG;냉각/NNG;되/XSV,1,0.23039505221345213,20,11,9,11,0.5037235616171627,0.31502201040871264
성장/NNG;인/VCP,1,0.23039505221345213,20,11,9,17,0.5037235616171627,0.31502201040871264
고용악화/NNG;따른/VV,1,0.23039505221345213,20,11,9,5,0.5037235616171627,0.31502201040871264
영업이익/NNG;증가/NNG;한/XSA,1,0.23039505221345213,20,11,9,30,0.5037235616171627,0.31502201040871264
국채가격/NNG;내린/VV,1,0.23039505221345213,20,11,9,6,0.5037235616171627,0.31502201040871264
기준금리/NNG;낮/VA;지/VX,1,0.23039505221345213,20,11,9,18,0.5037235616171627,0.31502201040871264
견조/NNG;한/XSA;성장세/NNG;하/XSV,1,0.23039505221345213,20,11,9,11,0.5037235616171627,0.31502201040871264
투자/NNG;늘려/VV,1,0.23039505221345213,20,11,9,25,0.5037235616171627,0.31502201040871264
달러화/NNG;약세/NNG;나타냈/VV,1,0.23039505221345213,20,11,9,13,0.5037235616171627,0.31502201040871264
실적전망/NNG;하향/NNG;조정/NNG;한/XSA,1,0.23039505221345213,20,11,9,12,0.5037235616171627,0.31502201040871264
기준금리인상/NNG;늦출/VV,1,0.23039505221345213,20,11,9,17,0.5037235616171627,0.31502201040871264
순이익/NNG;늘어날/VV,1,0.23039505221345213,20,11,9,13,0.5037235616171627,0.31502201040871264
달러화/NNG;레벨/NNG;낮추/VV,1,0.23039505221345213,20,11,9,16,0.5037235616171627,0.31502201040871264
금리인상/NNG;해야/VV,1,0.23039505221345213,20,11,9,9,0.5037235616171627,0.31502201040871264
기준금리인상/NNG;가능성/NNG;있/VV,1,0.23039505221345213,20,11,9,3,0.5037235616171627,0.31502201040871264
인플레이션/NNG;넘어서/VV,1,0.23039505221345213,20,11,9,2,0.5037235616171627,0.31502201040871264
금융시장변동성/NNG;확대/NNG;되/XSV,1,0.23039505221345213,20,11,9,27,0.5037235616171627,0.31502201040871264
물가상승률/NNG;되/XSV,1,0.23039505221345213,20,11,9,18,0.5037235616171627,0.31502201040871264
불확실성/NNG;커지/VV,1,0.23022258960734465,203,108,95,177,0.7976009220190116,0.4989906877524244
초저금리/NNG;유지/NNG;할/XSV,1,0.2285092573148435,54,29,25,60,0.6368499770025411,0.3998659800518817
금리/NNG;인상/NNG;한/XSA,1,0.22798741812753254,252,134,118,159,0.7984283748475182,0.5018701519464692
금리/NNG;상승/NNG;할/XSV,1,0.22666037899296554,365,194,171,312,0.7980483734429633,0.5030369131674978
국고채/NNG;금리/NNG;상승/NNG;하/XSV,1,0.2263934610056333,75,40,35,46,0.6927406167882028,0.4369036033916452
투자/NNG;늘/VV,1,0.22476200322887907,56,30,26,45,0.6415490078484893,0.40601078659428536
금리인상/NNG;늦/VA,1,0.22476200322887907,56,30,26,58,0.6415490078484893,0.40601078659428536
수요/NNG;증가/NNG;한/XSA,1,0.2244350713904113,37,20,17,43,0.5753856403027526,0.3643894142776376
금리인상/NNG;점치/VV,1,0.2244350713904113,37,20,17,14,0.5753856403027526,0.3643894142776376
금리인상/NNG;강하/VA,1,0.2244350713904113,37,20,17,35,0.5753856403027526,0.3643894142776376
금리인하/NNG;기대/NNG;약화/NNG;되/XSV,1,0.2244350713904113,37,20,17,37,0.5753856403027526,0.3643894142776376
금리인상/NNG;지연/NNG;되/XSV,1,0.2244350713904113,37,20,17,33,0.5753856403027526,0.3643894142776376
기대심리/NNG;높/VA;질/VX,1,0.2244350713904113,37,20,17,21,0.5753856403027526,0.3643894142776376
금리동결/NNG;했/XSV,1,0.2244350713904113,37,20,17,33,0.5753856403027526,0.3643894142776376
소비심리/NNG;개선/NNG;되/XSV,1,0.2244350713904113,37,20,17,39,0.5753856403027526,0.3643894142776376
달러원/NNG;상승/NNG;하/XSV,1,0.22212126857329073,98,52,46,69,0.7339514766461568,0.46707742431134225
원화/NNG;강세/NNG;따른/VV,1,0.22125121031656403,58,31,27,62,0.6461208923763103,0.41193618715370145
달러화/NNG;하락압력/NNG;받/VV,1,0.2198560175957125,100,53,47,60,0.7358163827725902,0.47049952125552597
국채금리/NNG;상승/NNG;하/XSV,1,0.21979288645733086,119,63,56,106,0.7586376973676402,0.4851563953397229
금리/NNG;상승세/NNG;이/VV,1,0.21904070540697318,39,21,18,25,0.5812325955132932,0.3722918717565915
cd금리/NNG;하락/NNG;하/XSV,1,0.21904070540697318,39,21,18,18,0.5812325955132932,0.3722918717565915
금리하락/NNG;않/VX,1,0.21904070540697318,39,21,18,20,0.5812325955132932,0.3722918717565915
변동성/NNG;확대/NNG;하/XSV,1,0.21904070540697318,39,21,18,24,0.5812325955132932,0.3722918717565915
고용지표/NNG;상회/NNG;하/XSV,1,0.21870284434585052,22,12,10,11,0.5099864790464113,0.3268890889338047
대외불확실성/NNG;커지/VV,1,0.21870284434585052,22,12,10,16,0.5099864790464113,0.3268890889338047
경기회복/NNG;맞물려/VV,1,0.21870284434585052,22,12,10,13,0.5099864790464113,0.3268890889338047
지급준비율/NNG;인상/NNG;통해/VV,1,0.21870284434585052,22,12,10,10,0.5099864790464113,0.3268890889338047
내수회복/NNG;따른/VV,1,0.21870284434585052,22,12,10,6,0.5099864790464113,0.3268890889338047
채권수익률/NNG;하락/NNG;하/XSV,1,0.21870284434585052,22,12,10,24,0.5099864790464113,0.3268890889338047
성장/NNG;뒷받침/NNG;하/XSV,1,0.21870284434585052,22,12,10,12,0.5099864790464113,0.3268890889338047
달러엔/NNG;시장/NNG;하락/NNG;한/XSA,1,0.21870284434585052,22,12,10,19,0.5099864790464113,0.3268890889338047
국채금리/NNG;올랐/VV,1,0.21870284434585052,22,12,10,26,0.5099864790464113,0.3268890889338047
신용등급/NNG;하락/NNG;하/XSV,1,0.21870284434585052,22,12,10,36,0.5099864790464113,0.3268890889338047
변동폭/NNG;커질/VV,1,0.21870284434585052,22,12,10,17,0.5099864790464113,0.3268890889338047
선행지수/NNG;하락/NNG;하/XSV,1,0.21870284434585052,22,12,10,17,0.5099864790464113,0.3268890889338047
유가/NNG;급락/NNG;했/XSV,1,0.21870284434585052,22,12,10,17,0.5099864790464113,0.3268890889338047
회사채/NNG;금리/NNG;하락/NNG;한/XSA,1,0.21418342550871117,41,22,19,53,0.5869852096084333,0.3798276780445031
경기둔화우려/NNG;따른/VV,1,0.21418342550871117,41,22,19,33,0.5869852096084333,0.3798276780445031
국채금리/NNG;급등/NNG;하/XSV,1,0.21418342550871117,41,22,19,57,0.5869852096084333,0.3798276780445031
채권금리/NNG;상승/NNG;한/XSA,1,0.21120183898279077,87,46,41,77,0.710362579069351,0.4625423421172769
금리인하/NNG;어려울/VA,1,0.20978148064756885,43,23,20,14,0.5926360837642273,0.38703493662809324
변동성/NNG;확대/NNG;시키/XSV,1,0.2091709474128416,24,13,11,21,0.5163381463310548,0.3376376158438043
순이익/NNG;줄어들/VV,1,0.2091709474128416,24,13,11,24,0.5163381463310548,0.3376376158438043
인플레이션위험/NNG;상존/NNG;해/XSV,1,0.2091709474128416,24,13,11,20,0.5163381463310548,0.3376376158438043
불확실성/NNG;완화/NNG;하/XSV,1,0.2091709474128416,24,13,11,14,0.5163381463310548,0.3376376158438043
금리/NNG;유지/NNG;되/XSV,1,0.2091709474128416,24,13,11,16,0.5163381463310548,0.3376376158438043
주택가격/NNG;급락/NNG;하/XSV,1,0.2091709474128416,24,13,11,4,0.5163381463310548,0.3376376158438043
달러화/NNG;반락/NNG;했/XSV,1,0.2091709474128416,24,13,11,13,0.5163381463310548,0.3376376158438043
불안심리/NNG;해소/NNG;되/XSV;않/VX,1,0.2091709474128416,24,13,11,10,0.5163381463310548,0.3376376158438043
성장/NNG;견인/NNG;하/XSV,1,0.2091709474128416,24,13,11,26,0.5163381463310548,0.3376376158438043
환율하락/NNG;따른/VV,1,0.2084925571012226,150,79,71,83,0.7744770497690567,0.5071555247719783
성장/NNG;가능/NNG;하/XSV,1,0.20647400237427194,68,36,32,35,0.667068071743977,0.4386666147983773
기준금리인상/NNG;앞두/VV,1,0.20576885315167925,45,24,21,44,0.5981790488097816,0.3939446136097714
수출/NNG;둔화/NNG;되/XSV,1,0.20576885315167925,45,24,21,26,0.5981790488097816,0.3939446136097714
금리인하/NNG;기대/NNG;높/VA,1,0.20209165454432432,47,25,22,44,0.6036090055226372,0.4005821725281527
원달러/NNG;상승/NNG;하/XSV,1,0.20209165454432432,47,25,22,45,0.6036090055226372,0.4005821725281527
채권/NNG;시장/NNG;우호적/VAX;작용/NNG,1,0.20155804391713406,72,38,34,81,0.6745645052576876,0.44816967781851375
수요/NNG;부진/NNG;한/XSA,1,0.20125100601613521,26,14,12,26,0.522735862045972,0.34751951073536286
실적개선/NNG;기대/NNG;되/XSV,1,0.20125100601613521,26,14,12,34,0.522735862045972,0.34751951073536286
기준금리인상/NNG;가능성/NNG;커지/VV,1,0.20125100601613521,26,14,12,13,0.522735862045972,0.34751951073536286
회사채/NNG;금리/NNG;상승/NNG;했/XSV,1,0.20125100601613521,26,14,12,31,0.522735862045972,0.34751951073536286
기준금리/NNG;인상/NNG;될/XSV,1,0.19926044501714135,457,240,217,427,0.7844183109061261,0.5236552825429355
물가상승압력/NNG;작용/NNG;할/XSV,1,0.19870546824670043,49,26,23,19,0.608921787676779,0.40696878895593713
금리/NNG;올리/VV,1,0.1984381257914316,941,494,447,804,0.7839995409481588,0.5242725207539847
성장/NNG;이끌/VV,1,0.19557336142796067,51,27,24,39,0.6141140446496298,0.41312226405105235
물가/NNG;안정적/VAX;인/VCP,1,0.19557336142796067,51,27,24,24,0.6141140446496298,0.41312226405105235
금리인상/NNG;인한/VV,1,0.19537869567761312,103,54,49,45,0.7279443153865071,0.48989555431779447
물가상승/NNG;이/VCP,1,0.1945651139796356,28,15,13,20,0.5291453957695365,0.3567096131744612
금리/NNG;올리/VV;어려울/VA,1,0.1945651139796356,28,15,13,10,0.5291453957695365,0.3567096131744612
금리/NNG;올릴/VV;없/VA,1,0.1945651139796356,28,15,13,30,0.5291453957695365,0.3567096131744612
심리지표/NNG;개선/NNG;되/XSV,1,0.1945651139796356,28,15,13,26,0.5291453957695365,0.3567096131744612
순이익/NNG;증가/NNG;할/XSV,1,0.1945651139796356,28,15,13,16,0.5291453957695365,0.3567096131744612
순이익/NNG;늘어난/VV,1,0.1945651139796356,28,15,13,24,0.5291453957695365,0.3567096131744612
국제/NNG;유가/NNG;상승/NNG;했/XSV,1,0.1945651139796356,28,15,13,17,0.5291453957695365,0.3567096131744612
수출/NNG;감소/NNG;할/XSV,1,0.1945651139796356,28,15,13,16,0.5291453957695365,0.3567096131744612
성장/NNG;가능성/NNG;높/VA,1,0.1945651139796356,28,15,13,18,0.5291453957695365,0.3567096131744612
대출/NNG;증가/NNG;했/XSV,1,0.1945651139796356,28,15,13,28,0.5291453957695365,0.3567096131744612
경제성장/NNG;할/XSV,1,0.1945651139796356,28,15,13,11,0.5291453957695365,0.3567096131744612
달러화/NNG;강세/NNG;보이/VV,1,0.19366072951239022,105,55,50,117,0.7297204317546261,0.4928473646053135
금리/NNG;우호적/VAX;인/VCP,1,0.18995237878696147,55,29,26,60,0.6241270677362168,0.42478813119509523
채권/NNG;시장/NNG;국채선물/NNG;하락/NNG;한/XSA,1,0.18995237878696147,55,29,26,77,0.6241270677362168,0.42478813119509523
국제/NNG;유가/NNG;급등/NNG;하/XSV,1,0.18995237878696147,55,29,26,33,0.6241270677362168,0.42478813119509523
기준금리/NNG;동결/NNG;했으나/XSV,1,0.18884440090353594,30,16,14,34,0.5355391529010509,0.3653327246801892
금리차/NNG;축소/NNG;되/XSV,1,0.18884440090353594,30,16,14,40,0.5355391529010509,0.3653327246801892
외환시장/NNG;현물환/NNG;상승/NNG;했/XSV,1,0.18884440090353594,30,16,14,20,0.5355391529010509,0.3653327246801892
국채수익률/NNG;오른/VV,1,0.18884440090353594,30,16,14,19,0.5355391529010509,0.3653327246801892
순이익/NNG;늘/VV,1,0.18884440090353594,30,16,14,28,0.5355391529010509,0.3653327246801892
원화/NNG;약세/NNG;따른/VV,1,0.18884440090353594,30,16,14,22,0.5355391529010509,0.3653327246801892
수익/NNG;줄어들/VV,1,0.18884440090353594,30,16,14,22,0.5355391529010509,0.3653327246801892
자산/NNG;줄이/VV,1,0.18884440090353594,30,16,14,15,0.5355391529010509,0.3653327246801892
금리/NNG;동결/NNG;해/XSV,1,0.18884440090353594,30,16,14,20,0.5355391529010509,0.3653327246801892
기준금리/NNG;동결/NNG;됐/XSV,1,0.18741514858422836,57,30,27,66,0.6289443710644064,0.43032474410862676
금리/NNG;올라갈/VV,1,0.18733595996346808,86,45,41,59,0.6970258145582715,0.47698444741704843
금리인상/NNG;나서/VV,1,0.18668291225292055,161,84,77,149,0.7676050878158265,0.5259941017545154
국채수익률/NNG;하락/NNG;한/XSA,1,0.1850336863396429,59,31,28,80,0.6336340833946438,0.43567739574208236
국고채/NNG;금리/NNG;국고/NNG;지표물/NNG;인/VCP;오른/VV,1,0.1850336863396429,59,31,28,50,0.6336340833946438,0.43567739574208236
엔화/NNG;유로화/NNG;강세/NNG;나타냈/VV,1,0.1838923570797517,32,17,15,15,0.5418947508716928,0.3734801385283129
금리/NNG;하락세/NNG;보이/VV,1,0.1838923570797517,32,17,15,34,0.5418947508716928,0.3734801385283129
채권/NNG;시장/NNG;우호적/VAX;일/VCP,1,0.1838923570797517,32,17,15,25,0.5418947508716928,0.3734801385283129
원화/NNG;약세/NNG;보이/VV,1,0.1838923570797517,32,17,15,30,0.5418947508716928,0.3734801385283129
자산/NNG;늘리/VV,1,0.1838923570797517,32,17,15,36,0.5418947508716928,0.3734801385283129
금리상승/NNG;인한/VV,1,0.18279164998271424,61,32,29,43,0.6381956684132488,0.44085477201348316
경기/NNG;개선/NNG;되/XSV,1,0.1814741829225175,121,63,58,117,0.7410539523060201,0.5133042903298838
경제/NNG;호조/NNG;보이/VV,1,0.17956202324139192,34,18,16,15,0.5481939313056224,0.38122009568053605
경기회복/NNG;지연/NNG;될/XSV,1,0.17956202324139192,34,18,16,22,0.5481939313056224,0.38122009568053605
달러원/NNG;올랐/VV,1,0.17956202324139192,34,18,16,20,0.5481939313056224,0.38122009568053605
지표물/NNG;인/VCP;국고채/NNG;금리/NNG;하락/NNG;한/XSA,1,0.17956202324139192,34,18,16,18,0.5481939313056224,0.38122009568053605
금리/NNG;인상/NNG;한다면/XSV,1,0.17956202324139192,34,18,16,26,0.5481939313056224,0.38122009568053605
높/VA;수익률/NNG;했/XSV,1,0.17867119205244908,65,34,31,33,0.6469341730829318,0.45071386110518163
금리/NNG;반등/NNG;하/XSV,1,0.17867119205244908,65,34,31,60,0.6469341730829318,0.45071386110518163
금리인상/NNG;불구하/VAX,1,0.1757874604771541,156,81,75,109,0.7600268088975384,0.5326663234358942
달러강세/NNG;인해/VV,1,0.17574129898020163,36,19,17,29,0.5544217307977226,0.38860460125943014
서부텍사스산원유/NNG;하락/NNG;한/XSA,1,0.17574129898020163,36,19,17,48,0.5544217307977226,0.38860460125943014
가계대출/NNG;늘/VV,1,0.17574129898020163,36,19,17,27,0.5544217307977226,0.38860460125943014
금리/NNG;상승/NNG;함/XSV,1,0.17574129898020163,36,19,17,44,0.5544217307977226,0.38860460125943014
금리/NNG;인상/NNG;하/XSV;어려울/VA,1,0.17574129898020163,36,19,17,33,0.5544217307977226,0.38860460125943014
실업수당청구/NNG;감소/NNG;한/XSA,1,0.17496129484332723,69,36,33,31,0.6551624641958791,0.459955231156456
달러화/NNG;급등/NNG;하/XSV,1,0.1723431890338707,38,20,18,37,0.5605658462549727,0.39567398826919997
미국채금리/NNG;오른/VV,1,0.1723431890338707,38,20,18,64,0.5605658462549727,0.39567398826919997
채권/NNG;시장/NNG;국고채/NNG;지표금리/NNG;하락/NNG;한/XSA,1,0.17159101493280882,73,38,35,112,0.6628873827048852,0.4686231388659342
금리/NNG;국고/NNG;지표물/NNG;인/VCP;하락/NNG;한/XSA,1,0.17092439908671708,108,56,52,139,0.7218017597697485,0.5109734171803646
고용지표/NNG;부진/NNG;한/XSA,1,0.16929915397723372,40,21,19,20,0.5666161455417912,0.4024600458904232
투자심리/NNG;개선/NNG;되/XSV,1,0.1685050977735998,77,40,37,85,0.6701191025967723,0.4767554314882234
불확실성/NNG;완화/NNG;되/XSV,1,0.1670547773492299,79,41,38,85,0.6735539182184977,0.48063123100803123
엔화/NNG;강세/NNG;나타냈/VV,1,0.16655447026323755,42,22,20,18,0.5725642866783991,0.4089882091244183
경기부진/NNG;따른/VV,1,0.16655447026323755,42,22,20,45,0.5725642866783991,0.4089882091244183
저금리/NNG;유지/NNG;될/XSV,1,0.16655447026323755,42,22,20,28,0.5725642866783991,0.4089882091244183
완화적/VAX;유지/NNG;하/XSV,1,0.16607910798684888,15,8,7,12,0.46385340109475304,0.3316590368950991
하방경직성/NNG;유지/NNG;할/XSV,1,0.16607910798684888,15,8,7,6,0.46385340109475304,0.3316590368950991
cd금리/NNG;올라갈/VV,1,0.16607910798684888,15,8,7,4,0.46385340109475304,0.3316590368950991
실적개선/NNG;기대심리/NNG;높/VA,1,0.16607910798684888,15,8,7,9,0.46385340109475304,0.3316590368950991
실업률/NNG;높/VA;지/VX,1,0.16607910798684888,15,8,7,9,0.46385340109475304,0.3316590368950991
경제지표/NNG;오/VV,1,0.16607910798684888,15,8,7,8,0.46385340109475304,0.3316590368950991
기대심리/NNG;오른/VV,1,0.16607910798684888,15,8,7,6,0.46385340109475304,0.3316590368950991
스왑베이시스/NNG;역전폭/NNG;축소/NNG;되/XSV,1,0.16607910798684888,15,8,7,12,0.46385340109475304,0.3316590368950991
안전자산선호/NNG;심리/NNG;커지/VV,1,0.16607910798684888,15,8,7,8,0.46385340109475304,0.3316590368950991
환율하락/NNG;되/XSV,1,0.16607910798684888,15,8,7,14,0.46385340109475304,0.3316590368950991
엔화/NNG;강세/NNG;이끌/VV,1,0.16607910798684888,15,8,7,7,0.46385340109475304,0.3316590368950991
금리인하/NNG;가능성/NNG;없/VA,1,0.16607910798684888,15,8,7,9,0.46385340109475304,0.3316590368950991
신용경색/NNG;해소/NNG;위해/VV,1,0.16607910798684888,15,8,7,4,0.46385340109475304,0.3316590368950991
기준금리인상/NNG;가능성/NNG;배제/NNG;할/XSV;없/VA,1,0.16607910798684888,15,8,7,8,0.46385340109475304,0.3316590368950991
영업이익/NNG;감소/NNG;한/XSA,1,0.16607910798684888,15,8,7,18,0.46385340109475304,0.3316590368950991
완화정책/NNG;펴/VV,1,0.16607910798684888,15,8,7,7,0.46385340109475304,0.3316590368950991
투자매력/NNG;떨어지/VV,1,0.16607910798684888,15,8,7,10,0.46385340109475304,0.3316590368950991
금리인하/NNG;기대심리/NNG;커지/VV,1,0.16607910798684888,15,8,7,22,0.46385340109475304,0.3316590368950991
금리인하/NNG;가능성/NNG;높이/VV,1,0.16607910798684888,15,8,7,12,0.46385340109475304,0.3316590368950991
경기회복/NNG;확인/NNG;되/XSV,1,0.16607910798684888,15,8,7,8,0.46385340109475304,0.3316590368950991
금리인상/NNG;반대/NNG;한/XSA,1,0.16607910798684888,15,8,7,5,0.46385340109475304,0.3316590368950991
대출/NNG;낮/VA;금리/NNG,1,0.16607910798684888,15,8,7,13,0.46385340109475304,0.3316590368950991
인플레이션/NNG;우려/NNG;증폭/NNG;돼/XSV,1,0.16607910798684888,15,8,7,12,0.46385340109475304,0.3316590368950991
인플레이션/NNG;우려/NNG;인해/VV,1,0.16607910798684888,15,8,7,14,0.46385340109475304,0.3316590368950991
금리인상/NNG;결정/NNG;한/XSA,1,0.16607910798684888,15,8,7,7,0.46385340109475304,0.3316590368950991
금리/NNG;인상/NNG;했으나/XSV,1,0.16607910798684888,15,8,7,2,0.46385340109475304,0.3316590368950991
경기부진/NNG;이어지/VV,1,0.16607910798684888,15,8,7,12,0.46385340109475304,0.3316590368950991
금리인상/NNG;관한/VV,1,0.16607910798684888,15,8,7,12,0.46385340109475304,0.3316590368950991
금리/NNG;확대/NNG;되/XSV,1,0.16607910798684888,15,8,7,10,0.46385340109475304,0.3316590368950991
유로달러/NNG;오르/VV,1,0.16607910798684888,15,8,7,5,0.46385340109475304,0.3316590368950991
내수회복/NNG;힘입/VV,1,0.16607910798684888,15,8,7,3,0.46385340109475304,0.3316590368950991
비농업/NNG;고용자수/NNG;증가/NNG;했/XSV,1,0.16607910798684888,15,8,7,5,0.46385340109475304,0.3316590368950991
채권가격/NNG;떨어질/VV,1,0.16607910798684888,15,8,7,6,0.46385340109475304,0.3316590368950991
금리인상/NNG;불가피한/VAX,1,0.16607910798684888,15,8,7,8,0.46385340109475304,0.3316590368950991
경기회복세/NNG;이/VV,1,0.16607910798684888,15,8,7,7,0.46385340109475304,0.3316590368950991
달러원/NNG;떨어질/VV,1,0.16607910798684888,15,8,7,7,0.46385340109475304,0.3316590368950991
투자/NNG;늘린/VV,1,0.16607910798684888,15,8,7,10,0.46385340109475304,0.3316590368950991
적자/NNG;돌아섰/VV,1,0.16607910798684888,15,8,7,11,0.46385340109475304,0.3316590368950991
금리상승/NNG;나타날/VV,1,0.16607910798684888,15,8,7,20,0.46385340109475304,0.3316590368950991
불안심리/NNG;계속/NNG;되/XSV,1,0.16607910798684888,15,8,7,8,0.46385340109475304,0.3316590368950991
자산/NNG;증가/NNG;했/XSV,1,0.16607910798684888,15,8,7,14,0.46385340109475304,0.3316590368950991
경기/NNG;낙관적/VAX;인/VCP,1,0.16607910798684888,15,8,7,25,0.46385340109475304,0.3316590368950991
국채선물/NNG;오르/VV,1,0.16607910798684888,15,8,7,14,0.46385340109475304,0.3316590368950991
무역수지적자/NNG;축소/NNG;된/XSV,1,0.16607910798684888,15,8,7,2,0.46385340109475304,0.3316590368950991
견조/NNG;한/XSA;성장세/NNG;이/VV,1,0.16607910798684888,15,8,7,15,0.46385340109475304,0.3316590368950991
유가/NNG;떨어져/VV,1,0.16607910798684888,15,8,7,15,0.46385340109475304,0.3316590368950991
금리/NNG;하락세/NNG;보임/VV,1,0.16607910798684888,15,8,7,16,0.46385340109475304,0.3316590368950991
원화/NNG;약세/NNG;보일/VV,1,0.16607910798684888,15,8,7,15,0.46385340109475304,0.3316590368950991
금리인상/NNG;가늠/NNG;할/XSV,1,0.16607910798684888,15,8,7,10,0.46385340109475304,0.3316590368950991
기준금리인상/NNG;늦추/VV,1,0.16607910798684888,15,8,7,14,0.46385340109475304,0.3316590368950991
무역수지흑자/NNG;하/XSV,1,0.16607910798684888,15,8,7,10,0.46385340109475304,0.3316590368950991
채권금리/NNG;상승/NNG;하/XSV,1,0.16498095212826325,118,61,57,117,0.7295265271541761,0.522796540935792
비용/NNG;줄이/VV,1,0.16406492474621825,44,23,21,41,0.5784034184944892,0.4152791202061031
금리상승/NNG;제한/NNG;하/XSV,1,0.16406492474621825,44,23,21,44,0.5784034184944892,0.4152791202061031
연방기금금리/NNG;인상/NNG;될/XSV,1,0.16406492474621825,44,23,21,18,0.5784034184944892,0.4152791202061031
소비/NNG;늘/VV,1,0.16179441602646438,46,24,22,33,0.5841279428123026,0.4213497606641575
금리인상/NNG;한/XSA,1,0.16072119482854808,126,65,61,126,0.7343993659583393,0.5309137241200274
금리/NNG;내려갈/VV,1,0.16055936968158968,89,46,43,68,0.688992211488358,0.4982533483798414
경기둔화/NNG;되/XSV,1,0.15779648849244565,50,26,24,39,0.5952159313627181,0.4328846386978372
달러화/NNG;반등/NNG;하/XSV,1,0.15779648849244565,50,26,24,30,0.5952159313627181,0.4328846386978372
시중금리/NNG;상승/NNG;하/XSV,1,0.15779648849244565,50,26,24,40,0.5952159313627181,0.4328846386978372
경기침체/NNG;우려/NNG;하/XSV,1,0.15704171815793488,17,9,8,5,0.4703412484372471,0.3425964100105445
집값/NNG;오른/VV,1,0.15704171815793488,17,9,8,6,0.4703412484372471,0.3425964100105445
금리/NNG;인상/NNG;된다/XSV,1,0.15704171815793488,17,9,8,11,0.4703412484372471,0.3425964100105445
기준금리/NNG;내려도/VV,1,0.15704171815793488,17,9,8,8,0.4703412484372471,0.3425964100105445
양적완화/NNG;펴/VV,1,0.15704171815793488,17,9,8,16,0.4703412484372471,0.3425964100105445
경제/NNG;비관적/VAX;인/VCP,1,0.15704171815793488,17,9,8,8,0.4703412484372471,0.3425964100105445
달러화/NNG;상승/NNG;우호적/VAX,1,0.15704171815793488,17,9,8,20,0.4703412484372471,0.3425964100105445
금리/NNG;동결/NNG;된/XSV,1,0.15704171815793488,17,9,8,15,0.4703412484372471,0.3425964100105445
인플레이션기대/NNG;심리/NNG;억제/NNG;하/XSV,1,0.15704171815793488,17,9,8,15,0.4703412484372471,0.3425964100105445
달러엔/NNG;올랐/VV,1,0.15704171815793488,17,9,8,8,0.4703412484372471,0.3425964100105445
달러화/NNG;하락압력/NNG;가하/VV,1,0.15704171815793488,17,9,8,10,0.4703412484372471,0.3425964100105445
원/NNG;환율/NNG;급등/NNG;하/XSV,1,0.15704171815793488,17,9,8,9,0.4703412484372471,0.3425964100105445
경상수지적자/NNG;되/XSV,1,0.15704171815793488,17,9,8,12,0.4703412484372471,0.3425964100105445
경제성장/NNG;이루/VV,1,0.15704171815793488,17,9,8,7,0.4703412484372471,0.3425964100105445
경제성장/NNG;긍정적/VAX,1,0.15704171815793488,17,9,8,16,0.4703412484372471,0.3425964100105445
유가상승/NNG;불구하/VAX,1,0.15704171815793488,17,9,8,10,0.4703412484372471,0.3425964100105445
금리인상/NNG;이루어지/VV,1,0.15704171815793488,17,9,8,2,0.4703412484372471,0.3425964100105445
경제지표/NNG;하회/NNG;하/XSV,1,0.15704171815793488,17,9,8,17,0.4703412484372471,0.3425964100105445
금리/NNG;낙폭/NNG;확대/NNG;되/XSV,1,0.15704171815793488,17,9,8,12,0.4703412484372471,0.3425964100105445
금리인상/NNG;지지/NNG;할/XSV,1,0.15704171815793488,17,9,8,19,0.4703412484372471,0.3425964100105445
원화/NNG;절상/NNG;될/XSV,1,0.15704171815793488,17,9,8,23,0.4703412484372471,0.3425964100105445
낮/VA;금리/NNG;유지/NNG;하/XSV,1,0.15704171815793488,17,9,8,15,0.4703412484372471,0.3425964100105445
미국채가격/NNG;하락/NNG;했/XSV,1,0.15704171815793488,17,9,8,18,0.4703412484372471,0.3425964100105445
물가상승/NNG;선제적/VAX,1,0.15704171815793488,17,9,8,15,0.4703412484372471,0.3425964100105445
원자재/NNG;가격/NNG;급등/NNG;하/XSV,1,0.15704171815793488,17,9,8,15,0.4703412484372471,0.3425964100105445
경제/NNG;펀더멘털/NNG;개선/NNG;되/XSV,1,0.15704171815793488,17,9,8,5,0.4703412484372471,0.3425964100105445
고용지표/NNG;하회/NNG;하/XSV,1,0.15704171815793488,17,9,8,14,0.4703412484372471,0.3425964100105445
금리인상/NNG;많/VA,1,0.15704171815793488,17,9,8,18,0.4703412484372471,0.3425964100105445
달러약세/NNG;힘입/VV,1,0.15704171815793488,17,9,8,15,0.4703412484372471,0.3425964100105445
금리차확대/NNG;따른/VV,1,0.15704171815793488,17,9,8,4,0.4703412484372471,0.3425964100105445
원달러/NNG;상승/NNG;할/XSV,1,0.15704171815793488,17,9,8,10,0.4703412484372471,0.3425964100105445
채권금리/NNG;하락/NNG;했/XSV,1,0.15608303006296675,97,50,47,74,0.6993867412666137,0.5104351785284149
지급준비금적수/NNG;감소/NNG;한다/XSV,1,0.1560235954748468,52,27,25,43,0.6005729172643547,0.438371033405846
금리인상/NNG;가능성/NNG;커지/VV,1,0.15437701176998386,54,28,26,39,0.6058021065918073,0.4436822981272451
투자/NNG;늘어나/VV,1,0.15437701176998386,54,28,26,53,0.6058021065918073,0.4436822981272451
유로화/NNG;오른/VV,1,0.15284188030966273,56,29,27,26,0.6109019112886348,0.4488261578000968
금리/NNG;올려도/VV,1,0.15284188030966273,56,29,27,56,0.6109019112886348,0.4488261578000968
금리인상/NNG;시사/NNG;하/XSV,1,0.15243485305986648,144,74,70,117,0.7418970714583496,0.5455219557579547
달러화/NNG;하락/NNG;했/XSV,1,0.15209267207276822,105,54,51,88,0.7082009962295273,0.5211098954025263
금리/NNG;동결/NNG;하/XSV,1,0.15144332716189912,356,183,173,244,0.759122835097343,0.559322178115101
경기/NNG;둔화/NNG;하/XSV,1,0.15140550909411754,58,30,28,41,0.615871255475075,0.4538094465822303
기준금리/NNG;인하/NNG;하/XSV;않/VX,1,0.15140550909411754,58,30,28,32,0.615871255475075,0.4538094465822303
소비/NNG;위축/NNG;되/XSV,1,0.15140550909411754,58,30,28,43,0.615871255475075,0.4538094465822303
달러엔/NNG;오른/VV,1,0.15140550909411754,58,30,28,31,0.615871255475075,0.4538094465822303
금리/NNG;유지/NNG;하/XSV,1,0.15115916015074227,107,55,52,91,0.7101754535562582,0.5235620979474938
회사채/NNG;금리/NNG;상승/NNG;한/XSA,1,0.15012866869159835,19,10,9,36,0.4770517272612065,0.35243878234907944
금리/NNG;하향안정/NNG;될/XSV,1,0.15012866869159835,19,10,9,6,0.4770517272612065,0.35243878234907944
일자리/NNG;늘/VV,1,0.15012866869159835,19,10,9,11,0.4770517272612065,0.35243878234907944
경기회복/NNG;늦/VA,1,0.15012866869159835,19,10,9,9,0.4770517272612065,0.35243878234907944
임금상승/NNG;따른/VV,1,0.15012866869159835,19,10,9,12,0.4770517272612065,0.35243878234907944
경기회복세/NNG;이어질/VV,1,0.15012866869159835,19,10,9,11,0.4770517272612065,0.35243878234907944
자금유입/NNG;늘어나/VV,1,0.15012866869159835,19,10,9,10,0.4770517272612065,0.35243878234907944
금리인상/NNG;됐/XSV,1,0.15012866869159835,19,10,9,6,0.4770517272612065,0.35243878234907944
적자/NNG;보였/VV,1,0.15012866869159835,19,10,9,12,0.4770517272612065,0.35243878234907944
적자/NNG;할/XSV,1,0.15012866869159835,19,10,9,20,0.4770517272612065,0.35243878234907944
수출/NNG;개선/NNG;될/XSV,1,0.15012866869159835,19,10,9,11,0.4770517272612065,0.35243878234907944
금리인상/NNG;준비/NNG;하/XSV,1,0.15012866869159835,19,10,9,17,0.4770517272612065,0.35243878234907944
수입/NNG;늘어나/VV,1,0.15012866869159835,19,10,9,22,0.4770517272612065,0.35243878234907944
국채금리/NNG;높/VA;진/VX,1,0.15012866869159835,19,10,9,14,0.4770517272612065,0.35243878234907944
수입/NNG;감소/NNG;한/XSA,1,0.15012866869159835,19,10,9,16,0.4770517272612065,0.35243878234907944
금리인상/NNG;임박한/VAX,1,0.15012866869159835,19,10,9,14,0.4770517272612065,0.35243878234907944
소비자물가/NNG;낮/VA;수준/NNG,1,0.15012866869159835,19,10,9,14,0.4770517272612065,0.35243878234907944
금리인상/NNG;우려/NNG;따른/VV,1,0.15012866869159835,19,10,9,17,0.4770517272612065,0.35243878234907944
채산성/NNG;악화/NNG;되/XSV,1,0.15012866869159835,19,10,9,6,0.4770517272612065,0.35243878234907944
경기둔화/NNG;될/XSV,1,0.15012866869159835,19,10,9,17,0.4770517272612065,0.35243878234907944
달러강세/NNG;할/XSV,1,0.15012866869159835,19,10,9,10,0.4770517272612065,0.35243878234907944
경제/NNG;커지/VV,1,0.15012866869159835,19,10,9,10,0.4770517272612065,0.35243878234907944
금리/NNG;떨어뜨리/VV,1,0.15012866869159835,19,10,9,11,0.4770517272612065,0.35243878234907944
금리/NNG;상승/NNG;했으며/XSV,1,0.15012866869159835,19,10,9,25,0.4770517272612065,0.35243878234907944
인플레이션/NNG;밑돌/VV,1,0.15012866869159835,19,10,9,11,0.4770517272612065,0.35243878234907944
기대심리/NNG;약화/NNG;되/XSV,1,0.15012866869159835,19,10,9,19,0.4770517272612065,0.35243878234907944
달러화가치/NNG;오르/VV,1,0.15012866869159835,19,10,9,24,0.4770517272612065,0.35243878234907944
전세가격/NNG;상승/NNG;하/XSV,1,0.15012866869159835,19,10,9,31,0.4770517272612065,0.35243878234907944
금리인상/NNG;신중/NNG;해야/XSV,1,0.15012866869159835,19,10,9,22,0.4770517272612065,0.35243878234907944
수출/NNG;부진/NNG;한/XSA,1,0.1500569971497221,60,31,29,53,0.6207095121368401,0.4586382753258322
달러화/NNG;약세/NNG;보였/VV,1,0.1475871654140457,64,33,31,46,0.6299921804812308,0.4678541444635427
채권/NNG;시장/NNG;국고채/NNG;금리/NNG;상승/NNG;한/XSA,1,0.14645058358866114,66,34,32,74,0.6344371289295642,0.4722508479631523
성장세/NNG;보일/VV,1,0.14537098072713217,68,35,33,69,0.6387519866791798,0.4765125682045004
매수/NNG;심리/NNG;위축/NNG;됐/XSV,1,0.14537098072713217,68,35,33,57,0.6387519866791798,0.4765125682045004
금리/NNG;급등/NNG;했/XSV,1,0.14521756818302167,121,62,59,89,0.7216975718506845,0.5385591876971763
금리인상/NNG;확률/NNG;높/VA,1,0.14469544896354192,21,11,10,11,0.4838952530573306,0.36148701881772466
경제성장률/NNG;하향/NNG;조정/NNG;하/XSV,1,0.14469544896354192,21,11,10,12,0.4838952530573306,0.36148701881772466
금리하락/NNG;이어질/VV,1,0.14469544896354192,21,11,10,18,0.4838952530573306,0.36148701881772466
지급준비금적수/NNG;늘어나/VV,1,0.14469544896354192,21,11,10,13,0.4838952530573306,0.36148701881772466
금리인상/NNG;계속/NNG;할/XSV,1,0.14469544896354192,21,11,10,9,0.4838952530573306,0.36148701881772466
재고/NNG;감소/NNG;한/XSA,1,0.14469544896354192,21,11,10,10,0.4838952530573306,0.36148701881772466
금리인상/NNG;나선/VV,1,0.14469544896354192,21,11,10,11,0.4838952530573306,0.36148701881772466
소득/NNG;증가/NNG;하/XSV,1,0.14469544896354192,21,11,10,28,0.4838952530573306,0.36148701881772466
금리인상/NNG;대응/NNG;하/XSV,1,0.14469544896354192,21,11,10,14,0.4838952530573306,0.36148701881772466
달러약세/NNG;불구하/VAX,1,0.14469544896354192,21,11,10,11,0.4838952530573306,0.36148701881772466
경기침체/NNG;이어지/VV,1,0.14469544896354192,21,11,10,16,0.4838952530573306,0.36148701881772466
경제성장률/NNG;높이/VV,1,0.14469544896354192,21,11,10,10,0.4838952530573306,0.36148701881772466
금리인상/NNG;가능성/NNG;높였/VV,1,0.14469544896354192,21,11,10,18,0.4838952530573306,0.36148701881772466
경기하강/NNG;막/VV,1,0.14469544896354192,21,11,10,8,0.4838952530573306,0.36148701881772466
유가/NNG;급등/NNG;한/XSA,1,0.14469544896354192,21,11,10,11,0.4838952530573306,0.36148701881772466
금리인상/NNG;서두/NNG;필요/NNG;없/VA,1,0.14469544896354192,21,11,10,4,0.4838952530573306,0.36148701881772466
기준금리동결/NNG;따른/VV,1,0.14469544896354192,21,11,10,28,0.4838952530573306,0.36148701881772466
경기/NNG;낙관/NNG;하/XSV,1,0.14469544896354192,21,11,10,15,0.4838952530573306,0.36148701881772466
금리인상/NNG;앞둔/VV,1,0.14469544896354192,21,11,10,32,0.4838952530573306,0.36148701881772466
통화정책/NNG;완화적/VAX;인/VCP,1,0.14469544896354192,21,11,10,28,0.4838952530573306,0.36148701881772466
경기회복/NNG;낙관적/VAX,1,0.14469544896354192,21,11,10,20,0.4838952530573306,0.36148701881772466
기준금리인하/NNG;단행/NNG;할/XSV,1,0.14469544896354192,21,11,10,19,0.4838952530573306,0.36148701881772466
달러화/NNG;상승/NNG;하/XSV,1,0.14434291009546873,70,36,34,60,0.6429376855865548,0.48064331729783594
채권/NNG;시장/NNG;국고채/NNG;지표금리/NNG;내린/VV,1,0.14434291009546873,70,36,34,106,0.6429376855865548,0.48064331729783594
대출/NNG;늘려/VV,1,0.14033291237623047,23,12,11,16,0.4908082438105973,0.36993058711652765
경기회복모멘텀/NNG;둔화/NNG;될/XSV,1,0.14033291237623047,23,12,11,15,0.4908082438105973,0.36993058711652765
국채가격/NNG;상승/NNG;한/XSA,1,0.14033291237623047,23,12,11,9,0.4908082438105973,0.36993058711652765
금리인상/NNG;고려/NNG;하/XSV,1,0.14033291237623047,23,12,11,21,0.4908082438105973,0.36993058711652765
유가/NNG;급등/NNG;했/XSV,1,0.14033291237623047,23,12,11,9,0.4908082438105973,0.36993058711652765
투자/NNG;줄어들/VV,1,0.14033291237623047,23,12,11,17,0.4908082438105973,0.36993058711652765
유가하락/NNG;불구하/VAX,1,0.14033291237623047,23,12,11,11,0.4908082438105973,0.36993058711652765
경기/NNG;하강/NNG;할/XSV,1,0.14033291237623047,23,12,11,8,0.4908082438105973,0.36993058711652765
달러약세/NNG;이어지/VV,1,0.14033291237623047,23,12,11,22,0.4908082438105973,0.36993058711652765
기준금리/NNG;인상/NNG;한다고/XSV,1,0.14033291237623047,23,12,11,14,0.4908082438105973,0.36993058711652765
경기부양/NNG;따른/VV,1,0.14033291237623047,23,12,11,22,0.4908082438105973,0.36993058711652765
경제성장/NNG;차지/NNG;하/XSV,1,0.14033291237623047,23,12,11,7,0.4908082438105973,0.36993058711652765
금리인하/NNG;필요/NNG;하/XSV,1,0.14033291237623047,23,12,11,29,0.4908082438105973,0.36993058711652765
발행/NNG;금리/NNG;낮/VA;지/VX,1,0.14033291237623047,23,12,11,15,0.4908082438105973,0.36993058711652765
금리상승/NNG;가능성/NNG;높/VA,1,0.14033291237623047,23,12,11,8,0.4908082438105973,0.36993058711652765
금리상승/NNG;제한/NNG;됐/XSV,1,0.14033291237623047,23,12,11,25,0.4908082438105973,0.36993058711652765
성장/NNG;하/XSV,1,0.13848789098178482,499,255,244,430,0.7519399002390089,0.5688863699577531
장단기금리차/NNG;확대/NNG;되/XSV,1,0.1382487723415433,84,43,41,87,0.6687380807747397,0.5061860362838188
순이익/NNG;증가/NNG;했/XSV,1,0.1382487723415433,84,43,41,74,0.6687380807747397,0.5061860362838188
안전자산선호/NNG;강화/NNG;되/XSV,1,0.1382487723415433,84,43,41,89,0.6687380807747397,0.5061860362838188
주택가격/NNG;하락/NNG;하/XSV,1,0.13749932139445242,86,44,42,58,0.671944828940077,0.509390884806259
금리/NNG;상승/NNG;해/XSV,1,0.13749932139445242,86,44,42,73,0.671944828940077,0.509390884806259
신용스프레드/NNG;확대/NNG;됐/XSV,1,0.13676868992421265,25,13,12,17,0.49774421739219893,0.3778943768535533
시장변동성/NNG;확대/NNG;되/XSV,1,0.13676868992421265,25,13,12,18,0.49774421739219893,0.3778943768535533
금융위기/NNG;벗어나/VV,1,0.13676868992421265,25,13,12,15,0.49774421739219893,0.3778943768535533
채권금리/NNG;급락/NNG;하/XSV,1,0.13676868992421265,25,13,12,24,0.49774421739219893,0.3778943768535533
수익성/NNG;높이/VV,1,0.13676868992421265,25,13,12,21,0.49774421739219893,0.3778943768535533
국고채/NNG;금리/NNG;떨어지/VV,1,0.13676868992421265,25,13,12,18,0.49774421739219893,0.3778943768535533
금리인상/NNG;확실/XR;되/XSV,1,0.13676868992421265,25,13,12,24,0.49774421739219893,0.3778943768535533
금가격/NNG;하락/NNG;했/XSV,1,0.13676868992421265,25,13,12,12,0.49774421739219893,0.3778943768535533
금리차/NNG;확대/NNG;됐/XSV,1,0.13676868992421265,25,13,12,14,0.49774421739219893,0.3778943768535533
투자/NNG;확대/NNG;될/XSV,1,0.13676868992421265,25,13,12,27,0.49774421739219893,0.3778943768535533
국고채/NNG;떨어진/VV,1,0.13676868992421265,25,13,12,21,0.49774421739219893,0.3778943768535533
기준금리인상/NNG;단행/NNG;한/XSA,1,0.13676868992421265,25,13,12,23,0.49774421739219893,0.3778943768535533
위안화/NNG;절상/NNG;될/XSV,1,0.13381438527913891,27,14,13,23,0.5046683223197773,0.38546384969370157
소비/NNG;줄/VV,1,0.13381438527913891,27,14,13,17,0.5046683223197773,0.38546384969370157
연방기금금리/NNG;인상/NNG;하/XSV,1,0.13381438527913891,27,14,13,17,0.5046683223197773,0.38546384969370157
경기회복/NNG;지원/NNG;하/XSV,1,0.13381438527913891,27,14,13,23,0.5046683223197773,0.38546384969370157
글로벌경제/NNG;회복세/NNG;이/VV,1,0.13381438527913891,27,14,13,9,0.5046683223197773,0.38546384969370157
경기둔화/NNG;반영/NNG;하/XSV,1,0.13381438527913891,27,14,13,10,0.5046683223197773,0.38546384969370157
채권가격/NNG;상승/NNG;채권강세/NNG;한/XSA,1,0.13381438527913891,27,14,13,26,0.5046683223197773,0.38546384969370157
투자심리/NNG;악화/NNG;된/XSV,1,0.13381438527913891,27,14,13,21,0.5046683223197773,0.38546384969370157
국채금리/NNG;상승/NNG;할/XSV,1,0.13133551193980741,29,15,14,21,0.5115538652544296,0.3926993536105727
금리/NNG;높/VA;채권/NNG,1,0.13133551193980741,29,15,14,28,0.5115538652544296,0.3926993536105727
높/VA;수익/NNG;기대/NNG;할/XSV,1,0.13133551193980741,29,15,14,12,0.5115538652544296,0.3926993536105727
마이너스/NNG;수익률/NNG;했/XSV,1,0.13133551193980741,29,15,14,32,0.5115538652544296,0.3926993536105727
달러강세/NNG;지지/NNG;했/XSV,1,0.13133551193980741,29,15,14,12,0.5115538652544296,0.3926993536105727
금리인상/NNG;주장/NNG;했/XSV,1,0.13133551193980741,29,15,14,25,0.5115538652544296,0.3926993536105727
전세가격/NNG;오르/VV,1,0.13133551193980741,29,15,14,31,0.5115538652544296,0.3926993536105727
금리하락/NNG;컸/VA,1,0.13133551193980741,29,15,14,19,0.5115538652544296,0.3926993536105727
양적완화/NNG;축소/NNG;될/XSV,1,0.13133551193980741,29,15,14,22,0.5115538652544296,0.3926993536105727
회사채/NNG;금리/NNG;하락/NNG;했/XSV,1,0.13133551193980741,29,15,14,29,0.5115538652544296,0.3926993536105727
금리/NNG;상회/NNG;하/XSV,1,0.13133551193980741,29,15,14,24,0.5115538652544296,0.3926993536105727
경기침체/NNG;따른/VV,1,0.1310650866973606,106,54,52,39,0.6981311475854365,0.5362221941784862
완화/NNG;될/XSV,1,0.13022165374012795,825,420,405,674,0.7472831507455626,0.5749606586897561
경기/NNG;둔화/NNG;될/XSV,1,0.12995378211388475,110,56,54,67,0.7022072384037852,0.5405736462086735
유가/NNG;떨어졌/VV,1,0.12923350067255646,31,16,15,15,0.5183800383517285,0.3996446696759659
유가/NNG;넘어서/VV,1,0.12923350067255646,31,16,15,20,0.5183800383517285,0.3996446696759659
금리인상/NNG;가능성/NNG;않/VX,1,0.12923350067255646,31,16,15,24,0.5183800383517285,0.3996446696759659
엔화/NNG;약세/NNG;하/XSV,1,0.12923350067255646,31,16,15,36,0.5183800383517285,0.3996446696759659
성장/NNG;달성/NNG;할/XSV,1,0.12923350067255646,31,16,15,17,0.5183800383517285,0.3996446696759659
국채가격/NNG;하락/NNG;부추겼/VV,1,0.12923350067255646,31,16,15,15,0.5183800383517285,0.3996446696759659
비용/NNG;증가/NNG;하/XSV,1,0.12923350067255646,31,16,15,29,0.5183800383517285,0.3996446696759659
달러화가치/NNG;떨어지/VV,1,0.12743447234864136,33,17,16,28,0.5251303901367848,0.4063323248404375
엔화/NNG;거래/NNG;돼/XSV;인/VCP;상승/NNG;했/XSV,1,0.12743447234864136,33,17,16,18,0.5251303901367848,0.4063323248404375
달러엔/NNG;하락/NNG;하/XSV,1,0.12743447234864136,33,17,16,15,0.5251303901367848,0.4063323248404375
서부텍사스산원유/NNG;내린/VV,1,0.12743447234864136,33,17,16,25,0.5251303901367848,0.4063323248404375
성장세/NNG;보였/VV,1,0.12743447234864136,33,17,16,42,0.5251303901367848,0.4063323248404375
시장금리/NNG;상승/NNG;했/XSV,1,0.12743447234864136,33,17,16,13,0.5251303901367848,0.4063323248404375
기준금리/NNG;동결/NNG;할/XSV,1,0.12601751906941772,555,282,273,365,0.7448929859435328,0.5780410655343198
투자심리/NNG;개선/NNG;됐/XSV,1,0.12588198025046893,35,18,17,44,0.5317917702969825,0.4127870093920327
외환시장/NNG;원달러/NNG;오른/VV,1,0.12588198025046893,35,18,17,68,0.5317917702969825,0.4127870093920327
불확실성/NNG;높/VA;이/VCP,1,0.12588198025046893,35,18,17,26,0.5317917702969825,0.4127870093920327
실적/NNG;내/VV,1,0.12588198025046893,35,18,17,30,0.5317917702969825,0.4127870093920327
스왑베이시스/NNG;축소/NNG;되/XSV,1,0.12453217382334669,37,19,18,21,0.5383535843810213,0.41902784073724897
금리인상/NNG;빨라질/VA,1,0.12453217382334669,37,19,18,42,0.5383535843810213,0.41902784073724897
금리/NNG;인상/NNG;한다고/XSV,1,0.12453217382334669,37,19,18,25,0.5383535843810213,0.41902784073724897
금리/NNG;하락/NNG;할/XSV,1,0.12453217382334669,37,19,18,29,0.5383535843810213,0.41902784073724897
유로화/NNG;약세/NNG;보이/VV,1,0.12453217382334669,37,19,18,32,0.5383535843810213,0.41902784073724897
경제지표/NNG;호조/NNG;보인/VV,1,0.12335048992790587,39,20,19,37,0.5448072559168239,0.42506990148623736
경기둔화우려/NNG;높/VA,1,0.12230933623111961,41,21,20,20,0.5511458303211059,0.4309253077499342
기준금리인상/NNG;시사/NNG;하/XSV,1,0.12230933623111961,41,21,20,31,0.5511458303211059,0.4309253077499342
콜금리/NNG;동결/NNG;되/XSV,1,0.12230933623111961,41,21,20,12,0.5511458303211059,0.4309253077499342
달러엔/NNG;상승/NNG;한/XSA,1,0.12230933623111961,41,21,20,16,0.5511458303211059,0.4309253077499342
인플레이션/NNG;억제/NNG;되/XSV,1,0.12230933623111961,41,21,20,21,0.5511458303211059,0.4309253077499342
경기/NNG;둔화/NNG;되/XSV,1,0.12187390763148498,213,108,105,116,0.7409702359594167,0.5798559151186888
양적완화/NNG;인한/VV,1,0.12138643576728425,43,22,21,19,0.5573636776325276,0.4366039655195363
국채가격/NNG;올랐/VV,1,0.12056362224823647,45,23,22,22,0.5634562653620064,0.4421141152506654
불안심리/NNG;완화/NNG;되/XSV,1,0.12056362224823647,45,23,22,25,0.5634562653620064,0.4421141152506654
물가안정/NNG;유지/NNG;될/XSV,1,0.11916101994309303,49,25,24,24,0.57525199714297,0.4526558085279753
엔화/NNG;상승/NNG;했/XSV,1,0.11916101994309303,49,25,24,44,0.57525199714297,0.4526558085279753
장기금리/NNG;하락/NNG;했/XSV,1,0.11916101994309303,49,25,24,48,0.57525199714297,0.4526558085279753
내수/NNG;부진/NNG;한/XSA,1,0.11916101994309303,49,25,24,23,0.57525199714297,0.4526558085279753
미국채금리/NNG;상승/NNG;하/XSV,1,0.11855848101453348,51,26,25,93,0.5809501502976937,0.4576985982228457
수요/NNG;위축/NNG;되/XSV,1,0.11704464895738598,57,29,28,31,0.5972280658809386,0.47196963163502625
금리인상/NNG;가능성/NNG;제기/NNG;되/XSV,1,0.11704464895738598,57,29,28,55,0.5972280658809386,0.47196963163502625
금리/NNG;낮/VA;질/VX,1,0.11704464895738598,57,29,28,46,0.5972280658809386,0.47196963163502625
금리인상/NNG;단행/NNG;할/XSV,1,0.11548182238868376,443,224,219,331,0.7388389367325031,0.5857326022234096
기준금리인상/NNG;나설/VV,1,0.11517082835774195,67,34,33,66,0.6216180594117597,0.4931135746104254
국채금리/NNG;하락/NNG;했/XSV,1,0.1148594875659672,69,35,34,72,0.6260894780608531,0.4969740784941412
기준금리인상/NNG;없/VA,1,0.11400853749614415,75,38,37,66,0.6387118657360198,0.5078682906285926
지급준비금적수/NNG;감소/NNG;했/XSV,1,0.11324864261582479,81,41,40,110,0.6501814281365886,0.5177846937219195
달러약세/NNG;따른/VV,1,0.11210500724974826,91,46,45,64,0.6668808302022605,0.5323151180744504
기준금리인상/NNG;불구하/VAX,1,0.11188823405497628,93,47,46,58,0.6698780546665165,0.5349423205055575
기준금리/NNG;동결/NNG;했/XSV,1,0.11159358843237954,317,160,157,329,0.7365737541681888,0.5885543256611419
금리/NNG;떨어질/VV,1,0.11125334576708301,99,50,49,78,0.6782265226011591,0.5423058268690347
수출/NNG;감소/NNG;하/XSV,1,0.11104579053862418,101,51,50,71,0.6808029612282032,0.5445947318620945
금리인하/NNG;가능성/NNG;높/VA,1,0.10768428854365575,135,68,67,98,0.7113936213733356,0.5729496750789649
금리인상/NNG;통해/VV,1,0.10730705411050057,139,70,69,75,0.7136466742260272,0.5752030517364067
시장금리/NNG;상승/NNG;하/XSV,1,0.10620729360995562,151,76,75,125,0.7191359527159433,0.5809182125316609
성장세/NNG;이/VV,1,0.10585321240701728,155,78,77,133,0.7205935672096828,0.5825126434672074
금리/NNG;오른/VV,1,0.10553315977482347,302,152,150,344,0.7330195060799067,0.5929411405215126
기준금리/NNG;인하/NNG;될/XSV,1,0.10165068848984071,416,209,207,261,0.7307528820358182,0.5957646775901274
금리/NNG;동결/NNG;한/XSA,1,0.09181297378603981,176,88,88,128,0.7185950164416516,0.5976024306179237
투자심리/NNG;위축/NNG;되/XSV,1,0.09179841854174664,180,90,90,105,0.719409432487639,0.5982972812075044
경제/NNG;성장/NNG;하/XSV,1,0.09126641883774766,128,64,64,93,0.6969649896330271,0.5802534903080495
금리인상/NNG;할/VV,1,0.09102019426761387,122,61,61,88,0.6920124432375319,0.5764163846388499
성장/NNG;이/VCP,1,0.09059088021112927,114,57,57,75,0.6843247427452609,0.5705064730690635
투자/NNG;확대/NNG;하/XSV,1,0.09032702931748493,110,55,55,94,0.6799733785036667,0.5671804653527076
금리인상/NNG;이어질/VV,1,0.09002670168082028,106,53,53,62,0.6752576800720469,0.5635881232504694
규제/NNG;완화/NNG;하/XSV,1,0.09002670168082028,106,53,53,91,0.6752576800720469,0.5635881232504694
금리/NNG;국고/NNG;지표물/NNG;인/VCP;상승/NNG;한/XSA,1,0.0886457973994601,92,46,46,116,0.6555966274413069,0.5487036494517313
채권/NNG;시장/NNG;국채선물/NNG;오른/VV,1,0.08758919365908957,84,42,42,93,0.6419202955411767,0.5384024029284042
소비자/NNG;물가상승률/NNG;높/VA,1,0.08697722621374337,80,40,40,47,0.6343528806333621,0.5327117997161991
금리인상/NNG;지연/NNG;될/XSV,1,0.0866488185519656,78,39,39,97,0.6303786908251359,0.5297247710960781
채권금리/NNG;급등/NNG;하/XSV,1,0.08630487413716548,76,38,38,63,0.6262745304965874,0.5266407285450261
시장금리/NNG;급등/NNG;하/XSV,1,0.08630487413716548,76,38,38,29,0.6262745304965874,0.5266407285450261
기준금리/NNG;동결/NNG;된/XSV,1,0.08630487413716548,76,38,38,55,0.6262745304965874,0.5266407285450261
금리/NNG;하락/NNG;했/XSV,1,0.08621305620207997,411,205,206,334,0.7215443828251595,0.6068663766473407
cd금리/NNG;상승/NNG;하/XSV,1,0.0851753375128892,70,35,35,42,0.6131610123452466,0.5167879625443689
금리인상/NNG;나설/VV,1,0.08492245051583436,329,164,165,286,0.7207622778556515,0.6077865917794667
금리/NNG;하락/NNG;해/XSV,1,0.08476474383060628,68,34,34,60,0.6085161558859845,0.5132974724754252
경기/NNG;위축/NNG;되/XSV,1,0.08388967562330518,64,32,32,22,0.5988049125412106,0.505996748823493
지표금리/NNG;하락/NNG;한/XSA,1,0.08388967562330518,64,32,32,79,0.5988049125412106,0.505996748823493
기준금리인상/NNG;가능성/NNG;낮/VA,1,0.08388967562330518,64,32,32,43,0.5988049125412106,0.505996748823493
국채선물/NNG;오른/VV,1,0.08366979294596,275,137,138,213,0.7199247620990055,0.6086137796469959
달러강세/NNG;되/XSV,1,0.08342427290231891,62,31,31,66,0.5937352512333033,0.5021832400409072
수요/NNG;감소/NNG;할/XSV,1,0.08342427290231891,62,31,31,65,0.5937352512333033,0.5021832400409072
국채선물/NNG;떨어진/VV,1,0.08293966969683875,60,30,30,74,0.5885209319576152,0.49825889360651915
수익/NNG;내/VV,1,0.0826282407899821,241,120,121,191,0.7189220089270643,0.6090419932103871
대출/NNG;줄이/VV,1,0.08243539898911245,58,29,29,53,0.5831606630491143,0.4942222503439866
달러약세/NNG;되/XSV,1,0.08243539898911245,58,29,29,40,0.5831606630491143,0.4942222503439866
유로화/NNG;상승/NNG;한/XSA,1,0.08191099388258638,56,28,28,31,0.5776533139552323,0.49007193845882663
금리인하/NNG;할/VV,1,0.08191099388258638,56,28,28,38,0.5776533139552323,0.49007193845882663
기준금리/NNG;인상/NNG;된/XSV,1,0.08136598842999332,54,27,27,41,0.5719979287774907,0.4858066832343466
콜금리/NNG;올리/VV,1,0.08136598842999332,54,27,27,40,0.5719979287774907,0.4858066832343466
달러화/NNG;엔화/NNG;거래/NNG;돼/XSV;인/VCP;떨어졌/VV,1,0.08079991853779189,52,26,26,28,0.5661937403016669,0.4814253172381149
달러강세/NNG;지지/NNG;하/XSV,1,0.07960274431029446,48,24,24,26,0.5541369152956334,0.47231018435400857
엔화/NNG;대해선/VV;내린/VV,1,0.07897073031361446,46,23,23,22,0.5478838200136491,0.46757471780041976
금리인상/NNG;가능성/NNG;부각/NNG;되/XSV,1,0.07897073031361446,46,23,23,44,0.5478838200136491,0.46757471780041976
금리인상/NNG;이/VCP,1,0.07871735108603661,336,167,169,201,0.717002166629222,0.61221564839199
국고채/NNG;금리/NNG;하락/NNG;했/XSV,1,0.07866496491737718,165,82,83,118,0.7078703979678787,0.6044821560225678
금리인상/NNG;늦추/VV,1,0.0776376197310984,42,21,21,49,0.5349289596424748,0.45774486460196684
경기/NNG;부양/NNG;하/XSV,1,0.07710291673681091,149,74,75,162,0.7009876463546837,0.6004887442153026
변동성/NNG;줄/VV,1,0.076935655266541,40,20,20,41,0.5282282756898206,0.4526497341594653
신용스프레드/NNG;확대/NNG;되/XSV,1,0.07638741476512645,143,71,72,130,0.6976261240641046,0.5984698420450546
기준금리인상/NNG;한/XSA,1,0.0762095225624766,38,19,19,36,0.521379959473356,0.4474342822445944
경제성장/NNG;이끌/VV,1,0.0762095225624766,38,19,19,23,0.521379959473356,0.4474342822445944
금리동결/NNG;하/XSV,1,0.0762095225624766,38,19,19,43,0.521379959473356,0.4474342822445944
경기/NNG;부진/NNG;하/XSV,1,0.0762095225624766,38,19,19,25,0.521379959473356,0.4474342822445944
금리/NNG;높/VA;이/VCP,1,0.07545881466841964,36,18,18,35,0.5143852993437796,0.44209862235679187
원자재/NNG;가격하락/NNG;따른/VV,1,0.07545881466841964,36,18,18,21,0.5143852993437796,0.44209862235679187
신용등급/NNG;낮/VA;기업/NNG,1,0.07545881466841964,36,18,18,28,0.5143852993437796,0.44209862235679187
저금리/NNG;유지/NNG;되/XSV,1,0.07545881466841964,36,18,18,40,0.5143852993437796,0.44209862235679187
달러화/NNG;강세/NNG;보일/VV,1,0.07545881466841964,36,18,18,43,0.5143852993437796,0.44209862235679187
안전자산선호/NNG;강화/NNG;됐/XSV,1,0.07545881466841964,36,18,18,21,0.5143852993437796,0.44209862235679187
침체/NNG;한/XSA,1,0.0746831382909976,34,17,17,42,0.5072459107226122,0.4366430863753121
금리/NNG;인상/NNG;해도/XSV,1,0.0746831382909976,34,17,17,39,0.5072459107226122,0.4366430863753121
경제지표/NNG;부진/NNG;할/XSV,1,0.0746831382909976,34,17,17,21,0.5072459107226122,0.4366430863753121
기준금리/NNG;동결/NNG;함/XSV,1,0.0738821154953837,32,16,16,41,0.49996375111722674,0.4310682381978301
수요/NNG;억제/NNG;하/XSV,1,0.0738821154953837,32,16,16,16,0.49996375111722674,0.4310682381978301
대출/NNG;억제/NNG;하/XSV,1,0.0738821154953837,32,16,16,24,0.49996375111722674,0.4310682381978301
경기/NNG;호전/NNG;되/XSV,1,0.0738821154953837,32,16,16,24,0.49996375111722674,0.4310682381978301
인플레이션/NNG;우려/NNG;제기/NNG;되/XSV,1,0.07305538547002222,30,15,15,15,0.4925411345900715,0.4253748873673891
실적/NNG;부진/NNG;했/XSV,1,0.07305538547002222,30,15,15,31,0.4925411345900715,0.4253748873673891
금리인하/NNG;가능성/NNG;있/VV,1,0.07305538547002222,30,15,15,25,0.4925411345900715,0.4253748873673891
수출호조/NNG;따른/VV,1,0.07305538547002222,30,15,15,16,0.4925411345900715,0.4253748873673891
물가안정/NNG;강조/NNG;하/XSV,1,0.07305538547002222,30,15,15,13,0.4925411345900715,0.4253748873673891
채권금리/NNG;오를/VV,1,0.07305538547002222,30,15,15,38,0.4925411345900715,0.4253748873673891
유가하락/NNG;따른/VV,1,0.0729254213844337,121,60,61,100,0.6805335086502265,0.587884921169394
국채가격/NNG;떨어진/VV,1,0.07220260634681885,28,14,14,9,0.4849807455169139,0.4195641025825927
불확실성/NNG;높/VA;판단/NNG,1,0.07220260634681885,28,14,14,25,0.4849807455169139,0.4195641025825927
금리인상/NNG;적절하/VAX,1,0.07220260634681885,28,14,14,35,0.4849807455169139,0.4195641025825927
성장/NNG;위해서/VV,1,0.07220260634681885,28,14,14,27,0.4849807455169139,0.4195641025825927
금리/NNG;상승/NNG;하/XSV;않/VX,1,0.07220260634681885,28,14,14,24,0.4849807455169139,0.4195641025825927
고용/NNG;늘어나/VV,1,0.07220260634681885,28,14,14,18,0.4849807455169139,0.4195641025825927
금리인하/NNG;필요/NNG;하/XSA,1,0.07220260634681885,28,14,14,28,0.4849807455169139,0.4195641025825927
투자/NNG;늘리/VV,1,0.07169134973155855,115,57,58,104,0.6743075835688856,0.5839533566103022
인플레이션기대/NNG;심리/NNG;확산/NNG;되/XSV,1,0.07132345706747811,26,13,13,7,0.4772856514581849,0.41363722497495653
금리인상/NNG;미루/VV,1,0.07132345706747811,26,13,13,27,0.4772856514581849,0.41363722497495653
지표금리/NNG;인/VCP;국고채/NNG;수익률/NNG;오른/VV,1,0.07132345706747811,26,13,13,7,0.4772856514581849,0.41363722497495653
양적완화/NNG;라는/VCP,1,0.07132345706747811,26,13,13,24,0.4772856514581849,0.41363722497495653
국채수익률/NNG;하락/NNG;하/XSV,1,0.07132345706747811,26,13,13,16,0.4772856514581849,0.41363722497495653
손실/NNG;커지/VV,1,0.07132345706747811,26,13,13,12,0.4772856514581849,0.41363722497495653
수출/NNG;회복/NNG;되/XSV,1,0.07132345706747811,26,13,13,19,0.4772856514581849,0.41363722497495653
요인/NNG;완화/NNG;되/XSV,1,0.07132345706747811,26,13,13,20,0.4772856514581849,0.41363722497495653
채권가격/NNG;하락/NNG;하/XSV,1,0.07132345706747811,26,13,13,29,0.4772856514581849,0.41363722497495653
금리인상/NNG;단행/NNG;한/XSA,1,0.07078331809197858,111,55,56,73,0.6697212806750072,0.581040997193545
금융안정/NNG;위해/VV,1,0.07041763928511857,24,12,12,16,0.4694593149578431,0.40759588102646865
기대심리/NNG;강세/NNG;보였/VV,1,0.07041763928511857,24,12,12,8,0.4694593149578431,0.40759588102646865
경제성장세/NNG;둔화/NNG;되/XSV,1,0.07041763928511857,24,12,12,21,0.4694593149578431,0.40759588102646865
낮/VA;금리/NNG;대출/NNG;받/VV,1,0.07041763928511857,24,12,12,32,0.4694593149578431,0.40759588102646865
경제/NNG;부담/NNG;작용/NNG;할/XSV,1,0.07041763928511857,24,12,12,16,0.4694593149578431,0.40759588102646865
대출/NNG;축소/NNG;하/XSV,1,0.07041763928511857,24,12,12,7,0.4694593149578431,0.40759588102646865
시장금리/NNG;급락/NNG;하/XSV,1,0.07041763928511857,24,12,12,9,0.4694593149578431,0.40759588102646865
금리/NNG;올린다는/VV,1,0.07041763928511857,24,12,12,20,0.4694593149578431,0.40759588102646865
차입금/NNG;증가/NNG;했/XSV,1,0.07041763928511857,24,12,12,11,0.4694593149578431,0.40759588102646865
국채수익률/NNG;떨어진/VV,1,0.07041763928511857,24,12,12,10,0.4694593149578431,0.40759588102646865
수요/NNG;약화/NNG;될/XSV,1,0.07041763928511857,24,12,12,24,0.4694593149578431,0.40759588102646865
인플레이션/NNG;우려/NNG;부각/NNG;되/XSV,1,0.07041763928511857,24,12,12,7,0.4694593149578431,0.40759588102646865
실업률/NNG;하락/NNG;한/XSA,1,0.07041763928511857,24,12,12,31,0.4694593149578431,0.40759588102646865
금리/NNG;하락/NNG;한/XSA,1,0.06977551878510813,394,195,199,304,0.7115306184438613,0.6185656422819856
이익/NNG;줄/VV,1,0.06948487928872238,22,11,11,23,0.4615056040759432,0.40144199498988703
경기침체/NNG;벗어나/VV,1,0.06948487928872238,22,11,11,18,0.4615056040759432,0.40144199498988703
집값/NNG;떨어질/VV,1,0.06948487928872238,22,11,11,5,0.4615056040759432,0.40144199498988703
재정지출/NNG;확대/NNG;하/XSV,1,0.06948487928872238,22,11,11,15,0.4615056040759432,0.40144199498988703
유가/NNG;안정/NNG;되/XSV,1,0.06948487928872238,22,11,11,13,0.4615056040759432,0.40144199498988703
순이익/NNG;내/VV,1,0.06948487928872238,22,11,11,8,0.4615056040759432,0.40144199498988703
달러화/NNG;레벨/NNG;높일/VV,1,0.06948487928872238,22,11,11,19,0.4615056040759432,0.40144199498988703
금리인하/NNG;배경/NNG;설명/NNG;했/XSV,1,0.06948487928872238,22,11,11,5,0.4615056040759432,0.40144199498988703
주택담보대출/NNG;증가/NNG;했/XSV,1,0.06948487928872238,22,11,11,14,0.4615056040759432,0.40144199498988703
원화/NNG;절상/NNG;따른/VV,1,0.06948487928872238,22,11,11,29,0.4615056040759432,0.40144199498988703
기대심리/NNG;상승/NNG;하/XSV,1,0.06948487928872238,22,11,11,13,0.4615056040759432,0.40144199498988703
채권/NNG;시장/NNG;강세/NNG;보일/VV,1,0.06948487928872238,22,11,11,23,0.4615056040759432,0.40144199498988703
시장금리/NNG;상승/NNG;할/XSV,1,0.06873581002802909,103,51,52,60,0.6594129393410753,0.574456179928703
달러강세/NNG;나타날/VV,1,0.06852492993636194,20,10,10,22,0.45342880145459924,0.39517780066433483
높/VA;수익률/NNG;하/XSV,1,0.06852492993636194,20,10,10,24,0.45342880145459924,0.39517780066433483
소비자물가/NNG;하락/NNG;했/XSV,1,0.06852492993636194,20,10,10,9,0.45342880145459924,0.39517780066433483
금리인상/NNG;단행/NNG;한다면/XSV,1,0.06852492993636194,20,10,10,12,0.45342880145459924,0.39517780066433483
달러강세/NNG;진행/NNG;되/XSV,1,0.06852492993636194,20,10,10,24,0.45342880145459924,0.39517780066433483
성장모멘텀/NNG;둔화/NNG;되/XSV,1,0.06852492993636194,20,10,10,13,0.45342880145459924,0.39517780066433483
성장세/NNG;나타냈/VV,1,0.06852492993636194,20,10,10,12,0.45342880145459924,0.39517780066433483
수요/NNG;유지/NNG;되/XSV,1,0.06852492993636194,20,10,10,23,0.45342880145459924,0.39517780066433483
금리인상/NNG;부정적/NNG;인/VCP,1,0.06852492993636194,20,10,10,24,0.45342880145459924,0.39517780066433483
금리/NNG;인하/NNG;된/XSV,1,0.06852492993636194,20,10,10,8,0.45342880145459924,0.39517780066433483
금리인상/NNG;미뤄질/VV,1,0.06852492993636194,20,10,10,35,0.45342880145459924,0.39517780066433483
변동성/NNG;높일/VV,1,0.06852492993636194,20,10,10,16,0.45342880145459924,0.39517780066433483
변동성/NNG;줄여/VV,1,0.06852492993636194,20,10,10,30,0.45342880145459924,0.39517780066433483
금리상승/NNG;영향/NNG;받/VV,1,0.06852492993636194,20,10,10,19,0.45342880145459924,0.39517780066433483
인플레이션/NNG;우려/NNG;완화/NNG;돼/XSV,1,0.06852492993636194,20,10,10,8,0.45342880145459924,0.39517780066433483
경기회복/NNG;발목/NNG;잡/VV,1,0.06852492993636194,20,10,10,18,0.45342880145459924,0.39517780066433483
엔화/NNG;강세/NNG;보일/VV,1,0.06852492993636194,20,10,10,20,0.45342880145459924,0.39517780066433483
원화/NNG;강세/NNG;보일/VV,1,0.06852492993636194,20,10,10,24,0.45342880145459924,0.39517780066433483
국고/NNG;지표금리/NNG;오른/VV,1,0.06852492993636194,20,10,10,8,0.45342880145459924,0.39517780066433483
채권/NNG;시장/NNG;강세/NNG;보인/VV,1,0.06852492993636194,20,10,10,18,0.45342880145459924,0.39517780066433483
금리하락/NNG;기대/NNG;하/XSV,1,0.06852492993636194,20,10,10,14,0.45342880145459924,0.39517780066433483
완화적/VAX;인/VCP;수준/NNG;이/VCP,1,0.06852492993636194,20,10,10,18,0.45342880145459924,0.39517780066433483
금리하락/NNG;요인/NNG;작용/NNG;하/XSV,1,0.06852492993636194,20,10,10,15,0.45342880145459924,0.39517780066433483
기준금리/NNG;인하/NNG;되/XSV;않/VX,1,0.06852492993636194,20,10,10,11,0.45342880145459924,0.39517780066433483
경기침체/NNG;인해/VV,1,0.06852492993636194,20,10,10,17,0.45342880145459924,0.39517780066433483
고용/NNG;늘리/VV,1,0.06852492993636194,20,10,10,18,0.45342880145459924,0.39517780066433483
국채가격/NNG;낮/VA;진/VX,1,0.06758296772663908,99,49,50,41,0.6536500094787314,0.5707560454664432
채권금리/NNG;내렸/VV,1,0.06753757258156567,18,9,9,9,0.4452336117126316,0.38880585236961007
경기/NNG;반등/NNG;하/XSV,1,0.06753757258156567,18,9,9,28,0.4452336117126316,0.38880585236961007
달러인덱스/NNG;하락/NNG;했/XSV,1,0.06753757258156567,18,9,9,22,0.4452336117126316,0.38880585236961007
금리인하/NNG;단행/NNG;되/XSV;않/VX,1,0.06753757258156567,18,9,9,9,0.4452336117126316,0.38880585236961007
자본/NNG;빠져나가/VV,1,0.06753757258156567,18,9,9,11,0.4452336117126316,0.38880585236961007
경기모멘텀/NNG;약화/NNG;되/XSV,1,0.06753757258156567,18,9,9,13,0.4452336117126316,0.38880585236961007
금리/NNG;상승세/NNG;이어질/VV,1,0.06753757258156567,18,9,9,20,0.4452336117126316,0.38880585236961007
금리인하/NNG;기대심리/NNG;형성/NNG;되/XSV,1,0.06753757258156567,18,9,9,6,0.4452336117126316,0.38880585236961007
금리인상/NNG;감안/NNG;할/XSV,1,0.06753757258156567,18,9,9,2,0.4452336117126316,0.38880585236961007
인플레이션/NNG;우려/NNG;해/XSV,1,0.06753757258156567,18,9,9,9,0.4452336117126316,0.38880585236961007
높/VA;수익률/NNG;기대/NNG;할/XSV,1,0.06753757258156567,18,9,9,18,0.4452336117126316,0.38880585236961007
소비자물가/NNG;하락/NNG;해/XSV,1,0.06753757258156567,18,9,9,7,0.4452336117126316,0.38880585236961007
물가상승률/NNG;둔화/NNG;될/XSV,1,0.06753757258156567,18,9,9,3,0.4452336117126316,0.38880585236961007
금리/NNG;높/VA;형성/NNG,1,0.06753757258156567,18,9,9,23,0.4452336117126316,0.38880585236961007
모기지/NNG;금리/NNG;낮/VA;수준/NNG,1,0.06753757258156567,18,9,9,5,0.4452336117126316,0.38880585236961007
순이익/NNG;줄어든/VV,1,0.06753757258156567,18,9,9,18,0.4452336117126316,0.38880585236961007
금리인상/NNG;기대심리/NNG;높/VA,1,0.06753757258156567,18,9,9,14,0.4452336117126316,0.38880585236961007
외화자금/NNG;시장/NNG;스왑/NNG;하락/NNG;한/XSA,1,0.06753757258156567,18,9,9,13,0.4452336117126316,0.38880585236961007
금리인상/NNG;염두/NNG;두/VV,1,0.06753757258156567,18,9,9,4,0.4452336117126316,0.38880585236961007
침체/NNG;따른/VV,1,0.06753757258156567,18,9,9,9,0.4452336117126316,0.38880585236961007
채권/NNG;시장/NNG;국고/NNG;지표금리/NNG;오른/VV,1,0.06753757258156567,18,9,9,35,0.4452336117126316,0.38880585236961007
금리/NNG;폭락/NNG;했/XSV,1,0.06753757258156567,18,9,9,2,0.4452336117126316,0.38880585236961007
금리하락/NNG;제한/NNG;할/XSV,1,0.06753757258156567,18,9,9,10,0.4452336117126316,0.38880585236961007
회사채/NNG;금리/NNG;하락/NNG;하/XSV,1,0.06753757258156567,18,9,9,13,0.4452336117126316,0.38880585236961007
양적완화/NNG;불구하/VAX,1,0.06753757258156567,18,9,9,15,0.4452336117126316,0.38880585236961007
저평가/NNG;줄어들/VV,1,0.06753757258156567,18,9,9,6,0.4452336117126316,0.38880585236961007
물가/NNG;상승/NNG;했/XSV,1,0.06753757258156567,18,9,9,12,0.4452336117126316,0.38880585236961007
금리인상/NNG;제한적/VAX,1,0.06753757258156567,18,9,9,21,0.4452336117126316,0.38880585236961007
투자/NNG;선호/NNG;하/XSV,1,0.06753757258156567,18,9,9,15,0.4452336117126316,0.38880585236961007
유가/NNG;안정/NNG;될/XSV,1,0.06753757258156567,18,9,9,8,0.4452336117126316,0.38880585236961007
이익/NNG;늘/VV,1,0.06753757258156567,18,9,9,14,0.4452336117126316,0.38880585236961007
금리/NNG;인하/NNG;해도/XSV,1,0.06753757258156567,18,9,9,5,0.4452336117126316,0.38880585236961007
물가상승률/NNG;낮/VA,1,0.0675039495416434,178,88,90,177,0.7042851195495623,0.6150673805151199
금리인상/NNG;검토/NNG;하/XSV,1,0.06652261897562428,16,8,8,11,0.43692516696222244,0.38232903495455783
내외금리차확대/NNG;따른/VV,1,0.06652261897562428,16,8,8,5,0.43692516696222244,0.38232903495455783
금리인하/NNG;기대/NNG;할/XSV,1,0.06652261897562428,16,8,8,14,0.43692516696222244,0.38232903495455783
금리/NNG;반등/NNG;한/XSA,1,0.06652261897562428,16,8,8,20,0.43692516696222244,0.38232903495455783
재무/NNG;안정성/NNG;개선/NNG;되/XSV,1,0.06652261897562428,16,8,8,8,0.43692516696222244,0.38232903495455783
물가안정/NNG;위해서/VV,1,0.06652261897562428,16,8,8,11,0.43692516696222244,0.38232903495455783
가산금리/NNG;확대/NNG;되/XSV,1,0.06652261897562428,16,8,8,2,0.43692516696222244,0.38232903495455783
기준금리동결/NNG;될/XSV,1,0.06652261897562428,16,8,8,17,0.43692516696222244,0.38232903495455783
실적/NNG;호조/NNG;보이/VV,1,0.06652261897562428,16,8,8,8,0.43692516696222244,0.38232903495455783
제로금리정책/NNG;유지/NNG;하/XSV,1,0.06652261897562428,16,8,8,8,0.43692516696222244,0.38232903495455783
소비/NNG;증가/NNG;했/XSV,1,0.06652261897562428,16,8,8,11,0.43692516696222244,0.38232903495455783
경제/NNG;과열/NNG;되/XSV,1,0.06652261897562428,16,8,8,15,0.43692516696222244,0.38232903495455783
cd/NNG;유통수익률/NNG;오른/VV,1,0.06652261897562428,16,8,8,11,0.43692516696222244,0.38232903495455783
고용개선/NNG;되/XSV,1,0.06652261897562428,16,8,8,20,0.43692516696222244,0.38232903495455783
성장/NNG;미치/VV,1,0.06652261897562428,16,8,8,24,0.43692516696222244,0.38232903495455783
금리인상/NNG;구체적/VAX,1,0.06652261897562428,16,8,8,17,0.43692516696222244,0.38232903495455783
매출/NNG;감소/NNG;했/XSV,1,0.06652261897562428,16,8,8,25,0.43692516696222244,0.38232903495455783
경기회복/NNG;한/XSA,1,0.06652261897562428,16,8,8,12,0.43692516696222244,0.38232903495455783
성장기여도/NNG;높/VA,1,0.06652261897562428,16,8,8,13,0.43692516696222244,0.38232903495455783
단기자금/NNG;시장/NNG;안정/NNG;되/XSV,1,0.06652261897562428,16,8,8,5,0.43692516696222244,0.38232903495455783
경기/NNG;비관적/VAX;인/VCP,1,0.06652261897562428,16,8,8,7,0.43692516696222244,0.38232903495455783
엔달러/NNG;환율/NNG;오른/VV,1,0.06652261897562428,16,8,8,18,0.43692516696222244,0.38232903495455783
신용등급/NNG;하향/NNG;조정/NNG;한/XSA,1,0.06652261897562428,16,8,8,22,0.43692516696222244,0.38232903495455783
경기과열/NNG;억제/NNG;하/XSV,1,0.06652261897562428,16,8,8,14,0.43692516696222244,0.38232903495455783
엔화/NNG;강세/NNG;하/XSV,1,0.06652261897562428,16,8,8,13,0.43692516696222244,0.38232903495455783
기준금리/NNG;하락/NNG;하/XSV,1,0.06652261897562428,16,8,8,8,0.43692516696222244,0.38232903495455783
수요부진/NNG;따른/VV,1,0.06652261897562428,16,8,8,6,0.43692516696222244,0.38232903495455783
기준금리인상/NNG;가능/NNG;하/XSV,1,0.06652261897562428,16,8,8,13,0.43692516696222244,0.38232903495455783
달러강세/NNG;재개/NNG;되/XSV,1,0.06652261897562428,16,8,8,15,0.43692516696222244,0.38232903495455783
불확실성/NNG;확대/NNG;된/XSV,1,0.06652261897562428,16,8,8,28,0.43692516696222244,0.38232903495455783
모기지/NNG;금리/NNG;떨어졌/VV,1,0.06652261897562428,16,8,8,9,0.43692516696222244,0.38232903495455783
베이시스/NNG;축소/NNG;될/XSV,1,0.06652261897562428,16,8,8,0,0.43692516696222244,0.38232903495455783
수요/NNG;위축/NNG;된/XSV,1,0.06652261897562428,16,8,8,6,0.43692516696222244,0.38232903495455783
경상수지흑자/NNG;유지/NNG;하/XSV,1,0.06652261897562428,16,8,8,13,0.43692516696222244,0.38232903495455783
성장동력/NNG;찾/VV,1,0.06652261897562428,16,8,8,28,0.43692516696222244,0.38232903495455783
국채금리/NNG;급락/NNG;하/XSV,1,0.06652261897562428,16,8,8,10,0.43692516696222244,0.38232903495455783
고용지표/NNG;개선/NNG;된/XSV,1,0.06652261897562428,16,8,8,17,0.43692516696222244,0.38232903495455783
금리/NNG;하락세/NNG;돌아섰/VV,1,0.06652261897562428,16,8,8,18,0.43692516696222244,0.38232903495455783
기준금리/NNG;인하/NNG;해/XSV,1,0.06426161456297197,89,44,45,68,0.6373004736702736,0.5602042012451476
금리/NNG;인상/NNG;되/XSV,1,0.06350524303253935,154,76,78,137,0.6948380168658397,0.6117094933821073
물가/NNG;안정/NNG;되/XSV,1,0.06273298268760241,85,42,43,46,0.629928847522149,0.5554263287773255
미국채금리/NNG;상승/NNG;한/XSA,1,0.06273298268760241,85,42,43,102,0.629928847522149,0.5554263287773255
금리/NNG;동결/NNG;될/XSV,1,0.06268860242145191,150,74,76,106,0.6926723797974794,0.610803515738762
금리/NNG;인상/NNG;했/XSV,1,0.06225284139961107,219,108,111,143,0.7056701846801513,0.6228096390862767
지급준비율/NNG;인상/NNG;한/XSA,1,0.059270450683134523,77,38,39,27,0.6136450561488818,0.544841671274771
국고/NNG;금리/NNG;하락/NNG;한/XSA,1,0.058310312893329996,75,37,38,63,0.6092381711337901,0.5419720144882266
기준금리/NNG;인상/NNG;할/XSV,1,0.05622711427350713,1029,506,523,792,0.7031184713286653,0.6281064793827633
경기회복/NNG;지연/NNG;되/XSV,1,0.055169631083699766,69,34,35,38,0.5951708860917566,0.5328041815557747
콜금리/NNG;동결/NNG;하/XSV,1,0.055169631083699766,69,34,35,34,0.5951708860917566,0.5328041815557747
기준금리동결/NNG;하/XSV,1,0.05402757998398089,67,33,34,33,0.5901913275346236,0.5295579538056735
지급준비금적수/NNG;줄어든다/VV,1,0.05283313220698571,65,32,33,71,0.5850624608375358,0.5262148948267124
국고채/NNG;상승/NNG;한/XSA,1,0.05185500516135888,163,80,83,103,0.6907889543943533,0.6225267671638504
국채가격/NNG;상승/NNG;했/XSV,1,0.05078003909747175,110,54,56,53,0.6568432176652,0.5932125536319601
달러원/NNG;상승/NNG;한/XSA,1,0.05027331408030311,61,30,31,32,0.5743471203323285,0.5192353219472406
기대심리/NNG;커졌/VV,1,0.05027331408030311,61,30,31,51,0.5743471203323285,0.5192353219472406
엔화/NNG;약세/NNG;보이/VV,1,0.048900097389104946,59,29,30,52,0.5687558116315486,0.5155978190590292
불확실성/NNG;해소/NNG;될/XSV,1,0.048900097389104946,59,29,30,39,0.5687558116315486,0.5155978190590292
채권/NNG;시장/NNG;강세/NNG;보였/VV,1,0.047458655961964746,57,28,29,35,0.5630054994193201,0.5118615696975729
경제/NNG;발목/NNG;잡/VV,1,0.047458655961964746,57,28,29,40,0.5630054994193201,0.5118615696975729
경제/NNG;둔화/NNG;될/XSV,1,0.047458655961964746,57,28,29,37,0.5630054994193201,0.5118615696975729
금리인상/NNG;계속/NNG;될/XSV,1,0.047458655961964746,57,28,29,17,0.5630054994193201,0.5118615696975729
인플레이션/NNG;우려/NNG;커지/VV,1,0.047458655961964746,57,28,29,31,0.5630054994193201,0.5118615696975729
콜금리/NNG;동결/NNG;할/XSV,1,0.04724648530474873,102,50,52,23,0.6456225554763951,0.5872232536427379
금리/NNG;떨어지/VV,1,0.04639527135857624,190,93,97,122,0.6931593272288459,0.6315364791316888
수요/NNG;확대/NNG;되/XSV,1,0.04594375592113109,55,27,28,42,0.5570937060295348,0.5080267214377897
금리/NNG;하락/NNG;하/XSV,1,0.044857702341738914,503,246,257,423,0.6959511812392508,0.636036675453246
금리/NNG;오를/VV,1,0.04456842891517243,409,200,209,333,0.6957675451903493,0.6362374926063167
금리/NNG;낮춘/VV,1,0.04434945886254105,53,26,27,41,0.5510178859311359,0.5040937556613619
금리/NNG;낮/VA;져/VX,1,0.04434945886254105,53,26,27,27,0.5510178859311359,0.5040937556613619
달러원/NNG;하락/NNG;한/XSA,1,0.04434945886254105,53,26,27,40,0.5510178859311359,0.5040937556613619
금리인상/NNG;단행/NNG;하/XSV;않/VX,1,0.042668984411044164,51,25,26,33,0.5447753875997864,0.5000635428766467
달러강세/NNG;이어질/VV,1,0.042668984411044164,51,25,26,46,0.5447753875997864,0.5000635428766467
이자/NNG;내/VV,1,0.040877786550185924,90,44,46,93,0.6254880986790639,0.5762155343160904
연방기금/NNG;금리선물/NNG;오/VV,1,0.04050920454612661,129,63,66,35,0.6671778762934173,0.6150751141532165
유가/NNG;급등/NNG;하/XSV,1,0.03901709997998215,47,23,24,24,0.5317788968356377,0.4917172158432451
달러약세/NNG;될/XSV,1,0.037026143569255376,45,22,23,23,0.5250185208722392,0.48740545885165937
금리/NNG;떨어져/VV,1,0.037026143569255376,45,22,23,39,0.5250185208722392,0.48740545885165937
국채수익률/NNG;상승/NNG;한/XSA,1,0.037026143569255376,45,22,23,51,0.5250185208722392,0.48740545885165937
소비심리/NNG;위축/NNG;되/XSV,1,0.03265187105237222,41,20,21,16,0.5109544068541412,0.478521163907559
재할인율/NNG;인하/NNG;하/XSV,1,0.03265187105237222,41,20,21,29,0.5109544068541412,0.478521163907559
달러엔/NNG;상승/NNG;할/XSV,1,0.03265187105237222,41,20,21,35,0.5109544068541412,0.478521163907559
불확실성/NNG;증대/NNG;되/XSV,1,0.03265187105237222,41,20,21,34,0.5109544068541412,0.478521163907559
소비자물가/NNG;오르/VV,1,0.03265187105237222,41,20,21,26,0.5109544068541412,0.478521163907559
인플레이션/NNG;상승/NNG;할/XSV,1,0.03265187105237222,41,20,21,31,0.5109544068541412,0.478521163907559
국채수익률/NNG;상승/NNG;할/XSV,1,0.03265187105237222,41,20,21,20,0.5109544068541412,0.478521163907559
투자심리/NNG;악화/NNG;되/XSV,1,0.03265187105237222,41,20,21,18,0.5109544068541412,0.478521163907559
인플레이션/NNG;상승/NNG;하/XSV,1,0.03265187105237222,41,20,21,45,0.5109544068541412,0.478521163907559
불확실성/NNG;높/VA;지/VX,1,0.03044393451227334,109,53,56,98,0.6435548418336582,0.60537410894464
금리하락/NNG;따른/VV,1,0.03044393451227334,109,53,56,105,0.6435548418336582,0.60537410894464
금리인상/NNG;서두르/VV;않/VX,1,0.03023629734217881,39,19,20,56,0.5036410694363813,0.47395804129466257
금리/NNG;하락/NNG;함/XSV,1,0.03023629734217881,39,19,20,29,0.5036410694363813,0.47395804129466257
기대심리/NNG;상승/NNG;했/XSV,1,0.03023629734217881,39,19,20,46,0.5036410694363813,0.47395804129466257
미국채/NNG;금리/NNG;상승/NNG;한/XSA,1,0.03023629734217881,39,19,20,44,0.5036410694363813,0.47395804129466257
금리인상/NNG;멈출/VV,1,0.03023629734217881,39,19,20,29,0.5036410694363813,0.47395804129466257
금리/NNG;올랐/VV,1,0.0291955049951218,342,166,176,267,0.6859188229557862,0.6468388560286344
경기/NNG;부양/NNG;할/XSV,1,0.027641311356428222,37,18,19,31,0.49613214027415614,0.4693226250058721
금리상승/NNG;컸/VA,1,0.027641311356428222,37,18,19,56,0.49613214027415614,0.4693226250058721
양적완화/NNG;축소/NNG;할/XSV,1,0.027641311356428222,37,18,19,62,0.49613214027415614,0.4693226250058721
채권/NNG;시장/NNG;비우호적/VA;인/VCP,1,0.027641311356428222,37,18,19,40,0.49613214027415614,0.4693226250058721
양적완화/NNG;통해/VV,1,0.026328229479933407,70,34,36,64,0.5816216959683885,0.551640108567691
소비자물가/NNG;상승/NNG;해/XSV,1,0.02538228827167921,101,49,52,42,0.6313807798425437,0.5999687030021741
유가/NNG;상승/NNG;했/XSV,1,0.024840909471855355,35,17,18,25,0.48841974476591055,0.4646231873814284
채권/NNG;시장/NNG;약세/NNG;보였/VV,1,0.024840909471855355,35,17,18,31,0.48841974476591055,0.4646231873814284
원화/NNG;강세/NNG;될/XSV,1,0.024840909471855355,35,17,18,29,0.48841974476591055,0.4646231873814284
기준금리인하/NNG;불구하/VAX,1,0.024840909471855355,35,17,18,38,0.48841974476591055,0.4646231873814284
기준금리/NNG;올리/VV,1,0.024118574391013503,411,199,212,355,0.6826306545380989,0.6503110060246863
기준금리/NNG;인상/NNG;하/XSV;않/VX,1,0.0240036510623296,99,48,51,68,0.6280598530635311,0.5984614869167603
기준금리/NNG;동결/NNG;될/XSV,1,0.02278497136320823,403,195,208,347,0.681763449980099,0.6512200534502928
대출/NNG;확대/NNG;하/XSV,1,0.02260724818126203,66,32,34,49,0.5710892116131498,0.5456980737919167
서부텍사스산원유/NNG;오른/VV,1,0.02260724818126203,66,32,34,53,0.5710892116131498,0.5456980737919167
수요/NNG;늘어났/VV,1,0.021802899855140723,33,16,17,39,0.48049388614683736,0.45987009495870435
양적완화/NNG;종료/NNG;하/XSV,1,0.021802899855140723,33,16,17,51,0.48049388614683736,0.45987009495870435
유로화/NNG;강세/NNG;보였/VV,1,0.021802899855140723,33,16,17,27,0.48049388614683736,0.45987009495870435
금리/NNG;인상/NNG;될/XSV,1,0.020963715794120263,302,146,156,232,0.6805581861724388,0.6524415977411296
금리/NNG;올릴/VV,1,0.02087985894318467,935,452,483,740,0.6805224543092901,0.6525167925475976
금융시장/NNG;안정/NNG;되/XSV,1,0.019561806665440606,93,45,48,60,0.6173850063731955,0.5935405173379045
성장세/NNG;유지/NNG;할/XSV,1,0.018528278209692273,62,30,32,25,0.5599106027786249,0.5393998505761016
달러강세/NNG;인한/VV,1,0.018486891427945462,31,15,16,23,0.47234161834504745,0.4550763811680945
경제/NNG;부진/NNG;한/XSA,1,0.018486891427945462,31,15,16,24,0.47234161834504745,0.4550763811680945
호황/NNG;누리/VV,1,0.018486891427945462,31,15,16,26,0.47234161834504745,0.4550763811680945
안전자산선호/NNG;심리/NNG;강화/NNG;되/XSV,1,0.018486891427945462,31,15,16,47,0.47234161834504745,0.4550763811680945
국고채/NNG;하락/NNG;한/XSA,1,0.018111372052666663,176,85,91,129,0.6726422497149203,0.6485424886648442
금리/NNG;올려/VV,1,0.017592279717039583,147,71,76,135,0.6630676989570065,0.639975110942077
금리/NNG;오르/VV,1,0.016827724959253665,713,344,369,617,0.6778743338822336,0.6552673599976478
재무구조/NNG;개선/NNG;되/XSV,1,0.014841441507220221,29,14,15,16,0.46394584846351655,0.4502585304149728
금리/NNG;오/VV,1,0.014841441507220221,29,14,15,14,0.46394584846351655,0.4502585304149728
인플레이션기대/NNG;심리/NNG;낮추/VV,1,0.014841441507220221,29,14,15,29,0.46394584846351655,0.4502585304149728
유로화/NNG;달러화/NNG;높/VA;진/VX,1,0.014841441507220221,29,14,15,22,0.46394584846351655,0.4502585304149728
기준금리인하/NNG;기대심리/NNG;높/VA,1,0.014841441507220221,29,14,15,25,0.46394584846351655,0.4502585304149728
유로화/NNG;급락/NNG;했/XSV,1,0.014841441507220221,29,14,15,14,0.46394584846351655,0.4502585304149728
금리인하/NNG;가능성/NNG;배제/NNG;할/XSV;없/VA,1,0.014841441507220221,29,14,15,21,0.46394584846351655,0.4502585304149728
금리동결/NNG;이어질/VV,1,0.014841441507220221,29,14,15,26,0.46394584846351655,0.4502585304149728
변동성/NNG;확대/NNG;되/XSV,1,0.014534308599851498,222,107,115,205,0.6753287865515456,0.6558079682598057
엔화/NNG;강세/NNG;보였/VV,1,0.014035613049199869,58,28,30,32,0.5480567430608065,0.5327458867570957
금리하락/NNG;이끌/VV,1,0.011612756149908199,56,27,29,51,0.5418665248674254,0.5292870208524849
금리상승/NNG;않/VX,1,0.011612756149908199,56,27,29,60,0.5418665248674254,0.5292870208524849
국고채/NNG;지표금리/NNG;하락/NNG;한/XSA,1,0.011289964137067399,110,53,57,110,0.6328678828603732,0.6185749461217038
성장세/NNG;하/XSV,1,0.010979739888407503,83,40,43,62,0.5970384282784708,0.5839168195634911
스왑베이시스/NNG;축소/NNG;됐/XSV,1,0.010799918877713255,27,13,14,18,0.4552835646855883,0.44543757247227633
달러화/NNG;강세/NNG;나타내/VV,1,0.010799918877713255,27,13,14,40,0.4552835646855883,0.44543757247227633
금리/NNG;인상/NNG;할/XSV;없/VA,1,0.010799918877713255,27,13,14,18,0.4552835646855883,0.44543757247227633
채권수익률/NNG;상승/NNG;하/XSV,1,0.010799918877713255,27,13,14,19,0.4552835646855883,0.44543757247227633
소득/NNG;줄어들/VV,1,0.010799918877713255,27,13,14,12,0.4552835646855883,0.44543757247227633
cd금리/NNG;하락/NNG;한/XSA,1,0.010799918877713255,27,13,14,11,0.4552835646855883,0.44543757247227633
채권가격/NNG;하락/NNG;했/XSV,1,0.010799918877713255,27,13,14,35,0.4552835646855883,0.44543757247227633
경기후퇴/NNG;막/VV,1,0.010799918877713255,27,13,14,13,0.4552835646855883,0.44543757247227633
금리/NNG;하락세/NNG;하/XSV,1,0.010799918877713255,27,13,14,16,0.4552835646855883,0.44543757247227633
불안정성/NNG;높/VA,1,0.010799918877713255,27,13,14,28,0.4552835646855883,0.44543757247227633
재정/NNG;집행/NNG;하/XSV,1,0.010799918877713255,27,13,14,13,0.4552835646855883,0.44543757247227633
채권가격/NNG;하락/NNG;채권/NNG;약세/NNG;한/XSA,1,0.010799918877713255,27,13,14,30,0.4552835646855883,0.44543757247227633
제로금리/NNG;유지/NNG;할/XSV,1,0.010799918877713255,27,13,14,28,0.4552835646855883,0.44543757247227633
이익/NNG;실현/NNG;매물/NNG;나와/VV;하락/NNG;했/XSV,1,0.010799918877713255,27,13,14,14,0.4552835646855883,0.44543757247227633
금리인상/NNG;가능성/NNG;낮/VA,1,0.01036841223922691,160,77,83,156,0.6634185138520665,0.6496317174556374
인플레이션압력/NNG;커지/VV,1,0.009058448031841637,54,26,28,41,0.5354947693189164,0.5257418374753831
성장/NNG;하/VV,1,0.0065585065306059676,104,50,54,65,0.6234957661652217,0.6152078666960491
달러화/NNG;엔화/NNG;높/VA;진/VX,1,0.006360486003055943,52,25,27,31,0.5289364102009761,0.52211215228511
기준금리인하/NNG;가능성/NNG;높/VA,1,0.006360486003055943,52,25,27,37,0.5289364102009761,0.52211215228511
엔화/NNG;약세/NNG;따른/VV,1,0.006360486003055943,52,25,27,67,0.5289364102009761,0.52211215228511
금리/NNG;인상/NNG;하/XSV,1,0.006344233871448113,700,336,364,510,0.670970302167535,0.6623350687378656
이익/NNG;증가/NNG;하/XSV,1,0.006274348837024268,25,12,13,25,0.44632314607654644,0.44064064248361207
달러화/NNG;약세/NNG;보인/VV,1,0.006274348837024268,25,12,13,26,0.44632314607654644,0.44064064248361207
스왑베이시스/NNG;역전폭/NNG;확대/NNG;됐/XSV,1,0.006274348837024268,25,12,13,27,0.44632314607654644,0.44064064248361207
금리/NNG;높/VA;회사채/NNG,1,0.006274348837024268,25,12,13,30,0.44632314607654644,0.44064064248361207
국고채/NNG;수익률/NNG;내린/VV,1,0.006274348837024268,25,12,13,17,0.44632314607654644,0.44064064248361207
인플레이션/NNG;낮/VA;질/VX,1,0.006274348837024268,25,12,13,8,0.44632314607654644,0.44064064248361207
안전자산선호/NNG;강해/VV,1,0.006274348837024268,25,12,13,20,0.44632314607654644,0.44064064248361207
환율하락/NNG;막/VV,1,0.006274348837024268,25,12,13,20,0.44632314607654644,0.44064064248361207
경제활동/NNG;위축/NNG;되/XSV,1,0.006274348837024268,25,12,13,9,0.44632314607654644,0.44064064248361207
금리인하/NNG;결정/NNG;하/XSV,1,0.006274348837024268,25,12,13,12,0.44632314607654644,0.44064064248361207
물가상승률/NNG;감안/NNG;하/XSV,1,0.006274348837024268,25,12,13,11,0.44632314607654644,0.44064064248361207
기준금리인하/NNG;나설/VV,1,0.006274348837024268,25,12,13,26,0.44632314607654644,0.44064064248361207
경제지표/NNG;호조/NNG;보여/VV,1,0.006274348837024268,25,12,13,17,0.44632314607654644,0.44064064248361207
외환시장/NNG;현물환/NNG;하락/NNG;했/XSV,1,0.006274348837024268,25,12,13,29,0.44632314607654644,0.44064064248361207
자산가격/NNG;상승/NNG;하/XSV,1,0.006274348837024268,25,12,13,17,0.44632314607654644,0.44064064248361207
경제/NNG;둔화/NNG;되/XSV,1,0.005296775453433877,127,61,66,50,0.6437009543721627,0.6367489555589552
침체/NNG;되/XSV,1,0.004977158575173002,77,37,40,68,0.5831573028360548,0.577227970212633
경쟁력/NNG;높이/VV,1,0.0035048015003518174,50,24,26,52,0.5221857865875099,0.5184003690172446
금리인상/NNG;시사/NNG;했/XSV,1,0.0035048015003518174,50,24,26,55,0.5221857865875099,0.5184003690172446
경제성장률/NNG;둔화/NNG;되/XSV,1,0.0035048015003518174,50,24,26,40,0.5221857865875099,0.5184003690172446
적자/NNG;했/XSV,1,0.0035048015003518174,50,24,26,57,0.5221857865875099,0.5184003690172446
성장/NNG;할/VV,1,0.002808867459960007,75,36,39,28,0.578231051371594,0.5748387217916282
기준금리/NNG;인상/NNG;했으나/XSV,1,0.0011459822459192193,23,11,12,20,0.4370201548109949,0.4359032567198218
기대/NNG;인플레이션/NNG;높/VA;수준/NNG,1,0.0011459822459192193,23,11,12,17,0.4370201548109949,0.4359032567198218
경쟁력/NNG;확보/NNG;할/XSV,1,0.0011459822459192193,23,11,12,12,0.4370201548109949,0.4359032567198218
재고/NNG;증가/NNG;한/XSA,1,0.0011459822459192193,23,11,12,23,0.4370201548109949,0.4359032567198218
원달러/NNG;급등/NNG;하/XSV,1,0.0011459822459192193,23,11,12,21,0.4370201548109949,0.4359032567198218
성장/NNG;된다/XSV,1,0.0011459822459192193,23,11,12,15,0.4370201548109949,0.4359032567198218
금리/NNG;하락세/NNG;이어질/VV,1,0.0011459822459192193,23,11,12,37,0.4370201548109949,0.4359032567198218
금리동결/NNG;될/XSV,1,0.0011459822459192193,23,11,12,13,0.4370201548109949,0.4359032567198218
달러약세/NNG;진행/NNG;되/XSV,1,0.0011459822459192193,23,11,12,15,0.4370201548109949,0.4359032567198218
인플레이션/NNG;하락/NNG;하/XSV,1,0.0011459822459192193,23,11,12,12,0.4370201548109949,0.4359032567198218
경기/NNG;부양책/NNG;따른/VV,1,0.0011459822459192193,23,11,12,23,0.4370201548109949,0.4359032567198218
유로엔/NNG;오른/VV,1,0.0011459822459192193,23,11,12,6,0.4370201548109949,0.4359032567198218
금리인상/NNG;높/VA,1,0.0011459822459192193,23,11,12,15,0.4370201548109949,0.4359032567198218
수익성/NNG;악화/NNG;하/XSV,1,0.0011459822459192193,23,11,12,14,0.4370201548109949,0.4359032567198218
안전자산선호/NNG;높/VA,1,0.0011459822459192193,23,11,12,17,0.4370201548109949,0.4359032567198218
금리인하/NNG;기정사실화/NNG;하/XSV,1,0.0011459822459192193,23,11,12,17,0.4370201548109949,0.4359032567198218
수요/NNG;증가/NNG;해/XSV,1,0.0011459822459192193,23,11,12,15,0.4370201548109949,0.4359032567198218
연방기금/NNG;금리선물/NNG;기준금리/NNG;인하/NNG;될/XSV,1,0.0011459822459192193,23,11,12,9,0.4370201548109949,0.4359032567198218
높/VA;변동성/NNG;보일/VV,1,0.0011459822459192193,23,11,12,18,0.4370201548109949,0.4359032567198218
수요/NNG;줄어드/VV,1,0.0011459822459192193,23,11,12,19,0.4370201548109949,0.4359032567198218
금리/NNG;끌어올렸/VV,1,0.0011459822459192193,23,11,12,9,0.4370201548109949,0.4359032567198218
원화/NNG;절상/NNG;되/XSV,1,0.00047506536133723465,48,23,25,18,0.5152364761393747,0.5146095808240101
침체/NNG;벗어나/VV,1,0.00047506536133723465,48,23,25,36,0.5152364761393747,0.5146095808240101
달러강세/NNG;될/XSV,1,0.00047506536133723465,48,23,25,48,0.5152364761393747,0.5146095808240101
수익성/NNG;악화/NNG;되/XSV,-1,-0.0027478125784216045,46,22,24,67,0.5080810780305356,0.5107436927751714
고용/NNG;개선/NNG;되/XSV,-1,-0.0027478125784216045,46,22,24,37,0.5080810780305356,0.5107436927751714
경제지표/NNG;개선/NNG;되/XSV,-1,-0.0040203729449731496,115,55,60,131,0.628121422152639,0.6330218322496403
국고채/NNG;지표금리/NNG;내린/VV,-1,-0.004274750573671771,69,33,36,94,0.5625028060390498,0.5671797011977783
기준금리/NNG;낮추/VV,-1,-0.004479060031370996,92,44,48,71,0.6015954767902646,0.6068452714571562
경기회복/NNG;찬물/NNG;끼얹/VV,-1,-0.004749660601441774,21,10,11,11,0.42731051966440015,0.4312727186061842
물가상승/NNG;하/XSV,-1,-0.004749660601441774,21,10,11,16,0.42731051966440015,0.4312727186061842
장기물/NNG;하락/NNG;하/XSV,-1,-0.004749660601441774,21,10,11,28,0.42731051966440015,0.4312727186061842
경기회복세/NNG;유지/NNG;되/XSV,-1,-0.004749660601441774,21,10,11,12,0.42731051966440015,0.4312727186061842
시중금리/NNG;상승/NNG;할/XSV,-1,-0.004749660601441774,21,10,11,19,0.42731051966440015,0.4312727186061842
금리/NNG;상승세/NNG;될/XSV,-1,-0.004749660601441774,21,10,11,20,0.42731051966440015,0.4312727186061842
침체/NNG;이어질/VV,-1,-0.004749660601441774,21,10,11,14,0.42731051966440015,0.4312727186061842
안전자산선호/NNG;강화/NNG;된/XSV,-1,-0.004749660601441774,21,10,11,16,0.42731051966440015,0.4312727186061842
소비/NNG;부진/NNG;하/XSV,-1,-0.004749660601441774,21,10,11,16,0.42731051966440015,0.4312727186061842
높/VA;수익률/NNG;제공/NNG;하/XSV,-1,-0.004749660601441774,21,10,11,12,0.42731051966440015,0.4312727186061842
성장/NNG;힘입/VV,-1,-0.004749660601441774,21,10,11,16,0.42731051966440015,0.4312727186061842
고용개선/NNG;따른/VV,-1,-0.004749660601441774,21,10,11,13,0.42731051966440015,0.4312727186061842
금리인상/NNG;속도/NNG;않/VX,-1,-0.004749660601441774,21,10,11,21,0.42731051966440015,0.4312727186061842
금리인상/NNG;기대/NNG;하/XSV,-1,-0.004749660601441774,21,10,11,22,0.42731051966440015,0.4312727186061842
성장/NNG;친화적/VAX,-1,-0.004749660601441774,21,10,11,16,0.42731051966440015,0.4312727186061842
하방위험/NNG;있/VA,-1,-0.004749660601441774,21,10,11,18,0.42731051966440015,0.4312727186061842
수요/NNG;유지/NNG;될/XSV,-1,-0.004749660601441774,21,10,11,15,0.42731051966440015,0.4312727186061842
낮/VA;금리/NNG;받/VV,-1,-0.004749660601441774,21,10,11,33,0.42731051966440015,0.4312727186061842
침체/NNG;빠지/VV,-1,-0.004749660601441774,21,10,11,21,0.42731051966440015,0.4312727186061842
지급준비금적수/NNG;증가/NNG;했/XSV,-1,-0.009547546433233745,65,31,34,91,0.5511853306729505,0.5616589819370452
금리인상/NNG;된/XSV,-1,-0.009867192951687143,42,20,22,51,0.4931157224567756,0.5028072269192867
경제/NNG;둔화/NNG;하/XSV,-1,-0.009867192951687143,42,20,22,29,0.4931157224567756,0.5028072269192867
금리상승/NNG;해/XSV,-1,-0.009867192951687143,42,20,22,30,0.4931157224567756,0.5028072269192867
금리인상/NNG;할/XSV,-1,-0.01126960501806007,107,51,56,80,0.6157345014142652,0.6295991396816207
경기회복세/NNG;따른/VV,-1,-0.011647494351566312,19,9,10,14,0.41709902461416754,0.42681336381499657
달러원/NNG;상승/NNG;따른/VV,-1,-0.011647494351566312,19,9,10,12,0.41709902461416754,0.42681336381499657
기준금리인상/NNG;하/VV,-1,-0.011647494351566312,19,9,10,13,0.41709902461416754,0.42681336381499657
유로달러/NNG;시장/NNG;하락/NNG;한/XSA,-1,-0.011647494351566312,19,9,10,17,0.41709902461416754,0.42681336381499657
기준금리동결/NNG;점쳤/VV,-1,-0.011647494351566312,19,9,10,7,0.41709902461416754,0.42681336381499657
금리/NNG;낮/VA;엔화/NNG,-1,-0.011647494351566312,19,9,10,11,0.41709902461416754,0.42681336381499657
경기/NNG;위축/NNG;시킬/XSV,-1,-0.011647494351566312,19,9,10,4,0.41709902461416754,0.42681336381499657
투자/NNG;증가/NNG;했/XSV,-1,-0.011647494351566312,19,9,10,12,0.41709902461416754,0.42681336381499657
경제/NNG;위축/NNG;되/XSV,-1,-0.011647494351566312,19,9,10,22,0.41709902461416754,0.42681336381499657
대출/NNG;증가/NNG;한/XSA,-1,-0.011647494351566312,19,9,10,17,0.41709902461416754,0.42681336381499657
금리하락/NNG;나타나/VV,-1,-0.011647494351566312,19,9,10,4,0.41709902461416754,0.42681336381499657
손실/NNG;내/VV,-1,-0.011647494351566312,19,9,10,14,0.41709902461416754,0.42681336381499657
신용등급/NNG;상향/NNG;되/XSV,-1,-0.011647494351566312,19,9,10,17,0.41709902461416754,0.42681336381499657
금리인상/NNG;연속적/VAX,-1,-0.011647494351566312,19,9,10,3,0.41709902461416754,0.42681336381499657
투자매력/NNG;높/VA;지/VX,-1,-0.011647494351566312,19,9,10,12,0.41709902461416754,0.42681336381499657
높/VA;수익률/NNG;얻/VV,-1,-0.011647494351566312,19,9,10,11,0.41709902461416754,0.42681336381499657
성장/NNG;시키/XSV,-1,-0.011647494351566312,19,9,10,12,0.41709902461416754,0.42681336381499657
금리인상/NNG;뒷받침/NNG;하/XSV,-1,-0.011647494351566312,19,9,10,8,0.41709902461416754,0.42681336381499657
경제/NNG;개선/NNG;될/XSV,-1,-0.011647494351566312,19,9,10,20,0.41709902461416754,0.42681336381499657
금리인상/NNG;우호적/VAX,-1,-0.011647494351566312,19,9,10,14,0.41709902461416754,0.42681336381499657
경제회복/NNG;위한/VV,-1,-0.011647494351566312,19,9,10,14,0.41709902461416754,0.42681336381499657
기준금리인하/NNG;단행/NNG;하/XSV,-1,-0.011647494351566312,19,9,10,22,0.41709902461416754,0.42681336381499657
디플레이션/NNG;우려/NNG;높/VA,-1,-0.011647494351566312,19,9,10,15,0.41709902461416754,0.42681336381499657
수요/NNG;줄이/VV,-1,-0.011647494351566312,19,9,10,20,0.41709902461416754,0.42681336381499657
성장세/NNG;확대/NNG;되/XSV,-1,-0.011647494351566312,19,9,10,21,0.41709902461416754,0.42681336381499657
경기회복세/NNG;지원/NNG;하/XSV,-1,-0.011647494351566312,19,9,10,17,0.41709902461416754,0.42681336381499657
회사채/NNG;신용스프레드/NNG;축소/NNG;된/XSV,-1,-0.011647494351566312,19,9,10,30,0.41709902461416754,0.42681336381499657
금가격/NNG;올랐/VV,-1,-0.011647494351566312,19,9,10,11,0.41709902461416754,0.42681336381499657
유가상승/NNG;인한/VV,-1,-0.013822460290463301,40,19,21,19,0.48528301298418025,0.4987500433973868
인플레이션/NNG;낮/VA;수준/NNG,-1,-0.015339456083684921,61,29,32,55,0.5391596666799342,0.5558055441257661
달러엔/NNG;하락/NNG;한/XSA,-1,-0.015339456083684921,61,29,32,32,0.5391596666799342,0.5558055441257661
국제/NNG;유가/NNG;상승/NNG;하/XSV,-1,-0.015339456083684921,61,29,32,54,0.5391596666799342,0.5558055441257661
금리/NNG;상승/NNG;한/XSA,-1,-0.016083558037127466,356,169,187,335,0.655951831689428,0.677210613719738
금리/NNG;끌어올릴/VV,-1,-0.018090929628092667,38,18,20,21,0.4771975271679572,0.49464506121011653
금리인상/NNG;가능성/NNG;강하/VA,-1,-0.018090929628092667,38,18,20,23,0.4771975271679572,0.49464506121011653
채권가격/NNG;상승/NNG;했/XSV,-1,-0.018090929628092667,38,18,20,35,0.4771975271679572,0.49464506121011653
부도위험/NNG;높/VA,-1,-0.01989572771187842,17,8,9,17,0.40623887589979146,0.4226148987776287
경기회복/NNG;될/VV,-1,-0.01989572771187842,17,8,9,7,0.40623887589979146,0.4226148987776287
부진/NNG;완화/NNG;되/XSV,-1,-0.01989572771187842,17,8,9,15,0.40623887589979146,0.4226148987776287
미국채수익률/NNG;하락/NNG;했/XSV,-1,-0.01989572771187842,17,8,9,11,0.40623887589979146,0.4226148987776287
금리/NNG;인하/NNG;할/XSV;없/VA,-1,-0.01989572771187842,17,8,9,8,0.40623887589979146,0.4226148987776287
매수/NNG;심리/NNG;위축/NNG;될/XSV,-1,-0.01989572771187842,17,8,9,16,0.40623887589979146,0.4226148987776287
금리인하/NNG;중단/NNG;될/XSV,-1,-0.01989572771187842,17,8,9,4,0.40623887589979146,0.4226148987776287
기준금리인하/NNG;인해/VV,-1,-0.01989572771187842,17,8,9,14,0.40623887589979146,0.4226148987776287
경기지표/NNG;부진/NNG;하/XSV,-1,-0.01989572771187842,17,8,9,16,0.40623887589979146,0.4226148987776287
채권/NNG;시장/NNG;국채가격/NNG;하락/NNG;한/XSA,-1,-0.01989572771187842,17,8,9,8,0.40623887589979146,0.4226148987776287
고용자수/NNG;늘어나/VV,-1,-0.01989572771187842,17,8,9,18,0.40623887589979146,0.4226148987776287
지급준비율/NNG;인상/NNG;이/VV,-1,-0.01989572771187842,17,8,9,4,0.40623887589979146,0.4226148987776287
완화적/VAX;통화정책/NNG;유지/NNG;할/XSV,-1,-0.01989572771187842,17,8,9,11,0.40623887589979146,0.4226148987776287
경제/NNG;성장세/NNG;둔화/NNG;되/XSV,-1,-0.01989572771187842,17,8,9,4,0.40623887589979146,0.4226148987776287
기준금리인상/NNG;주장/NNG;하/XSV,-1,-0.01989572771187842,17,8,9,11,0.40623887589979146,0.4226148987776287
달러원/NNG;넘어서/VV,-1,-0.01989572771187842,17,8,9,10,0.40623887589979146,0.4226148987776287
금리인상/NNG;더불/VV,-1,-0.01989572771187842,17,8,9,25,0.40623887589979146,0.4226148987776287
장기물/NNG;상승/NNG;했/XSV,-1,-0.01989572771187842,17,8,9,14,0.40623887589979146,0.4226148987776287
금리/NNG;동결/NNG;한다면/XSV,-1,-0.01989572771187842,17,8,9,12,0.40623887589979146,0.4226148987776287
수요/NNG;높/VA;지/VX,-1,-0.01989572771187842,17,8,9,24,0.40623887589979146,0.4226148987776287
유로화/NNG;낙폭/NNG;확대/NNG;했/XSV,-1,-0.01989572771187842,17,8,9,3,0.40623887589979146,0.4226148987776287
기준금리/NNG;유지/NNG;되/XSV,-1,-0.01989572771187842,17,8,9,10,0.40623887589979146,0.4226148987776287
생산자물가/NNG;상승/NNG;하/XSV,-1,-0.01989572771187842,17,8,9,15,0.40623887589979146,0.4226148987776287
하방위험/NNG;확대/NNG;되/XSV,-1,-0.01989572771187842,17,8,9,17,0.40623887589979146,0.4226148987776287
유가/NNG;급등/NNG;할/XSV,-1,-0.01989572771187842,17,8,9,11,0.40623887589979146,0.4226148987776287
단기물/NNG;강세/NNG;보이/VV,-1,-0.01989572771187842,17,8,9,8,0.40623887589979146,0.4226148987776287
가산금리/NNG;낮추/VV,-1,-0.01989572771187842,17,8,9,14,0.40623887589979146,0.4226148987776287
내수부양/NNG;위해/VV,-1,-0.01989572771187842,17,8,9,15,0.40623887589979146,0.4226148987776287
높/VA;수익/NNG;낼/VV,-1,-0.01989572771187842,17,8,9,15,0.40623887589979146,0.4226148987776287
국채수익률/NNG;하락/NNG;했/XSV,-1,-0.01989572771187842,17,8,9,21,0.40623887589979146,0.4226148987776287
양적완화/NNG;인/VCP,-1,-0.01989572771187842,17,8,9,12,0.40623887589979146,0.4226148987776287
채권/NNG;시장/NNG;안정/NNG;되찾/VV,-1,-0.01989572771187842,17,8,9,4,0.40623887589979146,0.4226148987776287
기준금리인하/NNG;어렵/VA,-1,-0.01989572771187842,17,8,9,18,0.40623887589979146,0.4226148987776287
금리/NNG;하락세/NNG;보였/VV,-1,-0.022720111067578097,36,17,19,34,0.468840234626021,0.49050333874099944
성장/NNG;보일/VV,-1,-0.022720111067578097,36,17,19,22,0.468840234626021,0.49050333874099944
금리/NNG;안정/NNG;될/XSV,-1,-0.022720111067578097,36,17,19,18,0.468840234626021,0.49050333874099944
cd금리/NNG;오른/VV,-1,-0.022720111067578097,36,17,19,16,0.468840234626021,0.49050333874099944
금리/NNG;상승/NNG;하/XSV,-1,-0.023415770646918688,685,324,361,546,0.6509726050647859,0.6819997702600337
물가상승/NNG;따른/VV,-1,-0.02351060592829657,76,36,40,59,0.5648142109866918,0.5918471083297707
투자심리/NNG;위축/NNG;시키/XSV,-1,-0.02351060592829657,76,36,40,49,0.5648142109866918,0.5918471083297707
지표물/NNG;인/VCP;국고채/NNG;금리/NNG;오른/VV,-1,-0.02351060592829657,76,36,40,64,0.5648142109866918,0.5918471083297707
초저금리/NNG;유지/NNG;하/XSV,-1,-0.023946763893874512,114,54,60,133,0.6145671377828125,0.6445434738635505
장단기금리차/NNG;축소/NNG;되/XSV,-1,-0.024087808648415754,95,45,50,80,0.5936794679804315,0.6228127043472014
채권/NNG;시장/NNG;우호적/VAX;이/VCP,-1,-0.025198721396868518,55,26,29,49,0.5196967076843936,0.5464125753685468
유로화/NNG;달러화/NNG;움직여/VV;인/VCP;낮/VA;졌/VX,-1,-0.025198721396868518,55,26,29,26,0.5196967076843936,0.5464125753685468
금리/NNG;올렸/VV,-1,-0.026110276934249277,218,103,115,160,0.6479415420289139,0.6824937020708254
국고채/NNG;수익률/NNG;상승/NNG;한/XSA,-1,-0.026340782384702277,74,35,39,52,0.5595248040198579,0.5896339372840971
경기부양/NNG;나서/VV,-1,-0.026340782384702277,74,35,39,51,0.5595248040198579,0.5896339372840971
수요/NNG;늘어난/VV,-1,-0.026340782384702277,74,35,39,55,0.5595248040198579,0.5896339372840971
경상수지흑자/NNG;되/XSV,-1,-0.027768885821993106,34,16,18,45,0.46018704946929506,0.4863384126027966
달러원/NNG;하락/NNG;했/XSV,-1,-0.027768885821993106,34,16,18,30,0.46018704946929506,0.4863384126027966
인플레이션/NNG;높/VA;수준/NNG,-1,-0.027768885821993106,34,16,18,18,0.46018704946929506,0.4863384126027966
기준금리/NNG;낮춘/VV,-1,-0.027768885821993106,34,16,18,25,0.46018704946929506,0.4863384126027966
미국채수익률/NNG;하락/NNG;하/XSV,-1,-0.027768885821993106,34,16,18,18,0.46018704946929506,0.4863384126027966
실업률/NNG;오르/VV,-1,-0.030034845803276533,15,7,8,9,0.39449316693527364,0.4188061356322302
외환보유액/NNG;줄어들/VV,-1,-0.030034845803276533,15,7,8,13,0.39449316693527364,0.4188061356322302
물가상승/NNG;인한/VV,-1,-0.030034845803276533,15,7,8,16,0.39449316693527364,0.4188061356322302
외국인/NNG;자금/NNG;빠져/VV,-1,-0.030034845803276533,15,7,8,8,0.39449316693527364,0.4188061356322302
조달비용/NNG;낮추/VV,-1,-0.030034845803276533,15,7,8,9,0.39449316693527364,0.4188061356322302
국채금리/NNG;상승/NNG;따른/VV,-1,-0.030034845803276533,15,7,8,12,0.39449316693527364,0.4188061356322302
경기둔화/NNG;진행/NNG;되/XSV,-1,-0.030034845803276533,15,7,8,5,0.39449316693527364,0.4188061356322302
경기하강/NNG;따른/VV,-1,-0.030034845803276533,15,7,8,5,0.39449316693527364,0.4188061356322302
순이익/NNG;줄/VV,-1,-0.030034845803276533,15,7,8,33,0.39449316693527364,0.4188061356322302
손실/NNG;확대/NNG;될/XSV,-1,-0.030034845803276533,15,7,8,8,0.39449316693527364,0.4188061356322302
수요/NNG;줄일/VV,-1,-0.030034845803276533,15,7,8,6,0.39449316693527364,0.4188061356322302
미국채가격/NNG;상승/NNG;했/XSV,-1,-0.030034845803276533,15,7,8,23,0.39449316693527364,0.4188061356322302
부양책/NNG;나오/VV,-1,-0.030034845803276533,15,7,8,10,0.39449316693527364,0.4188061356322302
잠재/NNG;성장률/NNG;하락/NNG;하/XSV,-1,-0.030034845803276533,15,7,8,19,0.39449316693527364,0.4188061356322302
부동산경기/NNG;침체/NNG;되/XSV,-1,-0.030034845803276533,15,7,8,7,0.39449316693527364,0.4188061356322302
경기회복/NNG;해/XSV,-1,-0.030034845803276533,15,7,8,3,0.39449316693527364,0.4188061356322302
경기지표/NNG;호전/NNG;되/XSV,-1,-0.030034845803276533,15,7,8,8,0.39449316693527364,0.4188061356322302
금리/NNG;떨어뜨릴/VV,-1,-0.030034845803276533,15,7,8,5,0.39449316693527364,0.4188061356322302
장단기금리차/NNG;축소/NNG;된/XSV,-1,-0.030034845803276533,15,7,8,8,0.39449316693527364,0.4188061356322302
금리/NNG;인하/NNG;된다/XSV,-1,-0.030034845803276533,15,7,8,11,0.39449316693527364,0.4188061356322302
정제유/NNG;재고/NNG;증가/NNG;했/XSV,-1,-0.030034845803276533,15,7,8,9,0.39449316693527364,0.4188061356322302
성장/NNG;정체/NNG;되/XSV,-1,-0.030034845803276533,15,7,8,18,0.39449316693527364,0.4188061356322302
인플레이션/NNG;우려/NNG;고조/NNG;되/XSV,-1,-0.030034845803276533,15,7,8,4,0.39449316693527364,0.4188061356322302
재무/NNG;안정성/NNG;유지/NNG;할/XSV,-1,-0.030034845803276533,15,7,8,4,0.39449316693527364,0.4188061356322302
경기/NNG;반등/NNG;할/XSV,-1,-0.030034845803276533,15,7,8,12,0.39449316693527364,0.4188061356322302
인플레이션/NNG;안정/NNG;될/XSV,-1,-0.030034845803276533,15,7,8,10,0.39449316693527364,0.4188061356322302
통화완화/NNG;유지/NNG;할/XSV,-1,-0.030034845803276533,15,7,8,22,0.39449316693527364,0.4188061356322302
통화완화/NNG;이/VV,-1,-0.030034845803276533,15,7,8,18,0.39449316693527364,0.4188061356322302
경제/NNG;성장세/NNG;하/XSV,-1,-0.030034845803276533,15,7,8,12,0.39449316693527364,0.4188061356322302
추이/NNG;화면/NNG;번호/NNG;따르/VV;미국채금리/NNG;오른/VV,-1,-0.030034845803276533,15,7,8,9,0.39449316693527364,0.4188061356322302
경제/NNG;회복/NNG;시키/XSV,-1,-0.030034845803276533,15,7,8,13,0.39449316693527364,0.4188061356322302
소비/NNG;위축/NNG;시킬/XSV,-1,-0.030034845803276533,15,7,8,11,0.39449316693527364,0.4188061356322302
성장/NNG;있/VV,-1,-0.030034845803276533,15,7,8,20,0.39449316693527364,0.4188061356322302
기준금리인상/NNG;선반영/NNG;하/XSV,-1,-0.030034845803276533,15,7,8,16,0.39449316693527364,0.4188061356322302
금리인하/NNG;기대/NNG;따른/VV,-1,-0.030034845803276533,15,7,8,11,0.39449316693527364,0.4188061356322302
기준금리인상/NNG;가능성/NNG;않/VX,-1,-0.030034845803276533,15,7,8,13,0.39449316693527364,0.4188061356322302
달러약세/NNG;이끌/VV,-1,-0.030034845803276533,15,7,8,16,0.39449316693527364,0.4188061356322302
기대심리/NNG;높인/VV,-1,-0.030034845803276533,15,7,8,10,0.39449316693527364,0.4188061356322302
금리인하/NNG;가능성/NNG;않/VX,-1,-0.030034845803276533,15,7,8,5,0.39449316693527364,0.4188061356322302
가산금리/NNG;하락/NNG;했/XSV,-1,-0.030034845803276533,15,7,8,9,0.39449316693527364,0.4188061356322302
금융시장/NNG;변동성/NNG;커질/VV,-1,-0.030034845803276533,15,7,8,21,0.39449316693527364,0.4188061356322302
달러화/NNG;유로화/NNG;상승/NNG;했/XSV,-1,-0.030034845803276533,15,7,8,13,0.39449316693527364,0.4188061356322302
금리하락/NNG;한/XSA,-1,-0.030034845803276533,15,7,8,13,0.39449316693527364,0.4188061356322302
투자심리/NNG;냉각/NNG;됐/XSV,-1,-0.030034845803276533,15,7,8,8,0.39449316693527364,0.4188061356322302
달러원/NNG;하락/NNG;해/XSV,-1,-0.030034845803276533,15,7,8,6,0.39449316693527364,0.4188061356322302
금리인하/NNG;단행/NNG;했으나/XSV,-1,-0.030034845803276533,15,7,8,5,0.39449316693527364,0.4188061356322302
건전성/NNG;높이/VV,-1,-0.030034845803276533,15,7,8,18,0.39449316693527364,0.4188061356322302
건전성/NNG;유지/NNG;하/XSV,-1,-0.030034845803276533,15,7,8,10,0.39449316693527364,0.4188061356322302
기준금리/NNG;수준/NNG;동결/NNG;될/XSV,-1,-0.030034845803276533,15,7,8,5,0.39449316693527364,0.4188061356322302
물가/NNG;안정/NNG;시킬/XSV,-1,-0.030034845803276533,15,7,8,3,0.39449316693527364,0.4188061356322302
유가/NNG;오르/VV,-1,-0.031561565195226016,89,42,47,49,0.5808969537574263,0.6185854306921121
금리변동성/NNG;확대/NNG;될/XSV,-1,-0.033311223741960605,32,15,17,31,0.4512069942715741,0.4821668921201731
채권/NNG;시장/NNG;약세/NNG;보임/VV,-1,-0.033311223741960605,32,15,17,35,0.4512069942715741,0.4821668921201731
경기둔화/NNG;인해/VV,-1,-0.033311223741960605,32,15,17,22,0.4512069942715741,0.4821668921201731
불확실성/NNG;높/VA;질/VX,-1,-0.033311223741960605,32,15,17,33,0.4512069942715741,0.4821668921201731
투자/NNG;줄/VV,-1,-0.033311223741960605,32,15,17,15,0.4512069942715741,0.4821668921201731
금리/NNG;하락세/NNG;되/XSV,-1,-0.033311223741960605,32,15,17,42,0.4512069942715741,0.4821668921201731
성장/NNG;될/XSV,-1,-0.033311223741960605,32,15,17,20,0.4512069942715741,0.4821668921201731
금리인상/NNG;지지/NNG;하/XSV,-1,-0.03684202748516707,49,23,26,47,0.49835228180908286,0.5363248053357653
유가/NNG;반등/NNG;하/XSV,-1,-0.03944147917636576,30,14,16,30,0.4418595514747814,0.4780092349525328
투자심리/NNG;위축/NNG;돼/XSV,-1,-0.03944147917636576,30,14,16,14,0.4418595514747814,0.4780092349525328
금리인상/NNG;결정/NNG;할/XSV,-1,-0.03944147917636576,30,14,16,28,0.4418595514747814,0.4780092349525328
소비/NNG;줄어들/VV,-1,-0.03944147917636576,30,14,16,18,0.4418595514747814,0.4780092349525328
통화완화/NNG;유지/NNG;하/XSV,-1,-0.03944147917636576,30,14,16,17,0.4418595514747814,0.4780092349525328
금리인하/NNG;없/VA,-1,-0.039899301144208366,83,39,44,55,0.5668135421094637,0.6137485064062754
금리/NNG;인하/NNG;하/XSV;않/VX,-1,-0.03999029402733156,100,47,53,41,0.5899264096424325,0.6388916502479914
기준금리동결/NNG;되/XSV,-1,-0.04122093505670976,47,22,25,29,0.49077472222482715,0.532821805770569
국제/NNG;유가하락/NNG;따른/VV,-1,-0.04122093505670976,47,22,25,38,0.49077472222482715,0.532821805770569
금리/NNG;낮/VA;졌/VX,-1,-0.042896111007627025,81,38,43,55,0.5618110755343625,0.6119942895094351
달러강세/NNG;이끌/VV,-1,-0.04589787732810324,45,21,24,24,0.4829443017500195,0.5292561878247496
안전자산선호/NNG;약화/NNG;되/XSV,-1,-0.04589787732810324,45,21,24,41,0.4829443017500195,0.5292561878247496
채권금리/NNG;하락/NNG;한/XSA,-1,-0.046012497731918955,79,37,42,67,0.5566472663754344,0.6101670108048962
물가/NNG;상승/NNG;할/XSV,-1,-0.04620556864889647,62,29,33,44,0.5240804338215861,0.5746912764966244
투자심리/NNG;위축/NNG;될/XSV,-1,-0.04620556864889647,62,29,33,36,0.5240804338215861,0.5746912764966244
경제성장세/NNG;둔화/NNG;될/XSV,-1,-0.046282115621352204,28,13,15,13,0.43209075714423717,0.47389076958501963
달러화/NNG;거래/NNG;돼/XSV;인/VCP;높/VA;졌/VX,-1,-0.046282115621352204,28,13,15,11,0.43209075714423717,0.47389076958501963
신용등급/NNG;하향/NNG;조정/NNG;했/XSV,-1,-0.046282115621352204,28,13,15,24,0.43209075714423717,0.47389076958501963
채권/NNG;시장/NNG;국채가격/NNG;낮/VA;졌/VX,-1,-0.046282115621352204,28,13,15,39,0.43209075714423717,0.47389076958501963
기준금리인하/NNG;가능성/NNG;낮/VA,-1,-0.046282115621352204,28,13,15,32,0.43209075714423717,0.47389076958501963
채권금리/NNG;상승/NNG;할/XSV,-1,-0.049255864679621286,77,36,41,62,0.5513173687548982,0.6082655193900061
물가상승압력/NNG;낮/VA,-1,-0.05010051500002355,60,28,32,39,0.5174999877294717,0.5719224686908517
국고채/NNG;금리/NNG;떨어졌/VV,-1,-0.05010051500002355,60,28,32,31,0.5174999877294717,0.5719224686908517
구조/NNG;개선/NNG;하/XSV,-1,-0.05091073155398873,43,20,23,23,0.4748443573628915,0.5256340257340493
수요/NNG;줄어들/VV,-1,-0.053772416538161893,178,83,95,119,0.6247973052823292,0.695605792718372
매수/NNG;심리/NNG;위축/NNG;시킬/XSV,-1,-0.053995282434761815,26,12,14,14,0.4218272925005973,0.46984305637099705
금리인상/NNG;해서/XSV,-1,-0.053995282434761815,26,12,14,16,0.4218272925005973,0.46984305637099705
엔화/NNG;약세/NNG;되/XSV,-1,-0.053995282434761815,26,12,14,22,0.4218272925005973,0.46984305637099705
금리인상/NNG;기정사실화/NNG;하/XSV,-1,-0.053995282434761815,26,12,14,14,0.4218272925005973,0.46984305637099705
경제지표/NNG;양호/NNG;하/XSV,-1,-0.053995282434761815,26,12,14,33,0.4218272925005973,0.46984305637099705
국채금리/NNG;급등/NNG;한/XSA,-1,-0.053995282434761815,26,12,14,26,0.4218272925005973,0.46984305637099705
장기물/NNG;금리/NNG;하락/NNG;했/XSV,-1,-0.053995282434761815,26,12,14,12,0.4218272925005973,0.46984305637099705
불확실성/NNG;줄/VV,-1,-0.053995282434761815,26,12,14,12,0.4218272925005973,0.46984305637099705
양적완화/NNG;되/XSV,-1,-0.053995282434761815,26,12,14,25,0.4218272925005973,0.46984305637099705
연방기금/NNG;금리/NNG;인상/NNG;될/XSV,-1,-0.053995282434761815,26,12,14,16,0.4218272925005973,0.46984305637099705
변동폭/NNG;확대/NNG;되/XSV,-1,-0.053995282434761815,26,12,14,16,0.4218272925005973,0.46984305637099705
기준금리인상/NNG;단행/NNG;될/XSV,-1,-0.0542008354273682,58,27,31,43,0.5107079957496017,0.5690754053226215
금리/NNG;인하/NNG;해야/XSV,-1,-0.0542008354273682,58,27,31,39,0.5107079957496017,0.5690754053226215
물가/NNG;잡/VV,-1,-0.05548854965233985,204,95,109,149,0.6267965797511712,0.7002375128819202
성장/NNG;할/XSV,-1,-0.05579662295405918,361,168,193,274,0.6285948418867504,0.7026805339141836
순이익/NNG;증가/NNG;한/XSA,-1,-0.056156939908131864,73,34,39,67,0.5401388943674422,0.6042357754058798
수익성/NNG;악화/NNG;될/XSV,-1,-0.05630501130796928,41,19,22,18,0.4664546825632264,0.5219626543246432
채권/NNG;시장/NNG;국채가격/NNG;낮/VA;진/VX,-1,-0.05722281133152285,103,48,55,54,0.5823432039801243,0.6528427088561897
금리상승/NNG;제한적/VAX,-1,-0.05722281133152285,103,48,55,99,0.5823432039801243,0.6528427088561897
수요/NNG;증가/NNG;하/XSV,-1,-0.05728614286134959,174,81,93,154,0.6216074272452823,0.6969488696322069
양적완화축소/NNG;따른/VV,-1,-0.058525549860696136,56,26,30,93,0.5036953252166886,0.5661513359415848
변동성/NNG;확대/NNG;된/XSV,-1,-0.058525549860696136,56,26,30,42,0.5036953252166886,0.5661513359415848
경기/NNG;개선/NNG;될/XSV,-1,-0.058525549860696136,56,26,30,44,0.5036953252166886,0.5661513359415848
금리인상/NNG;늦춰질/VV,-1,-0.05983357533525657,71,33,38,74,0.5342792472815725,0.6021057464959305
금리인하/NNG;하/XSV,-1,-0.060085441749815005,101,47,54,67,0.5783102168910913,0.6520559100089396
국채선물/NNG;상승/NNG;한/XSA,-1,-0.06098120157452469,293,136,157,316,0.6249240226145981,0.7058816745268057
속도/NNG;내/VV,-1,-0.06208792283032505,114,53,61,75,0.5898684774232984,0.6677664238623561
물가/NNG;급등/NNG;하/XSV,-1,-0.06213596878277461,39,18,21,19,0.45775045410613185,0.5182508912355352
소비/NNG;늘리/VV,-1,-0.06213596878277461,39,18,21,30,0.45775045410613185,0.5182508912355352
경기둔화/NNG;불구하/VAX,-1,-0.06213596878277461,39,18,21,22,0.45775045410613185,0.5182508912355352
기준금리인상/NNG;늦/VA,-1,-0.06213596878277461,39,18,21,31,0.45775045410613185,0.5182508912355352
경기/NNG;회복/NNG;하/XSV,-1,-0.06213596878277461,39,18,21,35,0.45775045410613185,0.5182508912355352
양적완화/NNG;유지/NNG;하/XSV,-1,-0.06213596878277461,39,18,21,54,0.45775045410613185,0.5182508912355352
고용지표/NNG;개선/NNG;되/XSV,-1,-0.06213596878277461,39,18,21,45,0.45775045410613185,0.5182508912355352
국고채/NNG;금리/NNG;올랐으며/VV,-1,-0.06280071698147627,24,11,13,8,0.4109672842997412,0.4659057139508863
고용사정/NNG;개선/NNG;되/XSV,-1,-0.06280071698147627,24,11,13,12,0.4109672842997412,0.4659057139508863
엔화/NNG;강세/NNG;따른/VV,-1,-0.06280071698147627,24,11,13,14,0.4109672842997412,0.4659057139508863
금리인하/NNG;가능/NNG;하/XSA,-1,-0.06280071698147627,24,11,13,19,0.4109672842997412,0.4659057139508863
채권금리/NNG;상승압력/NNG;받/VV,-1,-0.06280071698147627,24,11,13,22,0.4109672842997412,0.4659057139508863
모기지/NNG;금리/NNG;상승/NNG;했/XSV,-1,-0.06280071698147627,24,11,13,10,0.4109672842997412,0.4659057139508863
회사채/NNG;금리/NNG;내렸/VV,-1,-0.06280071698147627,24,11,13,23,0.4109672842997412,0.4659057139508863
지급준비금적수/NNG;증가/NNG;하/XSV,-1,-0.06280071698147627,24,11,13,15,0.4109672842997412,0.4659057139508863
경기회복세/NNG;가시화/NNG;되/XSV,-1,-0.06280071698147627,24,11,13,12,0.4109672842997412,0.4659057139508863
수익/NNG;확보/NNG;하/XSV,-1,-0.06280071698147627,24,11,13,33,0.4109672842997412,0.4659057139508863
가계부채/NNG;증가/NNG;하/XSV,-1,-0.06280071698147627,24,11,13,31,0.4109672842997412,0.4659057139508863
cd/NNG;금리/NNG;하락/NNG;한/XSA,-1,-0.06280071698147627,24,11,13,12,0.4109672842997412,0.4659057139508863
경기/NNG;부양책/NNG;힘입/VV,-1,-0.06280071698147627,24,11,13,25,0.4109672842997412,0.4659057139508863
금리/NNG;반등/NNG;했/XSV,-1,-0.06280071698147627,24,11,13,39,0.4109672842997412,0.4659057139508863
금리/NNG;상승/NNG;시키/XSV,-1,-0.06280071698147627,24,11,13,12,0.4109672842997412,0.4659057139508863
금리인상/NNG;가능/NNG;하/XSV,-1,-0.06280071698147627,24,11,13,48,0.4109672842997412,0.4659057139508863
금리/NNG;올리/VV;못할/VX,-1,-0.06280071698147627,24,11,13,19,0.4109672842997412,0.4659057139508863
기준금리/NNG;동결/NNG;했으며/XSV,-1,-0.06280071698147627,24,11,13,33,0.4109672842997412,0.4659057139508863
투자심리/NNG;악화/NNG;시키/XSV,-1,-0.06280071698147627,24,11,13,10,0.4109672842997412,0.4659057139508863
기준금리/NNG;올릴/VV,-1,-0.06297222127284208,358,166,192,371,0.6235562242068007,0.7071571326694001
지급준비율/NNG;인상/NNG;하/XSV,-1,-0.06304411574538893,99,46,53,72,0.5741437217226169,0.6512138191386252
안전자산선호/NNG;따른/VV,-1,-0.06309652306361324,54,25,29,42,0.49645159848645976,0.5631519498510933
금리인상/NNG;인해/VV,-1,-0.06309652306361324,54,25,29,36,0.49645159848645976,0.5631519498510933
달러원/NNG;오르/VV,-1,-0.06309652306361324,54,25,29,52,0.49645159848645976,0.5631519498510933
변동성/NNG;커지/VV,-1,-0.06340326831083953,194,90,104,160,0.6203483223481413,0.7041281882033289
경제지표/NNG;부진/NNG;하/XSV,-1,-0.06362627198830795,84,39,45,82,0.5538646417343771,0.6289472098466847
엔화/NNG;대해선/VV;오른/VV,-1,-0.06367531601483722,69,32,37,26,0.5282312474526235,0.599897986020595
경기회복/NNG;긍정적/VAX,-1,-0.06793905123888544,52,24,28,49,0.48896489964759865,0.5600794369011695
국고채/NNG;금리/NNG;내렸/VV,-1,-0.06793905123888544,52,24,28,33,0.48896489964759865,0.5600794369011695
유로화/NNG;엔화/NNG;하락/NNG;했/XSV,-1,-0.06793905123888544,52,24,28,28,0.48896489964759865,0.5600794369011695
기준금리/NNG;내려야/VV,-1,-0.06847144145391182,37,17,20,26,0.44870076983734625,0.5145093040042226
금리인상/NNG;반영/NNG;하/XSV,-1,-0.06847144145391182,37,17,20,24,0.44870076983734625,0.5145093040042226
외환시장/NNG;현물환/NNG;내린/VV,-1,-0.06847144145391182,37,17,20,25,0.44870076983734625,0.5145093040042226
경기침체/NNG;막/VV,-1,-0.06926841436357845,95,44,51,48,0.5653947648054215,0.6493570638011247
금리/NNG;낮/VA;수준/NNG,-1,-0.07131243662145148,223,103,120,153,0.6167458018896878,0.7112491756795516
경기회복/NNG;가시화/NNG;되/XSV,-1,-0.07190499329973699,65,30,35,40,0.5155427582728732,0.5952473588402879
실적/NNG;악화/NNG;될/XSV,-1,-0.07300446157124396,22,10,12,12,0.39936549451448417,0.4621288819058968
성장/NNG;질적/VAX,-1,-0.07300446157124396,22,10,12,12,0.39936549451448417,0.4621288819058968
투자매력/NNG;높/VA;판단/NNG,-1,-0.07300446157124396,22,10,12,20,0.39936549451448417,0.4621288819058968
금리인상/NNG;고려/NNG;해야/XSV,-1,-0.07300446157124396,22,10,12,6,0.39936549451448417,0.4621288819058968
순이자마진/NNG;하락/NNG;하/XSV,-1,-0.07300446157124396,22,10,12,15,0.39936549451448417,0.4621288819058968
신용등급/NNG;떨어지/VV,-1,-0.07300446157124396,22,10,12,11,0.39936549451448417,0.4621288819058968
금리인상/NNG;포함/NNG;한/XSA,-1,-0.07300446157124396,22,10,12,16,0.39936549451448417,0.4621288819058968
달러화/NNG;약세/NNG;돌아서/VV,-1,-0.07300446157124396,22,10,12,7,0.39936549451448417,0.4621288819058968
매출액/NNG;증가/NNG;한/XSA,-1,-0.07300446157124396,22,10,12,21,0.39936549451448417,0.4621288819058968
외환시장/NNG;원달러/NNG;하락/NNG;한/XSA,-1,-0.07300446157124396,22,10,12,26,0.39936549451448417,0.4621288819058968
유로화/NNG;달러화/NNG;상승/NNG;했/XSV,-1,-0.07300446157124396,22,10,12,15,0.39936549451448417,0.4621288819058968
원화/NNG;약세/NNG;하/XSV,-1,-0.07300446157124396,22,10,12,11,0.39936549451448417,0.4621288819058968
경기선행지수/NNG;하락/NNG;했/XSV,-1,-0.07300446157124396,22,10,12,16,0.39936549451448417,0.4621288819058968
경기/NNG;둔화/NNG;할/XSV,-1,-0.07300446157124396,22,10,12,16,0.39936549451448417,0.4621288819058968
물가상승/NNG;막/VV,-1,-0.07300446157124396,22,10,12,13,0.39936549451448417,0.4621288819058968
금리인하/NNG;이뤄질/VV,-1,-0.07300446157124396,22,10,12,25,0.39936549451448417,0.4621288819058968
위안화절상/NNG;이/VCP,-1,-0.07300446157124396,22,10,12,5,0.39936549451448417,0.4621288819058968
환율변동성/NNG;확대/NNG;되/XSV,-1,-0.07300446157124396,22,10,12,16,0.39936549451448417,0.4621288819058968
금리인하/NNG;결정/NNG;한/XSA,-1,-0.07300446157124396,22,10,12,5,0.39936549451448417,0.4621288819058968
수출/NNG;호조/NNG;보이/VV,-1,-0.07445591171985211,78,36,42,60,0.5377726591272384,0.6241063186753337
금리/NNG;인하/NNG;해/XSV,-1,-0.07445591171985211,78,36,42,58,0.5377726591272384,0.6241063186753337
달러약세/NNG;인한/VV,-1,-0.07539577279752474,35,16,19,22,0.4392666271981799,0.5107505311910551
기대심리/NNG;높였/VV,-1,-0.07632237014038856,63,29,34,41,0.5088868555251072,0.5928040179970071
성장세/NNG;할/XSV,-1,-0.07632237014038856,63,29,34,32,0.5088868555251072,0.5928040179970071
수요/NNG;늘어나/VV,-1,-0.07701703105391666,228,105,123,165,0.6128761882948505,0.7149397499162999
지표금리/NNG;내린/VV,-1,-0.0783637089572573,76,35,41,72,0.5320581127586644,0.6223465447357802
신용스프레드/NNG;확대/NNG;될/XSV,-1,-0.07856175989901215,48,22,26,53,0.4732048826332169,0.5537267152931622
시중금리/NNG;오르/VV,-1,-0.07856175989901215,48,22,26,34,0.4732048826332169,0.5537267152931622
변동성/NNG;확대/NNG;됐/XSV,-1,-0.07856175989901215,48,22,26,31,0.4732048826332169,0.5537267152931622
달러원/NNG;하락/NNG;하/XSV,-1,-0.07967195029098162,115,53,62,105,0.5791167702315662,0.6791763125017573
투자/NNG;확대/NNG;되/XSV,-1,-0.08096429687540097,61,28,33,39,0.5020114980373619,0.590282047857209
금리/NNG;인상/NNG;하/XSV;않/VX,-1,-0.08118075115438006,163,75,88,93,0.6024401972852099,0.7086781765373283
기대심리/NNG;커지/VV,-1,-0.08184993469603474,198,91,107,194,0.6077440422850636,0.7158809618874005
물가상승률/NNG;목표/NNG;인/VCP,-1,-0.08243700167025003,74,34,40,59,0.526158465059707,0.6205116204315355
투자/NNG;위축/NNG;되/XSV,-1,-0.08301531594706246,33,15,18,22,0.4293980821708539,0.5069896674579266
신용위험/NNG;낮/VA,-1,-0.08301531594706246,33,15,18,38,0.4293980821708539,0.5069896674579266
채권금리/NNG;올랐/VV,-1,-0.08301531594706246,33,15,18,36,0.4293980821708539,0.5069896674579266
달러엔/NNG;상승/NNG;하/XSV,-1,-0.08301531594706246,33,15,18,21,0.4293980821708539,0.5069896674579266
금리/NNG;동결/NNG;되/XSV,-1,-0.0830981200710097,87,40,47,69,0.5461162553913488,0.6449061458921405
원자재/NNG;가격상승/NNG;따른/VV,-1,-0.08441743809035085,46,21,25,36,0.46489611288550997,0.5504540559100026
유로화/NNG;강세/NNG;보이/VV,-1,-0.08441743809035085,46,21,25,32,0.46489611288550997,0.5504540559100026
금리인상/NNG;통한/VV,-1,-0.08441743809035085,46,21,25,43,0.46489611288550997,0.5504540559100026
채권금리/NNG;떨어지/VV,-1,-0.08441743809035085,46,21,25,19,0.46489611288550997,0.5504540559100026
침체/NNG;빠진/VV,-1,-0.08441743809035085,46,21,25,11,0.46489611288550997,0.5504540559100026
경제상황/NNG;악화/NNG;되/XSV,-1,-0.08504696777497,20,9,11,11,0.38680853608846283,0.458576534270884
금리/NNG;영향/NNG;줄/VV,-1,-0.08504696777497,20,9,11,17,0.38680853608846283,0.458576534270884
가계부채/NNG;늘어난/VV,-1,-0.08504696777497,20,9,11,15,0.38680853608846283,0.458576534270884
경기회복/NNG;되/VV,-1,-0.08504696777497,20,9,11,10,0.38680853608846283,0.458576534270884
재무구조/NNG;개선/NNG;하/XSV,-1,-0.08504696777497,20,9,11,17,0.38680853608846283,0.458576534270884
금리인상/NNG;놓/VV,-1,-0.08504696777497,20,9,11,19,0.38680853608846283,0.458576534270884
성장/NNG;했으며/XSV,-1,-0.08504696777497,20,9,11,7,0.38680853608846283,0.458576534270884
높/VA;수익/NNG;얻/VV,-1,-0.08504696777497,20,9,11,31,0.38680853608846283,0.458576534270884
성장잠재력/NNG;높이/VV,-1,-0.08504696777497,20,9,11,20,0.38680853608846283,0.458576534270884
서부텍사스산원유/NNG;가격/NNG;내린/VV,-1,-0.08504696777497,20,9,11,10,0.38680853608846283,0.458576534270884
금리인상/NNG;매파적/VAX,-1,-0.08504696777497,20,9,11,17,0.38680853608846283,0.458576534270884
경기회복세/NNG;나타나/VV,-1,-0.08504696777497,20,9,11,15,0.38680853608846283,0.458576534270884
소비위축/NNG;따른/VV,-1,-0.08504696777497,20,9,11,6,0.38680853608846283,0.458576534270884
달러약세/NNG;심화/NNG;되/XSV,-1,-0.08504696777497,20,9,11,12,0.38680853608846283,0.458576534270884
물가/NNG;안정적/VAX;이/VCP,-1,-0.08504696777497,20,9,11,12,0.38680853608846283,0.458576534270884
실적/NNG;올리/VV,-1,-0.08504696777497,20,9,11,11,0.38680853608846283,0.458576534270884
금리인상기대/NNG;따른/VV,-1,-0.08504696777497,20,9,11,12,0.38680853608846283,0.458576534270884
경기둔화/NNG;이어지/VV,-1,-0.08504696777497,20,9,11,12,0.38680853608846283,0.458576534270884
금리/NNG;인상/NNG;할지/XSV,-1,-0.08504696777497,20,9,11,17,0.38680853608846283,0.458576534270884
변동성/NNG;축소/NNG;될/XSV,-1,-0.08504696777497,20,9,11,18,0.38680853608846283,0.458576534270884
신용스프레드/NNG;축소/NNG;됐/XSV,-1,-0.08504696777497,20,9,11,14,0.38680853608846283,0.458576534270884
금리상승/NNG;커지/VV,-1,-0.08504696777497,20,9,11,12,0.38680853608846283,0.458576534270884
금리인상/NNG;단행/NNG;하/XSV,-1,-0.08559265443783082,194,89,105,132,0.6046989947660308,0.717682500444745
금리상승/NNG;제한/NNG;되/XSV,-1,-0.08668732389925693,72,33,39,71,0.5200671446716585,0.6186004201364139
인플레이션/NNG;억제/NNG;하/XSV,-1,-0.08868657590046358,168,77,91,91,0.5983960881541268,0.7146428901846446
국고채/NNG;금리/NNG;내린/VV,-1,-0.08868657590046358,168,77,91,121,0.5983960881541268,0.7146428901846446
채권금리/NNG;하락/NNG;하/XSV,-1,-0.08901329427882165,133,61,72,123,0.5851579615556962,0.6992933834684645
물가/NNG;오를/VV,-1,-0.0900632235093114,96,44,52,68,0.5533096501479252,0.6626338813757254
금리인하/NNG;나설/VV,-1,-0.09054518975424264,155,71,84,128,0.5935578394651128,0.7115253924004683
금리인상/NNG;반영/NNG;한/XSA,-1,-0.09069846622383915,44,20,24,23,0.4562720355268454,0.5471235549468018
달러원/NNG;상승/NNG;할/XSV,-1,-0.09069846622383915,44,20,24,43,0.4562720355268454,0.5471235549468018
경기/NNG;위축/NNG;될/XSV,-1,-0.09069846622383915,44,20,24,21,0.4562720355268454,0.5471235549468018
엔화/NNG;강세/NNG;보이/VV,-1,-0.09080844975398383,83,38,45,80,0.5355130061932942,0.6422851527143009
금리인상/NNG;중단/NNG;될/XSV,-1,-0.09112751533620278,70,32,38,37,0.51377701989463,0.6166119155522576
금리인상/NNG;쉽/VA;않/VX,-1,-0.09112751533620278,70,32,38,63,0.51377701989463,0.6166119155522576
성장성/NNG;높/VA,-1,-0.09146632611738414,31,14,17,16,0.4190301825168395,0.5032447217937291
달러엔/NNG;오르/VV,-1,-0.09146632611738414,31,14,17,28,0.4190301825168395,0.5032447217937291
성장/NNG;둔화/NNG;하/XSV,-1,-0.09146632611738414,31,14,17,13,0.4190301825168395,0.5032447217937291
국제/NNG;유가/NNG;하락/NNG;한/XSA,-1,-0.09146632611738414,31,14,17,26,0.4190301825168395,0.5032447217937291
기대심리/NNG;커질/VV,-1,-0.09146632611738414,31,14,17,32,0.4190301825168395,0.5032447217937291
수출/NNG;둔화/NNG;될/XSV,-1,-0.09146632611738414,31,14,17,14,0.4190301825168395,0.5032447217937291
침체/NNG;이어지/VV,-1,-0.09146632611738414,31,14,17,12,0.4190301825168395,0.5032447217937291
엔화/NNG;강세/NNG;나타내/VV,-1,-0.09146632611738414,31,14,17,16,0.4190301825168395,0.5032447217937291
금리인하/NNG;단행/NNG;하/XSV,-1,-0.095592366316825,151,69,82,88,0.5886792595517949,0.7128976693863022
금리인하/NNG;통한/VV,-1,-0.0957719293605549,68,31,37,25,0.507280298535415,0.6145451884931644
달러화/NNG;상승압력/NNG;받/VV,-1,-0.09645350319993484,55,25,30,44,0.47996096525476806,0.5822494922104833
금리/NNG;급등/NNG;할/XSV,-1,-0.09645350319993484,55,25,30,44,0.47996096525476806,0.5822494922104833
인플레이션압력/NNG;높/VA;질/VX,-1,-0.09645350319993484,55,25,30,40,0.47996096525476806,0.5822494922104833
금리인상/NNG;속도/NNG;빨라질/VA,-1,-0.09645350319993484,55,25,30,63,0.47996096525476806,0.5822494922104833
금리/NNG;내려야/VV,-1,-0.09645350319993484,55,25,30,47,0.47996096525476806,0.5822494922104833
채권/NNG;시장/NNG;국채가격/NNG;오른/VV,-1,-0.0969692479501163,116,53,63,68,0.5683874013401806,0.690239369032826
수익/NNG;올렸/VV,-1,-0.09746367916474208,42,19,23,39,0.44730469954024177,0.54374113287613
금리인하/NNG;어렵/VA,-1,-0.09746367916474208,42,19,23,28,0.44730469954024177,0.54374113287613
물가상승/NNG;억제/NNG;하/XSV,-1,-0.09746367916474208,42,19,23,33,0.44730469954024177,0.54374113287613
금리/NNG;빠질/VV,-1,-0.09958796542972326,18,8,10,10,0.3729714796898745,0.4553308623784481
금리/NNG;높/VA;않/VX,-1,-0.09958796542972326,18,8,10,13,0.3729714796898745,0.4553308623784481
신규주택판매/NNG;감소/NNG;한/XSA,-1,-0.09958796542972326,18,8,10,13,0.3729714796898745,0.4553308623784481
자산매입/NNG;축소/NNG;하/XSV,-1,-0.09958796542972326,18,8,10,17,0.3729714796898745,0.4553308623784481
금리인하/NNG;기대/NNG;되/XSV,-1,-0.09958796542972326,18,8,10,10,0.3729714796898745,0.4553308623784481
경제활동/NNG;위축/NNG;될/XSV,-1,-0.09958796542972326,18,8,10,6,0.3729714796898745,0.4553308623784481
성장형/NNG;낮/VA,-1,-0.09958796542972326,18,8,10,9,0.3729714796898745,0.4553308623784481
소비/NNG;둔화/NNG;되/XSV,-1,-0.09958796542972326,18,8,10,10,0.3729714796898745,0.4553308623784481
재고/NNG;늘어나/VV,-1,-0.09958796542972326,18,8,10,14,0.3729714796898745,0.4553308623784481
자산가격/NNG;하락/NNG;하/XSV,-1,-0.09958796542972326,18,8,10,11,0.3729714796898745,0.4553308623784481
스왑베이시스/NNG;확대/NNG;된/XSV,-1,-0.09958796542972326,18,8,10,6,0.3729714796898745,0.4553308623784481
기준금리인하/NNG;기대/NNG;하/XSV,-1,-0.09958796542972326,18,8,10,20,0.3729714796898745,0.4553308623784481
유가하락/NNG;힘입/VV,-1,-0.09958796542972326,18,8,10,11,0.3729714796898745,0.4553308623784481
채권/NNG;시장/NNG;우호적/VAX;이/VCP;않/VX,-1,-0.09958796542972326,18,8,10,26,0.3729714796898745,0.4553308623784481
채권/NNG;시장/NNG;국고채/NNG;하락/NNG;한/XSA,-1,-0.09958796542972326,18,8,10,15,0.3729714796898745,0.4553308623784481
기업/NNG;실적/NNG;개선/NNG;될/XSV,-1,-0.09958796542972326,18,8,10,19,0.3729714796898745,0.4553308623784481
국채선물/NNG;하락/NNG;했/XSV,-1,-0.09958796542972326,18,8,10,11,0.3729714796898745,0.4553308623784481
채권금리/NNG;떨어졌/VV,-1,-0.09958796542972326,18,8,10,14,0.3729714796898745,0.4553308623784481
금리인상/NNG;전망/NNG;했/XSV,-1,-0.09958796542972326,18,8,10,21,0.3729714796898745,0.4553308623784481
수출비중/NNG;높/VA;기업/NNG,-1,-0.09958796542972326,18,8,10,12,0.3729714796898745,0.4553308623784481
성장/NNG;해/VV,-1,-0.09958796542972326,18,8,10,10,0.3729714796898745,0.4553308623784481
수익성/NNG;하락/NNG;하/XSV,-1,-0.09958796542972326,18,8,10,21,0.3729714796898745,0.4553308623784481
금리인상/NNG;단행/NNG;하/XSV;어려울/VA,-1,-0.09958796542972326,18,8,10,10,0.3729714796898745,0.4553308623784481
실적/NNG;상회/NNG;하/XSV,-1,-0.09958796542972326,18,8,10,9,0.3729714796898745,0.4553308623784481
기준금리/NNG;수준/NNG;인/VCP;유지/NNG;해/XSV,-1,-0.09958796542972326,18,8,10,18,0.3729714796898745,0.4553308623784481
금리인상/NNG;앞당겨/VV,-1,-0.09958796542972326,18,8,10,14,0.3729714796898745,0.4553308623784481
비농업/NNG;고용/NNG;증가/NNG;했/XSV,-1,-0.09958796542972326,18,8,10,9,0.3729714796898745,0.4553308623784481
금리인하/NNG;필요/NNG;한/XSA,-1,-0.09958796542972326,18,8,10,12,0.3729714796898745,0.4553308623784481
역외/NNG;환율/NNG;상승/NNG;한/XSA,-1,-0.09958796542972326,18,8,10,14,0.3729714796898745,0.4553308623784481
엔화/NNG;약세/NNG;인한/VV,-1,-0.09958796542972326,18,8,10,20,0.3729714796898745,0.4553308623784481
경기침체/NNG;인한/VV,-1,-0.10092655479047474,29,13,16,19,0.4080770260406528,0.4995371537731002
외환시장/NNG;현물환/NNG;오른/VV,-1,-0.10092655479047474,29,13,16,52,0.4080770260406528,0.4995371537731002
유동성/NNG;줄이/VV,-1,-0.10092655479047474,29,13,16,36,0.4080770260406528,0.4995371537731002
자산/NNG;증가/NNG;하/XSV,-1,-0.10092655479047474,29,13,16,24,0.4080770260406528,0.4995371537731002
금융시장/NNG;안정/NNG;찾/VV,-1,-0.10092655479047474,29,13,16,37,0.4080770260406528,0.4995371537731002
신용등급/NNG;전망/NNG;안정적/VAX;부정적/NNG,-1,-0.10092655479047474,29,13,16,31,0.4080770260406528,0.4995371537731002
대출/NNG;늘릴/VV,-1,-0.10092655479047474,29,13,16,21,0.4080770260406528,0.4995371537731002
금리인상/NNG;가능성/NNG;높이/VV,-1,-0.10092655479047474,29,13,16,24,0.4080770260406528,0.4995371537731002
유동성/NNG;축소/NNG;되/XSV,-1,-0.10092655479047474,29,13,16,18,0.4080770260406528,0.4995371537731002
금리인하/NNG;신중/NNG;한/XSA,-1,-0.10092655479047474,29,13,16,14,0.4080770260406528,0.4995371537731002
gdp/NNG;증가/NNG;했/XSV,-1,-0.10092655479047474,29,13,16,30,0.4080770260406528,0.4995371537731002
성장세/NNG;유지/NNG;하/XSV,-1,-0.1014103984487601,90,41,49,74,0.5385761298060622,0.6599290519631312
지표금리/NNG;상승/NNG;한/XSA,-1,-0.10222676979856915,53,24,29,86,0.47209218417365373,0.579419744417785
국채선물/NNG;내린/VV,-1,-0.10355537960986361,77,35,42,73,0.5182832060322206,0.6378222670064277
금리/NNG;떨어졌/VV,-1,-0.10394875923613633,123,56,67,102,0.568819828549862,0.7005716853622115
환율급등/NNG;따른/VV,-1,-0.10478471526243727,40,18,22,22,0.4379598295096304,0.5403137735494352
원유/NNG;재고/NNG;증가/NNG;했/XSV,-1,-0.10478471526243727,40,18,22,37,0.4379598295096304,0.5403137735494352
엔화/NNG;대해선/VV;하락/NNG;한/XSA,-1,-0.10478471526243727,40,18,22,13,0.4379598295096304,0.5403137735494352
콜금리/NNG;동결/NNG;될/XSV,-1,-0.10573996043386147,64,29,35,18,0.4936318389154634,0.6101740267593527
국고채/NNG;수익률/NNG;하락/NNG;한/XSA,-1,-0.10573996043386147,64,29,35,45,0.4936318389154634,0.6101740267593527
금리인상/NNG;하/VV;않/VX,-1,-0.10836076311754117,51,23,28,45,0.4639369667284588,0.5765164727044797
고용지표/NNG;부진/NNG;하/XSV,-1,-0.10836076311754117,51,23,28,43,0.4639369667284588,0.5765164727044797
물가/NNG;높/VA;수준/NNG,-1,-0.11110237952042357,62,28,34,27,0.48645998038442273,0.6078684312818461
원화가치/NNG;상승/NNG;하/XSV,-1,-0.11163275453157084,27,12,15,23,0.39642287840271323,0.4958924802706464
신규/NNG;실업수당청구/NNG;증가/NNG;한/XSA,-1,-0.11163275453157084,27,12,15,23,0.39642287840271323,0.4958924802706464
유가/NNG;상승/NNG;할/XSV,-1,-0.11163275453157084,27,12,15,24,0.39642287840271323,0.4958924802706464
장기금리/NNG;오르/VV,-1,-0.11163275453157084,27,12,15,30,0.39642287840271323,0.4958924802706464
기준금리/NNG;내려가/VV,-1,-0.11163275453157084,27,12,15,29,0.39642287840271323,0.4958924802706464
달러원/NNG;급등/NNG;한/XSA,-1,-0.11163275453157084,27,12,15,15,0.39642287840271323,0.4958924802706464
채권/NNG;시장/NNG;약세/NNG;보이/VV,-1,-0.11163275453157084,27,12,15,30,0.39642287840271323,0.4958924802706464
경기둔화/NNG;가시화/NNG;되/XSV,-1,-0.11163275453157084,27,12,15,21,0.39642287840271323,0.4958924802706464
유가/NNG;떨어지/VV,-1,-0.11274981839177622,38,17,21,26,0.4281948940345336,0.5368496510656584
경기/NNG;부진/NNG;할/XSV,-1,-0.11274981839177622,38,17,21,19,0.4281948940345336,0.5368496510656584
금리인상/NNG;나서/VV;않/VX,-1,-0.11274981839177622,38,17,21,29,0.4281948940345336,0.5368496510656584
금리인하/NNG;했/XSV,-1,-0.11274981839177622,38,17,21,21,0.4281948940345336,0.5368496510656584
경기회복/NNG;위한/VV,-1,-0.11296630418280951,73,33,40,62,0.5058391877953278,0.6344743583273191
금리/NNG;상승/NNG;했/XSV,-1,-0.11443845953128684,372,168,204,318,0.5866863212849172,0.7380786962505302
금리하락/NNG;하/XSV,-1,-0.1148976501392952,49,22,27,32,0.4554748124102822,0.5735418704425629
유로화/NNG;엔화/NNG;상승/NNG;했/XSV,-1,-0.1148976501392952,49,22,27,17,0.4554748124102822,0.5735418704425629
제로금리/NNG;유지/NNG;하/XSV,-1,-0.1148976501392952,49,22,27,46,0.4554748124102822,0.5735418704425629
금리/NNG;동결/NNG;할/XSV,-1,-0.11546869126170589,401,181,220,289,0.5859369141908745,0.7386762881016751
국고채/NNG;오른/VV,-1,-0.11657159682847928,126,57,69,50,0.5621388115294083,0.7102604872857324
금리/NNG;인하/NNG;할/XSV,-1,-0.11739687882410588,652,294,358,390,0.5845326186489102,0.7397916396241434
달러화/NNG;유로화/NNG;하락/NNG;했/XSV,-1,-0.11766591701081441,16,7,9,13,0.35733773572868066,0.4524977697534304
물가상승률/NNG;상승/NNG;할/XSV,-1,-0.11766591701081441,16,7,9,6,0.35733773572868066,0.4524977697534304
금리인하/NNG;시사/NNG;한/XSA,-1,-0.11766591701081441,16,7,9,10,0.35733773572868066,0.4524977697534304
금리부담/NNG;덜/VV,-1,-0.11766591701081441,16,7,9,12,0.35733773572868066,0.4524977697534304
경쟁력/NNG;유지/NNG;하/XSV,-1,-0.11766591701081441,16,7,9,8,0.35733773572868066,0.4524977697534304
금리동결/NNG;이/VV,-1,-0.11766591701081441,16,7,9,15,0.35733773572868066,0.4524977697534304
경색/NNG;완화/NNG;하/XSV,-1,-0.11766591701081441,16,7,9,6,0.35733773572868066,0.4524977697534304
기준금리인하/NNG;기대심리/NNG;커지/VV,-1,-0.11766591701081441,16,7,9,13,0.35733773572868066,0.4524977697534304
마이너스성장/NNG;할/VV,-1,-0.11766591701081441,16,7,9,2,0.35733773572868066,0.4524977697534304
회사채/NNG;신용스프레드/NNG;축소/NNG;되/XSV,-1,-0.11766591701081441,16,7,9,31,0.35733773572868066,0.4524977697534304
양적완화/NNG;실시/NNG;할/XSV,-1,-0.11766591701081441,16,7,9,12,0.35733773572868066,0.4524977697534304
경기회복세/NNG;불구하/VAX,-1,-0.11766591701081441,16,7,9,7,0.35733773572868066,0.4524977697534304
인플레이션/NNG;완화/NNG;하/XSV,-1,-0.11766591701081441,16,7,9,10,0.35733773572868066,0.4524977697534304
신용등급/NNG;상향/NNG;가능성/NNG;높/VA,-1,-0.11766591701081441,16,7,9,16,0.35733773572868066,0.4524977697534304
물가/NNG;높/VA;오름세/NNG,-1,-0.11766591701081441,16,7,9,6,0.35733773572868066,0.4524977697534304
양적완화/NNG;인해/VV,-1,-0.11766591701081441,16,7,9,23,0.35733773572868066,0.4524977697534304
경기둔화/NNG;가능성/NNG;높/VA,-1,-0.11766591701081441,16,7,9,13,0.35733773572868066,0.4524977697534304
금리/NNG;낮/VA;형성/NNG,-1,-0.11766591701081441,16,7,9,10,0.35733773572868066,0.4524977697534304
재고/NNG;감소/NNG;하/XSV,-1,-0.11766591701081441,16,7,9,10,0.35733773572868066,0.4524977697534304
신용등급/NNG;상향/NNG;조정/NNG;했/XSV,-1,-0.11766591701081441,16,7,9,8,0.35733773572868066,0.4524977697534304
금리하락/NNG;이/VCP,-1,-0.11766591701081441,16,7,9,10,0.35733773572868066,0.4524977697534304
성장세/NNG;보인/VV,-1,-0.11766591701081441,16,7,9,16,0.35733773572868066,0.4524977697534304
금리인상/NNG;점쳤/VV,-1,-0.11766591701081441,16,7,9,12,0.35733773572868066,0.4524977697534304
인플레이션/NNG;우려/NNG;강조/NNG;한/XSA,-1,-0.11766591701081441,16,7,9,3,0.35733773572868066,0.4524977697534304
물가상승률/NNG;고려/NNG;할/XSV,-1,-0.11766591701081441,16,7,9,11,0.35733773572868066,0.4524977697534304
금리인하/NNG;효과/NNG;나타나/VV,-1,-0.11766591701081441,16,7,9,2,0.35733773572868066,0.4524977697534304
경제/NNG;악화/NNG;되/XSV,-1,-0.11766591701081441,16,7,9,13,0.35733773572868066,0.4524977697534304
채권금리/NNG;오른/VV,-1,-0.11766591701081441,16,7,9,11,0.35733773572868066,0.4524977697534304
미국채수익률/NNG;상승/NNG;했/XSV,-1,-0.11766591701081441,16,7,9,11,0.35733773572868066,0.4524977697534304
외환보유액/NNG;늘어나/VV,-1,-0.11766591701081441,16,7,9,6,0.35733773572868066,0.4524977697534304
원/NNG;환율/NNG;하락/NNG;하/XSV,-1,-0.11766591701081441,16,7,9,6,0.35733773572868066,0.4524977697534304
기준금리인상/NNG;다가오/VV,-1,-0.11766591701081441,16,7,9,12,0.35733773572868066,0.4524977697534304
금리인하/NNG;기대/NNG;남/VV,-1,-0.11766591701081441,16,7,9,14,0.35733773572868066,0.4524977697534304
성장/NNG;유지/NNG;할/XSV,-1,-0.11766591701081441,16,7,9,16,0.35733773572868066,0.4524977697534304
유로화/NNG;오/VV,-1,-0.11766591701081441,16,7,9,11,0.35733773572868066,0.4524977697534304
금리/NNG;급등세/NNG;진정/NNG;될/XSV,-1,-0.11766591701081441,16,7,9,6,0.35733773572868066,0.4524977697534304
국채금리/NNG;하락/NNG;해/XSV,-1,-0.11766591701081441,16,7,9,8,0.35733773572868066,0.4524977697534304
고용/NNG;호조/NNG;보이/VV,-1,-0.11766591701081441,16,7,9,5,0.35733773572868066,0.4524977697534304
금리/NNG;하락세/NNG;이어지/VV,-1,-0.11766591701081441,16,7,9,18,0.35733773572868066,0.4524977697534304
비용/NNG;내/VV,-1,-0.11766591701081441,16,7,9,2,0.35733773572868066,0.4524977697534304
수출/NNG;증가/NNG;할/XSV,-1,-0.11766591701081441,16,7,9,17,0.35733773572868066,0.4524977697534304
외환시장/NNG;달러원/NNG;오른/VV,-1,-0.11766591701081441,16,7,9,14,0.35733773572868066,0.4524977697534304
기대심리/NNG;높/VA;짐/NNG,-1,-0.11766591701081441,16,7,9,3,0.35733773572868066,0.4524977697534304
채권/NNG;시장/NNG;우호적/VAX;인/VCP,-1,-0.11924066682985446,233,105,128,203,0.5826206344189582,0.7401339577557998
금리인상/NNG;그칠/VV,-1,-0.12146909237455106,36,16,20,31,0.41795646030392297,0.5333582577283468
장단기금리차/NNG;확대/NNG;될/XSV,-1,-0.12146909237455106,36,16,20,31,0.41795646030392297,0.5333582577283468
달러화가치/NNG;상승/NNG;하/XSV,-1,-0.12146909237455106,36,16,20,33,0.41795646030392297,0.5333582577283468
물가/NNG;오르/VV;않/VX,-1,-0.12146909237455106,36,16,20,30,0.41795646030392297,0.5333582577283468
소비자물가/NNG;상승/NNG;할/XSV,-1,-0.12188742836574051,47,21,26,39,0.44668141781921944,0.5704986105863598
달러화/NNG;하락/NNG;한/XSA,-1,-0.12270210548713312,58,26,32,47,0.4713609800764339,0.6030155403805966
채권/NNG;시장/NNG;국고채/NNG;지표금리/NNG;상승/NNG;한/XSA,-1,-0.12270210548713312,58,26,32,91,0.4713609800764339,0.6030155403805966
금리/NNG;내려/VV,-1,-0.1233160639966655,80,36,44,93,0.5106626744026969,0.6541092902919198
불안심리/NNG;해소/NNG;하/XSV,-1,-0.12390794648695258,25,11,14,10,0.383908551361257,0.49234091452056145
고용/NNG;감소/NNG;하/XSV,-1,-0.12390794648695258,25,11,14,14,0.383908551361257,0.49234091452056145
국채가격/NNG;하락압력/NNG;가했/VV,-1,-0.12390794648695258,25,11,14,15,0.383908551361257,0.49234091452056145
경기회복세/NNG;하/XSV,-1,-0.12390794648695258,25,11,14,19,0.383908551361257,0.49234091452056145
하향압력/NNG;받/VV,-1,-0.12390794648695258,25,11,14,17,0.383908551361257,0.49234091452056145
잠재/NNG;성장률/NNG;밑돌/VV,-1,-0.12390794648695258,25,11,14,15,0.383908551361257,0.49234091452056145
침체/NNG;벗어나/VV;못하/VX,-1,-0.12390794648695258,25,11,14,17,0.383908551361257,0.49234091452056145
연체율/NNG;높/VA;지/VX,-1,-0.12390794648695258,25,11,14,16,0.383908551361257,0.49234091452056145
물가상승압력/NNG;될/XSV,-1,-0.12390794648695258,25,11,14,17,0.383908551361257,0.49234091452056145
달러원/NNG;오를/VV,-1,-0.12390794648695258,25,11,14,23,0.383908551361257,0.49234091452056145
실업률/NNG;낮추/VV,-1,-0.12390794648695258,25,11,14,31,0.383908551361257,0.49234091452056145
국제금융시장/NNG;안정/NNG;되/XSV,-1,-0.12390794648695258,25,11,14,8,0.383908551361257,0.49234091452056145
금리차/NNG;줄어들/VV,-1,-0.12390794648695258,25,11,14,15,0.383908551361257,0.49234091452056145
경제성장률/NNG;전망/NNG;하향/NNG;조정/NNG;하/XSV,-1,-0.12390794648695258,25,11,14,28,0.383908551361257,0.49234091452056145
기준금리/NNG;동결/NNG;되/XSV,-1,-0.12478921466713111,189,85,104,190,0.5760171322913412,0.7400325389636386
경제/NNG;성장/NNG;할/XSV,-1,-0.1263039356437815,100,45,55,70,0.5341433011720729,0.6883504202347773
국채선물/NNG;하락/NNG;한/XSA,-1,-0.13036769717846552,355,159,196,321,0.5750485188043866,0.7472125688528944
유가/NNG;오를/VV,-1,-0.13108189925287717,34,15,19,23,0.4071765173676378,0.5298505206291511
성장/NNG;달성/NNG;하/XSV,-1,-0.13108189925287717,34,15,19,21,0.4071765173676378,0.5298505206291511
가산금리/NNG;상승/NNG;하/XSV,-1,-0.13108189925287717,34,15,19,12,0.4071765173676378,0.5298505206291511
국고채/NNG;지표금리/NNG;상승/NNG;한/XSA,-1,-0.132041294459614,87,39,48,94,0.5150167448788305,0.6714903243883481
금리/NNG;높/VA;수준/NNG,-1,-0.13377255779006147,145,65,80,78,0.5595875733268653,0.7321782982209144
유로화/NNG;하락/NNG;한/XSA,-1,-0.13449797538185726,65,29,36,35,0.47836625201336364,0.6268314575108527
경기회복/NNG;뒷받침/NNG;하/XSV,-1,-0.13566955827747385,54,24,30,41,0.4551543537461308,0.597840327658236
소비/NNG;늘어나/VV,-1,-0.13566955827747385,54,24,30,35,0.4551543537461308,0.597840327658236
엔화/NNG;하락/NNG;했/XSV,-1,-0.13566955827747385,54,24,30,44,0.4551543537461308,0.597840327658236
엔화/NNG;거래/NNG;돼/XSV;인/VCP;높/VA;졌/VX,-1,-0.13698435379754015,105,47,58,48,0.5320150420662788,0.7006703550328766
경기침체/NNG;되/XSV,-1,-0.13747731965875787,43,19,24,23,0.42797845371827964,0.5642194076404765
원자재/NNG;가격/NNG;하락/NNG;하/XSV,-1,-0.13747731965875787,43,19,24,33,0.42797845371827964,0.5642194076404765
경기부양/NNG;위한/VV,-1,-0.13799133896280036,334,149,185,293,0.569444469733774,0.7515060401331817
금리인상/NNG;한/VV,-1,-0.13820544617501185,23,10,13,15,0.3703099084555815,0.4889179290681654
경제/NNG;부담/NNG;될/VV,-1,-0.13820544617501185,23,10,13,22,0.3703099084555815,0.4889179290681654
채권스왑/NNG;스프레드/NNG;확대/NNG;되/XSV,-1,-0.13820544617501185,23,10,13,9,0.3703099084555815,0.4889179290681654
경제성장/NNG;하/XSV,-1,-0.13820544617501185,23,10,13,18,0.3703099084555815,0.4889179290681654
경제성장률/NNG;전망/NNG;하향/NNG;조정/NNG;한/XSA,-1,-0.13820544617501185,23,10,13,16,0.3703099084555815,0.4889179290681654
모기지/NNG;금리/NNG;하락/NNG;하/XSV,-1,-0.13820544617501185,23,10,13,14,0.3703099084555815,0.4889179290681654
채권/NNG;시장/NNG;부담/NNG;되/VV,-1,-0.13820544617501185,23,10,13,10,0.3703099084555815,0.4889179290681654
금리인하/NNG;우호적/VAX,-1,-0.13820544617501185,23,10,13,18,0.3703099084555815,0.4889179290681654
경기회복/NNG;더디/VA,-1,-0.13820544617501185,23,10,13,14,0.3703099084555815,0.4889179290681654
신용위험/NNG;나타내/VV,-1,-0.13820544617501185,23,10,13,9,0.3703099084555815,0.4889179290681654
가산금리/NNG;올려/VV,-1,-0.13820544617501185,23,10,13,10,0.3703099084555815,0.4889179290681654
글로벌경기/NNG;둔화/NNG;되/XSV,-1,-0.13820544617501185,23,10,13,19,0.3703099084555815,0.4889179290681654
유가/NNG;상승/NNG;한/XSA,-1,-0.13820544617501185,23,10,13,11,0.3703099084555815,0.4889179290681654
채권/NNG;시장/NNG;강세/NNG;했/XSV,-1,-0.13820544617501185,23,10,13,14,0.3703099084555815,0.4889179290681654
기준금리인상/NNG;할/XSV,-1,-0.13820544617501185,23,10,13,20,0.3703099084555815,0.4889179290681654
금리상승/NNG;확대/NNG;됐/XSV,-1,-0.13820544617501185,23,10,13,8,0.3703099084555815,0.4889179290681654
임금/NNG;상승/NNG;하/XSV,-1,-0.13820544617501185,23,10,13,27,0.3703099084555815,0.4889179290681654
물가상승률/NNG;높/VA,-1,-0.13987782839579843,258,115,143,150,0.5678721605407884,0.7523190383290248
달러화/NNG;상승/NNG;했/XSV,-1,-0.1405571976125295,63,28,35,60,0.470900501269312,0.6247156538676203
달러강세/NNG;하/XSV,-1,-0.14176749375297326,32,14,18,18,0.3957672836200008,0.5263388831972325
금리상승/NNG;확대/NNG;되/XSV,-1,-0.14176749375297326,32,14,18,33,0.3957672836200008,0.5263388831972325
환율급락/NNG;따른/VV,-1,-0.14176749375297326,32,14,18,7,0.3957672836200008,0.5263388831972325
기대심리/NNG;높/VA;진/VX,-1,-0.1427606415606255,52,23,29,47,0.44658893380162806,0.5951325938769256
경기부양/NNG;위해/VV,-1,-0.14403235485501176,443,197,246,353,0.5649971801002658,0.7548828070224664
금리인하/NNG;통해/VV,-1,-0.14566243250772382,101,45,56,57,0.5223276370329384,0.7001999406430253
금리동결/NNG;따른/VV,-1,-0.14623783841049698,41,18,23,37,0.4179907478815049,0.5609914737188749
금리인상/NNG;될/XSV,-1,-0.1463569779318793,164,73,91,103,0.5562975554724239,0.7467968209447309
기준금리/NNG;올렸/VV,-1,-0.14721431790934192,119,53,66,92,0.5364392030590375,0.7214009013807707
경제지표/NNG;부진/NNG;한/XSA,-1,-0.15126987477541654,117,52,65,109,0.5322349537729466,0.7217078443832179
경기회복/NNG;되/XSV,-1,-0.1536650896906674,59,26,33,50,0.45516103354766446,0.6202295930557369
유로달러/NNG;내린/VV,-1,-0.1536650896906674,59,26,33,47,0.45516103354766446,0.6202295930557369
채권가격/NNG;오르/VV,-1,-0.15376066486368667,30,13,17,35,0.38361374549170085,0.5228373079738725
규제/NNG;완화/NNG;되/XSV,-1,-0.15376066486368667,30,13,17,26,0.38361374549170085,0.5228373079738725
기준금리/NNG;내려갈/VV,-1,-0.15376066486368667,30,13,17,18,0.38361374549170085,0.5228373079738725
채권/NNG;시장/NNG;부담/NNG;작용/NNG;할/XSV,-1,-0.15376066486368667,30,13,17,23,0.38361374549170085,0.5228373079738725
금리/NNG;폭등/NNG;하/XSV,-1,-0.15376066486368667,30,13,17,20,0.38361374549170085,0.5228373079738725
유로화/NNG;엔화/NNG;강세/NNG;나타냈/VV,-1,-0.15518294749108397,21,9,12,9,0.35530286169225644,0.48566447529188367
소비심리/NNG;회복/NNG;되/XSV,-1,-0.15518294749108397,21,9,12,19,0.35530286169225644,0.48566447529188367
금리인상/NNG;유지/NNG;하/XSV,-1,-0.15518294749108397,21,9,12,12,0.35530286169225644,0.48566447529188367
성장/NNG;어려울/VA,-1,-0.15518294749108397,21,9,12,7,0.35530286169225644,0.48566447529188367
cd/NNG;금리/NNG;오르/VV,-1,-0.15518294749108397,21,9,12,6,0.35530286169225644,0.48566447529188367
금리인하/NNG;기대/NNG;선반영/NNG;하/XSV,-1,-0.15518294749108397,21,9,12,29,0.35530286169225644,0.48566447529188367
기준금리인하/NNG;통한/VV,-1,-0.15518294749108397,21,9,12,21,0.35530286169225644,0.48566447529188367
안정적/VAX;인/VCP;수익/NNG;추구/NNG;하/XSV,-1,-0.15518294749108397,21,9,12,16,0.35530286169225644,0.48566447529188367
경제지표부진/NNG;따른/VV,-1,-0.15518294749108397,21,9,12,17,0.35530286169225644,0.48566447529188367
미국채금리/NNG;떨어졌/VV,-1,-0.15518294749108397,21,9,12,16,0.35530286169225644,0.48566447529188367
금리인상/NNG;가능성/NNG;언급/NNG;하/XSV,-1,-0.15518294749108397,21,9,12,16,0.35530286169225644,0.48566447529188367
소비자심리지수/NNG;상승/NNG;했/XSV,-1,-0.15518294749108397,21,9,12,14,0.35530286169225644,0.48566447529188367
물가상승/NNG;이어질/VV,-1,-0.15518294749108397,21,9,12,5,0.35530286169225644,0.48566447529188367
소득/NNG;감소/NNG;하/XSV,-1,-0.15518294749108397,21,9,12,9,0.35530286169225644,0.48566447529188367
성장기여도/NNG;낮/VA,-1,-0.15518294749108397,21,9,12,9,0.35530286169225644,0.48566447529188367
금리인하/NNG;반영/NNG;하/XSV,-1,-0.15518294749108397,21,9,12,19,0.35530286169225644,0.48566447529188367
기준금리/NNG;인상/NNG;한다면/XSV,-1,-0.15518294749108397,21,9,12,22,0.35530286169225644,0.48566447529188367
달러화/NNG;강세/NNG;이/VV,-1,-0.15518294749108397,21,9,12,20,0.35530286169225644,0.48566447529188367
엔화가치/NNG;떨어지/VV,-1,-0.15518294749108397,21,9,12,18,0.35530286169225644,0.48566447529188367
대외여건/NNG;개선/NNG;되/XSV,-1,-0.15518294749108397,21,9,12,8,0.35530286169225644,0.48566447529188367
crs금리/NNG;하락/NNG;하/XSV,-1,-0.15518294749108397,21,9,12,13,0.35530286169225644,0.48566447529188367
연방기금/NNG;금리/NNG;인하/NNG;될/XSV,-1,-0.15518294749108397,21,9,12,3,0.35530286169225644,0.48566447529188367
투자심리/NNG;위축/NNG;됐/XSV,-1,-0.1554467622811193,115,51,64,92,0.5278998707551233,0.7219779477491736
cd금리/NNG;오를/VV,-1,-0.15578032909034523,39,17,22,10,0.40751154359865444,0.557710898729178
기준금리/NNG;낮춰/VV,-1,-0.15578032909034523,39,17,22,24,0.40751154359865444,0.557710898729178
경제성장/NNG;촉진/NNG;하/XSV,-1,-0.15840789307612013,48,21,27,14,0.4284110216058016,0.5894801893603393
투자심리/NNG;위축/NNG;시켰/XSV,-1,-0.159750115730251,113,50,63,77,0.523430041840279,0.7222091636680767
금리인상/NNG;어렵/VA,-1,-0.15980444459035548,95,42,53,57,0.5066137847211317,0.6990846465638533
장기금리/NNG;하락/NNG;하/XSV,-1,-0.15980444459035548,95,42,53,74,0.5066137847211317,0.6990846465638533
금리/NNG;내리/VV,-1,-0.16157689351587867,463,204,259,346,0.5520072216563073,0.7644998589054143
성장/NNG;했/XSV,-1,-0.16257885349995993,154,68,86,133,0.5420128546553302,0.7522041980597713
gdp/NNG;증가/NNG;하/XSV,-1,-0.1626267920114851,66,29,37,30,0.46313855407750665,0.6428059073368034
금리/NNG;급등/NNG;하/XSV,-1,-0.16335322646546735,243,107,136,171,0.5503376587709417,0.7649731006238023
수요/NNG;감소/NNG;하/XSV,-1,-0.16485029072390178,93,41,52,72,0.5010396282100027,0.6985941548043482
국고채/NNG;금리/NNG;급등/NNG;했/XSV,-1,-0.1662409340992358,37,16,21,17,0.3964746669464779,0.5543829849895735
엔화/NNG;약세/NNG;보였/VV,-1,-0.1662409340992358,37,16,21,33,0.3964746669464779,0.5543829849895735
변동성/NNG;커졌/VV,-1,-0.167093827450992,46,20,26,46,0.4187352449551769,0.5865374254640056
재정적자/NNG;줄이/VV,-1,-0.167093827450992,46,20,26,44,0.4187352449551769,0.5865374254640056
금리/NNG;내려온/VV,-1,-0.16737533795939452,28,12,16,12,0.37056273536756357,0.5193611206080531
cd금리/NNG;상승/NNG;한/XSA,-1,-0.16737533795939452,28,12,16,24,0.37056273536756357,0.5193611206080531
금리하락/NNG;제한/NNG;될/XSV,-1,-0.16737533795939452,28,12,16,36,0.37056273536756357,0.5193611206080531
기준금리/NNG;동결/NNG;해/XSV,-1,-0.16737533795939452,28,12,16,26,0.37056273536756357,0.5193611206080531
내수/NNG;부진/NNG;하/XSV,-1,-0.16737533795939452,28,12,16,13,0.37056273536756357,0.5193611206080531
달러약세/NNG;라는/VCP,-1,-0.16737533795939452,28,12,16,16,0.37056273536756357,0.5193611206080531
채권/NNG;시장/NNG;국채가격/NNG;떨어진/VV,-1,-0.16737533795939452,28,12,16,11,0.37056273536756357,0.5193611206080531
기준금리인상/NNG;가능성/NNG;반영/NNG;했/XSV,-1,-0.16936060209923798,64,28,36,46,0.4553854278101611,0.6408568033368528
금리/NNG;낮췄/VV,-1,-0.16936060209923798,64,28,36,54,0.4553854278101611,0.6408568033368528
금리인하/NNG;라는/VCP,-1,-0.1702460960824026,82,36,46,48,0.483717378849904,0.6819700437172231
국고채/NNG;금리/NNG;상승/NNG;한/XSA,-1,-0.17032555958772844,285,125,160,247,0.5454443412389861,0.7691217796444502
수요/NNG;늘/VV,-1,-0.1740695552104934,210,92,118,163,0.5414271254306878,0.7693697098644534
유로엔/NNG;하락/NNG;한/XSA,-1,-0.17583328914549257,19,8,11,12,0.33840438120082655,0.48262623261902315
금리인하/NNG;기대심리/NNG;유지/NNG;되/XSV,-1,-0.17583328914549257,19,8,11,29,0.33840438120082655,0.48262623261902315
채권수익률/NNG;급등/NNG;하/XSV,-1,-0.17583328914549257,19,8,11,3,0.33840438120082655,0.48262623261902315
실적/NNG;개선/NNG;됐/XSV,-1,-0.17583328914549257,19,8,11,22,0.33840438120082655,0.48262623261902315
금리인하/NNG;단행/NNG;된/XSV,-1,-0.17583328914549257,19,8,11,15,0.33840438120082655,0.48262623261902315
장기물/NNG;강세/NNG;보이/VV,-1,-0.17583328914549257,19,8,11,30,0.33840438120082655,0.48262623261902315
신용위험도/NNG;높/VA,-1,-0.17583328914549257,19,8,11,6,0.33840438120082655,0.48262623261902315
금리인하/NNG;불가피하/VAX,-1,-0.17583328914549257,19,8,11,4,0.33840438120082655,0.48262623261902315
역외/NNG;차액결제선물환/NNG;환율/NNG;반영/NNG;해/XSV;내린/VV,-1,-0.17583328914549257,19,8,11,11,0.33840438120082655,0.48262623261902315
달러화/NNG;올라서/VV,-1,-0.17583328914549257,19,8,11,9,0.33840438120082655,0.48262623261902315
물가/NNG;떨어지/VV,-1,-0.17583328914549257,19,8,11,15,0.33840438120082655,0.48262623261902315
기준금리/NNG;인하/NNG;해도/XSV,-1,-0.17583328914549257,19,8,11,9,0.33840438120082655,0.48262623261902315
투자/NNG;확대/NNG;해/XSV,-1,-0.17583328914549257,19,8,11,12,0.33840438120082655,0.48262623261902315
확장국면/NNG;하/XSV,-1,-0.17583328914549257,19,8,11,19,0.33840438120082655,0.48262623261902315
금리인상/NNG;힘들/VA,-1,-0.17583328914549257,19,8,11,20,0.33840438120082655,0.48262623261902315
수출/NNG;감소세/NNG;하/XSV,-1,-0.17583328914549257,19,8,11,21,0.33840438120082655,0.48262623261902315
경제/NNG;높/VA;성장률/NNG,-1,-0.17583328914549257,19,8,11,7,0.33840438120082655,0.48262623261902315
금리/NNG;상승세/NNG;이어지/VV,-1,-0.17583328914549257,19,8,11,9,0.33840438120082655,0.48262623261902315
디플레이션/NNG;벗어나/VV,-1,-0.17583328914549257,19,8,11,26,0.33840438120082655,0.48262623261902315
경기회복세/NNG;이어지/VV,-1,-0.17634079573952932,53,23,30,33,0.4292629714894965,0.6128485491999398
수출/NNG;부진/NNG;하/XSV,-1,-0.17634079573952932,53,23,30,36,0.4292629714894965,0.6128485491999398
국채금리/NNG;상승/NNG;했/XSV,-1,-0.17634079573952932,53,23,30,34,0.4292629714894965,0.6128485491999398
유가/NNG;하락/NNG;했/XSV,-1,-0.17644971007510168,62,27,35,41,0.4473524868419922,0.6388180844754148
소비자물가/NNG;상승/NNG;한/XSA,-1,-0.17646375050520335,44,19,25,14,0.408615348092935,0.5835184671674547
신용등급/NNG;하향/NNG;조정/NNG;하/XSV,-1,-0.17646375050520335,44,19,25,40,0.408615348092935,0.5835184671674547
기준금리인상/NNG;지연/NNG;될/XSV,-1,-0.17646375050520335,44,19,25,32,0.408615348092935,0.5835184671674547
성장세/NNG;둔화/NNG;될/XSV,-1,-0.17646375050520335,44,19,25,41,0.408615348092935,0.5835184671674547
금리/NNG;인하/NNG;한/XSA,-1,-0.1770957363271246,146,64,82,107,0.5290166614906227,0.7564422185533471
성장/NNG;낮/VA,-1,-0.1777923137959193,35,15,20,37,0.3847965902710683,0.5510133888909355
유로화/NNG;달러화/NNG;움직여/VV;인/VCP;높/VA;졌/VX,-1,-0.1777923137959193,35,15,20,37,0.3847965902710683,0.5510133888909355
금리/NNG;내릴/VV,-1,-0.17889221444196324,339,148,191,241,0.5391049641079612,0.7737322977654945
양적완화/NNG;따른/VV,-1,-0.18141908791096917,112,49,63,121,0.507783745344206,0.732595027611924
성장세/NNG;했/XSV,-1,-0.18304121651148486,26,11,15,13,0.356406628980801,0.5159265488317393
금리/NNG;높일/VV,-1,-0.18304121651148486,26,11,15,17,0.356406628980801,0.5159265488317393
회사채/NNG;수익률/NNG;내린/VV,-1,-0.18304121651148486,26,11,15,10,0.356406628980801,0.5159265488317393
엔화/NNG;올랐/VV,-1,-0.18304121651148486,26,11,15,11,0.356406628980801,0.5159265488317393
민평금리/NNG;낮/VA;수준/NNG,-1,-0.18304121651148486,26,11,15,28,0.356406628980801,0.5159265488317393
금융시장/NNG;충격/NNG;받/VV,-1,-0.18304121651148486,26,11,15,19,0.356406628980801,0.5159265488317393
금리인하/NNG;카드/NNG;꺼내/VV,-1,-0.18304121651148486,26,11,15,20,0.356406628980801,0.5159265488317393
투자심리/NNG;악화/NNG;됐/XSV,-1,-0.18304121651148486,26,11,15,18,0.356406628980801,0.5159265488317393
기대심리/NNG;확대/NNG;되/XSV,-1,-0.18304121651148486,26,11,15,27,0.356406628980801,0.5159265488317393
고용지표/NNG;부진/NNG;할/XSV,-1,-0.18304121651148486,26,11,15,10,0.356406628980801,0.5159265488317393
경기회복/NNG;기대/NNG;하/XSV,-1,-0.18304121651148486,26,11,15,9,0.356406628980801,0.5159265488317393
달러화/NNG;강세/NNG;보였/VV,-1,-0.18311866982928637,69,30,39,53,0.4557474187946758,0.6598358517236433
불안심리/NNG;확산/NNG;되/XSV,-1,-0.18392869738672912,60,26,34,55,0.4390225559809599,0.6366876346861273
금리동결/NNG;가능성/NNG;높/VA,-1,-0.18392869738672912,60,26,34,35,0.4390225559809599,0.6366876346861273
유로달러/NNG;하락/NNG;한/XSA,-1,-0.18393734415244112,119,52,67,105,0.5109927391932543,0.7410748621036244
수요/NNG;늘어날/VV,-1,-0.184930235463462,142,62,80,121,0.521937922959083,0.7585054856285138
금리인상/NNG;어려울/VA,-1,-0.18522133509010863,94,41,53,80,0.48867297261050885,0.710591371336171
금리/NNG;올라/VV,-1,-0.186165405439646,149,65,84,94,0.5234641845730116,0.762671690668529
달러화/NNG;오르/VV,-1,-0.18662218228552996,42,18,24,65,0.39800102437234464,0.580424523840901
부채/NNG;줄이/VV,-1,-0.18662218228552996,42,18,24,50,0.39800102437234464,0.580424523840901
불확실성/NNG;높/VA;졌/VX,-1,-0.18662218228552996,42,18,24,50,0.39800102437234464,0.580424523840901
물가/NNG;오르/VV,-1,-0.18941487544514213,177,77,100,149,0.5271715723903929,0.7732633024157517
금리/NNG;낮추/VV,-1,-0.18966407209934855,311,135,176,264,0.5310355033692995,0.7793336401473548
기준금리인상/NNG;빨라질/VA,-1,-0.19065687758200822,33,14,19,18,0.3723706085175109,0.5476078775349605
달러엔/NNG;하락/NNG;했/XSV,-1,-0.19065687758200822,33,14,19,21,0.3723706085175109,0.5476078775349605
금리/NNG;높/VA;질/VX,-1,-0.19065687758200822,33,14,19,27,0.3723706085175109,0.5476078775349605
물가상승압력/NNG;커지/VV,-1,-0.19065687758200822,33,14,19,19,0.3723706085175109,0.5476078775349605
적자/NNG;되/XSV,-1,-0.19065687758200822,33,14,19,23,0.3723706085175109,0.5476078775349605
지급준비율/NNG;인상/NNG;따른/VV,-1,-0.19065687758200822,33,14,19,17,0.3723706085175109,0.5476078775349605
경기부양/NNG;나설/VV,-1,-0.19183752194736425,58,25,33,39,0.43037602609855197,0.6344632528238433
국제/NNG;유가/NNG;하락/NNG;했/XSV,-1,-0.1940435774679663,49,21,28,28,0.41018986163218557,0.6074813864773644
금리인상/NNG;가능성/NNG;반영/NNG;하/XSV,-1,-0.1940435774679663,49,21,28,56,0.41018986163218557,0.6074813864773644
성장/NNG;한/XSA,-1,-0.19641185323890176,106,46,60,97,0.4926841282324953,0.7332541890057468
달러화/NNG;엔화/NNG;하락/NNG;했/XSV,-1,-0.197698265870053,40,17,23,24,0.38683063173390186,0.5772567147598971
달러화/NNG;오를/VV,-1,-0.197698265870053,40,17,23,33,0.38683063173390186,0.5772567147598971
수출/NNG;늘리/VV,-1,-0.197698265870053,40,17,23,28,0.38683063173390186,0.5772567147598971
금리인하/NNG;단행/NNG;될/XSV,-1,-0.19947619615801004,97,42,55,72,0.4822962954641834,0.7223859183461727
달러강세/NNG;따른/VV,-1,-0.19988430300878635,120,52,68,102,0.5004934485712202,0.7502790655110406
물가/NNG;안정/NNG;돼/XSV,-1,-0.20022264455520922,56,24,32,18,0.4213903632477021,0.6321426176031796
금리인하/NNG;부정적/NNG;인/VCP,-1,-0.20022264455520922,56,24,32,39,0.4213903632477021,0.6321426176031796
외환시장/NNG;현물환/NNG;하락/NNG;한/XSA,-1,-0.20022264455520922,56,24,32,69,0.4213903632477021,0.6321426176031796
투자심리/NNG;호전/NNG;시켰/XSV,-1,-0.20136248997513984,24,10,14,16,0.3408585271237207,0.5125496873822053
신규/NNG;실업수당청구/NNG;줄어든/VV,-1,-0.20136248997513984,24,10,14,14,0.3408585271237207,0.5125496873822053
규제/NNG;완화/NNG;할/XSV,-1,-0.20136248997513984,24,10,14,11,0.3408585271237207,0.5125496873822053
스왑베이시스/NNG;역전폭/NNG;축소/NNG;됐/XSV,-1,-0.20136248997513984,24,10,14,28,0.3408585271237207,0.5125496873822053
금리인상/NNG;진행/NNG;될/XSV,-1,-0.20136248997513984,24,10,14,27,0.3408585271237207,0.5125496873822053
경기부진/NNG;되/XSV,-1,-0.20136248997513984,24,10,14,23,0.3408585271237207,0.5125496873822053
기준금리/NNG;높/VA;수준/NNG,-1,-0.20136248997513984,24,10,14,18,0.3408585271237207,0.5125496873822053
소비자/NNG;물가상승률/NNG;하/XSV,-1,-0.20136248997513984,24,10,14,37,0.3408585271237207,0.5125496873822053
인플레이션/NNG;우려/NNG;완화/NNG;된/XSV,-1,-0.20136248997513984,24,10,14,13,0.3408585271237207,0.5125496873822053
통화정책/NNG;완화/NNG;유지/NNG;하/XSV,-1,-0.20136248997513984,24,10,14,23,0.3408585271237207,0.5125496873822053
높/VA;수익률/NNG;추구/NNG;하/XSV,-1,-0.20136248997513984,24,10,14,10,0.3408585271237207,0.5125496873822053
장기금리/NNG;오르/VV;않/VX,-1,-0.20136248997513984,24,10,14,9,0.3408585271237207,0.5125496873822053
달러약세/NNG;인해/VV,-1,-0.20136248997513984,24,10,14,17,0.3408585271237207,0.5125496873822053
물가상승률/NNG;하락/NNG;하/XSV,-1,-0.20136248997513984,24,10,14,22,0.3408585271237207,0.5125496873822053
경제성장률/NNG;떨어지/VV,-1,-0.20136248997513984,24,10,14,15,0.3408585271237207,0.5125496873822053
성장/NNG;통해/VV,-1,-0.20136248997513984,24,10,14,21,0.3408585271237207,0.5125496873822053
성장세/NNG;이어지/VV,-1,-0.20136248997513984,24,10,14,32,0.3408585271237207,0.5125496873822053
콜금리/NNG;동결/NNG;했/XSV,-1,-0.20136248997513984,24,10,14,17,0.3408585271237207,0.5125496873822053
기준금리동결/NNG;이/VCP,-1,-0.2017283504255788,17,7,10,24,0.3188694733360372,0.47985043349403483
주택가격/NNG;하락/NNG;한/XSA,-1,-0.2017283504255788,17,7,10,10,0.3188694733360372,0.47985043349403483
인플레이션압력/NNG;높/VA;졌/VX,-1,-0.2017283504255788,17,7,10,5,0.3188694733360372,0.47985043349403483
금리상승/NNG;작/VA,-1,-0.2017283504255788,17,7,10,9,0.3188694733360372,0.47985043349403483
글로벌경제/NNG;성장/NNG;할/XSV,-1,-0.2017283504255788,17,7,10,12,0.3188694733360372,0.47985043349403483
신용스프레드/NNG;줄어들/VV,-1,-0.2017283504255788,17,7,10,12,0.3188694733360372,0.47985043349403483
단기금리/NNG;인상/NNG;하/XSV,-1,-0.2017283504255788,17,7,10,7,0.3188694733360372,0.47985043349403483
민간/NNG;채권/NNG;수익률/NNG;민평/NNG;상승/NNG;한/XSA,-1,-0.2017283504255788,17,7,10,10,0.3188694733360372,0.47985043349403483
경제/NNG;회복/NNG;할/XSV,-1,-0.2017283504255788,17,7,10,13,0.3188694733360372,0.47985043349403483
금리인상/NNG;가능성/NNG;배제/NNG;하/XSV,-1,-0.2017283504255788,17,7,10,4,0.3188694733360372,0.47985043349403483
금리/NNG;낮추/VV;않/VX,-1,-0.2017283504255788,17,7,10,15,0.3188694733360372,0.47985043349403483
소비지출/NNG;증가/NNG;했/XSV,-1,-0.2017283504255788,17,7,10,8,0.3188694733360372,0.47985043349403483
채권/NNG;시장/NNG;국채가격/NNG;높/VA;졌/VX,-1,-0.2017283504255788,17,7,10,16,0.3188694733360372,0.47985043349403483
민간/NNG;소비/NNG;회복/NNG;되/XSV,-1,-0.2017283504255788,17,7,10,4,0.3188694733360372,0.47985043349403483
원화/NNG;강세/NNG;이어지/VV,-1,-0.2017283504255788,17,7,10,24,0.3188694733360372,0.47985043349403483
신용위험/NNG;커지/VV,-1,-0.2017283504255788,17,7,10,8,0.3188694733360372,0.47985043349403483
유동성/NNG;줄/VV,-1,-0.2017283504255788,17,7,10,16,0.3188694733360372,0.47985043349403483
디플레이션/NNG;우려/NNG;제기/NNG;되/XSV,-1,-0.2017283504255788,17,7,10,12,0.3188694733360372,0.47985043349403483
기준금리인상/NNG;될/VV,-1,-0.2017283504255788,17,7,10,10,0.3188694733360372,0.47985043349403483
기준금리/NNG;동결/NNG;됨/XSV,-1,-0.2017283504255788,17,7,10,18,0.3188694733360372,0.47985043349403483
금융위기/NNG;높/VA;수준/NNG,-1,-0.2017283504255788,17,7,10,9,0.3188694733360372,0.47985043349403483
금리인하/NNG;효과/NNG;지켜볼/VV,-1,-0.2017283504255788,17,7,10,23,0.3188694733360372,0.47985043349403483
금리인하/NNG;긍정적/VAX,-1,-0.2017283504255788,17,7,10,10,0.3188694733360372,0.47985043349403483
성장/NNG;중시/NNG;하/XSV,-1,-0.2017283504255788,17,7,10,12,0.3188694733360372,0.47985043349403483
시중금리/NNG;낮/VA;수준/NNG,-1,-0.2017283504255788,17,7,10,13,0.3188694733360372,0.47985043349403483
유동성증가/NNG;따른/VV,-1,-0.2017283504255788,17,7,10,8,0.3188694733360372,0.47985043349403483
경제/NNG;성장세/NNG;이/VV,-1,-0.2017283504255788,17,7,10,13,0.3188694733360372,0.47985043349403483
고용지표/NNG;호조/NNG;보여/VV,-1,-0.2017283504255788,17,7,10,9,0.3188694733360372,0.47985043349403483
달러화/NNG;하락/NNG;할/XSV,-1,-0.2017283504255788,17,7,10,19,0.3188694733360372,0.47985043349403483
유동성함정/NNG;빠질/VV,-1,-0.2017283504255788,17,7,10,3,0.3188694733360372,0.47985043349403483
외환보유액/NNG;증가/NNG;하/XSV,-1,-0.2017283504255788,17,7,10,22,0.3188694733360372,0.47985043349403483
기준금리/NNG;오른/VV,-1,-0.2017283504255788,17,7,10,10,0.3188694733360372,0.47985043349403483
불확실성/NNG;커졌/VV,-1,-0.20217273097362942,72,31,41,68,0.4487151759240306,0.6758743709923225
투자심리/NNG;회복/NNG;되/XSV,-1,-0.20262279079675416,88,38,50,73,0.47035666767071854,0.7091367890380164
원화/NNG;강세/NNG;되/XSV,-1,-0.20512611482278353,31,13,18,38,0.35905868128686624,0.5441718986456651
견조/NNG;한/XSA;성장/NNG;하/XSV,-1,-0.20512611482278353,31,13,18,15,0.35905868128686624,0.5441718986456651
고용/NNG;늘/VV,-1,-0.20512611482278353,31,13,18,23,0.35905868128686624,0.5441718986456651
달러화/NNG;강세/NNG;나타냈/VV,-1,-0.20512611482278353,31,13,18,20,0.35905868128686624,0.5441718986456651
국채가격/NNG;오른/VV,-1,-0.2052184840336172,95,41,54,46,0.4764085443238921,0.7221608694583447
장기금리/NNG;상승/NNG;하/XSV,-1,-0.2052184840336172,95,41,54,92,0.4764085443238921,0.7221608694583447
경제지표/NNG;호조/NNG;보이/VV,-1,-0.2072264640868522,102,44,58,92,0.4818299870825078,0.7334478793545282
채권/NNG;시장/NNG;국채선물/NNG;상승/NNG;한/XSA,-1,-0.20913844772031753,54,23,31,73,0.41203950385831417,0.6297232398556236
금리/NNG;인상/NNG;함/XSV,-1,-0.20985351559798615,38,16,22,14,0.3750279334235588,0.5740158620010686
국고채/NNG;금리/NNG;하락/NNG;한/XSA,-1,-0.21174684254832865,373,160,213,306,0.5144714220570452,0.7905730438383277
성장세/NNG;나타내/VV,-1,-0.2135158144305891,61,26,35,31,0.42300323225228137,0.6524289211947959
금리인상/NNG;늦출/VV,-1,-0.21449138313923855,45,19,26,36,0.3893463522841416,0.6017462498798248
물가안정/NNG;유지/NNG;하/XSV,-1,-0.2170792989243283,68,29,39,21,0.4329767606535285,0.6728197835439044
채권/NNG;시장/NNG;국고채/NNG;지표금리/NNG;오른/VV,-1,-0.21732639866248582,91,39,52,107,0.4640723566207564,0.7215144787478527
금융시장/NNG;안정/NNG;시키/XSV,-1,-0.21864903702902339,52,22,30,25,0.4022931066596479,0.6272023979320234
소비자물가/NNG;올랐/VV,-1,-0.2215894627254854,29,12,17,20,0.34467987357402396,0.5407098476732368
불안심리/NNG;높/VA;지/VX,-1,-0.2215894627254854,29,12,17,25,0.34467987357402396,0.5407098476732368
미국채금리/NNG;급등/NNG;한/XSA,-1,-0.2215894627254854,29,12,17,33,0.34467987357402396,0.5407098476732368
기준금리/NNG;인상/NNG;하/XSV;어려울/VA,-1,-0.2215894627254854,29,12,17,20,0.34467987357402396,0.5407098476732368
금융시장/NNG;안정/NNG;된/XSV,-1,-0.2215894627254854,29,12,17,17,0.34467987357402396,0.5407098476732368
장기시장금리/NNG;하락/NNG;하/XSV,-1,-0.2215894627254854,29,12,17,17,0.34467987357402396,0.5407098476732368
경기/NNG;부양책/NNG;할/XSV,-1,-0.22321521009737355,22,9,13,22,0.32351377363682604,0.5092443881815207
기준금리/NNG;낮/VA;질/VX,-1,-0.22321521009737355,22,9,13,9,0.32351377363682604,0.5092443881815207
금리인하/NNG;힘입/VV,-1,-0.22321521009737355,22,9,13,6,0.32351377363682604,0.5092443881815207
수익/NNG;올린/VV,-1,-0.22321521009737355,22,9,13,14,0.32351377363682604,0.5092443881815207
성장/NNG;지지/NNG;하/XSV,-1,-0.22321521009737355,22,9,13,8,0.32351377363682604,0.5092443881815207
금리상승/NNG;요인/NNG;작용/NNG;했/XSV,-1,-0.22321521009737355,22,9,13,18,0.32351377363682604,0.5092443881815207
금리/NNG;인하/NNG;됐/XSV,-1,-0.22321521009737355,22,9,13,10,0.32351377363682604,0.5092443881815207
금리인상/NNG;정당화/NNG;하/XSV,-1,-0.22321521009737355,22,9,13,12,0.32351377363682604,0.5092443881815207
인플레이션압력/NNG;강화/NNG;될/XSV,-1,-0.22321521009737355,22,9,13,7,0.32351377363682604,0.5092443881815207
소비자물가/NNG;오를/VV,-1,-0.22321521009737355,22,9,13,14,0.32351377363682604,0.5092443881815207
채권/NNG;시장/NNG;강세/NNG;나타냈/VV,-1,-0.22321521009737355,22,9,13,10,0.32351377363682604,0.5092443881815207
경제상황/NNG;악화/NNG;될/XSV,-1,-0.22321521009737355,22,9,13,10,0.32351377363682604,0.5092443881815207
금융시장/NNG;변동성/NNG;커지/VV,-1,-0.22321521009737355,22,9,13,27,0.32351377363682604,0.5092443881815207
성장잠재력/NNG;높/VA,-1,-0.22321521009737355,22,9,13,18,0.32351377363682604,0.5092443881815207
경기/NNG;호전/NNG;될/XSV,-1,-0.22321521009737355,22,9,13,28,0.32351377363682604,0.5092443881815207
금리/NNG;빠졌/VV,-1,-0.22321521009737355,22,9,13,19,0.32351377363682604,0.5092443881815207
달러화/NNG;강세/NNG;보인/VV,-1,-0.22329261690141988,36,15,21,44,0.36249774642071614,0.5707021736544405
국채금리/NNG;상승/NNG;한/XSA,-1,-0.2238535903988189,298,127,171,344,0.5053236347107724,0.7965014267460037
수익/NNG;올릴/VV,-1,-0.22509642487702197,66,28,38,55,0.42468233104063985,0.6711468805228846
국제/NNG;유가/NNG;오르/VV,-1,-0.22600582466137886,43,18,25,29,0.37813814002261426,0.5987366427550984
투자/NNG;줄이/VV,-1,-0.22600582466137886,43,18,25,29,0.37813814002261426,0.5987366427550984
성장/NNG;위해/VV,-1,-0.22738947124862685,73,31,42,53,0.4343321384387375,0.6897216370798309
기준금리인상/NNG;단행/NNG;할/XSV,-1,-0.22883054715174678,50,21,29,49,0.3921156240127639,0.6245770506678004
금리/NNG;높이/VV,-1,-0.22883054715174678,50,21,29,29,0.3921156240127639,0.6245770506678004
불확실성/NNG;커질/VV,-1,-0.23139116889071565,57,24,33,58,0.40470572400288246,0.6481252776582906
금리상승/NNG;제한/NNG;될/XSV,-1,-0.2335360618432739,64,27,37,53,0.4160820356716301,0.6693717961817706
변동성/NNG;줄어들/VV,-1,-0.2335360618432739,64,27,37,40,0.4160820356716301,0.6693717961817706
금리/NNG;낮/VA;진/VX,-1,-0.23521846518601053,71,30,41,47,0.42636948701892613,0.6883674456832951
적자/NNG;하/XSV,-1,-0.23521846518601053,71,30,41,55,0.42636948701892613,0.6883674456832951
기준금리인하/NNG;반영/NNG;하/XSV,-1,-0.23550334819281926,15,6,9,9,0.2955053048540337,0.4773768576731733
엔화/NNG;약세/NNG;이어질/VV,-1,-0.23550334819281926,15,6,9,15,0.2955053048540337,0.4773768576731733
미국채금리/NNG;상승/NNG;영향/NNG;받/VV,-1,-0.23550334819281926,15,6,9,10,0.2955053048540337,0.4773768576731733
금리인상/NNG;끝날/VV,-1,-0.23550334819281926,15,6,9,11,0.2955053048540337,0.4773768576731733
자금유입/NNG;확대/NNG;되/XSV,-1,-0.23550334819281926,15,6,9,26,0.2955053048540337,0.4773768576731733
재고/NNG;늘/VV,-1,-0.23550334819281926,15,6,9,17,0.2955053048540337,0.4773768576731733
엔화/NNG;약세/NNG;힘입/VV,-1,-0.23550334819281926,15,6,9,10,0.2955053048540337,0.4773768576731733
성장동력/NNG;이/VCP,-1,-0.23550334819281926,15,6,9,5,0.2955053048540337,0.4773768576731733
은행대출/NNG;늘/VV,-1,-0.23550334819281926,15,6,9,7,0.2955053048540337,0.4773768576731733
금리인하/NNG;가능성/NNG;커지/VV,-1,-0.23550334819281926,15,6,9,12,0.2955053048540337,0.4773768576731733
비농업/NNG;고용창출/NNG;감소/NNG;해/XSV,-1,-0.23550334819281926,15,6,9,4,0.2955053048540337,0.4773768576731733
국채/NNG;금리/NNG;상승/NNG;한/XSA,-1,-0.23550334819281926,15,6,9,12,0.2955053048540337,0.4773768576731733
금리/NNG;하향안정화/NNG;되/XSV,-1,-0.23550334819281926,15,6,9,6,0.2955053048540337,0.4773768576731733
달러화/NNG;급등/NNG;한/XSA,-1,-0.23550334819281926,15,6,9,15,0.2955053048540337,0.4773768576731733
금리인하/NNG;기대/NNG;확산/NNG;되/XSV,-1,-0.23550334819281926,15,6,9,3,0.2955053048540337,0.4773768576731733
채권가격하락/NNG;하/XSV,-1,-0.23550334819281926,15,6,9,16,0.2955053048540337,0.4773768576731733
경제회복/NNG;따른/VV,-1,-0.23550334819281926,15,6,9,8,0.2955053048540337,0.4773768576731733
금리인하/NNG;가능성/NNG;있/VA,-1,-0.23550334819281926,15,6,9,7,0.2955053048540337,0.4773768576731733
금리인하/NNG;기대/NNG;커질/VA,-1,-0.23550334819281926,15,6,9,12,0.2955053048540337,0.4773768576731733
채권금리/NNG;급락/NNG;한/XSA,-1,-0.23550334819281926,15,6,9,11,0.2955053048540337,0.4773768576731733
단기물/NNG;금리/NNG;하락/NNG;했/XSV,-1,-0.23550334819281926,15,6,9,4,0.2955053048540337,0.4773768576731733
손실/NNG;확대/NNG;되/XSV,-1,-0.23550334819281926,15,6,9,11,0.2955053048540337,0.4773768576731733
신용경색/NNG;우려/NNG;부각/NNG;되/XSV,-1,-0.23550334819281926,15,6,9,9,0.2955053048540337,0.4773768576731733
경제/NNG;둔화/NNG;할/XSV,-1,-0.23550334819281926,15,6,9,11,0.2955053048540337,0.4773768576731733
금융시장/NNG;영향/NNG;줄/VV,-1,-0.23550334819281926,15,6,9,13,0.2955053048540337,0.4773768576731733
소비심리/NNG;위축/NNG;될/XSV,-1,-0.23550334819281926,15,6,9,13,0.2955053048540337,0.4773768576731733
대출한도/NNG;늘리/VV,-1,-0.23550334819281926,15,6,9,18,0.2955053048540337,0.4773768576731733
소비/NNG;투자심리/NNG;위축/NNG;되/XSV,-1,-0.23550334819281926,15,6,9,10,0.2955053048540337,0.4773768576731733
투자/NNG;부진/NNG;하/XSV,-1,-0.23550334819281926,15,6,9,7,0.2955053048540337,0.4773768576731733
실적/NNG;악화/NNG;됐/XSV,-1,-0.23550334819281926,15,6,9,7,0.2955053048540337,0.4773768576731733
수입/NNG;줄어든/VV,-1,-0.23550334819281926,15,6,9,17,0.2955053048540337,0.4773768576731733
미국채/NNG;금리/NNG;하락/NNG;하/XSV,-1,-0.23550334819281926,15,6,9,11,0.2955053048540337,0.4773768576731733
irs/NNG;금리/NNG;하락/NNG;했/XSV,-1,-0.23550334819281926,15,6,9,5,0.2955053048540337,0.4773768576731733
경제성장률/NNG;전망/NNG;낮춘/VV,-1,-0.23550334819281926,15,6,9,5,0.2955053048540337,0.4773768576731733
실적/NNG;개선/NNG;된/XSV,-1,-0.23550334819281926,15,6,9,17,0.2955053048540337,0.4773768576731733
대외여건/NNG;악화/NNG;되/XSV,-1,-0.23550334819281926,15,6,9,10,0.2955053048540337,0.4773768576731733
달러원/NNG;상승/NNG;우호적/VAX,-1,-0.23550334819281926,15,6,9,14,0.2955053048540337,0.4773768576731733
수익/NNG;증가/NNG;할/XSV,-1,-0.23550334819281926,15,6,9,7,0.2955053048540337,0.4773768576731733
기준금리인하/NNG;한/XSA,-1,-0.23550334819281926,15,6,9,10,0.2955053048540337,0.4773768576731733
금리인상/NNG;완만하/VAX,-1,-0.23550334819281926,15,6,9,22,0.2955053048540337,0.4773768576731733
유동성/NNG;개선/NNG;되/XSV,-1,-0.23550334819281926,15,6,9,14,0.2955053048540337,0.4773768576731733
금리인상/NNG;가능성/NNG;대두/NNG;되/XSV,-1,-0.23550334819281926,15,6,9,12,0.2955053048540337,0.4773768576731733
순이자마진/NNG;개선/NNG;되/XSV,-1,-0.23550334819281926,15,6,9,9,0.2955053048540337,0.4773768576731733
유동성/NNG;위축/NNG;되/XSV,-1,-0.23550334819281926,15,6,9,3,0.2955053048540337,0.4773768576731733
통화완화/NNG;하/XSV,-1,-0.23550334819281926,15,6,9,15,0.2955053048540337,0.4773768576731733
환율하락/NNG;용인/NNG;하/XSV,-1,-0.23550334819281926,15,6,9,17,0.2955053048540337,0.4773768576731733
금리인상/NNG;가능성/NNG;희박하/VAX,-1,-0.23550334819281926,15,6,9,7,0.2955053048540337,0.4773768576731733
금리/NNG;인하/NNG;하/XSV,-1,-0.2368159717172602,475,201,274,340,0.4955783032034192,0.8028149463075935
금리/NNG;하락세/NNG;이/VV,-1,-0.2382787189547212,34,14,20,25,0.34912009434752617,0.5673147639576264
신용스프레드/NNG;축소/NNG;된/XSV,-1,-0.2382787189547212,34,14,20,22,0.34912009434752617,0.5673147639576264
매수/NNG;심리/NNG;위축/NNG;시켰/XSV,-1,-0.2382787189547212,34,14,20,26,0.34912009434752617,0.5673147639576264
성장세회복/NNG;이어지/VV,-1,-0.2382787189547212,34,14,20,25,0.34912009434752617,0.5673147639576264
금리인하/NNG;인해/VV,-1,-0.23856877300004964,41,17,24,19,0.36631919287474324,0.5956291579487526
규제/NNG;완화/NNG;해/XSV,-1,-0.23856877300004964,41,17,24,26,0.36631919287474324,0.5956291579487526
금리상승/NNG;이/VCP,-1,-0.23856877300004964,41,17,24,34,0.36631919287474324,0.5956291579487526
국고채/NNG;금리/NNG;국고/NNG;지표물/NNG;인/VCP;내린/VV,-1,-0.24057842788794548,27,11,16,28,0.32899382540833344,0.5372238412839455
금리인하/NNG;하/VV;않/VX,-1,-0.24057842788794548,27,11,16,16,0.32899382540833344,0.5372238412839455
엔화가치/NNG;하락/NNG;하/XSV,-1,-0.24057842788794548,27,11,16,19,0.32899382540833344,0.5372238412839455
금리인하/NNG;하/VV,-1,-0.24243963058961093,62,26,36,22,0.4071564065135168,0.667490363266996
유로화/NNG;상승/NNG;했/XSV,-1,-0.24243963058961093,62,26,36,30,0.4071564065135168,0.667490363266996
매수/NNG;심리/NNG;위축/NNG;되/XSV,-1,-0.24342820373977403,69,29,40,45,0.41812494478614803,0.6869134599179096
기준금리/NNG;낮/VA;수준/NNG,-1,-0.2441154779983037,97,41,56,63,0.45224931548123815,0.744060645147863
성장/NNG;해/XSV,-1,-0.2498435994324687,102,43,59,60,0.45281282192868105,0.7541296370256675
저금리정책/NNG;유지/NNG;할/XSV,-1,-0.2499149130317151,20,8,12,5,0.3037894855965425,0.506018129621642
금리인하/NNG;기대/NNG;강화/NNG;되/XSV,-1,-0.2499149130317151,20,8,12,7,0.3037894855965425,0.506018129621642
금리/NNG;상승세/NNG;타/VV,-1,-0.2499149130317151,20,8,12,6,0.3037894855965425,0.506018129621642
마이너스성장/NNG;할/XSV,-1,-0.2499149130317151,20,8,12,17,0.3037894855965425,0.506018129621642
국고/NNG;금리/NNG;오른/VV,-1,-0.2499149130317151,20,8,12,4,0.3037894855965425,0.506018129621642
시장변동성/NNG;커지/VV,-1,-0.2499149130317151,20,8,12,16,0.3037894855965425,0.506018129621642
통화정책/NNG;유지/NNG;해야/XSV,-1,-0.2499149130317151,20,8,12,15,0.3037894855965425,0.506018129621642
대출/NNG;늘어날/VV,-1,-0.2499149130317151,20,8,12,18,0.3037894855965425,0.506018129621642
환율방어/NNG;위한/VV,-1,-0.2499149130317151,20,8,12,18,0.3037894855965425,0.506018129621642
경제성장률/NNG;전망/NNG;치를/XSV;하향/NNG;조정/NNG,-1,-0.2499149130317151,20,8,12,24,0.3037894855965425,0.506018129621642
기대심리/NNG;낮/VA;지/VX,-1,-0.2499149130317151,20,8,12,30,0.3037894855965425,0.506018129621642
달러화/NNG;상승폭/NNG;확대/NNG;했/XSV,-1,-0.2499149130317151,20,8,12,9,0.3037894855965425,0.506018129621642
부양책/NNG;없/VA,-1,-0.2499149130317151,20,8,12,13,0.3037894855965425,0.506018129621642
인플레이션압력/NNG;억제/NNG;하/XSV,-1,-0.2499149130317151,20,8,12,10,0.3037894855965425,0.506018129621642
신용경색/NNG;해소/NNG;하/XSV,-1,-0.2499149130317151,20,8,12,12,0.3037894855965425,0.506018129621642
엔화/NNG;약세/NNG;나타냈/VV,-1,-0.2499149130317151,20,8,12,11,0.3037894855965425,0.506018129621642
투자/NNG;늘렸/VV,-1,-0.2499149130317151,20,8,12,25,0.3037894855965425,0.506018129621642
경기/NNG;회복/NNG;시키/XSV,-1,-0.2499149130317151,20,8,12,25,0.3037894855965425,0.506018129621642
매출/NNG;늘어난/VV,-1,-0.2499149130317151,20,8,12,20,0.3037894855965425,0.506018129621642
침체/NNG;했/XSV,-1,-0.2499149130317151,20,8,12,4,0.3037894855965425,0.506018129621642
성장/NNG;견인/NNG;했/XSV,-1,-0.2499149130317151,20,8,12,8,0.3037894855965425,0.506018129621642
금리인상/NNG;가능성/NNG;열려/VV,-1,-0.2499149130317151,20,8,12,23,0.3037894855965425,0.506018129621642
비용/NNG;줄어들/VV,-1,-0.2499149130317151,20,8,12,17,0.3037894855965425,0.506018129621642
성장세/NNG;둔화/NNG;된/XSV,-1,-0.2499149130317151,20,8,12,5,0.3037894855965425,0.506018129621642
수출/NNG;증가/NNG;해/XSV,-1,-0.2499149130317151,20,8,12,17,0.3037894855965425,0.506018129621642
경제성장/NNG;이/VCP,-1,-0.2499149130317151,20,8,12,10,0.3037894855965425,0.506018129621642
물가상승률/NNG;감안/NNG;한/XSA,-1,-0.2499149130317151,20,8,12,9,0.3037894855965425,0.506018129621642
경제성장/NNG;따른/VV,-1,-0.2499149130317151,20,8,12,16,0.3037894855965425,0.506018129621642
기준금리/NNG;인하/NNG;할/XSV,-1,-0.2503833045163756,719,302,417,499,0.48533464828099565,0.8092235059495636
대출/NNG;늘어나/VV,-1,-0.2507328719818879,95,40,55,70,0.44588461533962387,0.7440010401479857
기준금리/NNG;인하/NNG;된/XSV,-1,-0.25158977898335766,46,19,27,36,0.3702919539381974,0.6189983359800838
주택시장침체/NNG;따른/VV,-1,-0.25158977898335766,46,19,27,12,0.3702919539381974,0.6189983359800838
성장세/NNG;될/XSV,-1,-0.25160928052946474,53,22,31,43,0.38486267971403826,0.6433822618606397
국고채/NNG;금리/NNG;하락/NNG;하/XSV,-1,-0.2520525789972179,67,28,39,52,0.4095825662838952,0.6853552241108731
국고채/NNG;금리/NNG;올랐/VV,-1,-0.2520525789972179,67,28,39,66,0.4095825662838952,0.6853552241108731
통화정책/NNG;완화/NNG;하/XSV,-1,-0.25236504018933714,39,16,23,35,0.3538065918205957,0.5924202917682788
경쟁력/NNG;확보/NNG;하/XSV,-1,-0.25236504018933714,39,16,23,29,0.3538065918205957,0.5924202917682788
연체율/NNG;상승/NNG;하/XSV,-1,-0.25236504018933714,39,16,23,33,0.3538065918205957,0.5924202917682788
시중금리/NNG;하락/NNG;하/XSV,-1,-0.25236504018933714,39,16,23,16,0.3538065918205957,0.5924202917682788
금리인상/NNG;시작/NNG;할/XSV,-1,-0.2551554443147561,32,13,19,44,0.33474231971667695,0.5638509295602135
엔화/NNG;약세/NNG;나타내/VV,-1,-0.2551554443147561,32,13,19,23,0.33474231971667695,0.5638509295602135
금리인상/NNG;가능/NNG;하/XSA,-1,-0.2551554443147561,32,13,19,31,0.33474231971667695,0.5638509295602135
금리급등/NNG;따른/VV,-1,-0.2563236782001814,100,42,58,67,0.44669042829584216,0.7543027473134155
금리/NNG;급락/NNG;하/XSV,-1,-0.25758719256508,93,39,54,48,0.43932354072407137,0.7438719560648541
성장세/NNG;되/XSV,-1,-0.2611302542183448,65,27,38,43,0.40072452019392407,0.683687964415627
시장금리/NNG;오를/VV,-1,-0.26278224000768835,51,21,30,33,0.37427762864576797,0.6408346473777662
금리차/NNG;확대/NNG;되/XSV,-1,-0.26278224000768835,51,21,30,49,0.37427762864576797,0.6408346473777662
내수부진/NNG;따른/VV,-1,-0.26283565089928596,25,10,15,19,0.3116770141851065,0.5337116798983258
경기지표/NNG;부진/NNG;한/XSA,-1,-0.26283565089928596,25,10,15,9,0.3116770141851065,0.5337116798983258
유로화/NNG;상승/NNG;할/XSV,-1,-0.26283565089928596,25,10,15,16,0.3116770141851065,0.5337116798983258
불확실성/NNG;계속/NNG;되/XSV,-1,-0.26283565089928596,25,10,15,21,0.3116770141851065,0.5337116798983258
기준금리/NNG;인상/NNG;했으며/XSV,-1,-0.26283565089928596,25,10,15,19,0.3116770141851065,0.5337116798983258
안전자산선호/NNG;강화/NNG;될/XSV,-1,-0.26283565089928596,25,10,15,18,0.3116770141851065,0.5337116798983258
국채금리/NNG;넘어서/VV,-1,-0.26283565089928596,25,10,15,11,0.3116770141851065,0.5337116798983258
국채가격/NNG;상승/NNG;하/XSV,-1,-0.26283565089928596,25,10,15,20,0.3116770141851065,0.5337116798983258
불확실성/NNG;확대/NNG;되/XSV,-1,-0.26302493601666244,98,41,57,79,0.4403831382687584,0.7544130218870687
금리/NNG;끌어내렸/VV,-1,-0.26441153313753596,44,18,26,33,0.3585367226725838,0.6160360218459698
경제성장/NNG;둔화/NNG;될/XSV,-1,-0.26441153313753596,44,18,26,35,0.3585367226725838,0.6160360218459698
금리인하/NNG;될/XSV,-1,-0.26762795576721565,37,15,22,24,0.3404982272210022,0.5891051420095069
펀더멘털/NNG;개선/NNG;되/XSV,-1,-0.26762795576721565,37,15,22,39,0.3404982272210022,0.5891051420095069
금리/NNG;높/VA;진/VX,-1,-0.26762795576721565,37,15,22,28,0.3404982272210022,0.5891051420095069
안전자산/NNG;선호도/NNG;높/VA,-1,-0.26762795576721565,37,15,22,36,0.3404982272210022,0.5891051420095069
국채가격/NNG;떨어졌/VV,-1,-0.27245194291286956,56,23,33,30,0.3781909345533591,0.6611609348003886
높/VA;금리/NNG;받/VV,-1,-0.27245194291286956,56,23,33,44,0.3781909345533591,0.6611609348003886
연방기금/NNG;금리선물/NNG;시장/NNG;오/VV,-1,-0.27414066560777917,82,34,48,67,0.4163594186899361,0.7305486242025034
유로화/NNG;약세/NNG;보였/VV,-1,-0.27437908394205524,30,12,18,11,0.3191684506569719,0.5603050586411659
안전자산선호/NNG;강화/NNG;돼/XSV,-1,-0.27437908394205524,30,12,18,16,0.3191684506569719,0.5603050586411659
유로화/NNG;급등/NNG;했/XSV,-1,-0.27437908394205524,30,12,18,18,0.3191684506569719,0.5603050586411659
소매판매/NNG;증가/NNG;하/XSV,-1,-0.27437908394205524,30,12,18,41,0.3191684506569719,0.5603050586411659
금리상승/NNG;이어지/VV,-1,-0.27437908394205524,30,12,18,24,0.3191684506569719,0.5603050586411659
서부텍사스산원유/NNG;상승/NNG;한/XSA,-1,-0.27437908394205524,30,12,18,25,0.3191684506569719,0.5603050586411659
고용/NNG;증가/NNG;하/XSV,-1,-0.27437908394205524,30,12,18,20,0.3191684506569719,0.5603050586411659
국채수익률/NNG;상승/NNG;하/XSV,-1,-0.27437908394205524,30,12,18,21,0.3191684506569719,0.5603050586411659
지급준비율/NNG;올리/VV,-1,-0.27437908394205524,30,12,18,13,0.3191684506569719,0.5603050586411659
환율상승/NNG;따른/VV,-1,-0.274582674237397,101,42,59,54,0.4351076603891637,0.7641744205590772
불확실성/NNG;해소/NNG;되/XSV,-1,-0.276523050952463,188,78,110,203,0.4634669993853148,0.8174060185421321
유로달러/NNG;상승/NNG;한/XSA,-1,-0.27714052552814195,94,39,55,81,0.4271881562346287,0.7544298490335811
투자/NNG;늘릴/VV,-1,-0.2784041258117209,42,17,25,26,0.3461282643469489,0.6129508147954131
불안심리/NNG;커졌/VV,-1,-0.2784041258117209,42,17,25,38,0.3461282643469489,0.6129508147954131
서부텍사스산원유/NNG;가격/NNG;오른/VV,-1,-0.2784073845466477,68,28,40,46,0.3947033206054668,0.6989762339111694
달러강세/NNG;이어지/VV,-1,-0.28082951537810785,61,25,36,57,0.38197876814710635,0.6800053696903475
금리/NNG;내리/VV;않/VX,-1,-0.28082951537810785,61,25,36,29,0.38197876814710635,0.6800053696903475
경기선행지수/NNG;상승/NNG;한/XSA,-1,-0.28351618912244647,18,7,11,18,0.2808295823943737,0.5028640463665522
인플레이션/NNG;우려/NNG;덜/VV,-1,-0.28351618912244647,18,7,11,3,0.2808295823943737,0.5028640463665522
기준금리/NNG;상승/NNG;하/XSV,-1,-0.28351618912244647,18,7,11,13,0.2808295823943737,0.5028640463665522
cd금리/NNG;상승/NNG;할/XSV,-1,-0.28351618912244647,18,7,11,15,0.2808295823943737,0.5028640463665522
경제성장률/NNG;전망/NNG;하향/NNG;조정/NNG;했/XSV,-1,-0.28351618912244647,18,7,11,25,0.2808295823943737,0.5028640463665522
금리인상/NNG;막/VV,-1,-0.28351618912244647,18,7,11,17,0.2808295823943737,0.5028640463665522
경제/NNG;부담/NNG;주/VV,-1,-0.28351618912244647,18,7,11,17,0.2808295823943737,0.5028640463665522
엔화/NNG;강세/NNG;되/XSV,-1,-0.28351618912244647,18,7,11,15,0.2808295823943737,0.5028640463665522
금리인상/NNG;앞당길/VV,-1,-0.28351618912244647,18,7,11,14,0.2808295823943737,0.5028640463665522
소비자물가/NNG;높/VA;수준/NNG,-1,-0.28351618912244647,18,7,11,17,0.2808295823943737,0.5028640463665522
국고채/NNG;금리/NNG;급락/NNG;한/XSA,-1,-0.28351618912244647,18,7,11,13,0.2808295823943737,0.5028640463665522
스왑베이시스/NNG;역전폭/NNG;확대/NNG;되/XSV,-1,-0.28351618912244647,18,7,11,9,0.2808295823943737,0.5028640463665522
irs/NNG;금리/NNG;하락/NNG;하/XSV,-1,-0.28351618912244647,18,7,11,10,0.2808295823943737,0.5028640463665522
듀레이션/NNG;축소/NNG;하/XSV,-1,-0.28351618912244647,18,7,11,24,0.2808295823943737,0.5028640463665522
물가/NNG;높/VA;지/VX,-1,-0.28351618912244647,18,7,11,18,0.2808295823943737,0.5028640463665522
달러원/NNG;하락압력/NNG;받/VV,-1,-0.28351618912244647,18,7,11,29,0.2808295823943737,0.5028640463665522
경기회복/NNG;힘입/VV,-1,-0.28351618912244647,18,7,11,20,0.2808295823943737,0.5028640463665522
국채수익률/NNG;낮/VA;진/VX,-1,-0.28351618912244647,18,7,11,10,0.2808295823943737,0.5028640463665522
국채선물/NNG;상승/NNG;했/XSV,-1,-0.28351618912244647,18,7,11,17,0.2808295823943737,0.5028640463665522
잠재/NNG;성장률/NNG;높이/VV,-1,-0.28351618912244647,18,7,11,15,0.2808295823943737,0.5028640463665522
시장금리/NNG;반등/NNG;하/XSV,-1,-0.28351618912244647,18,7,11,11,0.2808295823943737,0.5028640463665522
경기침체/NNG;심화/NNG;되/XSV,-1,-0.28351618912244647,18,7,11,15,0.2808295823943737,0.5028640463665522
경기/NNG;회복/NNG;되/XSV;않/VX,-1,-0.28351618912244647,18,7,11,7,0.2808295823943737,0.5028640463665522
채권/NNG;가격/NNG;떨어졌/VV,-1,-0.28351618912244647,18,7,11,9,0.2808295823943737,0.5028640463665522
달러화/NNG;낙폭/NNG;확대/NNG;하/XSV,-1,-0.28351618912244647,18,7,11,16,0.2808295823943737,0.5028640463665522
금리/NNG;낮/VA;유지/NNG,-1,-0.28377446873249634,54,22,32,55,0.36770971165630556,0.6588047375626263
듀레이션/NNG;확대/NNG;하/XSV,-1,-0.2846558220561003,35,14,21,22,0.32626754786657575,0.5856767814736451
국채금리/NNG;낮/VA;진/VX,-1,-0.2846558220561003,35,14,21,21,0.32626754786657575,0.5856767814736451
기준금리인상/NNG;쉽/VA;않/VX,-1,-0.2846558220561003,35,14,21,22,0.32626754786657575,0.5856767814736451
신용경색/NNG;완화/NNG;하/XSV,-1,-0.2846558220561003,35,14,21,15,0.32626754786657575,0.5856767814736451
통화정책/NNG;완화/NNG;할/XSV,-1,-0.2846558220561003,35,14,21,25,0.32626754786657575,0.5856767814736451
소비자물가/NNG;상승/NNG;하/XSV,-1,-0.28545774062220564,104,43,61,98,0.43004720922206846,0.7733180346009644
국채금리/NNG;하락/NNG;하/XSV,-1,-0.28545774062220564,104,43,61,102,0.43004720922206846,0.7733180346009644
금리인상/NNG;중단/NNG;할/XSV,-1,-0.28665220348737375,133,55,78,84,0.4452903912874425,0.8028139139924462
매출/NNG;증가/NNG;했/XSV,-1,-0.28775906225254244,47,19,28,34,0.3515605718841219,0.6353590189253413
수출/NNG;증가/NNG;하/XSV,-1,-0.28884011319649683,109,45,64,92,0.43130168839579974,0.7813110086018699
이자/NNG;부담/NNG;줄어들/VV,-1,-0.2894255358115463,23,9,14,31,0.2922889040770005,0.5301634654628159
안전자산선호/NNG;심리/NNG;강해/VV,-1,-0.2894255358115463,23,9,14,24,0.2922889040770005,0.5301634654628159
달러화/NNG;레벨/NNG;낮췄/VV,-1,-0.2894255358115463,23,9,14,21,0.2922889040770005,0.5301634654628159
부동산가격상승/NNG;따른/VV,-1,-0.2894255358115463,23,9,14,10,0.2922889040770005,0.5301634654628159
유로화/NNG;올랐/VV,-1,-0.2894255358115463,23,9,14,16,0.2922889040770005,0.5301634654628159
지급준비율/NNG;인상/NNG;해/XSV,-1,-0.2894255358115463,23,9,14,5,0.2922889040770005,0.5301634654628159
장기물/NNG;강세/NNG;보였/VV,-1,-0.2894255358115463,23,9,14,19,0.2922889040770005,0.5301634654628159
통화완화/NNG;나서/VV,-1,-0.2894255358115463,23,9,14,15,0.2922889040770005,0.5301634654628159
금리인상/NNG;시작/NNG;될/XSV,-1,-0.2894255358115463,23,9,14,33,0.2922889040770005,0.5301634654628159
지표물/NNG;인/VCP;국고채/NNG;금리/NNG;상승/NNG;한/XSA,-1,-0.2894255358115463,23,9,14,17,0.2922889040770005,0.5301634654628159
경쟁력강화/NNG;위한/VV,-1,-0.2894255358115463,23,9,14,15,0.2922889040770005,0.5301634654628159
금리/NNG;낮출/VV,-1,-0.2917859891509894,114,47,67,95,0.43244243326788584,0.7884322161154912
엔화/NNG;거래/NNG;돼/XSV;인/VCP;낮/VA;졌/VX,-1,-0.29434780914335834,119,49,70,66,0.43347300397501703,0.7947517478836449
성장세/NNG;둔화/NNG;되/XSV,-1,-0.29569782630360497,107,44,63,64,0.425191111397986,0.7818754144984773
단기금리/NNG;하락/NNG;하/XSV,-1,-0.29589491019722025,52,21,31,26,0.3567560041849133,0.6563148080377387
달러화/NNG;반등/NNG;했/XSV,-1,-0.2965664080885253,28,11,17,14,0.30214500499792474,0.5566669833602795
기업/NNG;실적/NNG;개선/NNG;되/XSV,-1,-0.2965664080885253,28,11,17,22,0.30214500499792474,0.5566669833602795
금리인상/NNG;주장/NNG;한/XSA,-1,-0.2965664080885253,28,11,17,29,0.30214500499792474,0.5566669833602795
성장세/NNG;유지/NNG;되/XSV,-1,-0.2965664080885253,28,11,17,24,0.30214500499792474,0.5566669833602795
경기회복/NNG;위해/VV,-1,-0.29846349505783776,112,46,66,67,0.4265682545665427,0.7891793915425623
금리인하/NNG;단행/NNG;할/XSV,-1,-0.302870981721721,245,100,145,126,0.4454632362806945,0.8321590358802251
기준금리/NNG;올려야/VV,-1,-0.3029696290383055,57,23,34,45,0.36169420541398634,0.6758188843409723
경기/NNG;부진/NNG;한/XSA,-1,-0.3029696290383055,57,23,34,45,0.36169420541398634,0.6758188843409723
실적/NNG;부진/NNG;한/XSA,-1,-0.3038350321912907,33,13,20,39,0.31095687783043086,0.5821253713822631
채권/NNG;시장/NNG;강세/NNG;이/VV,-1,-0.3038350321912907,33,13,20,21,0.31095687783043086,0.5821253713822631
순이익/NNG;감소/NNG;할/XSV,-1,-0.3038350321912907,33,13,20,15,0.31095687783043086,0.5821253713822631
수요/NNG;위축/NNG;될/XSV,-1,-0.3038350321912907,33,13,20,27,0.31095687783043086,0.5821253713822631
장단기금리차/NNG;축소/NNG;될/XSV,-1,-0.3038350321912907,33,13,20,27,0.31095687783043086,0.5821253713822631
인플레이션/NNG;우려/NNG;완화/NNG;되/XSV,-1,-0.3038350321912907,33,13,20,22,0.31095687783043086,0.5821253713822631
금리/NNG;내려갔/VV,-1,-0.3038350321912907,33,13,20,40,0.31095687783043086,0.5821253713822631
기준금리/NNG;낮출/VV,-1,-0.30416047982735817,69,28,41,44,0.3800792732451623,0.7120359131586317
금리/NNG;내렸/VV,-1,-0.3082241531294406,263,107,156,210,0.44155228103274363,0.834647789117914
시장금리/NNG;오르/VV,-1,-0.31008533766633606,103,42,61,86,0.4124388852992166,0.7828300823966993
경제성장/NNG;되/XSV,-1,-0.3107718126728216,38,15,23,21,0.3189902171198015,0.6063800091704912
소비/NNG;회복/NNG;되/XSV,-1,-0.3107718126728216,38,15,23,30,0.3189902171198015,0.6063800091704912
국고채/NNG;금리/NNG;오른/VV,-1,-0.3130292014543944,177,72,105,136,0.4353205077610079,0.8316639605869024
경기/NNG;회복/NNG;될/XSV,-1,-0.31356599699472887,79,32,47,53,0.38722772907035996,0.7406653268386104
금리/NNG;유지/NNG;할/XSV,-1,-0.3144306036971334,67,27,40,83,0.3707703428136339,0.7105479247902378
채권금리/NNG;오르/VV,-1,-0.3144306036971334,67,27,40,85,0.3707703428136339,0.7105479247902378
부양책/NNG;나올/VV,-1,-0.3171787367225213,43,17,26,34,0.3263906195451804,0.6293272036990707
비용/NNG;늘어나/VV,-1,-0.3171787367225213,43,17,26,34,0.3263906195451804,0.6293272036990707
인플레이션/NNG;완화/NNG;되/XSV,-1,-0.3171787367225213,43,17,26,20,0.3263906195451804,0.6293272036990707
매수/NNG;심리/NNG;위축/NNG;된/XSV,-1,-0.3171787367225213,43,17,26,46,0.3263906195451804,0.6293272036990707
기준금리/NNG;낮/VA;진/VX,-1,-0.32191480734836264,21,8,13,14,0.27022522433289353,0.526555968580311
인플레이션압력/NNG;완화/NNG;하/XSV,-1,-0.32191480734836264,21,8,13,3,0.27022522433289353,0.526555968580311
침체/NNG;인해/VV,-1,-0.32191480734836264,21,8,13,11,0.27022522433289353,0.526555968580311
국제금융시장/NNG;불안/NNG;완화/NNG;되/XSV,-1,-0.32191480734836264,21,8,13,2,0.27022522433289353,0.526555968580311
경기/NNG;부양책/NNG;인/VCP,-1,-0.32191480734836264,21,8,13,11,0.27022522433289353,0.526555968580311
성장세/NNG;유지/NNG;될/XSV,-1,-0.32191480734836264,21,8,13,12,0.27022522433289353,0.526555968580311
국고채/NNG;금리/NNG;내렸으며/VV,-1,-0.32191480734836264,21,8,13,9,0.27022522433289353,0.526555968580311
금리인하/NNG;가능성/NNG;반영/NNG;하/XSV,-1,-0.32191480734836264,21,8,13,10,0.27022522433289353,0.526555968580311
금리인하/NNG;요구/NNG;하/XSV,-1,-0.32191480734836264,21,8,13,19,0.27022522433289353,0.526555968580311
경상수지흑자/NNG;따른/VV,-1,-0.32191480734836264,21,8,13,30,0.27022522433289353,0.526555968580311
기준금리/NNG;인상/NNG;할지/XSV,-1,-0.32191480734836264,21,8,13,10,0.27022522433289353,0.526555968580311
cd금리/NNG;상승/NNG;했/XSV,-1,-0.32191480734836264,21,8,13,10,0.27022522433289353,0.526555968580311
금융안정/NNG;이/VCP,-1,-0.32191480734836264,21,8,13,14,0.27022522433289353,0.526555968580311
기준금리동결/NNG;불구하/VAX,-1,-0.32191480734836264,21,8,13,26,0.27022522433289353,0.526555968580311
금리동결/NNG;결정/NNG;한/XSA,-1,-0.32191480734836264,21,8,13,12,0.27022522433289353,0.526555968580311
물가상승압력/NNG;완화/NNG;될/XSV,-1,-0.32191480734836264,21,8,13,11,0.27022522433289353,0.526555968580311
유가하락/NNG;부추겼/VV,-1,-0.32191480734836264,21,8,13,16,0.27022522433289353,0.526555968580311
경제성장률/NNG;하락/NNG;하/XSV,-1,-0.32256651325396957,26,10,16,19,0.283342565492158,0.5529194828055681
양적완화/NNG;통한/VV,-1,-0.32256651325396957,26,10,16,16,0.283342565492158,0.5529194828055681
실업률/NNG;낮/VA;지/VX,-1,-0.32256651325396957,26,10,16,23,0.283342565492158,0.5529194828055681
기준금리/NNG;하회/NNG;하/XSV,-1,-0.32256651325396957,26,10,16,37,0.283342565492158,0.5529194828055681
경기회복/NNG;이끌/VV,-1,-0.32256651325396957,26,10,16,13,0.283342565492158,0.5529194828055681
소비/NNG;위축/NNG;될/XSV,-1,-0.3229781996103315,48,19,29,26,0.33324746346894824,0.650902509938556
근원/NNG;소비자물가/NNG;상승/NNG;했/XSV,-1,-0.3256728035893469,31,12,19,19,0.29436912019065176,0.5784369029810842
미국채금리/NNG;올랐/VV,-1,-0.3256728035893469,31,12,19,29,0.29436912019065176,0.5784369029810842
고용자수/NNG;증가/NNG;하/XSV,-1,-0.3256728035893469,31,12,19,28,0.29436912019065176,0.5784369029810842
금리하락/NNG;되/XSV,-1,-0.3256728035893469,31,12,19,16,0.29436912019065176,0.5784369029810842
달러약세/NNG;이어질/VV,-1,-0.3256728035893469,31,12,19,17,0.29436912019065176,0.5784369029810842
금리인하/NNG;이어지/VV,-1,-0.32736524533621014,16,6,10,13,0.2533613523550386,0.49974557158390864
금융시장변동성/NNG;확대/NNG;될/XSV,-1,-0.32736524533621014,16,6,10,23,0.2533613523550386,0.49974557158390864
실물/NNG;경제/NNG;개선/NNG;되/XSV,-1,-0.32736524533621014,16,6,10,5,0.2533613523550386,0.49974557158390864
순이익/NNG;감소/NNG;하/XSV,-1,-0.32736524533621014,16,6,10,19,0.2533613523550386,0.49974557158390864
금리인상/NNG;신호/NNG;나올/VV,-1,-0.32736524533621014,16,6,10,13,0.2533613523550386,0.49974557158390864
달러원/NNG;올라서/VV,-1,-0.32736524533621014,16,6,10,4,0.2533613523550386,0.49974557158390864
기준금리/NNG;상승/NNG;할/XSV,-1,-0.32736524533621014,16,6,10,6,0.2533613523550386,0.49974557158390864
양적완화/NNG;줄어들/VV,-1,-0.32736524533621014,16,6,10,11,0.2533613523550386,0.49974557158390864
물가상승률/NNG;넘/VV,-1,-0.32736524533621014,16,6,10,7,0.2533613523550386,0.49974557158390864
기준금리/NNG;수준/NNG;유지/NNG;될/XSV,-1,-0.32736524533621014,16,6,10,10,0.2533613523550386,0.49974557158390864
금리/NNG;상승폭/NNG;않/VX,-1,-0.32736524533621014,16,6,10,10,0.2533613523550386,0.49974557158390864
국채금리/NNG;떨어졌/VV,-1,-0.32736524533621014,16,6,10,17,0.2533613523550386,0.49974557158390864
변동폭/NNG;확대/NNG;하/XSV,-1,-0.32736524533621014,16,6,10,5,0.2533613523550386,0.49974557158390864
위안화/NNG;절하/NNG;되/XSV,-1,-0.32736524533621014,16,6,10,13,0.2533613523550386,0.49974557158390864
침체/NNG;보이/VV,-1,-0.32736524533621014,16,6,10,10,0.2533613523550386,0.49974557158390864
원화가치/NNG;하락/NNG;하/XSV,-1,-0.32736524533621014,16,6,10,15,0.2533613523550386,0.49974557158390864
원자재/NNG;가격/NNG;급락/NNG;하/XSV,-1,-0.32736524533621014,16,6,10,14,0.2533613523550386,0.49974557158390864
성장/NNG;기대/NNG;하/XSV,-1,-0.32736524533621014,16,6,10,13,0.2533613523550386,0.49974557158390864
경기둔화/NNG;대응/NNG;하/XSV,-1,-0.32736524533621014,16,6,10,16,0.2533613523550386,0.49974557158390864
적자/NNG;냈/VV,-1,-0.32736524533621014,16,6,10,16,0.2533613523550386,0.49974557158390864
회사채/NNG;신용스프레드/NNG;확대/NNG;된/XSV,-1,-0.32736524533621014,16,6,10,12,0.2533613523550386,0.49974557158390864
투자매력/NNG;높이/VV,-1,-0.32736524533621014,16,6,10,16,0.2533613523550386,0.49974557158390864
부채/NNG;증가/NNG;했/XSV,-1,-0.32736524533621014,16,6,10,9,0.2533613523550386,0.49974557158390864
인플레이션/NNG;낮출/VV,-1,-0.32736524533621014,16,6,10,14,0.2533613523550386,0.49974557158390864
미국채가격/NNG;영향/NNG;하락/NNG;출발/NNG;된다/XSV,-1,-0.32736524533621014,16,6,10,29,0.2533613523550386,0.49974557158390864
순이자마진/NNG;하락/NNG;했/XSV,-1,-0.32736524533621014,16,6,10,15,0.2533613523550386,0.49974557158390864
경제성장률/NNG;낮/VA;지/VX,-1,-0.32736524533621014,16,6,10,15,0.2533613523550386,0.49974557158390864
지표금리/NNG;인/VCP;국고채/NNG;수익률/NNG;하락/NNG;한/XSA,-1,-0.32736524533621014,16,6,10,17,0.2533613523550386,0.49974557158390864
수익성/NNG;개선/NNG;됐/XSV,-1,-0.32736524533621014,16,6,10,11,0.2533613523550386,0.49974557158390864
수요/NNG;부진/NNG;하/XSV,-1,-0.32736524533621014,16,6,10,10,0.2533613523550386,0.49974557158390864
경기/NNG;부양책/NNG;했/XSV,-1,-0.32736524533621014,16,6,10,6,0.2533613523550386,0.49974557158390864
경제/NNG;침체/NNG;빠졌/VV,-1,-0.32736524533621014,16,6,10,3,0.2533613523550386,0.49974557158390864
이익/NNG;늘어날/VV,-1,-0.32736524533621014,16,6,10,13,0.2533613523550386,0.49974557158390864
금리수준/NNG;낮/VA;지/VX,-1,-0.32736524533621014,16,6,10,18,0.2533613523550386,0.49974557158390864
하방위험/NNG;커지/VV,-1,-0.32736524533621014,16,6,10,28,0.2533613523550386,0.49974557158390864
기준금리인하/NNG;했/XSV,-1,-0.32736524533621014,16,6,10,8,0.2533613523550386,0.49974557158390864
신용등급/NNG;오른/VV,-1,-0.32736524533621014,16,6,10,16,0.2533613523550386,0.49974557158390864
투자심리/NNG;위축/NNG;시킨/XSV,-1,-0.32736524533621014,16,6,10,21,0.2533613523550386,0.49974557158390864
금리/NNG;안정/NNG;시키/XSV,-1,-0.32736524533621014,16,6,10,8,0.2533613523550386,0.49974557158390864
불안심리/NNG;완화/NNG;됐/XSV,-1,-0.32736524533621014,16,6,10,7,0.2533613523550386,0.49974557158390864
채권스왑/NNG;스프레드/NNG;축소/NNG;됐/XSV,-1,-0.32736524533621014,16,6,10,9,0.2533613523550386,0.49974557158390864
금리인하/NNG;쉽/VA;않/VX,-1,-0.32815245582541475,53,21,32,36,0.3396211586000336,0.6710719565964695
집값/NNG;떨어지/VV,-1,-0.3297281944597481,36,14,22,28,0.30403057808100903,0.6028728992755502
이중침체/NNG;빠질/VV,-1,-0.3297281944597481,36,14,22,25,0.30403057808100903,0.6028728992755502
유동성공급/NNG;확대/NNG;하/XSV,-1,-0.3297281944597481,36,14,22,13,0.30403057808100903,0.6028728992755502
달러화/NNG;엔화/NNG;낮/VA;진/VX,-1,-0.3327147368046418,58,23,35,36,0.3455560366240997,0.6898260735234877
금리/NNG;급락/NNG;한/XSA,-1,-0.33277508432704095,75,30,45,34,0.3700679256701379,0.7388588638535413
스왑베이시스/NNG;확대/NNG;됐/XSV,-1,-0.3340286867057415,41,16,25,27,0.31269753800454286,0.626078902685227
기준금리/NNG;내려/VV,-1,-0.3340286867057415,41,16,25,38,0.31269753800454286,0.626078902685227
금리인상/NNG;고려/NNG;할/XSV,-1,-0.33822318092124626,46,18,28,24,0.32058180587586155,0.6479615597535001
유로화/NNG;내린/VV,-1,-0.33822318092124626,46,18,28,18,0.32058180587586155,0.6479615597535001
침체/NNG;된/XSV,-1,-0.33899305695808135,157,63,94,127,0.4136233522066828,0.8374722656600502
수익/NNG;올리/VV,-1,-0.3401287555736382,68,27,41,64,0.35624275086765717,0.7231460263242983
금리인하/NNG;단행/NNG;되/XSV,-1,-0.34213372964652855,51,20,31,27,0.3278158366800641,0.6684670071801375
금융안정/NNG;유의/NNG;하/XSV,-1,-0.34213372964652855,51,20,31,42,0.3278158366800641,0.6684670071801375
금리인하/NNG;따른/VV,-1,-0.344476901890306,208,83,125,140,0.4136479352176801,0.84798306325302
소비자/NNG;물가상승률/NNG;낮/VA,-1,-0.34923592229731026,88,35,53,71,0.37357793852415166,0.7741670086425044
경제지표/NNG;호조/NNG;보였/VV,-1,-0.35084364692885994,29,11,18,23,0.2762580049212564,0.5745914061761402
금리하락/NNG;했/XSV,-1,-0.35084364692885994,29,11,18,31,0.2762580049212564,0.5745914061761402
장기금리/NNG;낮추/VV,-1,-0.35084364692885994,29,11,18,25,0.2762580049212564,0.5745914061761402
경기회복/NNG;하/XSV,-1,-0.35084364692885994,29,11,18,22,0.2762580049212564,0.5745914061761402
투자/NNG;늘어날/VV,-1,-0.35084364692885994,29,11,18,28,0.2762580049212564,0.5745914061761402
경제/NNG;부담/NNG;줄/VV,-1,-0.35084364692885994,29,11,18,20,0.2762580049212564,0.5745914061761402
기준금리인하/NNG;나서/VV,-1,-0.35084364692885994,29,11,18,13,0.2762580049212564,0.5745914061761402
국채선물/NNG;낮/VA;된/XSV,-1,-0.35084364692885994,29,11,18,12,0.2762580049212564,0.5745914061761402
투자심리/NNG;개선/NNG;된/XSV,-1,-0.35084364692885994,29,11,18,27,0.2762580049212564,0.5745914061761402
금리상승/NNG;불구하/VAX,-1,-0.35084364692885994,29,11,18,26,0.2762580049212564,0.5745914061761402
달러화가치/NNG;하락/NNG;하/XSV,-1,-0.3510567794805277,34,13,21,34,0.2879487686925908,0.5991982347277703
수요/NNG;회복/NNG;되/XSV,-1,-0.3510567794805277,34,13,21,28,0.2879487686925908,0.5991982347277703
금리/NNG;상승세/NNG;보였/VV,-1,-0.3510567794805277,34,13,21,26,0.2879487686925908,0.5991982347277703
경기침체/NNG;겪/VV,-1,-0.3510567794805277,34,13,21,29,0.2879487686925908,0.5991982347277703
금리인상/NNG;가능성/NNG;있/VV,-1,-0.35265067197911226,39,15,24,42,0.29813669330012044,0.62265882686894
인플레이션압력/NNG;높일/VV,-1,-0.3535692263537794,24,9,15,11,0.26233351034425206,0.549034484083688
침체/NNG;됐/XSV,-1,-0.3535692263537794,24,9,15,21,0.26233351034425206,0.549034484083688
금리/NNG;우호적/VAX;이/VCP,-1,-0.3535692263537794,24,9,15,10,0.26233351034425206,0.549034484083688
금리/NNG;올리/VV;어렵/VA,-1,-0.3535692263537794,24,9,15,19,0.26233351034425206,0.549034484083688
침체/NNG;라는/VCP,-1,-0.3535692263537794,24,9,15,11,0.26233351034425206,0.549034484083688
달러엔/NNG;오를/VV,-1,-0.3535692263537794,24,9,15,16,0.26233351034425206,0.549034484083688
듀레이션/NNG;줄여/VV,-1,-0.3535692263537794,24,9,15,11,0.26233351034425206,0.549034484083688
원화/NNG;강세/NNG;하/XSV,-1,-0.3535692263537794,24,9,15,22,0.26233351034425206,0.549034484083688
금리인상/NNG;가능성/NNG;커진/VA,-1,-0.3535692263537794,24,9,15,17,0.26233351034425206,0.549034484083688
채권가격/NNG;떨어지/VV,-1,-0.3535692263537794,24,9,15,25,0.26233351034425206,0.549034484083688
부채/NNG;늘리/VV,-1,-0.3535692263537794,24,9,15,10,0.26233351034425206,0.549034484083688
순이익/NNG;감소/NNG;했/XSV,-1,-0.35578070299785514,76,30,46,58,0.35666136363699796,0.750236700954044
변동성/NNG;확대/NNG;될/XSV,-1,-0.35638282371198304,245,97,148,224,0.4053521997244176,0.8538340505135656
듀레이션/NNG;줄이/VV,-1,-0.35953063491936943,54,21,33,50,0.3229335361703855,0.6851549477918946
장기물/NNG;금리/NNG;상승/NNG;했/XSV,-1,-0.36266892006145934,19,7,12,11,0.24465972157606508,0.5228432057693481
시장변동성/NNG;커질/VV,-1,-0.36266892006145934,19,7,12,24,0.24465972157606508,0.5228432057693481
호황/NNG;이/VCP,-1,-0.36266892006145934,19,7,12,19,0.24465972157606508,0.5228432057693481
외환시장/NNG;달러화/NNG;원화/NNG;환율/NNG;하락/NNG;한/XSA,-1,-0.36266892006145934,19,7,12,14,0.24465972157606508,0.5228432057693481
금리/NNG;하락/NNG;했으며/XSV,-1,-0.36266892006145934,19,7,12,10,0.24465972157606508,0.5228432057693481
금리인상/NNG;멈추/VV,-1,-0.36266892006145934,19,7,12,19,0.24465972157606508,0.5228432057693481
임금상승률/NNG;높/VA,-1,-0.36266892006145934,19,7,12,13,0.24465972157606508,0.5228432057693481
설비투자/NNG;부진/NNG;한/XSA,-1,-0.36266892006145934,19,7,12,13,0.24465972157606508,0.5228432057693481
인플레이션압력/NNG;완화/NNG;된/XSV,-1,-0.36266892006145934,19,7,12,5,0.24465972157606508,0.5228432057693481
물가상승률/NNG;전망/NNG;치가/XSA,-1,-0.36266892006145934,19,7,12,17,0.24465972157606508,0.5228432057693481
금리상승/NNG;요인/NNG;이/VCP,-1,-0.36266892006145934,19,7,12,22,0.24465972157606508,0.5228432057693481
금가격/NNG;오르/VV,-1,-0.36266892006145934,19,7,12,15,0.24465972157606508,0.5228432057693481
비용/NNG;늘/VV,-1,-0.36266892006145934,19,7,12,14,0.24465972157606508,0.5228432057693481
높/VA;이자/NNG;받/VV,-1,-0.36266892006145934,19,7,12,10,0.24465972157606508,0.5228432057693481
기준금리인상/NNG;시사/NNG;한/XSA,-1,-0.36266892006145934,19,7,12,23,0.24465972157606508,0.5228432057693481
높/VA;진/VX;유로화/NNG;달러화/NNG;낮/VA,-1,-0.36266892006145934,19,7,12,12,0.24465972157606508,0.5228432057693481
채권/NNG;매수/NNG;심리/NNG;위축/NNG;됐/XSV,-1,-0.36266892006145934,19,7,12,16,0.24465972157606508,0.5228432057693481
국채수익률/NNG;급등/NNG;하/XSV,-1,-0.36266892006145934,19,7,12,12,0.24465972157606508,0.5228432057693481
주택시장/NNG;안정/NNG;되/XSV,-1,-0.36266892006145934,19,7,12,2,0.24465972157606508,0.5228432057693481
엔화/NNG;상승/NNG;하/XSV,-1,-0.36266892006145934,19,7,12,13,0.24465972157606508,0.5228432057693481
통화완화/NNG;종료/NNG;하/XSV,-1,-0.36266892006145934,19,7,12,14,0.24465972157606508,0.5228432057693481
국채/NNG;매입/NNG;늘리/VV,-1,-0.36266892006145934,19,7,12,20,0.24465972157606508,0.5228432057693481
성장모멘텀/NNG;약화/NNG;되/XSV,-1,-0.36266892006145934,19,7,12,11,0.24465972157606508,0.5228432057693481
금리/NNG;강세/NNG;보였/VV,-1,-0.36266892006145934,19,7,12,9,0.24465972157606508,0.5228432057693481
금리/NNG;내려간/VV,-1,-0.36266892006145934,19,7,12,31,0.24465972157606508,0.5228432057693481
금리인상/NNG;결정/NNG;하/XSV,-1,-0.36356510561171573,64,25,39,38,0.33617641406069393,0.7199005556920368
투자심리/NNG;위축/NNG;된/XSV,-1,-0.3664336324545051,129,51,78,92,0.3869117155786933,0.834046957928893
금리/NNG;떨어진/VV,-1,-0.3684115364520625,114,45,69,76,0.37914470005035666,0.8210486739715368
실업률/NNG;하락/NNG;하/XSV,-1,-0.3688676363672797,89,35,54,74,0.3616000071876993,0.7838818743707259
국채가격/NNG;하락/NNG;했/XSV,-1,-0.36912424469836014,104,41,63,61,0.3728971337469491,0.8088521588579046
금리상승/NNG;이어질/VV,-1,-0.3733851018458193,37,14,23,33,0.2825890165061612,0.6190506609859745
집값/NNG;오를/VV,-1,-0.3733851018458193,37,14,23,35,0.2825890165061612,0.6190506609859745
침체/NNG;빠질/VV,-1,-0.3733851018458193,37,14,23,26,0.2825890165061612,0.6190506609859745
금리인하/NNG;인한/VV,-1,-0.3733851018458193,37,14,23,25,0.2825890165061612,0.6190506609859745
수요/NNG;둔화/NNG;되/XSV,-1,-0.3733851018458193,37,14,23,25,0.2825890165061612,0.6190506609859745
수요/NNG;줄어든/VV,-1,-0.3744001784934079,52,20,32,25,0.31084863832796555,0.682565645952549
마이너스성장/NNG;하/XSV,-1,-0.37529396040710006,32,12,20,19,0.2705598690008117,0.5953353943299797
인플레이션위험/NNG;높/VA,-1,-0.37529396040710006,32,12,20,21,0.2705598690008117,0.5953353943299797
통화정책/NNG;유지/NNG;할/XSV,-1,-0.37630329298332743,62,24,38,43,0.32556390527052065,0.7180505374496929
신용위험/NNG;높/VA,-1,-0.378226573847914,77,30,47,40,0.34356396788461163,0.7611553735051096
국고채/NNG;금리/NNG;상승/NNG;했/XSV,-1,-0.37970945980202564,130,51,79,101,0.3778694024935844,0.8400609974042051
금리인하/NNG;기대/NNG;하/XSV;어렵/VA,-1,-0.38025480343331775,27,10,17,18,0.25631802472633924,0.5705603948356446
금리인하/NNG;주장/NNG;했/XSV,-1,-0.38025480343331775,27,10,17,22,0.25631802472633924,0.5705603948356446
경기과열/NNG;막/VV,-1,-0.38025480343331775,27,10,17,31,0.25631802472633924,0.5705603948356446
경기/NNG;부양책/NNG;이/VCP,-1,-0.38025480343331775,27,10,17,20,0.25631802472633924,0.5705603948356446
수익성/NNG;떨어지/VV,-1,-0.38025480343331775,27,10,17,25,0.25631802472633924,0.5705603948356446
대출/NNG;줄어들/VV,-1,-0.38025480343331775,27,10,17,21,0.25631802472633924,0.5705603948356446
높/VA;변동성/NNG;보이/VV,-1,-0.38025480343331775,27,10,17,29,0.25631802472633924,0.5705603948356446
변동폭/NNG;커지/VV,-1,-0.38025480343331775,27,10,17,9,0.25631802472633924,0.5705603948356446
금리인하/NNG;가능성/NNG;열/VV,-1,-0.384565555130681,110,43,67,61,0.3659283617336132,0.8228152033917957
기준금리/NNG;인하/NNG;한/XSA,-1,-0.3853403773913958,347,135,212,232,0.3840487496496186,0.8651319236417143
인플레이션/NNG;잡/VV,-1,-0.38559869222554,105,41,64,86,0.36234946360444104,0.8167460039420731
수요/NNG;줄/VV,-1,-0.38653229403018785,100,39,61,68,0.35849690708180454,0.8098365073646724
경기둔화/NNG;따른/VV,-1,-0.38915396693413107,141,55,86,98,0.37422409916248345,0.850595104438451
기준금리/NNG;내릴/VV,-1,-0.3893499682252457,185,72,113,154,0.3795717000901416,0.8631484829541833
지표물/NNG;인/VCP;국고채/NNG;금리/NNG;내린/VV,-1,-0.3897113322142278,65,25,40,36,0.321664671320852,0.7320907392244601
금리/NNG;인하/NNG;될/XSV,-1,-0.39010977560697324,118,46,72,79,0.3660242889651489,0.8338336354973765
금융시장안정/NNG;위한/VV,-1,-0.390418118918221,50,19,31,31,0.2981881658124439,0.6797914766472583
수출/NNG;감소/NNG;했/XSV,-1,-0.390418118918221,50,19,31,34,0.2981881658124439,0.6797914766472583
변동성/NNG;줄이/VV,-1,-0.390418118918221,50,19,31,47,0.2981881658124439,0.6797914766472583
수요/NNG;확대/NNG;하/XSV,-1,-0.3912663672131649,22,8,14,10,0.23857001909270253,0.5449672710847971
모기지/NNG;금리/NNG;하락/NNG;했/XSV,-1,-0.3912663672131649,22,8,14,8,0.23857001909270253,0.5449672710847971
임금상승률/NNG;낮/VA,-1,-0.3912663672131649,22,8,14,9,0.23857001909270253,0.5449672710847971
채권금리/NNG;급락/NNG;했/XSV,-1,-0.3912663672131649,22,8,14,7,0.23857001909270253,0.5449672710847971
금리변동성/NNG;커지/VV,-1,-0.3912663672131649,22,8,14,15,0.23857001909270253,0.5449672710847971
채권/NNG;시장/NNG;국고채/NNG;금리/NNG;오른/VV,-1,-0.3912663672131649,22,8,14,21,0.23857001909270253,0.5449672710847971
기준금리인하/NNG;쉽/VA;않/VX,-1,-0.3912663672131649,22,8,14,13,0.23857001909270253,0.5449672710847971
투자심리/NNG;약화/NNG;되/XSV,-1,-0.3912663672131649,22,8,14,7,0.23857001909270253,0.5449672710847971
장기물/NNG;금리/NNG;하락/NNG;하/XSV,-1,-0.3912663672131649,22,8,14,26,0.23857001909270253,0.5449672710847971
금리/NNG;빠지/VV,-1,-0.39316452896219967,40,15,25,37,0.27806999253945786,0.6380523256010346
급성장/NNG;하/XSV,-1,-0.39666017320617764,35,13,22,29,0.2659147829895189,0.6152340834449458
수입/NNG;줄/VV,-1,-0.39666017320617764,35,13,22,22,0.2659147829895189,0.6152340834449458
수입/NNG;증가/NNG;한/XSA,-1,-0.39666017320617764,35,13,22,23,0.2659147829895189,0.6152340834449458
물가/NNG;하락/NNG;하/XSV,-1,-0.40201640775393166,68,26,42,54,0.318082494108855,0.7453672515998666
원자재/NNG;가격/NNG;상승/NNG;하/XSV,-1,-0.40313680831482435,30,11,19,21,0.25164306404115083,0.5912571164566798
금리인하/NNG;될/VV,-1,-0.40313680831482435,30,11,19,20,0.25164306404115083,0.5912571164566798
시장금리/NNG;하락/NNG;한/XSA,-1,-0.40313680831482435,30,11,19,11,0.25164306404115083,0.5912571164566798
경기회복/NNG;본격화/NNG;되/XSV,-1,-0.40313680831482435,30,11,19,5,0.25164306404115083,0.5912571164566798
성장/NNG;긍정적/VAX,-1,-0.40313680831482435,30,11,19,22,0.25164306404115083,0.5912571164566798
소매판매/NNG;증가/NNG;했/XSV,-1,-0.40313680831482435,30,11,19,42,0.25164306404115083,0.5912571164566798
침체/NNG;돼/XSV,-1,-0.40313680831482435,30,11,19,18,0.25164306404115083,0.5912571164566798
유가급등/NNG;따른/VV,-1,-0.4041945602183141,58,22,36,33,0.3030513848104204,0.7138464476284988
외환시장/NNG;현물환/NNG;상승/NNG;한/XSA,-1,-0.40568296359863387,53,20,33,64,0.29443655948353437,0.6960267865588178
원달러/NNG;하락/NNG;하/XSV,-1,-0.407744880068157,48,18,30,34,0.28490047994154527,0.6768187326013436
유로화/NNG;달러화/NNG;낮/VA;진/VX,-1,-0.407744880068157,48,18,30,32,0.28490047994154527,0.6768187326013436
금리인상/NNG;단행/NNG;했/XSV,-1,-0.4086162206712779,109,42,67,59,0.3490029602517212,0.8308373966651323
금리인하/NNG;가능성/NNG;낮/VA,-1,-0.4128305617322927,99,38,61,97,0.34026526203917956,0.8182874895373468
유로달러/NNG;오른/VV,-1,-0.41511971260806424,66,25,41,68,0.3075763492808562,0.7437717896440654
손실/NNG;커질/VV,-1,-0.4151355656724801,25,9,16,11,0.2341777577986275,0.5663032276280318
국고채/NNG;수익률/NNG;오른/VV,-1,-0.4151355656724801,25,9,16,20,0.2341777577986275,0.5663032276280318
적자/NNG;내/VV,-1,-0.4151355656724801,25,9,16,18,0.2341777577986275,0.5663032276280318
금리인상/NNG;적극적/VAX,-1,-0.4151355656724801,25,9,16,17,0.2341777577986275,0.5663032276280318
기준금리/NNG;밑돌/VV,-1,-0.4151355656724801,25,9,16,16,0.2341777577986275,0.5663032276280318
산업생산/NNG;감소/NNG;하/XSV,-1,-0.4151355656724801,25,9,16,15,0.2341777577986275,0.5663032276280318
국채가격/NNG;하락/NNG;하/XSV,-1,-0.4151355656724801,25,9,16,10,0.2341777577986275,0.5663032276280318
내외금리차/NNG;축소/NNG;되/XSV,-1,-0.4151355656724801,25,9,16,17,0.2341777577986275,0.5663032276280318
회사채/NNG;수익률/NNG;하락/NNG;한/XSA,-1,-0.4153239880093147,17,6,11,10,0.21449473531105234,0.5189406584047804
인플레이션기대/NNG;심리/NNG;잡/VV,-1,-0.4153239880093147,17,6,11,12,0.21449473531105234,0.5189406584047804
금리인상/NNG;나타날/VV,-1,-0.4153239880093147,17,6,11,12,0.21449473531105234,0.5189406584047804
경기회복기대/NNG;높/VA,-1,-0.4153239880093147,17,6,11,14,0.21449473531105234,0.5189406584047804
채권/NNG;시장심리/NNG;악화/NNG;된/XSV,-1,-0.4153239880093147,17,6,11,1,0.21449473531105234,0.5189406584047804
금리인하/NNG;소극적/VAX,-1,-0.4153239880093147,17,6,11,12,0.21449473531105234,0.5189406584047804
양적완화/NNG;할/VV,-1,-0.4153239880093147,17,6,11,14,0.21449473531105234,0.5189406584047804
금리동결/NNG;주장/NNG;한/XSA,-1,-0.4153239880093147,17,6,11,11,0.21449473531105234,0.5189406584047804
엔화가치/NNG;상승/NNG;하/XSV,-1,-0.4153239880093147,17,6,11,11,0.21449473531105234,0.5189406584047804
달러원/NNG;급락/NNG;한/XSA,-1,-0.4153239880093147,17,6,11,13,0.21449473531105234,0.5189406584047804
실적/NNG;올린/VV,-1,-0.4153239880093147,17,6,11,11,0.21449473531105234,0.5189406584047804
수요/NNG;증가/NNG;함/XSV,-1,-0.4153239880093147,17,6,11,11,0.21449473531105234,0.5189406584047804
변동성/NNG;높/VA;진/VX,-1,-0.4153239880093147,17,6,11,10,0.21449473531105234,0.5189406584047804
금리상승/NNG;커졌/VV,-1,-0.4153239880093147,17,6,11,6,0.21449473531105234,0.5189406584047804
채권금리/NNG;올라가/VV,-1,-0.4153239880093147,17,6,11,18,0.21449473531105234,0.5189406584047804
발행/NNG;금리/NNG;낮추/VV,-1,-0.4153239880093147,17,6,11,13,0.21449473531105234,0.5189406584047804
달러강세/NNG;영향/NNG;받/VV,-1,-0.4153239880093147,17,6,11,16,0.21449473531105234,0.5189406584047804
원화/NNG;강세/NNG;불구하/VAX,-1,-0.4153239880093147,17,6,11,14,0.21449473531105234,0.5189406584047804
기준금리/NNG;올려도/VV,-1,-0.4153239880093147,17,6,11,22,0.21449473531105234,0.5189406584047804
고용지표/NNG;호전/NNG;되/XSV,-1,-0.4153239880093147,17,6,11,8,0.21449473531105234,0.5189406584047804
gdp/NNG;하락/NNG;하/XSV,-1,-0.4153239880093147,17,6,11,2,0.21449473531105234,0.5189406584047804
호황/NNG;기에/XSA,-1,-0.4153239880093147,17,6,11,17,0.21449473531105234,0.5189406584047804
경기/NNG;뚜렷한/VAX;회복세/NNG;보이/VV,-1,-0.4153239880093147,17,6,11,5,0.21449473531105234,0.5189406584047804
기준금리동결/NNG;가능성/NNG;높/VA,-1,-0.41549119295463266,38,14,24,9,0.2620837716777251,0.6343320169216812
금리인상/NNG;가능성/NNG;시사/NNG;한/XSA,-1,-0.41549119295463266,38,14,24,38,0.2620837716777251,0.6343320169216812
인플레이션압력/NNG;증가/NNG;하/XSV,-1,-0.41549119295463266,38,14,24,22,0.2620837716777251,0.6343320169216812
양적완화/NNG;할/XSV,-1,-0.41549119295463266,38,14,24,32,0.2620837716777251,0.6343320169216812
금리인하/NNG;가능성/NNG;시사/NNG;했/XSV,-1,-0.41549119295463266,38,14,24,20,0.2620837716777251,0.6343320169216812
투자/NNG;증가/NNG;하/XSV,-1,-0.41549119295463266,38,14,24,51,0.2620837716777251,0.6343320169216812
지급준비율/NNG;인상/NNG;했/XSV,-1,-0.4171363236224098,61,23,38,19,0.2997154415155824,0.7283051090954733
고용지표/NNG;호조/NNG;보이/VV,-1,-0.419532334033087,56,21,35,51,0.29109228162197387,0.7114696634491688
금리인하/NNG;있/VV,-1,-0.4230163610147226,33,12,21,16,0.24795252433508205,0.6111835660330162
달러엔/NNG;상승/NNG;했/XSV,-1,-0.4230163610147226,33,12,21,22,0.24795252433508205,0.6111835660330162
서부텍사스산원유/NNG;가격/NNG;하락/NNG;한/XSA,-1,-0.4230163610147226,33,12,21,28,0.24795252433508205,0.6111835660330162
미국채금리/NNG;오르/VV,-1,-0.4265705504964161,46,17,29,44,0.27092828199593266,0.6736318109547733
집값/NNG;오르/VV,-1,-0.42895891642661355,64,24,40,46,0.29668856174281566,0.7420052588390283
불안심리/NNG;확산/NNG;하/XSV,-1,-0.4354933883728439,28,10,18,16,0.2309412714645533,0.5869271508321009
시장금리/NNG;상승/NNG;한/XSA,-1,-0.4354933883728439,28,10,18,20,0.2309412714645533,0.5869271508321009
통화긴축/NNG;중단/NNG;할/XSV,-1,-0.4354933883728439,28,10,18,18,0.2309412714645533,0.5869271508321009
금리/NNG;상승/NNG;했으나/XSV,-1,-0.4354933883728439,28,10,18,29,0.2309412714645533,0.5869271508321009
침체/NNG;될/XSV,-1,-0.43594516882752077,54,20,34,32,0.2786208877313493,0.7088926240501073
소매판매/NNG;증가/NNG;해/XSV,-1,-0.4380775738858319,20,7,13,24,0.2113777375083245,0.5406476871032003
국채/NNG;가격상승폭/NNG;제한/NNG;됐/XSV,-1,-0.4380775738858319,20,7,13,12,0.2113777375083245,0.5406476871032003
모기지/NNG;금리/NNG;낮/VA;진/VX,-1,-0.4380775738858319,20,7,13,4,0.2113777375083245,0.5406476871032003
동일점/NNG;매출/NNG;증가/NNG;했/XSV,-1,-0.4380775738858319,20,7,13,12,0.2113777375083245,0.5406476871032003
crs금리/NNG;급락/NNG;하/XSV,-1,-0.4380775738858319,20,7,13,7,0.2113777375083245,0.5406476871032003
경기/NNG;부양책/NNG;하/XSV,-1,-0.4380775738858319,20,7,13,16,0.2113777375083245,0.5406476871032003
비용/NNG;낮추/VV,-1,-0.4380775738858319,20,7,13,9,0.2113777375083245,0.5406476871032003
수익/NNG;증가/NNG;하/XSV,-1,-0.4380775738858319,20,7,13,22,0.2113777375083245,0.5406476871032003
자산매입/NNG;줄이/VV,-1,-0.4380775738858319,20,7,13,21,0.2113777375083245,0.5406476871032003
지급준비율/NNG;인하/NNG;할/XSV,-1,-0.4380775738858319,20,7,13,17,0.2113777375083245,0.5406476871032003
투자심리/NNG;안정/NNG;되/XSV,-1,-0.4380775738858319,20,7,13,11,0.2113777375083245,0.5406476871032003
달러강세/NNG;불구하/VAX,-1,-0.4380775738858319,20,7,13,12,0.2113777375083245,0.5406476871032003
기준금리인상/NNG;앞당길/VV,-1,-0.4380775738858319,20,7,13,9,0.2113777375083245,0.5406476871032003
유로화/NNG;내려앉/VV,-1,-0.4380775738858319,20,7,13,13,0.2113777375083245,0.5406476871032003
경기회복세/NNG;미약하/VAX,-1,-0.4380775738858319,20,7,13,22,0.2113777375083245,0.5406476871032003
매수/NNG;심리/NNG;위축/NNG;시키/XSV,-1,-0.4380775738858319,20,7,13,15,0.2113777375083245,0.5406476871032003
엔화/NNG;강세/NNG;보인/VV,-1,-0.4380775738858319,20,7,13,13,0.2113777375083245,0.5406476871032003
채권/NNG;시장/NNG;강세/NNG;하/XSV,-1,-0.4380775738858319,20,7,13,3,0.2113777375083245,0.5406476871032003
금리/NNG;내려왔/VV,-1,-0.4380775738858319,20,7,13,12,0.2113777375083245,0.5406476871032003
가계부채/NNG;증가/NNG;따른/VV,-1,-0.4380775738858319,20,7,13,18,0.2113777375083245,0.5406476871032003
물가상승압력/NNG;완화/NNG;되/XSV,-1,-0.4380775738858319,20,7,13,10,0.2113777375083245,0.5406476871032003
성장/NNG;가능/NNG;한/XSA,-1,-0.4380775738858319,20,7,13,13,0.2113777375083245,0.5406476871032003
경기/NNG;회복/NNG;조짐/NNG;보이/VV,-1,-0.4380775738858319,20,7,13,4,0.2113777375083245,0.5406476871032003
달러화/NNG;강세/NNG;지지/NNG;받/VV,-1,-0.44046571399440826,36,13,23,24,0.2450017627148685,0.6303668247521403
금리급락/NNG;따른/VV,-1,-0.44046571399440826,36,13,23,23,0.2450017627148685,0.6303668247521403
양적완화/NNG;시행/NNG;하/XSV,-1,-0.4407606022445587,49,18,31,38,0.2680794480722545,0.6902483062245197
금리하락/NNG;제한적/VAX,-1,-0.4436066535790518,62,23,39,61,0.28539839915810056,0.740056289978958
달러화/NNG;엔화/NNG;오른/VV,-1,-0.4531351459811235,31,11,20,23,0.22852105456285216,0.6068668188913552
양적완화/NNG;나설/VV,-1,-0.45356453123790064,52,19,33,53,0.265601369876828,0.7061007812025577
실업률/NNG;상승/NNG;하/XSV,-1,-0.45356453123790064,52,19,33,37,0.265601369876828,0.7061007812025577
가계부채/NNG;늘어나/VV,-1,-0.4540876993694689,65,24,41,51,0.28295891510841215,0.7532372042824597
금리상승압력/NNG;높/VA,-1,-0.4540876993694689,65,24,41,78,0.28295891510841215,0.7532372042824597
기준금리/NNG;인하/NNG;해야/XSV,-1,-0.4540876993694689,65,24,41,39,0.28295891510841215,0.7532372042824597
달러화/NNG;올랐/VV,-1,-0.4559071081640538,39,14,25,38,0.24261782404046264,0.6488181385750778
회사채/NNG;수익률/NNG;오른/VV,-1,-0.4559071081640538,39,14,25,25,0.24261782404046264,0.6488181385750778
기준금리인하/NNG;단행/NNG;될/XSV,-1,-0.4559071081640538,39,14,25,25,0.24261782404046264,0.6488181385750778
재정지출확대/NNG;따른/VV,-1,-0.4571488751407312,23,8,15,6,0.20940650312913822,0.5617619633374241
달러화/NNG;상승압력/NNG;가했/VV,-1,-0.4571488751407312,23,8,15,15,0.20940650312913822,0.5617619633374241
달러화가치/NNG;떨어질/VV,-1,-0.4571488751407312,23,8,15,7,0.20940650312913822,0.5617619633374241
기준금리인상/NNG;가능/NNG;할/XSV,-1,-0.4571488751407312,23,8,15,29,0.20940650312913822,0.5617619633374241
국고/NNG;금리/NNG;상승/NNG;하/XSV,-1,-0.4571488751407312,23,8,15,26,0.20940650312913822,0.5617619633374241
투자/NNG;증가/NNG;한/XSA,-1,-0.4571488751407312,23,8,15,7,0.20940650312913822,0.5617619633374241
부채/NNG;늘/VV,-1,-0.4571488751407312,23,8,15,15,0.20940650312913822,0.5617619633374241
매출/NNG;줄/VV,-1,-0.4571488751407312,23,8,15,19,0.20940650312913822,0.5617619633374241
금리인하/NNG;그칠/VV,-1,-0.4571488751407312,23,8,15,11,0.20940650312913822,0.5617619633374241
부양책/NNG;할/XSV,-1,-0.4571488751407312,23,8,15,9,0.20940650312913822,0.5617619633374241
금리/NNG;급등/NNG;한/XSA,-1,-0.4585012026235965,115,43,72,69,0.31798849249272676,0.8559707686591105
수출/NNG;감소/NNG;한/XSA,-1,-0.46049780297039056,47,17,30,32,0.25393566371887366,0.6870186309529489
소비자물가/NNG;상승/NNG;했/XSV,-1,-0.46715160102632836,76,28,48,59,0.2869622825707427,0.7896406810693087
지급준비율/NNG;인상/NNG;할/XSV,-1,-0.46860708702187637,34,12,22,24,0.2266943043287782,0.6261278281352175
경제/NNG;위축/NNG;될/XSV,-1,-0.46860708702187637,34,12,22,13,0.2266943043287782,0.6261278281352175
국고/NNG;금리/NNG;하락/NNG;하/XSV,-1,-0.46860708702187637,34,12,22,31,0.2266943043287782,0.6261278281352175
소비자물가/NNG;올라/VV,-1,-0.46860708702187637,34,12,22,20,0.2266943043287782,0.6261278281352175
경제/NNG;회복/NNG;될/XSV,-1,-0.46966089772394826,42,15,27,33,0.24067536011119375,0.6665412789233801
하방위험/NNG;높/VA,-1,-0.47254174317685727,50,18,32,50,0.25199603200410836,0.703077958575463
신용경색/NNG;완화/NNG;되/XSV,-1,-0.47254174317685727,50,18,32,16,0.25199603200410836,0.703077958575463
주택담보대출/NNG;금리/NNG;상승/NNG;하/XSV,-1,-0.47353917319693806,26,9,17,11,0.20817057310419834,0.5822971188652973
경제회복/NNG;위해/VV,-1,-0.47353917319693806,26,9,17,22,0.20817057310419834,0.5822971188652973
금리상승/NNG;요인/NNG;작용/NNG;할/XSV,-1,-0.47353917319693806,26,9,17,15,0.20817057310419834,0.5822971188652973
미국채금리/NNG;급등/NNG;하/XSV,-1,-0.47353917319693806,26,9,17,30,0.20817057310419834,0.5822971188652973
금리인상/NNG;반대/NNG;하/XSV,-1,-0.47353917319693806,26,9,17,22,0.20817057310419834,0.5822971188652973
장기물/NNG;하락/NNG;했/XSV,-1,-0.47353917319693806,26,9,17,20,0.20817057310419834,0.5822971188652973
서부텍사스산원유/NNG;가격/NNG;상승/NNG;한/XSA,-1,-0.47353917319693806,26,9,17,26,0.20817057310419834,0.5822971188652973
물가상승률/NNG;인/VCP,-1,-0.47353917319693806,26,9,17,17,0.20817057310419834,0.5822971188652973
유동성/NNG;확보/NNG;하/XSV,-1,-0.47643001479233105,87,32,55,65,0.2905385045097298,0.818784855440207
성장/NNG;위한/VV,-1,-0.48050337980299784,74,27,47,81,0.2768734388906845,0.7885577934294403
기준금리/NNG;인하/NNG;되/XSV,-1,-0.4806787027645266,122,45,77,124,0.30547084877987,0.8704020789854094
경제/NNG;회복/NNG;하/XSV,-1,-0.4819760671056801,45,16,29,54,0.23908154741550292,0.6835371051025534
경제/NNG;회복세/NNG;보이/VV,-1,-0.48342076483847685,53,19,34,40,0.2503304732272744,0.7183976904850271
기대심리/NNG;확산/NNG;되/XSV,-1,-0.48342076483847685,53,19,34,46,0.2503304732272744,0.7183976904850271
주택/NNG;판매/NNG;증가/NNG;한/XSA,-1,-0.4854319882143704,15,5,10,8,0.17841069596423464,0.5146991479972612
재정위기/NNG;확산/NNG;될/XSV,-1,-0.4854319882143704,15,5,10,21,0.17841069596423464,0.5146991479972612
달러화/NNG;벗어나/VV,-1,-0.4854319882143704,15,5,10,12,0.17841069596423464,0.5146991479972612
물가안정/NNG;달성/NNG;하/XSV,-1,-0.4854319882143704,15,5,10,13,0.17841069596423464,0.5146991479972612
신용등급/NNG;상향/NNG;조정/NNG;한/XSA,-1,-0.4854319882143704,15,5,10,19,0.17841069596423464,0.5146991479972612
대출/NNG;강화/NNG;하/XSV,-1,-0.4854319882143704,15,5,10,11,0.17841069596423464,0.5146991479972612
하방위험/NNG;커/VA,-1,-0.4854319882143704,15,5,10,12,0.17841069596423464,0.5146991479972612
성장/NNG;무게/NNG;두/VV,-1,-0.4854319882143704,15,5,10,5,0.17841069596423464,0.5146991479972612
성장세/NNG;한/XSA,-1,-0.4854319882143704,15,5,10,12,0.17841069596423464,0.5146991479972612
대출/NNG;감소/NNG;하/XSV,-1,-0.4854319882143704,15,5,10,10,0.17841069596423464,0.5146991479972612
금리인하/NNG;기대/NNG;반영/NNG;하/XSV,-1,-0.4854319882143704,15,5,10,14,0.17841069596423464,0.5146991479972612
시장금리/NNG;급등/NNG;했/XSV,-1,-0.4854319882143704,15,5,10,7,0.17841069596423464,0.5146991479972612
cd금리/NNG;떨어지/VV,-1,-0.4854319882143704,15,5,10,15,0.17841069596423464,0.5146991479972612
gdp/NNG;성장/NNG;했/XSV,-1,-0.4854319882143704,15,5,10,16,0.17841069596423464,0.5146991479972612
경제/NNG;약화/NNG;되/XSV,-1,-0.4854319882143704,15,5,10,9,0.17841069596423464,0.5146991479972612
가능/NNG;한/XSA;성장/NNG;물가안정/NNG,-1,-0.4854319882143704,15,5,10,3,0.17841069596423464,0.5146991479972612
원달러/NNG;상승/NNG;한/XSA,-1,-0.4854319882143704,15,5,10,15,0.17841069596423464,0.5146991479972612
금리/NNG;인하/NNG;키로/XSV,-1,-0.4854319882143704,15,5,10,7,0.17841069596423464,0.5146991479972612
실적/NNG;감소/NNG;한/XSA,-1,-0.4854319882143704,15,5,10,6,0.17841069596423464,0.5146991479972612
증시/NNG;하락압력/NNG;받/VV,-1,-0.4854319882143704,15,5,10,5,0.17841069596423464,0.5146991479972612
유가하락/NNG;인한/VV,-1,-0.4854319882143704,15,5,10,31,0.17841069596423464,0.5146991479972612
매수/NNG;심리/NNG;강화/NNG;되/XSV,-1,-0.4854319882143704,15,5,10,6,0.17841069596423464,0.5146991479972612
가동률/NNG;하락/NNG;하/XSV,-1,-0.4854319882143704,15,5,10,11,0.17841069596423464,0.5146991479972612
단기물/NNG;금리/NNG;오르/VV,-1,-0.4854319882143704,15,5,10,15,0.17841069596423464,0.5146991479972612
지급준비율/NNG;낮추/VV,-1,-0.4854319882143704,15,5,10,15,0.17841069596423464,0.5146991479972612
실적/NNG;호조/NNG;보인/VV,-1,-0.4854319882143704,15,5,10,14,0.17841069596423464,0.5146991479972612
적자전환/NNG;했/XSV,-1,-0.4854319882143704,15,5,10,15,0.17841069596423464,0.5146991479972612
대출규제/NNG;강화/NNG;되/XSV,-1,-0.4854319882143704,15,5,10,8,0.17841069596423464,0.5146991479972612
소매판매/NNG;감소/NNG;했/XSV,-1,-0.4854319882143704,15,5,10,20,0.17841069596423464,0.5146991479972612
금리인상/NNG;자제/NNG;할/XSV,-1,-0.4854319882143704,15,5,10,6,0.17841069596423464,0.5146991479972612
성장둔화/NNG;인한/VV,-1,-0.4854319882143704,15,5,10,1,0.17841069596423464,0.5146991479972612
연체율/NNG;상승/NNG;했/XSV,-1,-0.4854319882143704,15,5,10,8,0.17841069596423464,0.5146991479972612
달러화/NNG;밑돌/VV,-1,-0.4854319882143704,15,5,10,5,0.17841069596423464,0.5146991479972612
지표물/NNG;오른/VV,-1,-0.4854319882143704,15,5,10,20,0.17841069596423464,0.5146991479972612
금리/NNG;높/VA;지/VX,-1,-0.4867975803385204,69,25,44,53,0.2680236919992033,0.7759934835501158
억제/NNG;하/XSV;위해/VV;금리/NNG;인상/NNG,-1,-0.48786784363516345,29,10,19,11,0.20742840405768417,0.6022428026764358
임금/NNG;오르/VV,-1,-0.48786784363516345,29,10,19,12,0.20742840405768417,0.6022428026764358
달러약세/NNG;부추기/VV,-1,-0.48786784363516345,29,10,19,20,0.20742840405768417,0.6022428026764358
채권가격/NNG;상승/NNG;하/XSV,-1,-0.48786784363516345,29,10,19,32,0.20742840405768417,0.6022428026764358
시장변동성/NNG;확대/NNG;될/XSV,-1,-0.4945049129309683,40,14,26,37,0.2242589118902271,0.6625933273458234
경기/NNG;악화/NNG;될/XSV,-1,-0.4945049129309683,40,14,26,20,0.2242589118902271,0.6625933273458234
주택가격/NNG;떨어지/VV,-1,-0.4974058996043411,18,6,12,14,0.18001172814877334,0.5359670005090416
금리인하/NNG;기대/NNG;유지/NNG;될/XSV,-1,-0.4974058996043411,18,6,12,18,0.18001172814877334,0.5359670005090416
성장둔화/NNG;따른/VV,-1,-0.4974058996043411,18,6,12,12,0.18001172814877334,0.5359670005090416
원달러/NNG;하락/NNG;했/XSV,-1,-0.4974058996043411,18,6,12,22,0.18001172814877334,0.5359670005090416
원화/NNG;강세/NNG;베팅/NNG;하/VV,-1,-0.4974058996043411,18,6,12,11,0.18001172814877334,0.5359670005090416
내수부진/NNG;되/XSV,-1,-0.4974058996043411,18,6,12,12,0.18001172814877334,0.5359670005090416
금리상승/NNG;했/XSV,-1,-0.4974058996043411,18,6,12,23,0.18001172814877334,0.5359670005090416
베이시스/NNG;축소/NNG;되/XSV,-1,-0.4974058996043411,18,6,12,10,0.18001172814877334,0.5359670005090416
성장/NNG;하/XSV;않/VX,-1,-0.4974058996043411,18,6,12,10,0.18001172814877334,0.5359670005090416
생산자물가/NNG;오르/VV,-1,-0.4974058996043411,18,6,12,5,0.18001172814877334,0.5359670005090416
국채금리/NNG;급등/NNG;했/XSV,-1,-0.4974058996043411,18,6,12,25,0.18001172814877334,0.5359670005090416
금융시장/NNG;확산/NNG;되/XSV,-1,-0.4974058996043411,18,6,12,4,0.18001172814877334,0.5359670005090416
경기회복/NNG;기대/NNG;높/VA,-1,-0.4974058996043411,18,6,12,16,0.18001172814877334,0.5359670005090416
투자/NNG;늘어난/VV,-1,-0.4974058996043411,18,6,12,10,0.18001172814877334,0.5359670005090416
금리인하/NNG;나선/VV,-1,-0.4974058996043411,18,6,12,28,0.18001172814877334,0.5359670005090416
금융시장/NNG;불안정/NNG;한/XSA,-1,-0.4974058996043411,18,6,12,11,0.18001172814877334,0.5359670005090416
기준금리/NNG;유지/NNG;키로/XSV,-1,-0.4974058996043411,18,6,12,9,0.18001172814877334,0.5359670005090416
달러화/NNG;올라/VV,-1,-0.4974058996043411,18,6,12,15,0.18001172814877334,0.5359670005090416
기준금리인하/NNG;인/VCP,-1,-0.4974058996043411,18,6,12,13,0.18001172814877334,0.5359670005090416
금리/NNG;낮/VA;이/VCP,-1,-0.5005449224571782,32,11,21,14,0.20702897076497068,0.6215796261251613
달러화/NNG;상승/NNG;한/XSA,-1,-0.5005449224571782,32,11,21,46,0.20702897076497068,0.6215796261251613
달러강세/NNG;나타나/VV,-1,-0.5005449224571782,32,11,21,40,0.20702897076497068,0.6215796261251613
재정지출/NNG;늘리/VV,-1,-0.5005449224571782,32,11,21,11,0.20702897076497068,0.6215796261251613
경기침체/NNG;이어질/VV,-1,-0.5005449224571782,32,11,21,10,0.20702897076497068,0.6215796261251613
달러화/NNG;급등/NNG;했/XSV,-1,-0.5005449224571782,32,11,21,36,0.20702897076497068,0.6215796261251613
금리/NNG;인하/NNG;되/XSV,-1,-0.5018828887146831,67,24,43,43,0.25698519769180317,0.7743279373985114
금리/NNG;끌어올리/VV,-1,-0.5054425671622891,43,15,28,33,0.22346641206762405,0.6797818993139182
금리인하/NNG;단행/NNG;했/XSV,-1,-0.5076301473468163,105,38,67,47,0.28117077935929774,0.8603635015557345
수출/NNG;증가/NNG;한/XSA,-1,-0.507990170337606,78,28,50,50,0.26378867334549627,0.8079585285331788
고용/NNG;부진/NNG;하/XSV,-1,-0.5084958375266772,21,7,14,16,0.1815585722475409,0.5568542422877502
기준금리인상/NNG;단행/NNG;했/XSV,-1,-0.5084958375266772,21,7,14,19,0.1815585722475409,0.5568542422877502
낙찰/NNG;금리/NNG;높/VA;형성/NNG,-1,-0.5084958375266772,21,7,14,12,0.1815585722475409,0.5568542422877502
금리인상/NNG;속도/NNG;완만할/VAX,-1,-0.5084958375266772,21,7,14,38,0.1815585722475409,0.5568542422877502
설비투자/NNG;감소/NNG;하/XSV,-1,-0.5084958375266772,21,7,14,18,0.1815585722475409,0.5568542422877502
유로화/NNG;반락/NNG;했/XSV,-1,-0.5084958375266772,21,7,14,7,0.1815585722475409,0.5568542422877502
금리상승압력/NNG;커질/VV,-1,-0.5084958375266772,21,7,14,26,0.1815585722475409,0.5568542422877502
경쟁력강화/NNG;위해/VV,-1,-0.5084958375266772,21,7,14,11,0.1815585722475409,0.5568542422877502
고용지표/NNG;밑돌/VV,-1,-0.5084958375266772,21,7,14,10,0.1815585722475409,0.5568542422877502
높/VA;실업률/NNG;낮/VA,-1,-0.5084958375266772,21,7,14,8,0.1815585722475409,0.5568542422877502
완화적/VAX;통화정책/NNG;유지/NNG;하/XSV,-1,-0.5084958375266772,21,7,14,21,0.1815585722475409,0.5568542422877502
소비자물가/NNG;상승률/NNG;하/XSV,-1,-0.5084958375266772,21,7,14,14,0.1815585722475409,0.5568542422877502
금가격/NNG;오른/VV,-1,-0.5084958375266772,21,7,14,8,0.1815585722475409,0.5568542422877502
미국채금리/NNG;급락/NNG;한/XSA,-1,-0.5084958375266772,21,7,14,10,0.1815585722475409,0.5568542422877502
투자심리/NNG;냉각/NNG;시켰/XSV,-1,-0.5084958375266772,21,7,14,16,0.1815585722475409,0.5568542422877502
경기회복세/NNG;보이/VV,-1,-0.5084958375266772,21,7,14,25,0.1815585722475409,0.5568542422877502
소비자심리지수/NNG;하락/NNG;했/XSV,-1,-0.5084958375266772,21,7,14,15,0.1815585722475409,0.5568542422877502
채권금리/NNG;상승/NNG;했/XSV,-1,-0.5091435967332072,70,25,45,93,0.2557782868378084,0.7858636554218255
금리인하/NNG;이/VV,-1,-0.5118573319057851,35,12,23,31,0.2068732589603382,0.6402859868615164
마이너스금리/NNG;도입/NNG;했/XSV,-1,-0.5118573319057851,35,12,23,23,0.2068732589603382,0.6402859868615164
유동성확보/NNG;위한/VV,-1,-0.5118573319057851,35,12,23,13,0.2068732589603382,0.6402859868615164
주택담보대출/NNG;증가/NNG;하/XSV,-1,-0.5118573319057851,35,12,23,25,0.2068732589603382,0.6402859868615164
gdp/NNG;증가/NNG;해/XSV,-1,-0.5187594415358621,24,8,16,14,0.18305252972572186,0.5773024172930645
저축/NNG;늘리/VV,-1,-0.5187594415358621,24,8,16,15,0.18305252972572186,0.5773024172930645
기준금리/NNG;인하/NNG;한다면/XSV,-1,-0.5187594415358621,24,8,16,19,0.18305252972572186,0.5773024172930645
소비자/NNG;물가상승률/NNG;물가안정/NNG;목표/NNG;유지/NNG;되/XSV,-1,-0.5187594415358621,24,8,16,29,0.18305252972572186,0.5773024172930645
손실/NNG;줄이/VV,-1,-0.5187594415358621,24,8,16,17,0.18305252972572186,0.5773024172930645
국채수익률/NNG;오를/VV,-1,-0.5187594415358621,24,8,16,17,0.18305252972572186,0.5773024172930645
금리인하/NNG;단행/NNG;하/XSV;않/VX,-1,-0.5187594415358621,24,8,16,23,0.18305252972572186,0.5773024172930645
국채선물시장/NNG;하락/NNG;하/XSV,-1,-0.5220152768957791,38,13,25,18,0.20689384728497812,0.658341399908246
국채가격/NNG;상승/NNG;견인/NNG;했/XSV,-1,-0.5220152768957791,38,13,25,14,0.20689384728497812,0.658341399908246
금리/NNG;내려가/VV,-1,-0.5258062852692893,134,48,86,101,0.2779457375051311,0.8937159968561444
달러화가치/NNG;상승/NNG;했/XSV,-1,-0.5282515045063961,27,9,18,16,0.18449492701211984,0.5972592545510521
금리/NNG;내린/VV,-1,-0.5302362848315084,318,113,205,241,0.2799728057816777,0.9113550170253667
금리/NNG;상승세/NNG;보이/VV,-1,-0.5311787597380417,41,14,27,40,0.2070433939252451,0.6757281622336362
경기/NNG;악화/NNG;되/XSV,-1,-0.5311787597380417,41,14,27,32,0.2070433939252451,0.6757281622336362
양적완화/NNG;하/XSV,-1,-0.5322292365012236,52,18,34,47,0.22213292452162708,0.7271011985667065
달러화/NNG;상승/NNG;할/XSV,-1,-0.5322292365012236,52,18,34,70,0.22213292452162708,0.7271011985667065
부양책/NNG;않/VX,-1,-0.5370238888592694,30,10,20,14,0.18588710789952737,0.616678783381465
기준금리인하/NNG;통해/VV,-1,-0.5370238888592694,30,10,20,21,0.18588710789952737,0.616678783381465
경기/NNG;부양책/NNG;나올/VV,-1,-0.5370238888592694,30,10,20,17,0.18588710789952737,0.616678783381465
수입/NNG;증가/NNG;하/XSV,-1,-0.5370238888592694,30,10,20,24,0.18588710789952737,0.616678783381465
cds프리미엄/NNG;상승/NNG;하/XSV,-1,-0.5370238888592694,30,10,20,26,0.18588710789952737,0.616678783381465
금리/NNG;낮/VA;지/VX,-1,-0.5389712781807277,155,55,100,134,0.27175469080144216,0.9064958476243524
부동산가격/NNG;하락/NNG;하/XSV,-1,-0.5394735148431501,44,15,29,16,0.20728780777785016,0.6924321539225242
국고/NNG;금리/NNG;상승/NNG;한/XSA,-1,-0.5415131607914786,77,27,50,70,0.24275735272547214,0.8155997137228946
대외의존도/NNG;높/VA;경제/NNG,-1,-0.5451255037026745,33,11,22,23,0.1872304266773065,0.6355213307042074
경기/NNG;하강/NNG;하/XSV,-1,-0.5451255037026745,33,11,22,13,0.1872304266773065,0.6355213307042074
소비/NNG;늘어날/VV,-1,-0.5451255037026745,33,11,22,19,0.1872304266773065,0.6355213307042074
기준금리/NNG;내리/VV,-1,-0.550952854148828,251,88,163,160,0.2656214296712798,0.9167411492990644
수요증가/NNG;따른/VV,-1,-0.5526023302443981,36,12,24,25,0.18852624196115408,0.6537534160223645
금리인하/NNG;주장/NNG;하/XSV,-1,-0.5526023302443981,36,12,24,38,0.18852624196115408,0.6537534160223645
차입금/NNG;증가/NNG;하/XSV,-1,-0.5538449413171525,50,17,33,32,0.20796728931521616,0.7237549312227829
원화/NNG;강세/NNG;보이/VV,-1,-0.5538449413171525,50,17,33,49,0.20796728931521616,0.7237549312227829
금리인하/NNG;단행/NNG;한/XSA,-1,-0.5591302840780962,120,42,78,53,0.2528432302387308,0.8934984766295506
금리상승/NNG;이끌/VV,-1,-0.559497484632127,39,13,26,32,0.18977591118237866,0.6713475605489662
경제지표/NNG;악화/NNG;되/XSV,-1,-0.559497484632127,39,13,26,19,0.18977591118237866,0.6713475605489662
달러원/NNG;급등/NNG;하/XSV,-1,-0.5657531641786341,56,19,37,48,0.20879736642773075,0.7522747148722457
장기금리/NNG;상승/NNG;할/XSV,-1,-0.5658513090443751,42,14,28,25,0.19098078569731636,0.6882820269942531
금리/NNG;인하/NNG;했/XSV,-1,-0.5696938659198405,141,49,92,94,0.24973917811385807,0.9103020977291694
금리상승압력/NNG;작용/NNG;할/XSV,-1,-0.571701483361764,45,15,30,35,0.19214220647662833,0.7045405059132017
금리변동성/NNG;확대/NNG;되/XSV,-1,-0.571701483361764,45,15,30,32,0.19214220647662833,0.7045405059132017
통화긴축/NNG;될/XSV,-1,-0.5718911665234481,19,6,13,11,0.15031049507370914,0.5514639468382142
금리인하/NNG;시사/NNG;했/XSV,-1,-0.5718911665234481,19,6,13,9,0.15031049507370914,0.5514639468382142
경제/NNG;성장/NNG;했/XSV,-1,-0.5718911665234481,19,6,13,8,0.15031049507370914,0.5514639468382142
마이너스금리/NNG;라는/VCP,-1,-0.5718911665234481,19,6,13,9,0.15031049507370914,0.5514639468382142
성장/NNG;이어질/VV,-1,-0.5718911665234481,19,6,13,11,0.15031049507370914,0.5514639468382142
성장/NNG;그쳤/VV,-1,-0.5718911665234481,19,6,13,15,0.15031049507370914,0.5514639468382142
조달금리/NNG;상승/NNG;하/XSV,-1,-0.5718911665234481,19,6,13,7,0.15031049507370914,0.5514639468382142
채권/NNG;시장/NNG;변동성/NNG;확대/NNG;되/XSV,-1,-0.5718911665234481,19,6,13,7,0.15031049507370914,0.5514639468382142
수익/NNG;줄/VV,-1,-0.5729145038162624,22,7,15,18,0.15539556630485185,0.5718571538542885
불안심리/NNG;확대/NNG;되/XSV,-1,-0.5729145038162624,22,7,15,21,0.15539556630485185,0.5718571538542885
기준금리/NNG;떨어지/VV,-1,-0.5729145038162624,22,7,15,22,0.15539556630485185,0.5718571538542885
채권/NNG;시장/NNG;국고/NNG;하락/NNG;한/XSA,-1,-0.5729145038162624,22,7,15,24,0.15539556630485185,0.5718571538542885
경기둔화/NNG;우려/NNG;되/XSV,-1,-0.5729145038162624,22,7,15,3,0.15539556630485185,0.5718571538542885
양적완화/NNG;시행/NNG;할/XSV,-1,-0.5729145038162624,22,7,15,17,0.15539556630485185,0.5718571538542885
설비투자/NNG;늘어나/VV,-1,-0.5729145038162624,22,7,15,16,0.15539556630485185,0.5718571538542885
물가/NNG;올라/VV,-1,-0.5729145038162624,22,7,15,27,0.15539556630485185,0.5718571538542885
경기하강위험/NNG;여전하/VAX,-1,-0.5729145038162624,22,7,15,3,0.15539556630485185,0.5718571538542885
금리인상/NNG;전망/NNG;따른/VV,-1,-0.5729145038162624,22,7,15,23,0.15539556630485185,0.5718571538542885
소득/NNG;줄/VV,-1,-0.5736773310586359,16,5,11,17,0.14390052289434865,0.5307592923138758
국채선물/NNG;올라/VV,-1,-0.5736773310586359,16,5,11,21,0.14390052289434865,0.5307592923138758
지급준비율/NNG;내리/VV,-1,-0.5736773310586359,16,5,11,11,0.14390052289434865,0.5307592923138758
모기지/NNG;금리/NNG;낮추/VV,-1,-0.5736773310586359,16,5,11,4,0.14390052289434865,0.5307592923138758
수출증가율/NNG;높/VA,-1,-0.5736773310586359,16,5,11,16,0.14390052289434865,0.5307592923138758
투자심리/NNG;악화/NNG;시켰/XSV,-1,-0.5736773310586359,16,5,11,12,0.14390052289434865,0.5307592923138758
원화/NNG;강세/NNG;막/VV,-1,-0.5736773310586359,16,5,11,16,0.14390052289434865,0.5307592923138758
수출의존도/NNG;높/VA;경제/NNG,-1,-0.5736773310586359,16,5,11,15,0.14390052289434865,0.5307592923138758
유로화/NNG;달러화/NNG;하락/NNG;한/XSA,-1,-0.5736773310586359,16,5,11,7,0.14390052289434865,0.5307592923138758
유로화/NNG;강세/NNG;지지/NNG;받/VV,-1,-0.5736773310586359,16,5,11,13,0.14390052289434865,0.5307592923138758
유로/NNG;확대/NNG;하/XSV,-1,-0.5736773310586359,16,5,11,8,0.14390052289434865,0.5307592923138758
신용등급/NNG;낮/VA;회사채/NNG,-1,-0.5736773310586359,16,5,11,10,0.14390052289434865,0.5307592923138758
경제성장률/NNG;그칠/VV,-1,-0.5736773310586359,16,5,11,9,0.14390052289434865,0.5307592923138758
경제성장률/NNG;마이너스/NNG;할/XSV,-1,-0.5736773310586359,16,5,11,2,0.14390052289434865,0.5307592923138758
국채선물/NNG;올랐/VV,-1,-0.5736773310586359,16,5,11,10,0.14390052289434865,0.5307592923138758
경제지표/NNG;상회/NNG;하/XSV,-1,-0.5736773310586359,16,5,11,7,0.14390052289434865,0.5307592923138758
기준금리/NNG;떨어질/VV,-1,-0.5736773310586359,16,5,11,6,0.14390052289434865,0.5307592923138758
금리인하/NNG;된/XSV,-1,-0.5736773310586359,16,5,11,17,0.14390052289434865,0.5307592923138758
환율하락/NNG;인한/VV,-1,-0.5736773310586359,16,5,11,15,0.14390052289434865,0.5307592923138758
재할인율/NNG;인하/NNG;한/XSA,-1,-0.5736773310586359,16,5,11,26,0.14390052289434865,0.5307592923138758
금리/NNG;우호적/VAX;작용/NNG,-1,-0.5736773310586359,16,5,11,11,0.14390052289434865,0.5307592923138758
채권금리/NNG;끌어내리/VV,-1,-0.5736773310586359,16,5,11,9,0.14390052289434865,0.5307592923138758
금융위기/NNG;수준/NNG;회복/NNG;하/XSV,-1,-0.5736773310586359,16,5,11,11,0.14390052289434865,0.5307592923138758
금가격/NNG;하락/NNG;하/XSV,-1,-0.5736773310586359,16,5,11,7,0.14390052289434865,0.5307592923138758
소비/NNG;늘릴/VV,-1,-0.5736773310586359,16,5,11,14,0.14390052289434865,0.5307592923138758
수요/NNG;약화/NNG;되/XSV,-1,-0.5736773310586359,16,5,11,26,0.14390052289434865,0.5307592923138758
경기/NNG;부양책/NNG;고려/NNG;하/XSV,-1,-0.5736773310586359,16,5,11,4,0.14390052289434865,0.5307592923138758
연체율/NNG;하락/NNG;하/XSV,-1,-0.5736773310586359,16,5,11,10,0.14390052289434865,0.5307592923138758
금리/NNG;상승/NNG;시킬/XSV,-1,-0.5736773310586359,16,5,11,14,0.14390052289434865,0.5307592923138758
완화정책/NNG;나올/VV,-1,-0.5736773310586359,16,5,11,7,0.14390052289434865,0.5307592923138758
경제성장률/NNG;유지/NNG;하/XSV,-1,-0.5736773310586359,16,5,11,9,0.14390052289434865,0.5307592923138758
기준금리인하/NNG;단행/NNG;되/XSV,-1,-0.5754777857233893,25,8,17,14,0.15960380440120375,0.5918497722898054
금리인상/NNG;결정/NNG;했/XSV,-1,-0.5754777857233893,25,8,17,9,0.15960380440120375,0.5918497722898054
수입/NNG;줄어들/VV,-1,-0.5754777857233893,25,8,17,19,0.15960380440120375,0.5918497722898054
적자/NNG;줄이/VV,-1,-0.5754777857233893,25,8,17,16,0.15960380440120375,0.5918497722898054
엔화/NNG;유로화/NNG;상승/NNG;했/XSV,-1,-0.5754777857233893,25,8,17,25,0.15960380440120375,0.5918497722898054
고용지표/NNG;호조/NNG;보인/VV,-1,-0.5754777857233893,25,8,17,14,0.15960380440120375,0.5918497722898054
서부텍사스산원유/NNG;가격/NNG;떨어진/VV,-1,-0.5754777857233893,25,8,17,13,0.15960380440120375,0.5918497722898054
비농업/NNG;고용/NNG;증가/NNG;해/XSV,-1,-0.5754777857233893,25,8,17,19,0.15960380440120375,0.5918497722898054
기준금리/NNG;내렸/VV,-1,-0.5762371936900262,110,38,72,71,0.23896048377033305,0.8881381634990781
이자/NNG;부담/NNG;덜/VV,-1,-0.5770831510848389,48,16,32,39,0.19326150033401307,0.7201117633897184
금융시장/NNG;따르/VV;오/VV,-1,-0.5788787978704197,28,9,19,21,0.16319639627066632,0.6113720697825156
경제성장/NNG;위해/VV,-1,-0.5788787978704197,28,9,19,25,0.16319639627066632,0.6113720697825156
수요/NNG;감소/NNG;한/XSA,-1,-0.5788787978704197,28,9,19,19,0.16319639627066632,0.6113720697825156
침체/NNG;빠져/VV,-1,-0.5788787978704197,28,9,19,12,0.16319639627066632,0.6113720697825156
기준금리/NNG;인하/NNG;됐/XSV,-1,-0.5788787978704197,28,9,19,16,0.16319639627066632,0.6113720697825156
성장세/NNG;이어질/VV,-1,-0.5820290543305188,51,17,34,22,0.1943399766542275,0.7349892633589076
공적자금/NNG;투입/NNG;하/XSV,-1,-0.5827061699136857,31,10,21,19,0.16633588342867592,0.6303679859813254
양적완화/NNG;나서/VV,-1,-0.5827061699136857,31,10,21,40,0.16633588342867592,0.6303679859813254
양적완화/NNG;하/VV,-1,-0.5827061699136857,31,10,21,24,0.16633588342867592,0.6303679859813254
기준금리/NNG;인하/NNG;한다고/XSV,-1,-0.5827061699136857,31,10,21,13,0.16633588342867592,0.6303679859813254
하방위험/NNG;상존/NNG;하/XSV,-1,-0.5867093150949674,34,11,23,32,0.16912882423575934,0.6487920930007517
장기물/NNG;금리/NNG;상승/NNG;하/XSV,-1,-0.5907318184634036,37,12,25,24,0.1716481142713381,0.6666078048424964
달러약세/NNG;부추겼/VV,-1,-0.5907318184634036,37,12,25,27,0.1716481142713381,0.6666078048424964
경제지표호조/NNG;따른/VV,-1,-0.5907318184634036,37,12,25,38,0.1716481142713381,0.6666078048424964
실업률/NNG;높/VA;수준/NNG,-1,-0.5946749497187034,40,13,27,40,0.1739454292544532,0.6837861972113951
기준금리인하/NNG;따른/VV,-1,-0.596352497035851,80,27,53,92,0.2124378398700041,0.8394509986380002
경기둔화/NNG;막/VV,-1,-0.5984765656242222,43,14,29,32,0.17605853261768295,0.7003051393297324
스왑베이시스/NNG;확대/NNG;되/XSV,-1,-0.601217655512776,66,22,44,43,0.19916438346658935,0.7990211150953039
금리/NNG;급락/NNG;했/XSV,-1,-0.6087233276566798,52,17,35,33,0.18154490120536707,0.7457717569782909
기준금리/NNG;인하/NNG;하/XSV,-1,-0.6126142150828473,558,187,371,436,0.2242294283740228,0.9326094277614244
수익성/NNG;개선/NNG;되/XSV,-1,-0.6150487908338074,84,28,56,49,0.20385973915201924,0.8545337382717626
달러화/NNG;반등/NNG;할/XSV,-1,-0.6247732603062908,32,10,22,28,0.14872522003128394,0.6434142724746469
시장금리/NNG;떨어지/VV,-1,-0.6247732603062908,32,10,22,17,0.14872522003128394,0.6434142724746469
금리인하/NNG;단행/NNG;해/XSV,-1,-0.6247732603062908,32,10,22,14,0.14872522003128394,0.6434142724746469
달러화/NNG;하락압력/NNG;가할/VV,-1,-0.6247732603062908,32,10,22,24,0.14872522003128394,0.6434142724746469
금리인하/NNG;기대심리/NNG;약화/NNG;되/XSV,-1,-0.6247732603062908,32,10,22,20,0.14872522003128394,0.6434142724746469
시장금리/NNG;하락/NNG;하/XSV,-1,-0.6257364937289263,126,42,84,105,0.21132637006921562,0.9171330900839342
연방기금금리/NNG;선물/NNG;오/VV,-1,-0.6269397965325333,26,8,18,16,0.1389904212979237,0.60559469031338
경기침체/NNG;될/XSV,-1,-0.6269397965325333,26,8,18,10,0.1389904212979237,0.60559469031338
금리인하/NNG;적극적/VAX,-1,-0.6269397965325333,26,8,18,12,0.1389904212979237,0.60559469031338
금리인하/NNG;위한/VV,-1,-0.6269397965325333,26,8,18,12,0.1389904212979237,0.60559469031338
경제주체/NNG;심리/NNG;개선/NNG;되/XSV,-1,-0.6269397965325333,26,8,18,8,0.1389904212979237,0.60559469031338
시장금리상승/NNG;따른/VV,-1,-0.6269397965325333,26,8,18,23,0.1389904212979237,0.60559469031338
매출/NNG;증가/NNG;하/XSV,-1,-0.630659757887136,47,15,32,27,0.1648815124809252,0.7272923598062077
실적/NNG;감소/NNG;했/XSV,-1,-0.6307347588941535,23,7,16,11,0.1328009430805214,0.5859307750159052
금리인하/NNG;이어질/VV,-1,-0.6307347588941535,23,7,16,11,0.1328009430805214,0.5859307750159052
유가/NNG;높/VA;수준/NNG,-1,-0.6307347588941535,23,7,16,11,0.1328009430805214,0.5859307750159052
채권/NNG;시장/NNG;강세/NNG;보이/VV,-1,-0.6323076582156061,50,16,34,35,0.16730973925703815,0.7420566602119696
수출부진/NNG;따른/VV,-1,-0.6377586522434182,20,6,14,17,0.12527271429731945,0.5658486477613242
양적완화/NNG;한/XSA,-1,-0.6377586522434182,20,6,14,20,0.12527271429731945,0.5658486477613242
양적완화/NNG;확대/NNG;할/XSV,-1,-0.6377586522434182,20,6,14,16,0.12527271429731945,0.5658486477613242
금리하락/NNG;확대/NNG;되/XSV,-1,-0.6377586522434182,20,6,14,20,0.12527271429731945,0.5658486477613242
금융시장/NNG;충격/NNG;줄/VV,-1,-0.6377586522434182,20,6,14,23,0.12527271429731945,0.5658486477613242
금리/NNG;낮/VA;됐/XSV,-1,-0.6377586522434182,20,6,14,8,0.12527271429731945,0.5658486477613242
달러강세/NNG;일시적/VAX,-1,-0.6377586522434182,20,6,14,0,0.12527271429731945,0.5658486477613242
소비/NNG;감소/NNG;하/XSV,-1,-0.6377586522434182,20,6,14,24,0.12527271429731945,0.5658486477613242
경기침체/NNG;라는/VCP,-1,-0.6377586522434182,20,6,14,10,0.12527271429731945,0.5658486477613242
금리상승/NNG;막/VV,-1,-0.6377586522434182,20,6,14,16,0.12527271429731945,0.5658486477613242
소매판매/NNG;감소/NNG;하/XSV,-1,-0.6377586522434182,20,6,14,13,0.12527271429731945,0.5658486477613242
마이너스성장/NNG;했/XSV,-1,-0.6377586522434182,20,6,14,7,0.12527271429731945,0.5658486477613242
안전자산/NNG;선호/NNG;되/XSV,-1,-0.6377586522434182,20,6,14,14,0.12527271429731945,0.5658486477613242
일자리/NNG;늘어나/VV,-1,-0.6377586522434182,20,6,14,18,0.12527271429731945,0.5658486477613242
차입금/NNG;늘/VV,-1,-0.6377586522434182,20,6,14,15,0.12527271429731945,0.5658486477613242
주택가격/NNG;하락/NNG;했/XSV,-1,-0.6377586522434182,20,6,14,15,0.12527271429731945,0.5658486477613242
금리/NNG;내린다고/VV,-1,-0.6500205598939104,17,5,12,17,0.11580200244536192,0.5454305526319048
침체/NNG;빠졌/VV,-1,-0.6500205598939104,17,5,12,14,0.11580200244536192,0.5454305526319048
성장/NNG;보/VV,-1,-0.6500205598939104,17,5,12,7,0.11580200244536192,0.5454305526319048
수출감소세/NNG;확대/NNG;되/XSV,-1,-0.6500205598939104,17,5,12,4,0.11580200244536192,0.5454305526319048
제공/NNG;적합한/VAX;회원/NNG;투자/NNG;안정적/VAX;수익/NNG,-1,-0.6500205598939104,17,5,12,1,0.11580200244536192,0.5454305526319048
양적완화/NNG;해/XSV,-1,-0.6500205598939104,17,5,12,13,0.11580200244536192,0.5454305526319048
채권스왑/NNG;스프레드/NNG;역전폭/NNG;확대/NNG;됐/XSV,-1,-0.6500205598939104,17,5,12,19,0.11580200244536192,0.5454305526319048
금리하락/NNG;요인/NNG;이/VCP,-1,-0.6500205598939104,17,5,12,11,0.11580200244536192,0.5454305526319048
금융시장/NNG;안정적/VAX;인/VCP,-1,-0.6500205598939104,17,5,12,13,0.11580200244536192,0.5454305526319048
주택가격/NNG;상승/NNG;했/XSV,-1,-0.6500205598939104,17,5,12,18,0.11580200244536192,0.5454305526319048
금리인하/NNG;압박/NNG;하/XSV,-1,-0.6500205598939104,17,5,12,24,0.11580200244536192,0.5454305526319048
금리인하/NNG;기대/NNG;커지/VV,-1,-0.6500205598939104,17,5,12,24,0.11580200244536192,0.5454305526319048
투자심리/NNG;회복/NNG;된/XSV,-1,-0.6500205598939104,17,5,12,12,0.11580200244536192,0.5454305526319048
기준금리인상/NNG;가시화/NNG;되/XSV,-1,-0.6500205598939104,17,5,12,11,0.11580200244536192,0.5454305526319048
가계부채/NNG;늘어날/VV,-1,-0.6500205598939104,17,5,12,24,0.11580200244536192,0.5454305526319048
유가/NNG;강세/NNG;보였/VV,-1,-0.6500205598939104,17,5,12,5,0.11580200244536192,0.5454305526319048
내수부진/NNG;심화/NNG;되/XSV,-1,-0.6500205598939104,17,5,12,3,0.11580200244536192,0.5454305526319048
고성장/NNG;종목/NNG;종목수/NNG;매매/NNG;보/VV,-1,-0.6500205598939104,17,5,12,1,0.11580200244536192,0.5454305526319048
물가상승압력/NNG;거세/VA,-1,-0.6500205598939104,17,5,12,8,0.11580200244536192,0.5454305526319048
고용지표/NNG;오/VV,-1,-0.6500205598939104,17,5,12,2,0.11580200244536192,0.5454305526319048
채권/NNG;시장/NNG;강세/NNG;이어질/VV,-1,-0.6500205598939104,17,5,12,18,0.11580200244536192,0.5454305526319048
금리인하/NNG;불구하/VAX,-1,-0.6598365214578326,96,31,65,46,0.18284347103213272,0.8912931908719488
환율방어/NNG;위해/VV,-1,-0.6606122256808624,36,11,25,38,0.13781125843482867,0.6736265105544444
인플레이션위험/NNG;남/VV,-1,-0.6606122256808624,36,11,25,5,0.13781125843482867,0.6736265105544444
수요/NNG;늘리/VV,-1,-0.6631949149689464,33,10,23,26,0.13295782319761662,0.6558994403552778
경기/NNG;상승세/NNG;이/VV,-1,-0.667140616541873,30,9,21,6,0.1274275925532178,0.6375704604896788
국채가격/NNG;높/VA;진/VX,-1,-0.667140616541873,30,9,21,11,0.1274275925532178,0.6375704604896788
달러원/NNG;급락/NNG;하/XSV,-1,-0.6730424426652026,27,8,19,28,0.12103317213669859,0.6186780242410802
불확실성/NNG;높/VA;진/VX,-1,-0.677348383045634,67,21,46,54,0.15831776270961145,0.8221618269237212
높/VA;금리/NNG;주/VV,-1,-0.679160292143183,58,18,40,38,0.15078282045724462,0.7882997212988483
기준금리/NNG;인하/NNG;함/XSV,-1,-0.6810442397193313,52,16,36,24,0.14479818392785387,0.7623323720828964
국채가격/NNG;하락/NNG;한/XSA,-1,-0.6817896390752312,24,7,17,15,0.11350972777631835,0.599269025966335
경기침체/NNG;빠질/VV,-1,-0.6817896390752312,24,7,17,16,0.11350972777631835,0.599269025966335
경제지표/NNG;개선/NNG;된/XSV,-1,-0.6817896390752312,24,7,17,16,0.11350972777631835,0.599269025966335
경기후퇴/NNG;따른/VV,-1,-0.6817896390752312,24,7,17,11,0.11350972777631835,0.599269025966335
매출/NNG;증가/NNG;할/XSV,-1,-0.6817896390752312,24,7,17,14,0.11350972777631835,0.599269025966335
채권/NNG;시장강세/NNG;지지/NNG;하/XSV,-1,-0.6817896390752312,24,7,17,22,0.11350972777631835,0.599269025966335
물가안정/NNG;목표/NNG;달성/NNG;하/XSV,-1,-0.6817896390752312,24,7,17,11,0.11350972777631835,0.599269025966335
신규/NNG;실업수당청구/NNG;감소/NNG;한/XSA,-1,-0.6891630334233391,40,12,28,50,0.12933779510419305,0.7020757353560747
높/VA;금리/NNG;제공/NNG;하/XSV,-1,-0.6891630334233391,40,12,28,39,0.12933779510419305,0.7020757353560747
달러화/NNG;약세/NNG;보일/VV,-1,-0.6891630334233391,40,12,28,28,0.12933779510419305,0.7020757353560747
수요/NNG;확대/NNG;될/XSV,-1,-0.6891630334233391,40,12,28,41,0.12933779510419305,0.7020757353560747
수출/NNG;줄/VV,-1,-0.6929763946030786,37,11,26,46,0.12442084205111152,0.6853076175454369
금리인하/NNG;되/XSV,-1,-0.6947237418430804,68,21,47,42,0.1496747090402323,0.8299743054691732
소비자물가/NNG;높/VA;상승률/NNG,-1,-0.6947550047498369,21,6,15,13,0.10447426689249265,0.5793993365039843
소비/NNG;회복/NNG;될/XSV,-1,-0.6947550047498369,21,6,15,10,0.10447426689249265,0.5793993365039843
경제/NNG;확산/NNG;되/XSV,-1,-0.6947550047498369,21,6,15,14,0.10447426689249265,0.5793993365039843
금리/NNG;높/VA;져/VX,-1,-0.6947550047498369,21,6,15,11,0.10447426689249265,0.5793993365039843
엔화/NNG;떨어졌/VV,-1,-0.6947550047498369,21,6,15,14,0.10447426689249265,0.5793993365039843
민간/NNG;소비/NNG;증가/NNG;하/XSV,-1,-0.6947550047498369,21,6,15,10,0.10447426689249265,0.5793993365039843
안전자산선호/NNG;심리/NNG;부각/NNG;되/XSV,-1,-0.6947550047498369,21,6,15,14,0.10447426689249265,0.5793993365039843
재무구조개선/NNG;위해/VV,-1,-0.6947550047498369,21,6,15,17,0.10447426689249265,0.5793993365039843
금융시장안정/NNG;위해/VV,-1,-0.6974660460015658,62,19,43,23,0.14430724558203184,0.8087620396933664
금리인하/NNG;할/XSV,-1,-0.6980378612477287,34,10,24,21,0.11890615802821715,0.6678883739697693
인플레이션압력/NNG;높이/VV,-1,-0.6980378612477287,34,10,24,14,0.11890615802821715,0.6678883739697693
달러약세/NNG;하/XSV,-1,-0.6980378612477287,34,10,24,25,0.11890615802821715,0.6678883739697693
수출/NNG;증가/NNG;했/XSV,-1,-0.6980378612477287,34,10,24,29,0.11890615802821715,0.6678883739697693
금리/NNG;상승압력/NNG;받/VV,-1,-0.6990818050571412,59,18,41,74,0.14134385373253794,0.7971602123805037
내수/NNG;위축/NNG;되/XSV,-1,-0.7048008076828458,31,9,22,18,0.11265685747552942,0.6498435091516644
가계부채/NNG;늘/VV,-1,-0.7048008076828458,31,9,22,39,0.11265685747552942,0.6498435091516644
소비/NNG;부진/NNG;한/XSA,-1,-0.7048008076828458,31,9,22,15,0.11265685747552942,0.6498435091516644
금리하락/NNG;제한/NNG;하/XSV,-1,-0.7139058896109611,28,8,20,31,0.10549130574929559,0.6312049202992452
연방기금금리/NNG;선물/NNG;기준금리/NNG;인하/NNG;될/XSV,-1,-0.7141256325962958,18,5,13,1,0.09336259430066376,0.5591335774358271
금리인하/NNG;보/VV,-1,-0.7141256325962958,18,5,13,15,0.09336259430066376,0.5591335774358271
가계부채/NNG;줄이/VV,-1,-0.7141256325962958,18,5,13,18,0.09336259430066376,0.5591335774358271
경제/NNG;성장/NNG;한/XSA,-1,-0.7141256325962958,18,5,13,7,0.09336259430066376,0.5591335774358271
인플레이션/NNG;우려/NNG;되/XSV,-1,-0.7141256325962958,18,5,13,16,0.09336259430066376,0.5591335774358271
소비자물가/NNG;하락/NNG;한/XSA,-1,-0.7141256325962958,18,5,13,7,0.09336259430066376,0.5591335774358271
투자/NNG;부진/NNG;한/XSA,-1,-0.7141256325962958,18,5,13,17,0.09336259430066376,0.5591335774358271
이자/NNG;부담/NNG;줄여/VV,-1,-0.7141256325962958,18,5,13,15,0.09336259430066376,0.5591335774358271
금리인하/NNG;기대/NNG;약화/NNG;된/XSV,-1,-0.7141256325962958,18,5,13,7,0.09336259430066376,0.5591335774358271
기준금리/NNG;내리/VV;않/VX,-1,-0.7141256325962958,18,5,13,17,0.09336259430066376,0.5591335774358271
금리인하/NNG;결정/NNG;했/XSV,-1,-0.7141256325962958,18,5,13,9,0.09336259430066376,0.5591335774358271
금가격/NNG;상승/NNG;했/XSV,-1,-0.7141256325962958,18,5,13,9,0.09336259430066376,0.5591335774358271
고용지표/NNG;양호/NNG;하/XSV,-1,-0.7141256325962958,18,5,13,23,0.09336259430066376,0.5591335774358271
경기침체/NNG;장기화/NNG;될/XSV,-1,-0.7141256325962958,18,5,13,8,0.09336259430066376,0.5591335774358271
금융안정/NNG;위한/VV,-1,-0.7141256325962958,18,5,13,12,0.09336259430066376,0.5591335774358271
글로벌경제/NNG;회복세/NNG;완만할/VAX,-1,-0.7141256325962958,18,5,13,14,0.09336259430066376,0.5591335774358271
기준금리/NNG;내린/VV,-1,-0.7173418295150111,146,45,101,125,0.1563775227226426,0.9489394059703049
기준금리/NNG;인하/NNG;했/XSV,-1,-0.7241089968529806,249,76,173,179,0.15325219966745224,0.9565092048643145
금리인하/NNG;가능성/NNG;열려/VV,-1,-0.7294457361274088,35,10,25,25,0.10642656094538394,0.679432891109903
지급준비율/NNG;인하/NNG;하/XSV,-1,-0.7294457361274088,35,10,25,12,0.10642656094538394,0.679432891109903
기준금리동결/NNG;결정/NNG;한/XSA,-1,-0.7432463497647521,22,6,16,14,0.0873555803133069,0.5923050796476416
금리인하/NNG;가능성/NNG;시사/NNG;하/XSV,-1,-0.7432463497647521,22,6,16,16,0.0873555803133069,0.5923050796476416
금리/NNG;하락세/NNG;될/XSV,-1,-0.7432463497647521,22,6,16,31,0.0873555803133069,0.5923050796476416
실업률/NNG;상승/NNG;한/XSA,-1,-0.7432463497647521,22,6,16,11,0.0873555803133069,0.5923050796476416
물가상승압력/NNG;작용/NNG;하/XSV,-1,-0.7432463497647521,22,6,16,15,0.0873555803133069,0.5923050796476416
원달러/NNG;오른/VV,-1,-0.7434806281965626,15,4,11,21,0.07934335761698708,0.5385420747419609
유가/NNG;반등/NNG;했/XSV,-1,-0.7434806281965626,15,4,11,13,0.07934335761698708,0.5385420747419609
영업이익/NNG;증가/NNG;하/XSV,-1,-0.7434806281965626,15,4,11,22,0.07934335761698708,0.5385420747419609
양적완화/NNG;나올/VV,-1,-0.7434806281965626,15,4,11,12,0.07934335761698708,0.5385420747419609
국고채/NNG;금리/NNG;상승/NNG;해/XSV,-1,-0.7434806281965626,15,4,11,6,0.07934335761698708,0.5385420747419609
유로화/NNG;올라/VV,-1,-0.7434806281965626,15,4,11,11,0.07934335761698708,0.5385420747419609
양적완화/NNG;이/VV,-1,-0.7434806281965626,15,4,11,16,0.07934335761698708,0.5385420747419609
높/VA;유지/NNG;되/XSV;있/VX;인플레이션기대/NNG;심리/NNG,-1,-0.7434806281965626,15,4,11,10,0.07934335761698708,0.5385420747419609
국고/NNG;지표금리/NNG;낮/VA;한/XSA,-1,-0.7434806281965626,15,4,11,4,0.07934335761698708,0.5385420747419609
고용/NNG;유지/NNG;하/XSV,-1,-0.7434806281965626,15,4,11,13,0.07934335761698708,0.5385420747419609
흑자행진/NNG;이/VV,-1,-0.7434806281965626,15,4,11,11,0.07934335761698708,0.5385420747419609
내수부양/NNG;위한/VV,-1,-0.7434806281965626,15,4,11,14,0.07934335761698708,0.5385420747419609
성장/NNG;하방위험/NNG;높/VA,-1,-0.7434806281965626,15,4,11,6,0.07934335761698708,0.5385420747419609
금리인하/NNG;직접적/VAX,-1,-0.7434806281965626,15,4,11,5,0.07934335761698708,0.5385420747419609
소비자/NNG;물가상승률/NNG;머물/VV,-1,-0.7434806281965626,15,4,11,12,0.07934335761698708,0.5385420747419609
주택/NNG;판매/NNG;감소/NNG;한/XSA,-1,-0.7434806281965626,15,4,11,14,0.07934335761698708,0.5385420747419609
이자/NNG;부담/NNG;하/XSV,-1,-0.7434806281965626,15,4,11,23,0.07934335761698708,0.5385420747419609
인플레이션/NNG;우려/NNG;있/VA,-1,-0.7434806281965626,15,4,11,12,0.07934335761698708,0.5385420747419609
기준금리인상/NNG;기대/NNG;높/VA,-1,-0.7434806281965626,15,4,11,17,0.07934335761698708,0.5385420747419609
금리/NNG;내린다면/VV,-1,-0.7434806281965626,15,4,11,12,0.07934335761698708,0.5385420747419609
경기지표/NNG;둔화/NNG;되/XSV,-1,-0.7434806281965626,15,4,11,9,0.07934335761698708,0.5385420747419609
고용지표/NNG;호조/NNG;보일/VV,-1,-0.7576175156180307,36,10,26,18,0.0953698706563054,0.690574643276932
침체/NNG;하/XSV,-1,-0.7650099659361465,43,12,31,18,0.09783571108778923,0.7337548553385862
시중금리/NNG;떨어지/VV,-1,-0.766792755630108,19,5,14,10,0.07563168205445671,0.5721344207386275
침체/NNG;심화/NNG;되/XSV,-1,-0.766792755630108,19,5,14,4,0.07563168205445671,0.5721344207386275
금리인하/NNG;단행/NNG;함/XSV,-1,-0.766792755630108,19,5,14,7,0.07563168205445671,0.5721344207386275
자금사정/NNG;악화/NNG;되/XSV,-1,-0.766792755630108,19,5,14,10,0.07563168205445671,0.5721344207386275
재무구조개선/NNG;위한/VV,-1,-0.766792755630108,19,5,14,9,0.07563168205445671,0.5721344207386275
통화완화/NNG;될/XSV,-1,-0.766792755630108,19,5,14,13,0.07563168205445671,0.5721344207386275
수출증가율/NNG;둔화/NNG;되/XSV,-1,-0.766792755630108,19,5,14,15,0.07563168205445671,0.5721344207386275
물가/NNG;올랐/VV,-1,-0.7681273537438433,33,9,24,14,0.08839798363154601,0.6730591677763192
변동성/NNG;확대/NNG;할/XSV,-1,-0.7681273537438433,33,9,24,28,0.08839798363154601,0.6730591677763192
유동성확보/NNG;위해/VV,-1,-0.7681273537438433,33,9,24,20,0.08839798363154601,0.6730591677763192
경기침체/NNG;가능성/NNG;높/VA,-1,-0.7839954549071464,23,6,17,6,0.07333469231625976,0.6046963606092689
인플레이션압력/NNG;커질/VV,-1,-0.7839954549071464,23,6,17,13,0.07333469231625976,0.6046963606092689
생산자물가/NNG;상승/NNG;해/XSV,-1,-0.7839954549071464,23,6,17,22,0.07333469231625976,0.6046963606092689
베이시스/NNG;확대/NNG;되/XSV,-1,-0.7839954549071464,23,6,17,20,0.07333469231625976,0.6046963606092689
인플레이션/NNG;억제/NNG;할/XSV,-1,-0.7839954549071464,23,6,17,11,0.07333469231625976,0.6046963606092689
성장/NNG;도모/NNG;하/XSV,-1,-0.7839954549071464,23,6,17,14,0.07333469231625976,0.6046963606092689
기준금리인상/NNG;위한/VV,-1,-0.7839954549071464,23,6,17,42,0.07333469231625976,0.6046963606092689
금리/NNG;상승세/NNG;되/XSV,-1,-0.7858545964004144,44,12,32,39,0.08931303972829999,0.7436060533274471
금리/NNG;끌어내리/VV,-1,-0.7891689015233793,51,14,37,44,0.09223488695123225,0.7814317548499078
매출/NNG;감소/NNG;하/XSV,-1,-0.7943846250656461,34,9,25,8,0.07852238435926256,0.6840907012239408
국제/NNG;유가/NNG;반등/NNG;하/XSV,-1,-0.7974679476186779,27,7,20,24,0.0717953704195499,0.6360810410496385
수요증가/NNG;힘입/VV,-1,-0.7974679476186779,27,7,20,20,0.0717953704195499,0.6360810410496385
주택가격하락/NNG;따른/VV,-1,-0.7974679476186779,27,7,20,18,0.0717953704195499,0.6360810410496385
금리/NNG;인하/NNG;한다면/XSV,-1,-0.7974679476186779,27,7,20,17,0.0717953704195499,0.6360810410496385
금리인하/NNG;나섰/VV,-1,-0.7997330453454068,16,4,12,16,0.06148083515393195,0.5515417592259929
기준금리/NNG;밑도/VV,-1,-0.7997330453454068,16,4,12,12,0.06148083515393195,0.5515417592259929
인플레이션위험/NNG;낮/VA,-1,-0.7997330453454068,16,4,12,9,0.06148083515393195,0.5515417592259929
기준금리동결/NNG;결정/NNG;했/XSV,-1,-0.7997330453454068,16,4,12,16,0.06148083515393195,0.5515417592259929
신용등급/NNG;하향/NNG;조정/NNG;할/XSV,-1,-0.7997330453454068,16,4,12,7,0.06148083515393195,0.5515417592259929
기대심리/NNG;줄어든/VV,-1,-0.7997330453454068,16,4,12,11,0.06148083515393195,0.5515417592259929
환율변동성/NNG;커지/VV,-1,-0.7997330453454068,16,4,12,32,0.06148083515393195,0.5515417592259929
금리인하/NNG;있/VA,-1,-0.7997330453454068,16,4,12,10,0.06148083515393195,0.5515417592259929
금리인상/NNG;예고/NNG;한/XSA,-1,-0.7997330453454068,16,4,12,9,0.06148083515393195,0.5515417592259929
저성장/NNG;될/XSV,-1,-0.7997330453454068,16,4,12,7,0.06148083515393195,0.5515417592259929
국고채/NNG;스프레드/NNG;확대/NNG;되/XSV,-1,-0.7997330453454068,16,4,12,17,0.06148083515393195,0.5515417592259929
높/VA;이자/NNG;주/VV,-1,-0.7997330453454068,16,4,12,7,0.06148083515393195,0.5515417592259929
단기금리/NNG;상승/NNG;한/XSA,-1,-0.7997330453454068,16,4,12,6,0.06148083515393195,0.5515417592259929
달러강세/NNG;지지/NNG;할/XSV,-1,-0.7997330453454068,16,4,12,8,0.06148083515393195,0.5515417592259929
변동성장세/NNG;되/XSV,-1,-0.7997330453454068,16,4,12,5,0.06148083515393195,0.5515417592259929
원유/NNG;수요/NNG;감소/NNG;할/XSV,-1,-0.7997330453454068,16,4,12,8,0.06148083515393195,0.5515417592259929
금리/NNG;반등/NNG;할/XSV,-1,-0.8047380373141627,45,12,33,47,0.08163147429325882,0.7531368508925945
자금사정/NNG;개선/NNG;되/XSV,-1,-0.809442261491328,20,5,15,13,0.061680031836154225,0.5846051094933828
잠재/NNG;성장률/NNG;하회/NNG;하/XSV,-1,-0.809442261491328,20,5,15,13,0.061680031836154225,0.5846051094933828
경기회복/NNG;지연/NNG;따른/VV,-1,-0.809442261491328,20,5,15,4,0.061680031836154225,0.5846051094933828
장기금리/NNG;하락/NNG;한/XSA,-1,-0.809442261491328,20,5,15,20,0.061680031836154225,0.5846051094933828
엔화/NNG;유로화/NNG;하락/NNG;했/XSV,-1,-0.8179554263056337,24,6,18,32,0.061870273220182806,0.6166643879699915
금리/NNG;밑돌/VV,-1,-0.8179554263056337,24,6,18,26,0.061870273220182806,0.6166643879699915
주택시장/NNG;회복/NNG;되/XSV,-1,-0.8179554263056337,24,6,18,17,0.061870273220182806,0.6166643879699915
채권/NNG;시장/NNG;부담/NNG;작용/NNG;하/XSV,-1,-0.8179554263056337,24,6,18,4,0.061870273220182806,0.6166643879699915
물가상승률/NNG;하/XSV,-1,-0.8202332455272484,53,14,39,33,0.07899957731605672,0.7983491135768828
성장세회복/NNG;지원/NNG;하/XSV,-1,-0.8251342644184385,39,10,29,17,0.06930349145677447,0.7218902170367466
금리인하/NNG;인/VCP,-1,-0.8254260814725997,28,7,21,22,0.062051978124502055,0.647537559116963
금융위기/NNG;확산/NNG;되/XSV,-1,-0.8254260814725997,28,7,21,15,0.062051978124502055,0.647537559116963
금리인하/NNG;가능성/NNG;제기/NNG;되/XSV,-1,-0.8319866925492878,32,8,24,18,0.06222554629725547,0.6770748655196207
인플레이션압력/NNG;완화/NNG;될/XSV,-1,-0.8386097928527834,58,15,43,12,0.07265902788106583,0.8259485471852672
선행지수/NNG;상승/NNG;하/XSV,-1,-0.8428189352868735,17,4,13,11,0.048214446035974794,0.5640071579410568
경기침체/NNG;대응/NNG;하/XSV,-1,-0.8428189352868735,17,4,13,11,0.048214446035974794,0.5640071579410568
영업이익/NNG;감소/NNG;했/XSV,-1,-0.8428189352868735,17,4,13,20,0.048214446035974794,0.5640071579410568
변동성확대/NNG;따른/VV,-1,-0.8428189352868735,17,4,13,12,0.048214446035974794,0.5640071579410568
금리인상/NNG;이루어질/VV,-1,-0.8428189352868735,17,4,13,12,0.048214446035974794,0.5640071579410568
물가상승률/NNG;목표/NNG;달성/NNG;하/XSV,-1,-0.8428189352868735,17,4,13,7,0.048214446035974794,0.5640071579410568
글로벌경제/NNG;완만한/VAX;회복세/NNG;할/XSV,-1,-0.8428189352868735,17,4,13,26,0.048214446035974794,0.5640071579410568
경기/NNG;악화/NNG;되/XSV;않/VX,-1,-0.8428189352868735,17,4,13,6,0.048214446035974794,0.5640071579410568
가계부채/NNG;늘리/VV,-1,-0.8428189352868735,17,4,13,13,0.048214446035974794,0.5640071579410568
유가급등/NNG;인해/VV,-1,-0.8428189352868735,17,4,13,3,0.048214446035974794,0.5640071579410568
금리하락/NNG;베팅/NNG;하/VV,-1,-0.8428189352868735,17,4,13,13,0.048214446035974794,0.5640071579410568
경제지표/NNG;둔화/NNG;되/XSV,-1,-0.842819166487567,40,10,30,32,0.0625497798362423,0.7317014433337322
금리/NNG;인하/NNG;한다고/XSV,-1,-0.8436926721183774,21,5,16,19,0.05069877664239794,0.5966588515809723
수출/NNG;증가세/NNG;둔화/NNG;되/XSV,-1,-0.8461181238641963,25,6,19,19,0.05248958996628306,0.6282735790446363
부채/NNG;부담/NNG;높/VA,-1,-0.8461181238641963,25,6,19,13,0.05248958996628306,0.6282735790446363
침체/NNG;막/VV,-1,-0.8694207889740716,26,6,20,12,0.04479536595088915,0.639569802156928
성장세/NNG;약화/NNG;되/XSV,-1,-0.8694207889740716,26,6,20,34,0.04479536595088915,0.639569802156928
금리인상/NNG;가능성/NNG;없/VA,-1,-0.8694207889740716,26,6,20,10,0.04479536595088915,0.639569802156928
이익/NNG;늘어나/VV,-1,-0.8710988538121767,22,5,17,10,0.04202642595768382,0.6083711716282163
하방경직성/NNG;유지/NNG;될/XSV,-1,-0.8710988538121767,22,5,17,17,0.04202642595768382,0.6083711716282163
성장세/NNG;보여/VV,-1,-0.8710988538121767,22,5,17,28,0.04202642595768382,0.6083711716282163
미국채수익률/NNG;하락/NNG;한/XSA,-1,-0.8710988538121767,22,5,17,16,0.04202642595768382,0.6083711716282163
경상수지흑자/NNG;줄어들/VV,-1,-0.875620930210902,18,4,14,19,0.038310760212327544,0.5760770433494617
채권/NNG;시장/NNG;강세/NNG;이끌/VV,-1,-0.875620930210902,18,4,14,17,0.038310760212327544,0.5760770433494617
원달러/NNG;상승/NNG;했/XSV,-1,-0.875620930210902,18,4,14,16,0.038310760212327544,0.5760770433494617
지급준비율/NNG;올린/VV,-1,-0.875620930210902,18,4,14,8,0.038310760212327544,0.5760770433494617
물가안정/NNG;목표/NNG;하회/NNG;하/XSV,-1,-0.875620930210902,18,4,14,10,0.038310760212327544,0.5760770433494617
유가상승/NNG;인해/VV,-1,-0.875620930210902,18,4,14,4,0.038310760212327544,0.5760770433494617
경기회복/NNG;가시화/NNG;될/XSV,-1,-0.875620930210902,18,4,14,17,0.038310760212327544,0.5760770433494617
소비/NNG;위축/NNG;시키/XSV,-1,-0.8886988365338683,27,6,21,12,0.038461617021269205,0.6505859202101791
하방위험/NNG;커졌/VV,-1,-0.8886988365338683,27,6,21,18,0.038461617021269205,0.6505859202101791
수출/NNG;위축/NNG;될/XSV,-1,-0.8930259145806161,23,5,18,12,0.03514078268408533,0.6197929562168587
수출증가율/NNG;낮/VA,-1,-0.8930259145806161,23,5,18,15,0.03514078268408533,0.6197929562168587
경기회복세/NNG;완만하/VAX,-1,-0.9006048853325566,19,4,15,11,0.03085208332267609,0.5878370997373741
경기하강위험/NNG;남/VV,-1,-0.9006048853325566,19,4,15,2,0.03085208332267609,0.5878370997373741
디플레이션/NNG;우려/NNG;커지/VV,-1,-0.9006048853325566,19,4,15,21,0.03085208332267609,0.5878370997373741
금리인하/NNG;반영/NNG;한/XSA,-1,-0.9106108855081921,24,5,19,22,0.02963765006368922,0.6309587023053361
기준금리인하/NNG;라는/VCP,-1,-0.9106108855081921,24,5,19,16,0.02963765006368922,0.6309587023053361
불안/NNG;완화/NNG;되/XSV,-1,-0.9136630342954705,15,3,12,28,0.025138926384771106,0.5549107484458222
매수/NNG;심리/NNG;강화/NNG;됐/XSV,-1,-0.9136630342954705,15,3,12,5,0.025138926384771106,0.5549107484458222
이중침체/NNG;가능성/NNG;낮/VA,-1,-0.9136630342954705,15,3,12,16,0.025138926384771106,0.5549107484458222
물가/NNG;낮/VA;질/VX,-1,-0.9136630342954705,15,3,12,11,0.025138926384771106,0.5549107484458222
금리인하/NNG;여력/NNG;있/VV,-1,-0.9136630342954705,15,3,12,7,0.025138926384771106,0.5549107484458222
조달비용/NNG;증가/NNG;하/XSV,-1,-0.9136630342954705,15,3,12,3,0.025138926384771106,0.5549107484458222
금리/NNG;상승/NNG;한다고/XSV,-1,-0.9136630342954705,15,3,12,5,0.025138926384771106,0.5549107484458222
비용/NNG;감소/NNG;하/XSV,-1,-0.9136630342954705,15,3,12,4,0.025138926384771106,0.5549107484458222
금리인하/NNG;포함/NNG;한/XSA,-1,-0.9136630342954705,15,3,12,12,0.025138926384771106,0.5549107484458222
침체국면/NNG;접어들/VV,-1,-0.9247712110138518,25,5,20,20,0.025207301525328907,0.641891844895489
유가/NNG;올라/VV,-1,-0.9325189950821289,35,7,28,7,0.025269202559168123,0.7198398497456991
국채선물/NNG;상승/NNG;하/XSV,-1,-0.9336478624496976,16,3,13,19,0.01954969405892591,0.5666634414121812
기준금리/NNG;하향/NNG;조정/NNG;할/XSV,-1,-0.9336478624496976,16,3,13,8,0.01954969405892591,0.5666634414121812
주택담보대출/NNG;금리/NNG;상승/NNG;한/XSA,-1,-0.9336478624496976,16,3,13,7,0.01954969405892591,0.5666634414121812
장기금리/NNG;떨어지/VV,-1,-0.9336478624496976,16,3,13,12,0.01954969405892591,0.5666634414121812
경제성장/NNG;부정적/NNG;인/VCP,-1,-0.9336478624496976,16,3,13,11,0.01954969405892591,0.5666634414121812
기준금리인하/NNG;가능성/NNG;않/VX,-1,-0.9336478624496976,16,3,13,8,0.01954969405892591,0.5666634414121812
경기회복세/NNG;미약한/VAX,-1,-0.9344614342180919,21,4,17,12,0.020800601105471404,0.6106221940854021
투자심리/NNG;회복/NNG;시키/XSV,-1,-0.9344614342180919,21,4,17,9,0.020800601105471404,0.6106221940854021
기준금리인하/NNG;되/XSV,-1,-0.9455660509710884,27,5,22,15,0.018675279014053078,0.6631186343440852
매출/NNG;감소/NNG;한/XSA,-1,-0.945922440080165,22,4,18,25,0.01739180811768743,0.6217020450887636
금리동결/NNG;주장/NNG;했/XSV,-1,-0.9480755926709186,17,3,14,17,0.015518210961423485,0.5782098796217061
금리상승압력/NNG;작용/NNG;하/XSV,-1,-0.9480755926709186,17,3,14,22,0.015518210961423485,0.5782098796217061
기준금리/NNG;오/VV,-1,-0.9480755926709186,17,3,14,15,0.015518210961423485,0.5782098796217061
수익성/NNG;악화/NNG;할/XSV,-1,-0.9480755926709186,17,3,14,11,0.015518210961423485,0.5782098796217061
경상수지흑자/NNG;줄이/VV,-1,-0.9480755926709186,17,3,14,6,0.015518210961423485,0.5782098796217061
원화가치/NNG;떨어지/VV,-1,-0.9549206435388896,23,4,19,14,0.014703447961755808,0.6325934834630946
경기위축/NNG;의미/NNG;한다/XSV,-1,-0.9586652502631249,18,3,15,5,0.012550327163353182,0.5895780668049238
성장잠재력/NNG;확충/NNG;하/XSV,-1,-0.9586652502631249,18,3,15,23,0.012550327163353182,0.5895780668049238
부도위험/NNG;낮/VA,-1,-0.9586652502631249,18,3,15,24,0.012550327163353182,0.5895780668049238
차입금/NNG;확대/NNG;되/XSV,-1,-0.9586652502631249,18,3,15,3,0.012550327163353182,0.5895780668049238
재무/NNG;안정성/NNG;유지/NNG;하/XSV,-1,-0.9586652502631249,18,3,15,6,0.012550327163353182,0.5895780668049238
재무/NNG;안정성/NNG;양호한/VAX,-1,-0.9586652502631249,18,3,15,5,0.012550327163353182,0.5895780668049238
물가/NNG;억제/NNG;하/XSV,-1,-0.9586652502631249,18,3,15,11,0.012550327163353182,0.5895780668049238
gdp/NNG;감소/NNG;하/XSV,-1,-0.9665696415913115,19,3,16,15,0.010322790565243906,0.6007833214621092
투자증가/NNG;낮/VA,-1,-0.9665696415913115,19,3,16,5,0.010322790565243906,0.6007833214621092
높/VA;금리/NNG;하/XSV,-1,-0.9677663819828695,25,4,21,11,0.010829938349391872,0.6538385929984757
마이너스성장/NNG;한/XSA,-1,-0.9725670181765885,20,3,17,7,0.008620569846294314,0.6118334281700855
경쟁력/NNG;강화/NNG;하/XSV,-1,-0.9734064955798226,38,6,32,28,0.010339628084699386,0.7570179930545535
금리인하/NNG;선반영/NNG;하/XSV,-1,-0.9800900974876774,15,2,13,13,0.005812904813748544,0.567831651016999
주택담보대출/NNG;금리/NNG;오르/VV,-1,-0.9836670434186722,23,3,20,10,0.005420158411109536,0.6440723680119462
하방위험/NNG;커진/VA,-1,-0.984112555239872,16,2,14,9,0.004742700122158143,0.5791527949772589
금리/NNG;하락/NNG;반전/NNG;했/XSV,-1,-0.984112555239872,16,2,14,8,0.004742700122158143,0.5791527949772589
달러화/NNG;엔화/NNG;움직여/VV;인/VCP;상승/NNG;했/XSV,-1,-0.984112555239872,16,2,14,8,0.004742700122158143,0.5791527949772589
차입금/NNG;증가/NNG;한/XSA,-1,-0.985965972456718,24,3,21,20,0.004744013933859924,0.6545114606228986
불확실성/NNG;증대/NNG;따른/VV,-1,-0.987069360533309,17,2,15,11,0.003948814061845281,0.590353903863647
인플레이션압력/NNG;완화/NNG;됐/XSV,-1,-0.987069360533309,17,2,15,8,0.003948814061845281,0.590353903863647
고용자수/NNG;증가/NNG;한/XSA,-1,-0.9886224801617686,33,4,29,6,0.004319556603115356,0.7317929545146824
금리/NNG;내려도/VV,-1,-0.9892940210524884,18,2,16,22,0.003345858988467479,0.6014325612453492
경제성장률/NNG;상회/NNG;하/XSV,-1,-0.9942602354752819,22,2,20,10,0.001971432210305685,0.6444359888162445
실업률/NNG;상승/NNG;했/XSV,-1,-0.9942602354752819,22,2,20,15,0.001971432210305685,0.6444359888162445
경기후퇴/NNG;겪/VV,-1,-0.9968778556508798,15,1,14,3,0.0010108008279681776,0.5794699357762543
주택/NNG;판매가격/NNG;하락/NNG;한/XSA,-1,-0.9973246223863473,16,1,15,7,0.0008979189853922935,0.5906227274909648
수출/NNG;증가세/NNG;보이/VV,-1,-0.9973246223863473,16,1,15,8,0.0008979189853922935,0.5906227274909648
실업률/NNG;급등/NNG;한/XSA,-1,-0.9973246223863473,16,1,15,1,0.0008979189853922935,0.5906227274909648
국제/NNG;유가/NNG;오른/VV,-1,-0.9976779844318459,17,1,16,6,0.0008081223263297988,0.6016642652281607
원화/NNG;강세/NNG;이어졌/VV,-1,-0.9979627756671948,18,1,17,1,0.0007353618846658833,0.6125874767758152
유로화/NNG;달러화/NNG;하락/NNG;했/XSV,-1,-0.9985529804949477,21,1,20,16,0.0005831927997326886,0.6445809726285093
기준금리/NNG;하향/NNG;조정/NNG;하/XSV,-1,-0.999592058072002,38,1,37,8,0.00030712679881925165,0.7984119497811742
하향/NNG;조정/NNG;하/XSV;통화정책/NNG;운용/NNG,-1,-0.9999162420348447,16,0,16,2,0.00013389507857631842,0.6017254201163972
재정지출/NNG;유연/XR;높/VA;수준/NNG,-1,-0.9999458548583635,20,0,20,0,0.00013389507857631842,0.6446277213394981
gdp/NNG;증가/NNG;인/VCP,-1,-1.0,30,0,30,0,0.00013389507857631842,0.7412579690164841
