word,label,polarity,count,pos_count,neg_count,neu_count,pos_score,neg_score
원유가격올랐,1,1.0,20,20,0,3,0.6411454635433088,1.9152333508875412e-05
금리낮아니올리,1,0.9999982347424929,17,17,0,0,0.6227614437372324,1.9152333508875412e-05
금리인상부동산가격영향주아니,1,0.9999976140072433,16,16,0,0,0.6165449215311207,1.9152333508875412e-05
상환능력유지,1,0.9999969762845311,15,15,0,5,0.6102862079574082,1.9152333508875412e-05
성장안될,1,0.9996289767492923,18,17,1,0,0.6227503006837829,0.00013404673617664948
플러스성장세이,1,0.9995748772162429,17,16,1,1,0.6165325422235765,0.0001493769113213594
성장경로불확실성상존,1,0.9985582354525406,21,19,2,10,0.6350167409985538,0.0004766554851103438
경기회복세되,1,0.9970028368688155,17,15,2,18,0.6102009541476894,0.0009332033217726981
통화정책금융완화유지,1,0.9970003608560245,25,22,3,21,0.6530638156339282,0.0009995652997766059
완화적정책기조유지,1,0.9962374226936586,16,14,2,12,0.6038827830308925,0.001155222718954331
국채금리하락기록,1,0.9962374226936586,16,14,2,7,0.6038827830308925,0.001155222718954331
경제성장률상승,1,0.9951628617599155,15,13,2,6,0.5975180115566713,0.0014651725149522601
지정학적리스크커지,1,0.9951628617599155,15,13,2,15,0.5975180115566713,0.0014651725149522601
국고채하락마감,1,0.9926092461827751,20,17,3,11,0.622536901295454,0.0023255328168276168
인플레이션완화않,1,0.9926092461827751,20,17,3,5,0.622536901295454,0.0023255328168276168
콜금리목표인상,1,0.9920158198451092,44,37,7,9,0.7362100581919617,0.0029700980674596637
금리인상나타나,1,0.9907598285043804,19,16,3,8,0.6162720242845772,0.0028762443463839515
완화정책발표,1,0.9846985741148317,17,14,3,17,0.6035592147359672,0.00466702927180614
경제성장가능,1,0.9846985741148317,17,14,3,13,0.6035592147359672,0.00466702927180614
잠재성장률밑도,1,0.9846985741148317,17,14,3,14,0.6035592147359672,0.00466702927180614
인플레이션우려상존,1,0.9837989563126686,43,35,8,32,0.725432149563967,0.005940614240801953
내수증가,1,0.9831819207396688,22,18,4,9,0.6284031337524529,0.0053429692043057385
금리올려서,1,0.9823846757237786,27,22,5,29,0.6525444857892357,0.005812641129945669
기준금리인상이어질,1,0.9796358964150793,16,13,3,11,0.5970936339226376,0.006154377664488424
금리올라야,1,0.9796358964150793,16,13,3,12,0.5970936339226376,0.006154377664488424
경제물가안정견조성장지속,1,0.9796358964150793,16,13,3,0,0.5970936339226376,0.006154377664488424
적자나,1,0.9733066754997377,20,16,4,7,0.6157426044182701,0.008340000561309843
금리인상다가오,1,0.9685016113996554,24,19,5,21,0.6340230127881855,0.010154703702291417
불확실성해소않,1,0.9662820276613329,46,36,10,36,0.7297397700170051,0.012523873849676879
단기금리올리,1,0.9655620699805858,19,15,4,3,0.6092745569841365,0.01068321875546753
성장될,1,0.9648953050062619,28,22,6,9,0.6519027524301708,0.011655555224117172
경기해외위험요인상존,1,0.9609460948203936,23,18,5,8,0.6276726462655876,0.012507797799414246
이자부담늘어날,1,0.9577222289057574,27,21,6,17,0.6456873937026611,0.013950212930052608
엔화급락,1,0.9547968399512043,18,14,4,6,0.6026854843167955,0.013941679499158758
연방기금금리목표유지,1,0.9547968399512043,18,14,4,18,0.6026854843167955,0.013941679499158758
경제회복지연,1,0.9547968399512043,18,14,4,13,0.6026854843167955,0.013941679499158758
경기상승이어지,1,0.9472150939566744,30,23,7,7,0.6571155812941785,0.01781602201063008
금리높여,1,0.9472150939566744,30,23,7,38,0.6571155812941785,0.01781602201063008
부동산가격잡,1,0.9459947121165189,54,41,13,12,0.75358998645526,0.020916621152476025
비용줄여,1,0.9395884913919603,17,13,4,16,0.5959367207837173,0.018561782790385017
채권시장국채선물상승거래,1,0.9395884913919603,17,13,4,31,0.5959367207837173,0.018561782790385017
부동산잡,1,0.9297819029553267,40,30,10,19,0.6960016954581254,0.025322026678224453
경기상승세지속,1,0.9297819029553267,40,30,10,10,0.6960016954581254,0.025322026678224453
가산금리올리,1,0.922420752491732,24,18,6,17,0.6263267941445022,0.025270204916172073
국제원자재가격오르,1,0.922420752491732,24,18,6,7,0.6263267941445022,0.025270204916172073
성장경로벗어나않,1,0.9201944345664701,20,15,5,25,0.6078305361465284,0.02525639256824515
경기개선지속,1,0.9201944345664701,20,15,5,18,0.6078305361465284,0.02525639256824515
집값안정위해,1,0.9177856935209747,16,12,4,5,0.5889648924864849,0.025242217422305566
기준금리인상신중,1,0.9177856935209747,16,12,4,21,0.5889648924864849,0.025242217422305566
완화줄여,1,0.9177856935209747,16,12,4,16,0.5889648924864849,0.025242217422305566
경제호조지속,1,0.9167413608396913,35,26,9,13,0.6731100342518687,0.02923064777984584
경기회복세둔화,1,0.9163263162108941,57,42,15,22,0.7565140619949764,0.033023368753344065
기준금리인상나서,1,0.9081083272434816,38,28,10,27,0.6839209693024885,0.03292565499875725
국제원자재가격상승,1,0.9034786729779769,23,17,6,12,0.6195488540243203,0.031404480542180487
성장세회복,1,0.9004197133355836,41,30,11,48,0.6945117403464137,0.036377703177703606
국채수익률오르,1,0.8971248882959417,30,22,8,13,0.6491890304224528,0.03518911273313509
유동성늘,1,0.8963828690664186,19,14,5,9,0.600818207686725,0.03281477233821844
경기불확실성커지,1,0.8963828690664186,19,14,5,12,0.600818207686725,0.03281477233821844
성장이룰,1,0.8963828690664186,19,14,5,12,0.600818207686725,0.03281477233821844
달러화엔화상승,1,0.8944373102841181,37,27,10,26,0.6776798163455006,0.037745959780417
금융완화유지,1,0.892990148489506,75,54,21,63,0.807057058036136,0.04560282071223178
경기회복유지,1,0.8893985328229717,26,19,7,14,0.6310992969796196,0.0369265194378604
금리인상실시,1,0.8861797279757058,15,11,4,11,0.5816635352437783,0.03508361818079557
듀레이션유지,1,0.8861797279757058,15,11,4,15,0.5816635352437783,0.03508361818079557
콜금리올렸,1,0.8861797279757058,15,11,4,6,0.5816635352437783,0.03508361818079557
자산축소시작,1,0.8861797279757058,15,11,4,35,0.5816635352437783,0.03508361818079557
부도위험나타내,1,0.8861797279757058,15,11,4,7,0.5816635352437783,0.03508361818079557
조달금리낮출,1,0.8861797279757058,15,11,4,13,0.5816635352437783,0.03508361818079557
금리인상남,1,0.8790449890333001,22,16,6,16,0.6125359035307204,0.039409337606136956
달러화약세나타내,1,0.8651376575889942,25,18,7,11,0.6241160427066054,0.04510250760576719
호황누렸,1,0.8651376575889942,25,18,7,11,0.6241160427066054,0.04510250760576719
달러약세반영,1,0.8641358172621072,18,13,5,15,0.5934812953557312,0.04323030960745121
위안화절상따른,1,0.8641358172621072,18,13,5,9,0.5934812953557312,0.04323030960745121
위험경계,1,0.8641358172621072,18,13,5,11,0.5934812953557312,0.04323030960745121
이자부담증가,1,0.8641358172621072,18,13,5,13,0.5934812953557312,0.04323030960745121
물가올리,1,0.8641358172621072,18,13,5,10,0.5934812953557312,0.04323030960745121
gdp상회,1,0.8641358172621072,18,13,5,12,0.5934812953557312,0.04323030960745121
금리인상빨라질있,1,0.8641358172621072,18,13,5,24,0.5934812953557312,0.04323030960745121
이자부담커질,1,0.8641358172621072,18,13,5,16,0.5934812953557312,0.04323030960745121
기준금리동결발표,1,0.8641358172621072,18,13,5,6,0.5934812953557312,0.04323030960745121
금융완화줄여,1,0.8641358172621072,18,13,5,21,0.5934812953557312,0.04323030960745121
기준금리인상결정,1,0.8541675790414602,61,43,18,33,0.7568087481039352,0.059488047706337296
성장이루,1,0.8539874327805348,28,20,8,13,0.6355493701107563,0.050023140248923334
채권시장오,1,0.8539874327805348,28,20,8,18,0.6355493701107563,0.050023140248923334
인플레이션억제위한,1,0.8528677565543787,38,27,11,24,0.6755411259516239,0.053610741739023894
경기선행지수상승,1,0.8505586788005965,51,36,15,23,0.7229068407827911,0.05834229204107933
채권발행증가,1,0.8475177099430853,21,15,6,20,0.6052137155296565,0.049919322518727965
중소기업대출늘어나,1,0.8475177099430853,21,15,6,6,0.6052137155296565,0.049919322518727965
자금유입증가,1,0.8450201156742321,31,22,9,22,0.646824453070732,0.05429832613031126
금리인상필요성제기,1,0.8349294515184631,24,17,7,1,0.6168420325095727,0.05545456452471483
국제유가급락,1,0.8319050043945992,37,26,11,28,0.6688546322672847,0.061332847518166866
위험존재,1,0.8271243066545941,40,28,12,32,0.6795892942905638,0.06425641443156573
이자부담늘어나,1,0.8271243066545941,40,28,12,31,0.6795892942905638,0.06425641443156573
고용부진따른,1,0.8253199227390411,27,19,8,29,0.6283461889984822,0.060090455220645635
부동산가격안정위해,1,0.8253199227390411,27,19,8,9,0.6283461889984822,0.060090455220645635
기준금리상향조정,1,0.8240227865592087,65,45,20,53,0.7634384430718505,0.07360391525134757
펀더멘털양호,1,0.8205362108465291,17,12,5,37,0.5856778738056886,0.05769435489390991
유가떨어질,1,0.8205362108465291,17,12,5,12,0.5856778738056886,0.05769435489390991
경기회복세찬물끼얹,1,0.8205362108465291,17,12,5,14,0.5856778738056886,0.05769435489390991
지표금리하락,1,0.8205362108465291,17,12,5,10,0.5856778738056886,0.05769435489390991
주택시장침체지속,1,0.8205362108465291,17,12,5,6,0.5856778738056886,0.05769435489390991
경제부담되,1,0.8205362108465291,17,12,5,15,0.5856778738056886,0.05769435489390991
경제성장률떨어질,1,0.8205362108465291,17,12,5,12,0.5856778738056886,0.05769435489390991
변동성높이,1,0.8205362108465291,17,12,5,18,0.5856778738056886,0.05769435489390991
물가상승유발,1,0.8205362108465291,17,12,5,10,0.5856778738056886,0.05769435489390991
인플레이션우려지속,1,0.8205362108465291,17,12,5,9,0.5856778738056886,0.05769435489390991
경기침체우려커지,1,0.8205362108465291,17,12,5,3,0.5856778738056886,0.05769435489390991
글로벌경제회복세지속,1,0.8069898068818173,20,14,6,9,0.5974726805658855,0.0637714188120707
통화정책경제견조성장지속,1,0.7974798903842599,23,16,7,8,0.6091916353704284,0.06858558198456824
기준금리인상필요,1,0.7974798903842599,23,16,7,9,0.6091916353704284,0.06858558198456824
자금유입둔화,1,0.7974798903842599,23,16,7,19,0.6091916353704284,0.06858558198456824
채권투자심리위축,1,0.7974798903842599,23,16,7,32,0.6091916353704284,0.06858558198456824
금리인상카드꺼내,1,0.7974798903842599,23,16,7,11,0.6091916353704284,0.06858558198456824
부동산가격급등,1,0.7907307652295414,26,18,8,11,0.6208028317602302,0.07249327515558934
기준금리인상통해,1,0.7774920052474625,41,28,13,34,0.6765312964807987,0.08462214436954832
소비자물가오른,1,0.7621621177521636,16,11,5,11,0.5771793166130184,0.07783816527849396
외환시장안정위한,1,0.7621621177521636,16,11,5,9,0.5771793166130184,0.07783816527849396
위험잠재,1,0.7621621177521636,16,11,5,12,0.5771793166130184,0.07783816527849396
이자낮추,1,0.7621621177521636,16,11,5,11,0.5771793166130184,0.07783816527849396
대출증가세둔화,1,0.7621621177521636,16,11,5,15,0.5771793166130184,0.07783816527849396
국제유가급등따른,1,0.7621621177521636,16,11,5,8,0.5771793166130184,0.07783816527849396
성장전망하향조정,1,0.7621621177521636,16,11,5,8,0.5771793166130184,0.07783816527849396
경제성장률전망낮추,1,0.7621621177521636,16,11,5,7,0.5771793166130184,0.07783816527849396
호주달러강세보이,1,0.7553769928565424,19,13,6,6,0.5891484966345805,0.08203393045847986
위험요인작용,1,0.7553769928565424,19,13,6,20,0.5891484966345805,0.08203393045847986
불확실성해소따른,1,0.7553769928565424,19,13,6,22,0.5891484966345805,0.08203393045847986
금리인상가능성따른,1,0.7553769928565424,19,13,6,33,0.5891484966345805,0.08203393045847986
경제성장뒷받침,1,0.7553769928565424,19,13,6,10,0.5891484966345805,0.08203393045847986
달러화강세나타낼,1,0.7514381082757033,22,15,7,16,0.6010431716445158,0.08522844017433796
경제완만회복세이,1,0.7514381082757033,22,15,7,6,0.6010431716445158,0.08522844017433796
경기회복세강화,1,0.7514381082757033,22,15,7,26,0.6010431716445158,0.08522844017433796
불확실성줄어들,1,0.7493646333861463,37,25,12,25,0.6584180586860563,0.09425436060808517
경제안정,1,0.7493646333861463,37,25,12,33,0.6584180586860563,0.09425436060808517
낮금리발행,1,0.7492977425007206,25,17,8,21,0.6128267490428594,0.08775459849890127
금리인상필요,1,0.7399358976817234,94,62,32,57,0.8201854813172257,0.12248718819518092
국고채지표금리오른,1,0.7331634339055408,51,34,17,50,0.7042371032606934,0.10833076043307976
경제충격줄,1,0.7127924662301555,33,22,11,28,0.6394313360696856,0.10712715501700053
연방기금금리인하,1,0.7102770708706818,78,51,27,38,0.7770662241757251,0.13151870206022823
양적완화줄이,1,0.7045959799462997,27,18,9,41,0.6161877875413381,0.10668854806555253
통화가치하락,1,0.7001947582818961,24,16,8,33,0.6042905615202375,0.10646175208400231
통화완화강화,1,0.7001947582818961,24,16,8,23,0.6042905615202375,0.10646175208400231
기대심리축소,1,0.7001947582818961,24,16,8,17,0.6042905615202375,0.10646175208400231
경기회복확인,1,0.6955784373923419,21,14,7,14,0.5922216167298261,0.10622981206533384
글로벌경제완만회복세이,1,0.6955784373923419,21,14,7,25,0.5922216167298261,0.10622981206533384
민간소비위축,1,0.6955784373923419,21,14,7,15,0.5922216167298261,0.10622981206533384
위험유의,1,0.6955784373923419,21,14,7,7,0.5922216167298261,0.10622981206533384
불확실성줄이,1,0.6955784373923419,21,14,7,19,0.5922216167298261,0.10622981206533384
실적증가,1,0.692931816219136,41,27,14,40,0.6651974496381403,0.12054496474341171
기준금리동결배경설명,1,0.6907365858407433,18,12,6,14,0.5799907735552735,0.10599261355080328
경기선행지수반등,1,0.6907365858407433,18,12,6,7,0.5799907735552735,0.10599261355080328
금리인상가능성상존,1,0.6907365858407433,18,12,6,10,0.5799907735552735,0.10599261355080328
위험선호강화,1,0.6907365858407433,18,12,6,50,0.5799907735552735,0.10599261355080328
업황개선,1,0.6907365858407433,18,12,6,12,0.5799907735552735,0.10599261355080328
기대심리올랐,1,0.6907365858407433,18,12,6,16,0.5799907735552735,0.10599261355080328
듀레이션늘리,1,0.6878541443901625,52,34,18,34,0.7002916165387999,0.1293903562122719
높수익률보였,1,0.6856582749153965,15,10,5,7,0.5676085542545732,0.10575003993175745
위안화가치하락,1,0.6856582749153965,15,10,5,4,0.5676085542545732,0.10575003993175745
위안화변동폭확대,1,0.6856582749153965,15,10,5,13,0.5676085542545732,0.10575003993175745
경제호전,1,0.6856582749153965,15,10,5,26,0.5676085542545732,0.10575003993175745
관망심리확산,1,0.6856582749153965,15,10,5,9,0.5676085542545732,0.10575003993175745
경제성장률하회,1,0.6856582749153965,15,10,5,9,0.5676085542545732,0.10575003993175745
기준금리인상이어지,1,0.6856582749153965,15,10,5,9,0.5676085542545732,0.10575003993175745
금리하락거래,1,0.6856582749153965,15,10,5,12,0.5676085542545732,0.10575003993175745
유로화오르,1,0.6856582749153965,15,10,5,10,0.5676085542545732,0.10575003993175745
위험빠질,1,0.6856582749153965,15,10,5,10,0.5676085542545732,0.10575003993175745
금리인상유력,1,0.6856582749153965,15,10,5,30,0.5676085542545732,0.10575003993175745
단기금리올라가,1,0.6856582749153965,15,10,5,5,0.5676085542545732,0.10575003993175745
달러강세견인,1,0.6856582749153965,15,10,5,11,0.5676085542545732,0.10575003993175745
안정적성장세이,1,0.6856582749153965,15,10,5,3,0.5676085542545732,0.10575003993175745
엔화강세저지,1,0.6856582749153965,15,10,5,13,0.5676085542545732,0.10575003993175745
실적줄,1,0.6856582749153965,15,10,5,12,0.5676085542545732,0.10575003993175745
금리넘어서,1,0.6856582749153965,15,10,5,14,0.5676085542545732,0.10575003993175745
달러원상승압력받,1,0.6856582749153965,15,10,5,12,0.5676085542545732,0.10575003993175745
불확실성확대따른,1,0.6856582749153965,15,10,5,10,0.5676085542545732,0.10575003993175745
양적완화중단,1,0.6856582749153965,15,10,5,23,0.5676085542545732,0.10575003993175745
cd금리급등,1,0.6800421404287336,35,23,12,7,0.642717051222147,0.12228930501376033
경제견조성장지속,1,0.6800421404287336,35,23,12,14,0.642717051222147,0.12228930501376033
유가급락,1,0.6684143847099209,54,35,19,43,0.7032639346740783,0.13963681199517886
경제영향줄,1,0.6674730946965186,43,28,15,18,0.668365427842746,0.1331592247284253
원자재가격오르,1,0.6640105374185248,29,19,10,16,0.6193328963874182,0.12493417046703019
경제타격줄,1,0.6640105374185248,29,19,10,21,0.6193328963874182,0.12493417046703019
금리변동성축소,1,0.6542651708464211,26,17,9,13,0.6072962634985298,0.1268005266048815
달러화하락압력가했,1,0.6542651708464211,26,17,9,21,0.6072962634985298,0.1268005266048815
비용상승,1,0.6542651708464211,26,17,9,17,0.6072962634985298,0.1268005266048815
경기회복모멘텀둔화,1,0.6499828577019016,37,24,13,22,0.6458491420340731,0.13687408047852087
부동산가격상승,1,0.6499828577019016,37,24,13,26,0.6458491420340731,0.13687408047852087
대출줄,1,0.6428491217538994,23,15,8,10,0.5950171539196046,0.129229049027496
금리상승압력지속,1,0.6428491217538994,23,15,8,19,0.5950171539196046,0.129229049027496
투자수요증가,1,0.6428491217538994,23,15,8,5,0.5950171539196046,0.129229049027496
소비자물가상회,1,0.6428491217538994,23,15,8,17,0.5950171539196046,0.129229049027496
금리인상대비,1,0.6415909331549345,53,34,19,35,0.6958015582142814,0.15176632726544018
국제유가하락,1,0.6316691361457021,144,90,54,100,0.8725550205260671,0.1967749679008828
안전자산선호지속,1,0.6290875923859429,20,13,7,30,0.5824718110311682,0.13248648308427
금리인상우려커지,1,0.6290875923859429,20,13,7,17,0.5824718110311682,0.13248648308427
주문감소,1,0.6290875923859429,20,13,7,17,0.5824718110311682,0.13248648308427
경제회복세이,1,0.6290875923859429,20,13,7,15,0.5824718110311682,0.13248648308427
경기둔화감안,1,0.6290875923859429,20,13,7,9,0.5824718110311682,0.13248648308427
높금리제시,1,0.6290875923859429,20,13,7,23,0.5824718110311682,0.13248648308427
금리인하효과지켜보,1,0.6290875923859429,20,13,7,7,0.5824718110311682,0.13248648308427
채권가격급락,1,0.6290875923859429,20,13,7,16,0.5824718110311682,0.13248648308427
금리인상가능성남,1,0.6290875923859429,20,13,7,18,0.5824718110311682,0.13248648308427
국채선물하락거래마쳤,1,0.6290875923859429,20,13,7,18,0.5824718110311682,0.13248648308427
금리인상보,1,0.6290875923859429,20,13,7,25,0.5824718110311682,0.13248648308427
외환시장안정위해,1,0.6290875923859429,20,13,7,8,0.5824718110311682,0.13248648308427
환율상승요인작용,1,0.6275921467242913,31,20,11,19,0.62230908549761,0.14224872421566392
물가상승압력커질,1,0.6275921467242913,31,20,11,18,0.62230908549761,0.14224872421566392
시장기준금리인상,1,0.622516813213587,39,25,14,26,0.6488509806116954,0.15080643125254603
연방기금금리재할인율인하,1,0.6136901015218714,28,18,10,0,0.6101240700942607,0.1459136874239007
금리하락압력받,1,0.6136901015218714,28,18,10,28,0.6101240700942607,0.1459136874239007
위험줄,1,0.6136901015218714,28,18,10,11,0.6101240700942607,0.1459136874239007
소득늘,1,0.6118340573254963,17,11,6,22,0.5696108545124555,0.1370366164196054
물가높수준유지,1,0.6118340573254963,17,11,6,7,0.5696108545124555,0.1370366164196054
채권시장국채선물내린,1,0.6118340573254963,17,11,6,24,0.5696108545124555,0.1370366164196054
경기둔화이어질,1,0.6118340573254963,17,11,6,15,0.5696108545124555,0.1370366164196054
금리인상예정,1,0.6118340573254963,17,11,6,10,0.5696108545124555,0.1370366164196054
물가오른,1,0.6118340573254963,17,11,6,12,0.5696108545124555,0.1370366164196054
변동성줄어드,1,0.6118340573254963,17,11,6,6,0.5696108545124555,0.1370366164196054
국채발행증가따른,1,0.6118340573254963,17,11,6,3,0.5696108545124555,0.1370366164196054
경제호조나타내,1,0.6118340573254963,17,11,6,10,0.5696108545124555,0.1370366164196054
재정악화,1,0.6118340573254963,17,11,6,14,0.5696108545124555,0.1370366164196054
경기지표호조보이,1,0.6118340573254963,17,11,6,17,0.5696108545124555,0.1370366164196054
원화강세요인작용,1,0.6118340573254963,17,11,6,14,0.5696108545124555,0.1370366164196054
달러원떨어지,1,0.6118340573254963,17,11,6,25,0.5696108545124555,0.1370366164196054
위험선호심리살아나,1,0.6118340573254963,17,11,6,10,0.5696108545124555,0.1370366164196054
엔화오르,1,0.6118340573254963,17,11,6,8,0.5696108545124555,0.1370366164196054
금리인상둘러싼,1,0.6097412131663607,36,23,13,28,0.6371530937470499,0.15431234732261317
기준금리오를,1,0.6016015486123025,49,31,18,61,0.6771678475363723,0.16827353344200338
매수심리회복,1,0.5974699641074492,41,26,15,27,0.6517417794174005,0.16405727433919387
매출늘,1,0.5971967310332478,25,16,9,24,0.5976254237027016,0.15056285678990589
성장보였,1,0.5971967310332478,25,16,9,9,0.5976254237027016,0.15056285678990589
달러화떨어졌,1,0.5971967310332478,25,16,9,15,0.5976254237027016,0.15056285678990589
자산건전성악화,1,0.5950914308004418,33,21,12,18,0.6251533537668484,0.15852988744851443
고용자수감소,1,0.5950914308004418,33,21,12,16,0.6251533537668484,0.15852988744851443
시장심리안정,1,0.5950914308004418,33,21,12,31,0.6251533537668484,0.15852988744851443
경제침체,1,0.5950914308004418,33,21,12,29,0.6251533537668484,0.15852988744851443
금리상승예상,1,0.5917955341656356,77,48,29,87,0.7498723778564829,0.19210092266488216
주택담보대출늘,1,0.5828476135120777,38,24,14,31,0.6399861796288449,0.1684897903652381
주택가격오르,1,0.5780582431525214,30,19,11,25,0.6128222900203179,0.16368509371615356
유로화하락압력받,1,0.5780582431525214,30,19,11,19,0.6128222900203179,0.16368509371615356
선행지수하락,1,0.5780582431525214,30,19,11,18,0.6128222900203179,0.16368509371615356
경기회복기대커지,1,0.5780582431525214,30,19,11,25,0.6128222900203179,0.16368509371615356
기대심리높여,1,0.5780582431525214,30,19,11,18,0.6128222900203179,0.16368509371615356
내수개선,1,0.5780582431525214,30,19,11,22,0.6128222900203179,0.16368509371615356
기준금리인상가능성시사,1,0.5780582431525214,30,19,11,21,0.6128222900203179,0.16368509371615356
하방위험요인작용,1,0.5780582431525214,30,19,11,5,0.6128222900203179,0.16368509371615356
인플레이션압력줄어들,1,0.577132399732363,22,14,8,8,0.584757476038317,0.15662341965031976
경상수지적자확대,1,0.577132399732363,22,14,8,8,0.584757476038317,0.15662341965031976
공공요금인상,1,0.577132399732363,22,14,8,9,0.584757476038317,0.15662341965031976
물가안정위해,1,0.5760581595680034,124,76,48,93,0.8325563259262585,0.22371330822277943
기준금리인상따른,1,0.5737354294761485,169,103,66,103,0.879855636017747,0.2380685313779452
단기금리상승,1,0.5599219785021834,88,54,34,72,0.7665881997158505,0.21603568504508236
부채증가,1,0.5585751272199937,40,25,15,50,0.6427292425993946,0.18184151877691052
위험줄일,1,0.5579190474898998,27,17,10,22,0.6001114622339585,0.17010789160778128
수출늘어날,1,0.5579190474898998,27,17,10,13,0.6001114622339585,0.17010789160778128
콜금리올릴,1,0.5538008499837499,45,28,17,12,0.657249972904671,0.1885374620833548
주택담보대출증가세둔화,1,0.5519235178429847,19,12,7,9,0.571416183734048,0.16480378807206006
위험낮추,1,0.5519235178429847,19,12,7,10,0.571416183734048,0.16480378807206006
비용부담,1,0.5519235178429847,19,12,7,36,0.571416183734048,0.16480378807206006
경기회복맞물려,1,0.5519235178429847,19,12,7,13,0.571416183734048,0.16480378807206006
물가안정하,1,0.5519235178429847,19,12,7,15,0.571416183734048,0.16480378807206006
경상수지흑자이,1,0.5519235178429847,19,12,7,13,0.571416183734048,0.16480378807206006
금리인상신호보내,1,0.5519235178429847,19,12,7,10,0.571416183734048,0.16480378807206006
경기회복반영,1,0.5519235178429847,19,12,7,11,0.571416183734048,0.16480378807206006
물가상승인해,1,0.5519235178429847,19,12,7,6,0.571416183734048,0.16480378807206006
기준금리인하주장,1,0.5519235178429847,19,12,7,15,0.571416183734048,0.16480378807206006
전원기준금리동결예상,1,0.5519235178429847,19,12,7,2,0.571416183734048,0.16480378807206006
내수회복따른,1,0.5519235178429847,19,12,7,5,0.571416183734048,0.16480378807206006
금리상승유발,1,0.5519235178429847,19,12,7,8,0.571416183734048,0.16480378807206006
자산축소,1,0.5519235178429847,19,12,7,25,0.571416183734048,0.16480378807206006
금리하락나타날,1,0.5519235178429847,19,12,7,7,0.571416183734048,0.16480378807206006
설비투자증가,1,0.5508624847022996,50,31,19,18,0.6714021220976975,0.19423213014755117
성장이,1,0.5483195839700743,60,37,23,50,0.6984549718667057,0.20353551524580898
금리인상가능성열,1,0.5477647858768295,117,71,46,130,0.8146133463608148,0.23776165271316224
회사채스프레드확대,1,0.5467963299897902,32,20,12,27,0.6154267319154303,0.18012212598609217
콜금리인상,1,0.5441355854340297,349,210,139,180,0.9144691877970166,0.26967986249187187
원화강세이어질,1,0.5403052451346317,37,23,14,15,0.6305538890734728,0.18798030824787437
경기둔화인한,1,0.5403052451346317,37,23,14,18,0.6305538890734728,0.18798030824787437
물가안정세유지,1,0.5403052451346317,37,23,14,8,0.6305538890734728,0.18798030824787437
금리올린,1,0.53954876309697,141,85,56,92,0.8435226031878841,0.25200778740581703
재고감소,1,0.5366360939424843,42,26,16,24,0.6453967929515773,0.1944033116576381
금리상승지속,1,0.5336149260707306,24,15,9,16,0.586938576665378,0.17829749776254405
국채수익률하락기록,1,0.5336149260707306,24,15,9,29,0.586938576665378,0.17829749776254405
경기둔화우려지속,1,0.5336149260707306,24,15,9,16,0.586938576665378,0.17829749776254405
경기회복저해,1,0.5336149260707306,24,15,9,21,0.586938576665378,0.17829749776254405
소득늘어나,1,0.5241164479701408,29,18,11,17,0.6025208192401826,0.18792062968476758
수주증가,1,0.5241164479701408,29,18,11,20,0.6025208192401826,0.18792062968476758
경제성장률전망상향조정,1,0.5241164479701408,29,18,11,27,0.6025208192401826,0.18792062968476758
글로벌경기회복따른,1,0.5241164479701408,29,18,11,35,0.6025208192401826,0.18792062968476758
신용경색우려완화,1,0.5193137623517663,34,21,13,29,0.6179635301342233,0.19529660058513917
유가올랐,1,0.5193137623517663,34,21,13,30,0.6179635301342233,0.19529660058513917
기대심리유지,1,0.5193137623517663,34,21,13,44,0.6179635301342233,0.19529660058513917
국채선물급등,1,0.5188825653464579,16,10,6,9,0.5573928940313858,0.17636229727186256
주택담보대출금리올랐,1,0.5188825653464579,16,10,6,10,0.5573928940313858,0.17636229727186256
아파트가격오르,1,0.5188825653464579,16,10,6,19,0.5573928940313858,0.17636229727186256
위험회피심리완화,1,0.5188825653464579,16,10,6,15,0.5573928940313858,0.17636229727186256
수급영향줄,1,0.5188825653464579,16,10,6,7,0.5573928940313858,0.17636229727186256
고용회복,1,0.5188825653464579,16,10,6,9,0.5573928940313858,0.17636229727186256
금리인상필요성강조,1,0.5188825653464579,16,10,6,15,0.5573928940313858,0.17636229727186256
금융시장개선,1,0.5188825653464579,16,10,6,5,0.5573928940313858,0.17636229727186256
투자심리위축지속,1,0.5188825653464579,16,10,6,4,0.5573928940313858,0.17636229727186256
금리인상힘실,1,0.5188825653464579,16,10,6,22,0.5573928940313858,0.17636229727186256
경기호조보이,1,0.5188825653464579,16,10,6,12,0.5573928940313858,0.17636229727186256
기준금리올라갈,1,0.5188825653464579,16,10,6,14,0.5573928940313858,0.17636229727186256
금리상승세돌아섰,1,0.5188825653464579,16,10,6,14,0.5573928940313858,0.17636229727186256
내외금리차확대,1,0.5188825653464579,16,10,6,11,0.5573928940313858,0.17636229727186256
기업실적호조힘입,1,0.5188825653464579,16,10,6,7,0.5573928940313858,0.17636229727186256
금리변동위험헤지,1,0.5188825653464579,16,10,6,1,0.5573928940313858,0.17636229727186256
미국채금리내린,1,0.5188825653464579,16,10,6,16,0.5573928940313858,0.17636229727186256
고용호조따른,1,0.5173212839593444,49,30,19,46,0.6624665902919111,0.21050444690924447
지출증가,1,0.5172182399851799,39,24,15,39,0.6331486150932566,0.20124500368101944
금리인상이어지,1,0.5172182399851799,39,24,15,29,0.6331486150932566,0.20124500368101944
기준금리인상이,1,0.5167608451376517,44,27,17,21,0.6480001850693216,0.20622274883822625
경기개선따른,1,0.5070420963452034,61,37,24,39,0.6924977493279922,0.22626361875377224
금리인상가능성시사,1,0.5061150928897342,148,88,60,117,0.8408591650905407,0.27542435221330014
금리인상위한,1,0.504134449814621,56,34,22,86,0.6789750350815524,0.22358447467430742
금리수준상승,1,0.5035352172581617,21,13,8,24,0.5731569587843176,0.1890421686690424
채권시장강세보임,1,0.5035352172581617,21,13,8,23,0.5731569587843176,0.1890421686690424
국채금리떨어진,1,0.5035352172581617,21,13,8,14,0.5731569587843176,0.1890421686690424
변동성줄어든,1,0.5035352172581617,21,13,8,13,0.5731569587843176,0.1890421686690424
낮금리적용,1,0.5035352172581617,21,13,8,19,0.5731569587843176,0.1890421686690424
경제과열막,1,0.5035352172581617,21,13,8,3,0.5731569587843176,0.1890421686690424
실적올렸,1,0.5035352172581617,21,13,8,20,0.5731569587843176,0.1890421686690424
구조개선,1,0.5023481131769969,73,44,29,66,0.7202349727255309,0.23830821382799647
물가상승,1,0.4991751048029849,203,120,83,161,0.8779351169187036,0.29295722734980606
물가상승률고려,1,0.49707131864618836,26,16,10,25,0.589073886352269,0.1976700866787466
기준금리동결지속,1,0.49707131864618836,26,16,10,18,0.589073886352269,0.1976700866787466
경제성장위한,1,0.49707131864618836,26,16,10,18,0.589073886352269,0.1976700866787466
가격변수변동성확대,1,0.49707131864618836,26,16,10,12,0.589073886352269,0.1976700866787466
유로달러상승,1,0.4965140280845841,41,25,16,29,0.6356909489686766,0.21362871055477092
경기회복세지속,1,0.4963057980589747,152,90,62,124,0.841728265179148,0.2830254016889493
경제회복세지속,1,0.49506590671903505,36,22,14,31,0.6204514999577259,0.2093093021427966
유가급락따른,1,0.49491609159242067,31,19,12,24,0.6048847148182411,0.2041388150829514
통화정책완화유지,1,0.4865788938069844,53,32,21,51,0.6674519674709268,0.23025451057531307
신용등급유지,1,0.48225272269832,48,29,19,49,0.6530478575669788,0.2278457477039729
유동성축소,1,0.48225272269832,48,29,19,48,0.6530478575669788,0.2278457477039729
금리인상앞두,1,0.48209391014634706,127,75,52,130,0.8092168715547972,0.2824492990902462
cd금리오르,1,0.47925791098616943,84,50,34,37,0.7379694451619412,0.25948730290326055
물가안정세보이,1,0.4735759702711726,38,23,15,14,0.6229039901614026,0.22226986058639298
미국채금리하락,1,0.4707134240042632,157,92,65,144,0.8380846341091294,0.301262897135797
금리인상맞물려,1,0.4695522237157399,33,20,13,27,0.6072240800148034,0.2189278422346029
성장뒷받침,1,0.4695522237157399,33,20,13,20,0.6072240800148034,0.2189278422346029
채권시장국채선물하락거래,1,0.4661799667825106,28,17,11,33,0.5912001881184875,0.2149982716357955
달러화떨어지,1,0.4661799667825106,28,17,11,19,0.5912001881184875,0.2149982716357955
산업생산증가,1,0.46569205565510985,107,63,44,74,0.7754405842329118,0.2823514442575711
저금리계속,1,0.4651216549947246,18,11,7,16,0.5584866501327681,0.20365095228944893
금융시장오,1,0.4651216549947246,18,11,7,12,0.5584866501327681,0.20365095228944893
경제충격주,1,0.4651216549947246,18,11,7,4,0.5584866501327681,0.20365095228944893
안정적성장지속,1,0.4651216549947246,18,11,7,12,0.5584866501327681,0.20365095228944893
금리인하기대심리확대,1,0.4651216549947246,18,11,7,10,0.5584866501327681,0.20365095228944893
금리오른다,1,0.4651216549947246,18,11,7,15,0.5584866501327681,0.20365095228944893
자금유입계속,1,0.4651216549947246,18,11,7,14,0.5584866501327681,0.20365095228944893
고용악화따른,1,0.4651216549947246,18,11,7,5,0.5584866501327681,0.20365095228944893
물가상승률목표밑돌,1,0.4651216549947246,18,11,7,11,0.5584866501327681,0.20365095228944893
기준금리인상예상,1,0.464450573365637,114,67,47,92,0.7857825810930344,0.28702468094181044
기준금리동결유지,1,0.4641815087083916,23,14,9,24,0.5749093361782106,0.2101425604131255
자금난덜,1,0.4641815087083916,23,14,9,8,0.5749093361782106,0.2101425604131255
유가하락힘입,1,0.4641815087083916,23,14,9,9,0.5749093361782106,0.2101425604131255
달러강세부추기,1,0.4641815087083916,23,14,9,7,0.5749093361782106,0.2101425604131255
국고채금리오르,1,0.4641815087083916,23,14,9,25,0.5749093361782106,0.2101425604131255
통화가치급락,1,0.4641815087083916,23,14,9,19,0.5749093361782106,0.2101425604131255
양적완화축소시작,1,0.4641815087083916,23,14,9,47,0.5749093361782106,0.2101425604131255
연방기금금리동결,1,0.46103945778131705,45,27,18,48,0.6406530200131548,0.2360523367668334
글로벌경제회복,1,0.46103945778131705,45,27,18,40,0.6406530200131548,0.2360523367668334
인플레이션기대심리확산,1,0.45443740265999333,40,24,16,8,0.6253302980796871,0.23428598605871986
수출줄어들,1,0.45443740265999333,40,24,16,17,0.6253302980796871,0.23428598605871986
경상수지흑자유지,1,0.45443740265999333,40,24,16,36,0.6253302980796871,0.23428598605871986
단기금리오르,1,0.45443740265999333,40,24,16,23,0.6253302980796871,0.23428598605871986
금리인상가능성배제없,1,0.4534218775293155,52,31,21,44,0.6579214702913369,0.2471276944508839
금리낮춰,1,0.4481367311385085,113,66,47,87,0.7792330243308601,0.2966016594754366
기준금리인상이뤄질,1,0.44738247470837433,35,21,14,28,0.6095525538398893,0.23245369216790884
주택담보대출늘어나,1,0.44738247470837433,35,21,14,19,0.6095525538398893,0.23245369216790884
수입늘,1,0.44738247470837433,35,21,14,33,0.6095525538398893,0.23245369216790884
수출호조힘입,1,0.44576398691609787,47,28,19,40,0.6430845030659644,0.24623430948127098
금리인상예상,1,0.440223539128779,258,149,109,220,0.8753490518613356,0.3398181291875108
달러원떨어진,1,0.4398488319460929,30,18,12,19,0.5933395466686582,0.2305536576251945
기준금리인상지속,1,0.4398488319460929,30,18,12,23,0.5933395466686582,0.2305536576251945
유동성줄어들,1,0.4398488319460929,30,18,12,24,0.5933395466686582,0.2305536576251945
콜금리목표수준유지,1,0.43788128801936343,61,36,25,41,0.6768701042154998,0.26429550714295375
인플레이션우려따른,1,0.43788128801936343,61,36,25,31,0.6768701042154998,0.26429550714295375
실업률떨어지,1,0.43730808991346737,42,25,17,38,0.6277367339871145,0.2454581796474704
기대심리약화,1,0.4356947601261245,75,44,31,72,0.7077932275789259,0.27786686813696526
금리인상가능성약화,1,0.4318095635971262,25,15,10,17,0.576714438150902,0.22858410443990715
인플레이션유지,1,0.4318095635971262,25,15,10,20,0.576714438150902,0.22858410443990715
고용지표호전,1,0.4318095635971262,25,15,10,11,0.576714438150902,0.22858410443990715
경제여건악화,1,0.4318095635971262,25,15,10,11,0.576714438150902,0.22858410443990715
금리동결유지,1,0.42787892441831565,37,22,15,24,0.6118786492614655,0.2448705317565998
성장유지,1,0.4277628425217974,63,37,26,56,0.6791249271172374,0.2718593394601177
달러화급락,1,0.42744224165528766,70,41,29,48,0.6948530761382505,0.27837369673900403
금리인상이,1,0.42744224165528766,70,41,29,45,0.6948530761382505,0.27837369673900403
고용지표호조보였,1,0.42323673555848695,20,12,8,11,0.5597038692503572,0.22654328405683577
달러강세부추겼,1,0.42323673555848695,20,12,8,12,0.5597038692503572,0.22654328405683577
외환시장현물환상승,1,0.42323673555848695,20,12,8,16,0.5597038692503572,0.22654328405683577
경기모멘텀둔화,1,0.42323673555848695,20,12,8,36,0.5597038692503572,0.22654328405683577
인플레이션낮추,1,0.42323673555848695,20,12,8,9,0.5597038692503572,0.22654328405683577
금리올리쉽않,1,0.42323673555848695,20,12,8,17,0.5597038692503572,0.22654328405683577
매출늘어나,1,0.42323673555848695,20,12,8,10,0.5597038692503572,0.22654328405683577
경쟁력떨어지,1,0.42323673555848695,20,12,8,15,0.5597038692503572,0.22654328405683577
금리인상있,1,0.42126850615562583,146,84,62,96,0.8108021220400928,0.3297519342069186
금리인상신중,1,0.4181919931333893,58,34,24,51,0.6649649016868961,0.2724666788419733
기준금리유지,1,0.41802457007176796,356,204,152,284,0.8758575091469986,0.3590246616041715
콜금리수준유지,1,0.4172070436458015,32,19,13,13,0.595504312494108,0.24458816510041081
유로화강세나타냈,1,0.4172070436458015,32,19,13,9,0.595504312494108,0.24458816510041081
물가올라가,1,0.4172070436458015,32,19,13,12,0.595504312494108,0.24458816510041081
국채선물하락,1,0.4172070436458015,32,19,13,23,0.595504312494108,0.24458816510041081
근원인플레이션상승,1,0.4172070436458015,32,19,13,20,0.595504312494108,0.24458816510041081
위험커졌,1,0.4172070436458015,32,19,13,27,0.595504312494108,0.24458816510041081
현금확보,1,0.4172070436458015,32,19,13,20,0.595504312494108,0.24458816510041081
성장발목잡,1,0.41410145761527595,15,9,6,8,0.5423379984387005,0.22442948837350804
성장성있,1,0.41410145761527595,15,9,6,10,0.5423379984387005,0.22442948837350804
소비확대,1,0.41410145761527595,15,9,6,9,0.5423379984387005,0.22442948837350804
역외환율상승반영,1,0.41410145761527595,15,9,6,6,0.5423379984387005,0.22442948837350804
신뢰도떨어지,1,0.41410145761527595,15,9,6,5,0.5423379984387005,0.22442948837350804
인플레이션압력낮추,1,0.41410145761527595,15,9,6,11,0.5423379984387005,0.22442948837350804
금리인상속도늦출,1,0.41410145761527595,15,9,6,10,0.5423379984387005,0.22442948837350804
무역수지적자축소,1,0.41410145761527595,15,9,6,6,0.5423379984387005,0.22442948837350804
완화정책유지,1,0.41410145761527595,15,9,6,17,0.5423379984387005,0.22442948837350804
원화강세용인,1,0.41410145761527595,15,9,6,13,0.5423379984387005,0.22442948837350804
자본유출우려,1,0.41410145761527595,15,9,6,21,0.5423379984387005,0.22442948837350804
낮금리인해,1,0.41410145761527595,15,9,6,7,0.5423379984387005,0.22442948837350804
금리인상의미,1,0.41410145761527595,15,9,6,10,0.5423379984387005,0.22442948837350804
자산감소,1,0.41410145761527595,15,9,6,9,0.5423379984387005,0.22442948837350804
위험자산투자,1,0.41410145761527595,15,9,6,8,0.5423379984387005,0.22442948837350804
기준금리인상진행,1,0.41410145761527595,15,9,6,24,0.5423379984387005,0.22442948837350804
수요감소따른,1,0.41410145761527595,15,9,6,15,0.5423379984387005,0.22442948837350804
경기꺾이,1,0.41410145761527595,15,9,6,14,0.5423379984387005,0.22442948837350804
경제침체벗어나,1,0.41410145761527595,15,9,6,8,0.5423379984387005,0.22442948837350804
가계대출증가세둔화,1,0.41410145761527595,15,9,6,11,0.5423379984387005,0.22442948837350804
채권시장심리개선,1,0.41410145761527595,15,9,6,8,0.5423379984387005,0.22442948837350804
평균금리하락,1,0.41410145761527595,15,9,6,11,0.5423379984387005,0.22442948837350804
경기부양책쓰,1,0.41410145761527595,15,9,6,11,0.5423379984387005,0.22442948837350804
거시경제정책유지,1,0.41410145761527595,15,9,6,17,0.5423379984387005,0.22442948837350804
경기회복둔화,1,0.41410145761527595,15,9,6,11,0.5423379984387005,0.22442948837350804
실적부진,1,0.41289615648282063,81,47,34,56,0.7136854352143097,0.2961958499009413
회사채금리하락,1,0.41061130634567733,39,23,16,36,0.6142072993299178,0.25631602762111905
대출늘어난,1,0.41061130634567733,39,23,16,38,0.6142072993299178,0.25631602762111905
위험작용,1,0.41061130634567733,39,23,16,39,0.6142072993299178,0.25631602762111905
경제성장률둔화,1,0.4095333802982881,113,65,48,93,0.7667594076842013,0.3208078063491941
제로금리정책유지,1,0.40484389722374936,27,16,11,11,0.5785921736691698,0.2448155109593501
가산금리하락,1,0.40484389722374936,27,16,11,19,0.5785921736691698,0.2448155109593501
일자리늘리,1,0.40484389722374936,27,16,11,12,0.5785921736691698,0.2448155109593501
금리상승되돌리,1,0.40484389722374936,27,16,11,27,0.5785921736691698,0.2448155109593501
금리상승인해,1,0.40484389722374936,27,16,11,30,0.5785921736691698,0.2448155109593501
cd금리올랐,1,0.40484389722374936,27,16,11,18,0.5785921736691698,0.2448155109593501
기준금리올린,1,0.3995385546581274,101,58,43,82,0.7452224524717925,0.31933547112591876
변동성커질,1,0.3995034004557314,181,103,78,177,0.8313354181792442,0.35626555163854323
성장따른,1,0.3987747440885512,62,36,26,44,0.6695031070253142,0.2874104986416979
불확실성증가,1,0.3975690128464957,34,20,14,28,0.597700491442187,0.2573224404043921
국제유가상승따른,1,0.3975690128464957,34,20,14,24,0.597700491442187,0.2573224404043921
국채금리하락마감,1,0.39534115028496286,48,28,20,55,0.6348704117332695,0.274772976402546
투자감소,1,0.39534115028496286,48,28,20,31,0.6348704117332695,0.274772976402546
수출호조지속,1,0.39534115028496286,48,28,20,17,0.6348704117332695,0.274772976402546
소비지출증가,1,0.3952295468172169,41,24,17,21,0.616540954728033,0.2669105228180904
기준금리수준유지,1,0.3934780169122758,377,214,163,387,0.8676388323943971,0.3771754465268109
국제유가떨어지,1,0.38996321935873124,22,13,9,17,0.5610825333297746,0.24594372381609042
위험따른,1,0.38996321935873124,22,13,9,24,0.5610825333297746,0.24594372381609042
금리낮춰야,1,0.38996321935873124,22,13,9,20,0.5610825333297746,0.24594372381609042
물가상승세지속,1,0.38996321935873124,22,13,9,10,0.5610825333297746,0.24594372381609042
지급준비금적수늘,1,0.38996321935873124,22,13,9,19,0.5610825333297746,0.24594372381609042
성장보이,1,0.38996321935873124,22,13,9,36,0.5610825333297746,0.24594372381609042
채권가격하락채권약세한의미,1,0.38996321935873124,22,13,9,23,0.5610825333297746,0.24594372381609042
완화인해,1,0.38996321935873124,22,13,9,13,0.5610825333297746,0.24594372381609042
시장금리상승제한,1,0.3821024546781948,29,17,12,27,0.5805498397317365,0.25921978750422336
환율안정위해,1,0.3821024546781948,29,17,12,24,0.5805498397317365,0.25921978750422336
경제침체빠질,1,0.3821024546781948,29,17,12,28,0.5805498397317365,0.25921978750422336
채권시장영향줄,1,0.3821024546781948,29,17,12,14,0.5805498397317365,0.25921978750422336
회사채금리상승,1,0.3821024546781948,29,17,12,28,0.5805498397317365,0.25921978750422336
고용시장개선,1,0.3818695482269683,66,38,28,72,0.6739230162462257,0.3010756798665831
경기회복따른,1,0.3811373587445821,241,136,105,177,0.850147771404925,0.38045539445308896
금리반락,1,0.3803961047845079,36,21,15,38,0.5999299934432079,0.26894443002661783
경기상승따른,1,0.3803961047845079,36,21,15,18,0.5999299934432079,0.26894443002661783
금리수준유지,1,0.37973495639389987,109,62,47,81,0.7508986320296183,0.33714303302533816
지표금리하락거래,1,0.37327235150684945,52,30,22,77,0.6395673104342081,0.2915120182691889
대출증가,1,0.3710210876057687,95,54,41,83,0.7260884517638341,0.3326812972678446
시장금리올릴,1,0.3708203912115162,17,10,7,5,0.5428125433441091,0.24882313868260275
자산늘,1,0.3708203912115162,17,10,7,12,0.5428125433441091,0.24882313868260275
성장제약,1,0.3708203912115162,17,10,7,26,0.5428125433441091,0.24882313868260275
기업실적양호,1,0.3708203912115162,17,10,7,8,0.5428125433441091,0.24882313868260275
채권투자확대,1,0.3708203912115162,17,10,7,14,0.5428125433441091,0.24882313868260275
완화필요,1,0.3708203912115162,17,10,7,9,0.5428125433441091,0.24882313868260275
농산물가격급등,1,0.3708203912115162,17,10,7,5,0.5428125433441091,0.24882313868260275
침체빠지않,1,0.3708203912115162,17,10,7,8,0.5428125433441091,0.24882313868260275
원화약세지속,1,0.3708203912115162,17,10,7,11,0.5428125433441091,0.24882313868260275
달러화하락세이,1,0.3708203912115162,17,10,7,13,0.5428125433441091,0.24882313868260275
하방위험있,1,0.3708203912115162,17,10,7,18,0.5428125433441091,0.24882313868260275
미국채가격영향상승출발예상,1,0.3708203912115162,17,10,7,26,0.5428125433441091,0.24882313868260275
미국채가격하락,1,0.3708203912115162,17,10,7,18,0.5428125433441091,0.24882313868260275
변동성확대예상,1,0.3708203912115162,17,10,7,10,0.5428125433441091,0.24882313868260275
유로상승,1,0.3708203912115162,17,10,7,9,0.5428125433441091,0.24882313868260275
금리인하지지,1,0.3708203912115162,17,10,7,5,0.5428125433441091,0.24882313868260275
적자보였,1,0.3708203912115162,17,10,7,11,0.5428125433441091,0.24882313868260275
기준금리인상대비,1,0.3708203912115162,17,10,7,15,0.5428125433441091,0.24882313868260275
금리인상나섰,1,0.3708203912115162,17,10,7,20,0.5428125433441091,0.24882313868260275
기준금리인하기대심리약화,1,0.3708203912115162,17,10,7,15,0.5428125433441091,0.24882313868260275
수출늘어난,1,0.3708203912115162,17,10,7,13,0.5428125433441091,0.24882313868260275
수출증가힘입,1,0.3708203912115162,17,10,7,13,0.5428125433441091,0.24882313868260275
달러화급락따른,1,0.3708203912115162,17,10,7,6,0.5428125433441091,0.24882313868260275
회사채금리올랐,1,0.3708203912115162,17,10,7,23,0.5428125433441091,0.24882313868260275
통화가치상승,1,0.3708203912115162,17,10,7,10,0.5428125433441091,0.24882313868260275
국채가격반등,1,0.3708203912115162,17,10,7,10,0.5428125433441091,0.24882313868260275
가계대출늘어나,1,0.3652636573046213,38,22,16,19,0.6021921282753318,0.2796120841943956
저금리유지,1,0.36458088804132305,312,175,137,289,0.8544187703637417,0.3973520464836026
원달러오르,1,0.36301917434603714,24,14,10,23,0.5626308533252442,0.2625976521844979
채권시장부담될,1,0.36301917434603714,24,14,10,19,0.5626308533252442,0.2625976521844979
미국채금리상승영향받,1,0.36301917434603714,24,14,10,22,0.5626308533252442,0.2625976521844979
부동산가격오르,1,0.36301917434603714,24,14,10,20,0.5626308533252442,0.2625976521844979
성장저해,1,0.36301917434603714,24,14,10,18,0.5626308533252442,0.2625976521844979
유로화강세견인,1,0.3627006085831139,31,18,13,12,0.5825873868514001,0.2721114849036297
기준금리인상늦춰질,1,0.3627006085831139,31,18,13,22,0.5825873868514001,0.2721114849036297
소비자물가오르,1,0.3627006085831139,31,18,13,23,0.5825873868514001,0.2721114849036297
금리인상하,1,0.36121388012800426,99,56,43,98,0.7293070350392816,0.34180742914738727
대출늘리,1,0.36121388012800426,99,56,43,63,0.7293070350392816,0.34180742914738727
소비심리개선,1,0.35779401670200506,47,27,20,44,0.6235740286044568,0.29455659137239154
지출줄이,1,0.35779401670200506,47,27,20,49,0.6235740286044568,0.29455659137239154
글로벌경기둔화따른,1,0.35464537905665083,56,32,24,30,0.6442160782712505,0.30650886670873656
경기둔화우려커지,1,0.35464537905665083,56,32,24,47,0.6442160782712505,0.30650886670873656
완화유지,1,0.3538276002606162,74,42,32,63,0.6824150400058901,0.3252908852207004
금리인하나서,1,0.3538276002606162,74,42,32,61,0.6824150400058901,0.3252908852207004
금리인상주장,1,0.35367216233907106,65,37,28,70,0.6638733728690277,0.31656492894177857
외환시장안정,1,0.351834744185209,40,23,17,24,0.6044845992400815,0.2894573873641433
금리인상전망,1,0.351834744185209,40,23,17,44,0.6044845992400815,0.2894573873641433
금리인상따른,1,0.34906268534685836,509,284,225,420,0.8517205158911357,0.41043084534428437
달러약세지속,1,0.3477771244728407,76,43,33,54,0.6844654636212574,0.33079937231518813
금리인하가능,1,0.34756975597268847,49,28,21,28,0.6259254536411,0.30264989529138525
수출개선,1,0.34756975597268847,49,28,21,40,0.6259254536411,0.30264989529138525
금리하락요인작용,1,0.34756975597268847,49,28,21,38,0.6259254536411,0.30264989529138525
금융시장변동성확대,1,0.3456609299530651,116,65,51,117,0.7485376994475994,0.3635088591590077
실적악화,1,0.34405548460779434,87,49,38,45,0.7035096515704313,0.34288876867402435
지표금리오른,1,0.34081550948885986,26,15,11,31,0.5643422473672406,0.2770844493080676
고용지표상회,1,0.34081550948885986,26,15,11,12,0.5643422473672406,0.2770844493080676
양적완화축소,1,0.33974065624315775,109,61,48,152,0.7367563309088497,0.3626175153649748
재고증가,1,0.33870414959046036,60,34,26,39,0.6488098476198775,0.32008046625169767
재할인율인하,1,0.33870414959046036,60,34,26,72,0.6488098476198775,0.32008046625169767
기준금리인상있,1,0.3382285662283293,51,29,22,35,0.6282774285930752,0.3102840728024121
달러화하락출발,1,0.33795661723098247,19,11,8,21,0.5436486947088326,0.2686537659104929
경기침체우려,1,0.33795661723098247,19,11,8,14,0.5436486947088326,0.2686537659104929
국채가격내린,1,0.33795661723098247,19,11,8,6,0.5436486947088326,0.2686537659104929
경기침체벗어나,1,0.33795661723098247,19,11,8,18,0.5436486947088326,0.2686537659104929
기준금리인상가능성제기,1,0.33795661723098247,19,11,8,10,0.5436486947088326,0.2686537659104929
국채금리올랐,1,0.33795661723098247,19,11,8,26,0.5436486947088326,0.2686537659104929
유로화약세나타냈,1,0.33795661723098247,19,11,8,15,0.5436486947088326,0.2686537659104929
경기회복기대심리커지,1,0.33795661723098247,19,11,8,22,0.5436486947088326,0.2686537659104929
순이익줄어들,1,0.33795661723098247,19,11,8,19,0.5436486947088326,0.2686537659104929
원화강세보였,1,0.33795661723098247,19,11,8,11,0.5436486947088326,0.2686537659104929
위험커질,1,0.33795661723098247,19,11,8,23,0.5436486947088326,0.2686537659104929
경제성장미치,1,0.33795661723098247,19,11,8,17,0.5436486947088326,0.2686537659104929
경제개선,1,0.33725506413241435,100,56,44,97,0.7225470659904591,0.3576251999088364
성장둔화,1,0.33482152588954994,153,85,68,92,0.7849155182096083,0.3906307718882726
실적양호,1,0.3314100719995381,35,20,15,50,0.5868831603984893,0.29432450977966906
국채가격하락압력받,1,0.3314100719995381,35,20,15,25,0.5868831603984893,0.29432450977966906
달러화약세보이,1,0.32913595803635,104,58,46,80,0.7256607853767594,0.36578372018685046
금리올리않,1,0.32511078163019747,181,100,81,173,0.8019613607980347,0.40790334409053536
불확실성증대,1,0.3248941590277048,64,36,28,56,0.6533397847667366,0.3324705573394435
자산줄이,1,0.32223213260067407,28,16,12,13,0.566203308307882,0.2898462518344724
시장하락유로달러상승거래,1,0.32223213260067407,28,16,12,27,0.566203308307882,0.2898462518344724
금리인하나서않,1,0.32223213260067407,28,16,12,10,0.566203308307882,0.2898462518344724
수입물가상승,1,0.32223213260067407,28,16,12,23,0.566203308307882,0.2898462518344724
금리동결지속,1,0.32223213260067407,28,16,12,18,0.566203308307882,0.2898462518344724
실적개선,1,0.3217534344181312,130,72,58,133,0.756582916959539,0.3877175453249159
성장세보이,1,0.3217534344181312,130,72,58,111,0.756582916959539,0.3877175453249159
자산매입축소,1,0.31862420752539555,37,21,16,47,0.5891275837554978,0.3040150917245895
내수회복,1,0.3144776812859609,57,32,25,35,0.6353152674677388,0.3308838921208251
금리인하가능성낮추,1,0.31225668018474617,21,12,9,6,0.5448159187783437,0.28515051313783146
소비자심리지수상승,1,0.31225668018474617,21,12,9,13,0.5448159187783437,0.28515051313783146
통화완화따른,1,0.31225668018474617,21,12,9,28,0.5448159187783437,0.28515051313783146
물가끌어올리,1,0.31225668018474617,21,12,9,26,0.5448159187783437,0.28515051313783146
금리올라간,1,0.31225668018474617,21,12,9,20,0.5448159187783437,0.28515051313783146
국제유가넘어서,1,0.31225668018474617,21,12,9,12,0.5448159187783437,0.28515051313783146
금리확대,1,0.31225668018474617,21,12,9,21,0.5448159187783437,0.28515051313783146
국고채떨어진,1,0.31225668018474617,21,12,9,16,0.5448159187783437,0.28515051313783146
금융안정위해,1,0.31225668018474617,21,12,9,15,0.5448159187783437,0.28515051313783146
변동폭커질,1,0.31225668018474617,21,12,9,17,0.5448159187783437,0.28515051313783146
경기회복세감안,1,0.31225668018474617,21,12,9,15,0.5448159187783437,0.28515051313783146
금리하락기록,1,0.31225668018474617,21,12,9,24,0.5448159187783437,0.28515051313783146
불확실성완화,1,0.31148945225052493,171,94,77,148,0.7895579619577304,0.4139483811295259
금리인상기정사실화,1,0.31048349352805893,48,27,21,38,0.6138869192686116,0.32256506912684835
금리인상자제,1,0.30731042972323963,39,22,17,22,0.591426157262726,0.3129497535872391
미국채수익률상승,1,0.30731042972323963,39,22,17,37,0.591426157262726,0.3129497535872391
물가오름세확대,1,0.30731042972323963,39,22,17,18,0.591426157262726,0.3129497535872391
금리인하기정사실화,1,0.3064655034605379,30,17,13,22,0.568198004947732,0.30121981671902226
cds프리미엄하락,1,0.3064655034605379,30,17,13,22,0.568198004947732,0.30121981671902226
기준금리인상가능성열,1,0.3064655034605379,30,17,13,20,0.568198004947732,0.30121981671902226
소비부진,1,0.3064655034605379,30,17,13,22,0.568198004947732,0.30121981671902226
경기둔화심화,1,0.3064655034605379,30,17,13,10,0.568198004947732,0.30121981671902226
비용줄일,1,0.3064655034605379,30,17,13,22,0.568198004947732,0.30121981671902226
경제악화,1,0.30241831946035247,50,28,22,28,0.6162759222049355,0.32963349209356424
기대심리상승,1,0.30241831946035247,50,28,22,48,0.6162759222049355,0.32963349209356424
기준금리올리않,1,0.3014323023709127,61,34,27,47,0.6399706408318507,0.3430504573538839
위험감수,1,0.2976559947274042,98,54,44,75,0.7050515417937679,0.3810835328560235
수출늘어나,1,0.29557034956740313,63,35,28,53,0.6422812706904903,0.34874643703177755
성장가능,1,0.29318598127246487,126,69,57,76,0.7405312043201793,0.40419798174745547
금리올라갔,1,0.2929281409542712,32,18,14,12,0.5703098601333106,0.3114630389918069
유가상승세지속,1,0.29165365251707986,23,13,10,8,0.5462730369163756,0.29916799556815016
금리인상뒷받침,1,0.29165365251707986,23,13,10,18,0.5462730369163756,0.29916799556815016
미국채금리하락영향받,1,0.29165365251707986,23,13,10,19,0.5462730369163756,0.29916799556815016
불안심리해소않,1,0.29165365251707986,23,13,10,9,0.5462730369163756,0.29916799556815016
원화강세인한,1,0.29165365251707986,23,13,10,19,0.5462730369163756,0.29916799556815016
유동성떨어지,1,0.2882350319471296,54,30,24,37,0.6210732156844463,0.3426795905260522
금리국고지표물하락거래시작,1,0.2882350319471296,54,30,24,89,0.6210732156844463,0.3426795905260522
경기둔화지속,1,0.2881885514180522,43,24,19,26,0.5961554838970535,0.3289644644382448
집값잡,1,0.2811824825003244,34,19,15,27,0.5725230385114282,0.32077515648949634
낮금리유지,1,0.2811824825003244,34,19,15,26,0.5725230385114282,0.32077515648949634
지표금리내린,1,0.2811824825003244,34,19,15,49,0.5725230385114282,0.32077515648949634
국고채내린,1,0.28003508991068027,45,25,20,26,0.5985720256843695,0.336205908524926
금리인상따른부담,1,0.2747898968189819,25,14,11,6,0.5479783799450839,0.31130439286880623
유동성위축,1,0.2747898968189819,25,14,11,10,0.5479783799450839,0.31130439286880623
위험줄어들,1,0.2747898968189819,25,14,11,24,0.5479783799450839,0.31130439286880623
달러화떨어질,1,0.2747898968189819,25,14,11,11,0.5479783799450839,0.31130439286880623
국채매입확대,1,0.2747898968189819,25,14,11,16,0.5479783799450839,0.31130439286880623
국제금융시장변동성확대,1,0.2747898968189819,25,14,11,30,0.5479783799450839,0.31130439286880623
기준금리올려,1,0.27264308804496773,47,26,21,37,0.6010144720456829,0.34302145575980547
소비줄이,1,0.27264308804496773,47,26,21,37,0.6010144720456829,0.34302145575980547
경제성장둔화,1,0.2721183132723337,129,70,59,101,0.7351357121629184,0.42004510518765814
경기침체빠지,1,0.27174007051941507,16,9,7,10,0.5230328626018185,0.29909692389097664
침체계속,1,0.27174007051941507,16,9,7,8,0.5230328626018185,0.29909692389097664
안전자산선호부각,1,0.27174007051941507,16,9,7,15,0.5230328626018185,0.29909692389097664
경기회복세진행,1,0.27174007051941507,16,9,7,11,0.5230328626018185,0.29909692389097664
금리격차확대,1,0.27174007051941507,16,9,7,11,0.5230328626018185,0.29909692389097664
금리인상부담덜,1,0.27174007051941507,16,9,7,12,0.5230328626018185,0.29909692389097664
위험도사리,1,0.27174007051941507,16,9,7,13,0.5230328626018185,0.29909692389097664
경기부담줄,1,0.27174007051941507,16,9,7,9,0.5230328626018185,0.29909692389097664
미국채가격상승,1,0.27174007051941507,16,9,7,25,0.5230328626018185,0.29909692389097664
기준금리인상앞당겨질,1,0.27174007051941507,16,9,7,31,0.5230328626018185,0.29909692389097664
달러강세나타날,1,0.27174007051941507,16,9,7,19,0.5230328626018185,0.29909692389097664
실업수당청구증가,1,0.27174007051941507,16,9,7,14,0.5230328626018185,0.29909692389097664
수익늘,1,0.27174007051941507,16,9,7,13,0.5230328626018185,0.29909692389097664
안전자산선호심화,1,0.27174007051941507,16,9,7,9,0.5230328626018185,0.29909692389097664
달러화약세나타냈,1,0.27174007051941507,16,9,7,13,0.5230328626018185,0.29909692389097664
불확실성확산,1,0.27174007051941507,16,9,7,19,0.5230328626018185,0.29909692389097664
금리차확대따른,1,0.27174007051941507,16,9,7,4,0.5230328626018185,0.29909692389097664
엔화약세유도,1,0.27174007051941507,16,9,7,22,0.5230328626018185,0.29909692389097664
내구재주문증가,1,0.27174007051941507,16,9,7,8,0.5230328626018185,0.29909692389097664
소비줄일,1,0.27174007051941507,16,9,7,8,0.5230328626018185,0.29909692389097664
집값올랐,1,0.27174007051941507,16,9,7,20,0.5230328626018185,0.29909692389097664
양적완화종료앞두,1,0.27174007051941507,16,9,7,15,0.5230328626018185,0.29909692389097664
물가상승률낮추,1,0.27174007051941507,16,9,7,13,0.5230328626018185,0.29909692389097664
이익늘,1,0.27174007051941507,16,9,7,14,0.5230328626018185,0.29909692389097664
불확실성커지,1,0.27118973869697927,172,93,79,158,0.7726534403216798,0.4423677409117342
무역수지적자기록,1,0.270896887983086,36,20,16,20,0.5748228463696271,0.3293116544967816
유동성늘어나,1,0.270896887983086,36,20,16,18,0.5748228463696271,0.3293116544967816
채권스왑스프레드확대,1,0.270896887983086,36,20,16,25,0.5748228463696271,0.3293116544967816
금리올라도,1,0.270896887983086,36,20,16,34,0.5748228463696271,0.3293116544967816
경기선행지수하락,1,0.27075810174376014,60,33,27,40,0.6282669961495013,0.3600371700130079
수출늘,1,0.27075810174376014,60,33,27,31,0.6282669961495013,0.3600371700130079
금리올라가,1,0.2699475639763351,187,101,86,132,0.7814904521166162,0.4486274680569557
이익내,1,0.26338715457934314,77,42,35,52,0.6579798608009191,0.3830943130503041
대출늘,1,0.26338715457934314,77,42,35,62,0.6579798608009191,0.3830943130503041
건전성악화,1,0.26181591667684145,38,21,17,44,0.5771959166784898,0.3371951510034555
금리올려야,1,0.26082865720779536,169,91,78,141,0.7658744372792938,0.4483688854730609
성장세보였,1,0.26074377048941066,27,15,12,35,0.5498936630002642,0.3219850238508927
이익감소,1,0.26074377048941066,27,15,12,31,0.5498936630002642,0.3219850238508927
금리하향안정,1,0.26074377048941066,27,15,12,6,0.5498936630002642,0.3219850238508927
기준금리인상가능성반영,1,0.26074377048941066,27,15,12,20,0.5498936630002642,0.3219850238508927
채권시장국채가격올랐,1,0.26074377048941066,27,15,12,33,0.5498936630002642,0.3219850238508927
금리인상대응,1,0.26074377048941066,27,15,12,22,0.5498936630002642,0.3219850238508927
금리올린다고,1,0.26074377048941066,27,15,12,36,0.5498936630002642,0.3219850238508927
달러화하락압력받,1,0.256867881758595,96,52,44,58,0.686323256740115,0.4052208095311741
금리인상될,1,0.25663201877501995,66,36,30,47,0.635389816983538,0.3753379416088501
달러화하락,1,0.25611669902096135,218,117,101,189,0.7896243953305115,0.4669620377912475
엔화강세나타냈,1,0.25373989889600757,40,22,18,15,0.5796302289729193,0.3445233489717361
금리올린다면,1,0.25373989889600757,40,22,18,38,0.5796302289729193,0.3445233489717361
기대심리높이,1,0.2525005773723752,68,37,31,48,0.6377373004568612,0.38006589776374045
서비스업생산증가,1,0.24949688221052413,18,10,8,4,0.5238772053730091,0.314216713372264
통화긴축이어질,1,0.24949688221052413,18,10,8,9,0.5238772053730091,0.314216713372264
시장금리올라가,1,0.24949688221052413,18,10,8,10,0.5238772053730091,0.314216713372264
경제커지,1,0.24949688221052413,18,10,8,10,0.5238772053730091,0.314216713372264
내수확대,1,0.24949688221052413,18,10,8,6,0.5238772053730091,0.314216713372264
국가신용등급상향조정,1,0.24949688221052413,18,10,8,19,0.5238772053730091,0.314216713372264
높수익올릴,1,0.24949688221052413,18,10,8,9,0.5238772053730091,0.314216713372264
신용등급하락따른,1,0.24949688221052413,18,10,8,3,0.5238772053730091,0.314216713372264
마이너스금리적용,1,0.24949688221052413,18,10,8,11,0.5238772053730091,0.314216713372264
부동산가격안정,1,0.24949688221052413,18,10,8,11,0.5238772053730091,0.314216713372264
부동산시장안정위해,1,0.24949688221052413,18,10,8,5,0.5238772053730091,0.314216713372264
자금유입늘어나,1,0.24949688221052413,18,10,8,9,0.5238772053730091,0.314216713372264
물가안정목표상회,1,0.24949688221052413,18,10,8,16,0.5238772053730091,0.314216713372264
달러화가치오르,1,0.24949688221052413,18,10,8,21,0.5238772053730091,0.314216713372264
금리인상나서,1,0.24924324836333311,151,81,70,145,0.7465404275451888,0.4480101757921429
금리차축소,1,0.24887171958807275,55,30,25,75,0.6109332076587433,0.36692061710796353
경제부담작용,1,0.24887041431370105,29,16,13,19,0.5519851566038506,0.331517905800731
고용지표하회,1,0.24887041431370105,29,16,13,15,0.5519851566038506,0.331517905800731
위안화절상,1,0.24682517705385387,87,47,40,83,0.6685185700014915,0.4032595328743447
이자부담커지,1,0.24651065011523987,42,23,19,14,0.5821150463966797,0.35137487740950607
경기회복이어지,1,0.24651065011523987,42,23,19,17,0.5821150463966797,0.35137487740950607
경기개선,1,0.24514090635267416,172,92,80,166,0.7607087513561702,0.46051711880173635
기준금리인상,1,0.2447337327125627,2697,1442,1255,2168,0.806978739858419,0.48895114316322674
침체겪,1,0.24404448918637822,57,31,26,28,0.6134267248550916,0.37222228283240144
변동폭확대,1,0.24148234999646356,74,40,34,46,0.6446729974457673,0.3933168065317723
달러원상승,1,0.24050534660646883,144,77,67,122,0.7363388404190518,0.4501747295651463
양적완화지속,1,0.23956438068418473,59,32,27,60,0.6159178907882149,0.37730535110571084
기준금리인상나설,1,0.23956438068418473,59,32,27,58,0.6159178907882149,0.37730535110571084
국채수익률오른,1,0.2387063068183346,31,17,14,20,0.5542237241320904,0.3401302701152631
외환시장원달러내린,1,0.2387063068183346,31,17,14,37,0.5542237241320904,0.3401302701152631
안전자산선호나타나,1,0.2387063068183346,31,17,14,29,0.5542237241320904,0.3401302701152631
경기회복지원,1,0.2387063068183346,31,17,14,29,0.5542237241320904,0.3401302701152631
경기둔화반영,1,0.2387063068183346,31,17,14,12,0.5542237241320904,0.3401302701152631
원화약세보이,1,0.2387063068183346,31,17,14,29,0.5542237241320904,0.3401302701152631
인플레이션억제위해,1,0.236038913737598,95,51,44,80,0.676462535138248,0.4175010707353698
금리인상진행,1,0.2341090072276193,46,25,21,45,0.5871990506358249,0.36389192621019323
수입감소,1,0.2341090072276193,46,25,21,28,0.5871990506358249,0.36389192621019323
금리하락이어질,1,0.23224186178138329,20,11,9,18,0.5251931462863247,0.3267533681557359
금리내릴없,1,0.23224186178138329,20,11,9,19,0.5251931462863247,0.3267533681557359
순이익늘어난,1,0.23224186178138329,20,11,9,21,0.5251931462863247,0.3267533681557359
인플레이션넘어서,1,0.23224186178138329,20,11,9,2,0.5251931462863247,0.3267533681557359
투자늘려,1,0.23224186178138329,20,11,9,24,0.5251931462863247,0.3267533681557359
단기물금리상승,1,0.23224186178138329,20,11,9,23,0.5251931462863247,0.3267533681557359
국채선물하락마쳤,1,0.23224186178138329,20,11,9,8,0.5251931462863247,0.3267533681557359
지급준비금적수늘어나,1,0.23224186178138329,20,11,9,13,0.5251931462863247,0.3267533681557359
기준금리인상늦출,1,0.23224186178138329,20,11,9,16,0.5251931462863247,0.3267533681557359
실업수당청구줄어든,1,0.23224186178138329,20,11,9,9,0.5251931462863247,0.3267533681557359
달러약세이어지,1,0.23224186178138329,20,11,9,18,0.5251931462863247,0.3267533681557359
노동시장개선,1,0.22991024599667464,33,18,15,45,0.5565844211218036,0.34799272891545097
물가안정위한,1,0.22409169669535478,86,46,40,66,0.6579392583246259,0.4164377070308395
금리동결결정,1,0.22385299283061144,50,27,23,39,0.5923836545420051,0.37513316201994684
펀더멘털개선,1,0.22385299283061144,50,27,23,61,0.5923836545420051,0.37513316201994684
투자심리안정,1,0.22385299283061144,50,27,23,40,0.5923836545420051,0.37513316201994684
금리인상점치,1,0.22222574390350291,35,19,16,13,0.5590459627973409,0.3552354959354023
경제호조보이,1,0.22222574390350291,35,19,16,15,0.5590459627973409,0.3552354959354023
성장촉진,1,0.22222574390350291,35,19,16,25,0.5590459627973409,0.3552354959354023
위험떠안,1,0.22222574390350291,35,19,16,30,0.5590459627973409,0.3552354959354023
낮금리자금조달,1,0.22222574390350291,35,19,16,40,0.5590459627973409,0.3552354959354023
성장세보일,1,0.22122941094595583,69,37,32,68,0.6282336598220042,0.4000364867108175
금융시장안정되찾,1,0.21936149283078654,52,28,24,27,0.594997411471737,0.38036240581139646
부채늘어나,1,0.21936149283078654,52,28,24,41,0.594997411471737,0.38036240581139646
투자늘,1,0.21936149283078654,52,28,24,39,0.594997411471737,0.38036240581139646
금리상승축소,1,0.21848385609675058,22,12,10,27,0.5268825741991977,0.33743995631650364
금리끌어내릴,1,0.21848385609675058,22,12,10,11,0.5268825741991977,0.33743995631650364
국채수익률떨어진,1,0.21848385609675058,22,12,10,10,0.5268825741991977,0.33743995631650364
달러화오,1,0.21848385609675058,22,12,10,14,0.5268825741991977,0.33743995631650364
지급준비율인상통해,1,0.21848385609675058,22,12,10,10,0.5268825741991977,0.33743995631650364
성장그칠,1,0.21848385609675058,22,12,10,18,0.5268825741991977,0.33743995631650364
달러원내린,1,0.21848385609675058,22,12,10,21,0.5268825741991977,0.33743995631650364
글로벌경기회복,1,0.21848385609675058,22,12,10,18,0.5268825741991977,0.33743995631650364
경기회복진행,1,0.21848385609675058,22,12,10,23,0.5268825741991977,0.33743995631650364
기준금리내려가,1,0.21848385609675058,22,12,10,27,0.5268825741991977,0.33743995631650364
경제지표호조나타내,1,0.21848385609675058,22,12,10,30,0.5268825741991977,0.33743995631650364
변동성축소,1,0.21534469657670607,73,39,34,68,0.6330500802095556,0.4081127380788717
금리올리,1,0.2151715500336091,892,471,421,746,0.7927145038791917,0.5112301799733785
통화완화유지,1,0.2114055640038317,56,30,26,47,0.6002414147429096,0.3901668753646345
환율하락따른,1,0.209851265044539,144,76,68,81,0.722065511514766,0.47088280739672633
유로화강세보이,1,0.2094492745055221,39,21,18,30,0.5642015882204391,0.3682438589307113
수익감소,1,0.2094492745055221,39,21,18,38,0.5642015882204391,0.3682438589307113
불확실성높이,1,0.2094492745055221,39,21,18,44,0.5642015882204391,0.3682438589307113
유가상승따른,1,0.20896695351054695,100,53,47,58,0.6721780279177506,0.4391605763106243
원화강세따른,1,0.20786457919938206,58,31,27,59,0.6028628085012817,0.39478246702834136
금융위기벗어나,1,0.20727004697382778,24,13,11,13,0.5288684250570738,0.34675785005662874
소득증가,1,0.20727004697382778,24,13,11,35,0.5288684250570738,0.34675785005662874
물가상승률상승,1,0.20727004697382778,24,13,11,15,0.5288684250570738,0.34675785005662874
수신늘어나,1,0.20727004697382778,24,13,11,7,0.5288684250570738,0.34675785005662874
심리지표개선,1,0.20727004697382778,24,13,11,24,0.5288684250570738,0.34675785005662874
성장세나타낼,1,0.20727004697382778,24,13,11,18,0.5288684250570738,0.34675785005662874
수익성높이,1,0.20727004697382778,24,13,11,21,0.5288684250570738,0.34675785005662874
금리인상인한,1,0.2071278886574044,102,54,48,44,0.6740932714472764,0.4421071975300808
금리상승따른,1,0.2059514449333275,255,134,121,247,0.7759502210858134,0.5101620239126348
양적완화실시,1,0.20408362649689016,41,22,19,56,0.5668668636768311,0.37415173486678427
유로화하락,1,0.20364277854065027,106,56,50,51,0.6778318111173647,0.4478039222060535
채권금리급등,1,0.20198918230011453,108,57,51,81,0.6796548146278238,0.450558572776598
신용등급상향조정,1,0.20150473173285177,62,33,29,49,0.6080857659251216,0.4035209118890288
기준금리인상앞두,1,0.1992627810346379,43,23,20,40,0.5695745947505108,0.3797338032415836
cd금리오른,1,0.1992627810346379,43,23,20,23,0.5695745947505108,0.3797338032415836
하방위험작용,1,0.1992627810346379,43,23,20,43,0.5695745947505108,0.3797338032415836
순이익늘,1,0.1979641303666535,26,14,12,26,0.531090206931353,0.3550344300047077
기준금리만장일치동결,1,0.1979641303666535,26,14,12,46,0.531090206931353,0.3550344300047077
금리하락견인,1,0.1979641303666535,26,14,12,43,0.531090206931353,0.3550344300047077
소비줄,1,0.1979641303666535,26,14,12,15,0.531090206931353,0.3550344300047077
금리인상단행않,1,0.19595095119050754,66,35,31,47,0.613261974481442,0.41168608367303217
국채금리오르,1,0.1949084654424451,45,24,21,47,0.5723149336970031,0.3850313043143124
기준금리인상반영,1,0.19105502358148851,70,37,33,44,0.6183714395620084,0.4193576422450171
금리올릴없,1,0.19012527623927,28,15,13,30,0.5335001759669021,0.362499276297142
금리상향조정,1,0.19012527623927,28,15,13,15,0.5335001759669021,0.362499276297142
금리인상앞당겨질,1,0.19012527623927,28,15,13,37,0.5335001759669021,0.362499276297142
채산성악화,1,0.19012527623927,28,15,13,14,0.5335001759669021,0.362499276297142
성장이끌,1,0.1873543301418139,49,26,23,39,0.5778604850470677,0.3949022317461013
인플레이션안정,1,0.1873543301418139,49,26,23,36,0.5778604850470677,0.3949022317461013
금리인상이뤄질,1,0.18714295654116309,101,53,48,77,0.6639163853399808,0.4539103807290002
하방경직성강화,1,0.18670263011011845,74,39,35,85,0.623398241169822,0.4265975319658939
금리인상,1,0.18474124585416862,2811,1465,1346,2075,0.7772730309675222,0.5340595089773896
달러화상승폭제한,1,0.1834385039652242,30,16,14,19,0.5360603455225824,0.36931773819481784
원화약세따른,1,0.1834385039652242,30,16,14,21,0.5360603455225824,0.36931773819481784
금리하락세보이,1,0.1834385039652242,30,16,14,35,0.5360603455225824,0.36931773819481784
경제지표부진보이,1,0.1834385039652242,30,16,14,24,0.5360603455225824,0.36931773819481784
수요커지,1,0.1834385039652242,30,16,14,25,0.5360603455225824,0.36931773819481784
금리인상유지,1,0.1828042012747575,78,41,37,42,0.6283297244343133,0.4334547450262648
지급준비금적수감소,1,0.1816420301612125,109,57,52,111,0.6716577308704331,0.46445920160984366
기준금리오르,1,0.18102899013685447,53,28,25,48,0.5834478867802938,0.40397252386172305
가계대출증가,1,0.18102899013685447,53,28,25,56,0.5834478867802938,0.40397252386172305
달러원오른,1,0.1782375220561716,55,29,26,33,0.5862436236267401,0.408255115382822
금리올려도,1,0.1782375220561716,55,29,26,52,0.5862436236267401,0.408255115382822
국고채금리국고지표물오른,1,0.1782375220561716,55,29,26,49,0.5862436236267401,0.408255115382822
소비자물가안정,1,0.17767277642548307,32,17,15,20,0.5387402194576681,0.3756117096177956
대출심사강화,1,0.17767277642548307,32,17,15,33,0.5387402194576681,0.3756117096177956
유로달러하락,1,0.17767277642548307,32,17,15,19,0.5387402194576681,0.3756117096177956
서부텍사스산원유내린,1,0.17767277642548307,32,17,15,23,0.5387402194576681,0.3756117096177956
엔화유로화강세나타냈,1,0.17767277642548307,32,17,15,15,0.5387402194576681,0.3756117096177956
회사채신용스프레드확대,1,0.17767277642548307,32,17,15,30,0.5387402194576681,0.3756117096177956
금리상승인한,1,0.17326257025886505,59,31,28,42,0.5918174935013018,0.41638694765794365
소비개선,1,0.17265477426525533,34,18,16,42,0.54151509075006,0.3814729034489275
가산금리인상,1,0.17265477426525533,34,18,16,15,0.54151509075006,0.3814729034489275
시장국고채금리하락거래마쳤,1,0.17265477426525533,34,18,16,35,0.54151509075006,0.3814729034489275
성장모멘텀둔화,1,0.17265477426525533,34,18,16,18,0.54151509075006,0.3814729034489275
금리인상어려울,1,0.17265477426525533,34,18,16,31,0.54151509075006,0.3814729034489275
경제성장세나타내,1,0.16994646926560075,15,8,7,14,0.49698068307197824,0.3520581893445531
금리상승기록,1,0.16994646926560075,15,8,7,32,0.49698068307197824,0.3520581893445531
유가떨어져,1,0.16994646926560075,15,8,7,14,0.49698068307197824,0.3520581893445531
물가안정위해서,1,0.16994646926560075,15,8,7,11,0.49698068307197824,0.3520581893445531
물가안정도모,1,0.16994646926560075,15,8,7,15,0.49698068307197824,0.3520581893445531
내외금리차확대따른,1,0.16994646926560075,15,8,7,5,0.49698068307197824,0.3520581893445531
성장이어지,1,0.16994646926560075,15,8,7,10,0.49698068307197824,0.3520581893445531
단기자금시장안정,1,0.16994646926560075,15,8,7,5,0.49698068307197824,0.3520581893445531
재무구조유지,1,0.16994646926560075,15,8,7,8,0.49698068307197824,0.3520581893445531
고용확대,1,0.16994646926560075,15,8,7,14,0.49698068307197824,0.3520581893445531
채권가격올랐,1,0.16994646926560075,15,8,7,10,0.49698068307197824,0.3520581893445531
소득심사강화,1,0.16994646926560075,15,8,7,13,0.49698068307197824,0.3520581893445531
실적호조보이,1,0.16994646926560075,15,8,7,7,0.49698068307197824,0.3520581893445531
원화약세보일,1,0.16994646926560075,15,8,7,15,0.49698068307197824,0.3520581893445531
원환율하락,1,0.16994646926560075,15,8,7,6,0.49698068307197824,0.3520581893445531
cd금리올라갈,1,0.16994646926560075,15,8,7,4,0.49698068307197824,0.3520581893445531
금융위기회복,1,0.16994646926560075,15,8,7,5,0.49698068307197824,0.3520581893445531
순이익늘어날,1,0.16994646926560075,15,8,7,12,0.49698068307197824,0.3520581893445531
경제성장하,1,0.16994646926560075,15,8,7,14,0.49698068307197824,0.3520581893445531
금리차줄,1,0.16994646926560075,15,8,7,18,0.49698068307197824,0.3520581893445531
실업수당청구감소,1,0.16994646926560075,15,8,7,20,0.49698068307197824,0.3520581893445531
경제지표하회,1,0.16994646926560075,15,8,7,14,0.49698068307197824,0.3520581893445531
신용경색해소위해,1,0.16994646926560075,15,8,7,4,0.49698068307197824,0.3520581893445531
달러강세제한,1,0.16994646926560075,15,8,7,27,0.49698068307197824,0.3520581893445531
조달금리낮추,1,0.16994646926560075,15,8,7,20,0.49698068307197824,0.3520581893445531
금리하락세돌아섰,1,0.16994646926560075,15,8,7,16,0.49698068307197824,0.3520581893445531
불안정성확대,1,0.16994646926560075,15,8,7,6,0.49698068307197824,0.3520581893445531
금리하락세보임,1,0.16994646926560075,15,8,7,16,0.49698068307197824,0.3520581893445531
위험발생,1,0.16994646926560075,15,8,7,13,0.49698068307197824,0.3520581893445531
경제성장세유지,1,0.16994646926560075,15,8,7,5,0.49698068307197824,0.3520581893445531
달러원떨어질,1,0.16994646926560075,15,8,7,7,0.49698068307197824,0.3520581893445531
인플레이션우려인해,1,0.16994646926560075,15,8,7,13,0.49698068307197824,0.3520581893445531
국채선물시장국채선물상승거래,1,0.16994646926560075,15,8,7,20,0.49698068307197824,0.3520581893445531
기준금리인상빨라질있,1,0.16994646926560075,15,8,7,11,0.49698068307197824,0.3520581893445531
수요확보,1,0.16994646926560075,15,8,7,24,0.49698068307197824,0.3520581893445531
금리인하가능성높이,1,0.16994646926560075,15,8,7,11,0.49698068307197824,0.3520581893445531
국채선물가격하락,1,0.16994646926560075,15,8,7,8,0.49698068307197824,0.3520581893445531
투자늘린,1,0.16994646926560075,15,8,7,10,0.49698068307197824,0.3520581893445531
기준금리인상늦추,1,0.16994646926560075,15,8,7,12,0.49698068307197824,0.3520581893445531
위험요인될,1,0.16994646926560075,15,8,7,16,0.49698068307197824,0.3520581893445531
완화정책펴,1,0.16994646926560075,15,8,7,7,0.49698068307197824,0.3520581893445531
수급여건양호,1,0.16994646926560075,15,8,7,10,0.49698068307197824,0.3520581893445531
채권매입축소,1,0.16994646926560075,15,8,7,9,0.49698068307197824,0.3520581893445531
금리오르않,1,0.1689608473825126,63,33,30,57,0.5973447677445527,0.42401458177789625
금리오른,1,0.16878316448596054,232,120,112,265,0.7506184379945352,0.5330079755639697
부양책발표,1,0.16825191961750607,36,19,17,19,0.5443647642982415,0.3869715788650247
가계대출늘,1,0.16825191961750607,36,19,17,23,0.5443647642982415,0.3869715788650247
금리상승세이,1,0.16825191961750607,36,19,17,24,0.5443647642982415,0.3869715788650247
순이익증가,1,0.16689606556713565,100,52,48,92,0.6533972015228731,0.46577607686626993
달러화강세보이,1,0.16470073813546704,104,54,50,116,0.6575443014297154,0.4708518344546192
환율변동성확대,1,0.16436105909200416,38,20,18,25,0.5472725935080056,0.39216242769460125
위험회피,1,0.16436105909200416,38,20,18,33,0.5472725935080056,0.39216242769460125
지급준비금적수줄,1,0.16436105909200416,38,20,18,35,0.5472725935080056,0.39216242769460125
마이너스금리도입,1,0.16265616307583008,108,56,52,67,0.6615596006538026,0.47572032048193247
성장견인,1,0.16189215058050355,71,37,34,49,0.6081750295996989,0.4380184287441663
시중금리상승,1,0.16189215058050355,71,37,34,59,0.6081750295996989,0.4380184287441663
비용줄이,1,0.16090072222748475,40,21,19,41,0.5502247483679087,0.39708863646042025
경기둔화우려따른,1,0.16090072222748475,40,21,19,30,0.5502247483679087,0.39708863646042025
기준금리인하않,1,0.16037907473197044,73,38,35,40,0.6108241952636035,0.44129431711135836
달러화하락압력가하,1,0.15893994336657125,17,9,8,10,0.4987124281624721,0.3613633319013319
자산매입유지,1,0.15893994336657125,17,9,8,47,0.4987124281624721,0.3613633319013319
주택가격안정,1,0.15893994336657125,17,9,8,10,0.4987124281624721,0.3613633319013319
자본빠져나가,1,0.15893994336657125,17,9,8,10,0.4987124281624721,0.3613633319013319
신규실업수당청구감소,1,0.15893994336657125,17,9,8,18,0.4987124281624721,0.3613633319013319
달러엔올랐,1,0.15893994336657125,17,9,8,8,0.4987124281624721,0.3613633319013319
단기물상승,1,0.15893994336657125,17,9,8,15,0.4987124281624721,0.3613633319013319
시장금리변동성확대,1,0.15893994336657125,17,9,8,12,0.4987124281624721,0.3613633319013319
기준금리인하이,1,0.15893994336657125,17,9,8,22,0.4987124281624721,0.3613633319013319
성장세나타냈,1,0.15893994336657125,17,9,8,9,0.4987124281624721,0.3613633319013319
기준금리동결이,1,0.15893994336657125,17,9,8,13,0.4987124281624721,0.3613633319013319
채권수요증가,1,0.15893994336657125,17,9,8,12,0.4987124281624721,0.3613633319013319
물가상승률예상,1,0.15893994336657125,17,9,8,17,0.4987124281624721,0.3613633319013319
저평가줄어들,1,0.15893994336657125,17,9,8,6,0.4987124281624721,0.3613633319013319
금리인상준비,1,0.15893994336657125,17,9,8,14,0.4987124281624721,0.3613633319013319
금리인상두,1,0.15893994336657125,17,9,8,31,0.4987124281624721,0.3613633319013319
금리인상가능성커졌,1,0.15893994336657125,17,9,8,20,0.4987124281624721,0.3613633319013319
소비자기대지수하락,1,0.15893994336657125,17,9,8,5,0.4987124281624721,0.3613633319013319
경제성장이루,1,0.15893994336657125,17,9,8,7,0.4987124281624721,0.3613633319013319
투자선호,1,0.15893994336657125,17,9,8,14,0.4987124281624721,0.3613633319013319
기준금리낮유지,1,0.15893994336657125,17,9,8,18,0.4987124281624721,0.3613633319013319
경기부진따른,1,0.15780570371726377,42,22,20,44,0.5532096548078178,0.40178474764666317
양적완화인한,1,0.15780570371726377,42,22,20,15,0.5532096548078178,0.40178474764666317
경제성장세둔화,1,0.15759828050655678,77,40,37,39,0.6160418468818514,0.44760871776168754
신용스프레드확대,1,0.15564661552106585,208,107,101,206,0.7349808910009247,0.5361680564131662
국채금리오른,1,0.15502319431155187,44,23,21,35,0.55621756153944,0.4062787127669866
수급개선,1,0.15502319431155187,44,23,21,36,0.55621756153944,0.4062787127669866
금리올라갈,1,0.15284408164648045,85,44,41,55,0.6261243945330984,0.45938549337935447
기준금리낮췄,1,0.1525099672234107,46,24,22,28,0.5592402024779225,0.41059339035268744
달러엔시장하락거래,1,0.15046175320556543,19,10,9,16,0.5008963981666176,0.36930142912153713
대출늘렸,1,0.15046175320556543,19,10,9,15,0.5008963981666176,0.36930142912153713
금리인상우려따른,1,0.15046175320556543,19,10,9,16,0.5008963981666176,0.36930142912153713
경제반등,1,0.15046175320556543,19,10,9,19,0.5008963981666176,0.36930142912153713
인플레이션우려표명,1,0.15046175320556543,19,10,9,14,0.5008963981666176,0.36930142912153713
위험감내,1,0.15046175320556543,19,10,9,10,0.5008963981666176,0.36930142912153713
대외불확실성커지,1,0.15046175320556543,19,10,9,14,0.5008963981666176,0.36930142912153713
통화긴축단행,1,0.15046175320556543,19,10,9,14,0.5008963981666176,0.36930142912153713
기준금리인상가능성있,1,0.15046175320556543,19,10,9,3,0.5008963981666176,0.36930142912153713
잠재성장률하락,1,0.15046175320556543,19,10,9,19,0.5008963981666176,0.36930142912153713
가산금리확대,1,0.15046175320556543,19,10,9,2,0.5008963981666176,0.36930142912153713
금리떨어뜨리,1,0.15046175320556543,19,10,9,11,0.5008963981666176,0.36930142912153713
금리인상오,1,0.15046175320556543,19,10,9,16,0.5008963981666176,0.36930142912153713
지출늘,1,0.15046175320556543,19,10,9,17,0.5008963981666176,0.36930142912153713
경기회복세이어질,1,0.15046175320556543,19,10,9,10,0.5008963981666176,0.36930142912153713
금리인상해야,1,0.15046175320556543,19,10,9,9,0.5008963981666176,0.36930142912153713
임금상승따른,1,0.15046175320556543,19,10,9,9,0.5008963981666176,0.36930142912153713
경기회복세나타내,1,0.15046175320556543,19,10,9,8,0.5008963981666176,0.36930142912153713
인플레이션기대심리억제,1,0.15046175320556543,19,10,9,25,0.5008963981666176,0.36930142912153713
유가안정,1,0.15023029852418768,48,25,23,25,0.5622705314040183,0.4147476556400107
산업생산감소,1,0.15023029852418768,48,25,23,23,0.5622705314040183,0.4147476556400107
금리떨어질,1,0.148916520924393,93,48,45,71,0.6356964820800156,0.47016989245931984
금리유지,1,0.14851045040174204,236,121,115,217,0.7408212110705685,0.5483765007606651
유가하락,1,0.14750712702431423,197,101,96,137,0.7256901897920673,0.5382784811002747
위험고려,1,0.14625726985981324,52,27,25,27,0.5683309482626853,0.4226353351044738
연방기금금리인상,1,0.14596821453725117,154,79,75,93,0.6984662346360268,0.5197162212607406
경기회복지연,1,0.1456023286981114,101,52,49,71,0.644729436829925,0.4800901780194525
투자늘리,1,0.14485122847385856,103,53,50,94,0.646901665787038,0.48244693475190514
기준금리인상단행,1,0.14465226397976072,209,107,102,157,0.7294195562355408,0.544208187176278
유동성유지,1,0.14375396527519224,21,11,10,22,0.5034089541099352,0.376274541980967
물가상승세둔화,1,0.14375396527519224,21,11,10,12,0.5034089541099352,0.376274541980967
금리인상앞둔,1,0.14375396527519224,21,11,10,31,0.5034089541099352,0.376274541980967
엔화급등,1,0.14375396527519224,21,11,10,13,0.5034089541099352,0.376274541980967
원화절상따른,1,0.14375396527519224,21,11,10,29,0.5034089541099352,0.376274541980967
실적호조힘입,1,0.14375396527519224,21,11,10,13,0.5034089541099352,0.376274541980967
금리올라서,1,0.14375396527519224,21,11,10,21,0.5034089541099352,0.376274541980967
집값떨어질,1,0.14375396527519224,21,11,10,5,0.5034089541099352,0.376274541980967
기준금리인상가능성커지,1,0.14375396527519224,21,11,10,12,0.5034089541099352,0.376274541980967
금리인하기대,1,0.14291767657785281,56,29,27,52,0.574359832476715,0.43004018250342513
위험커지,1,0.14275365008868257,109,56,53,73,0.6532104871776281,0.48924168896541886
콜금리인하,1,0.14007647672707835,60,31,29,28,0.5803279147044612,0.4370335913671575
서부텍사스산원유오른,1,0.13881042302881186,62,32,30,47,0.5832819878321176,0.4403931669681875
경제성장률높이,1,0.1383338263602849,23,12,11,10,0.5061639129351977,0.3825383151939671
대외불확실성완화,1,0.1383338263602849,23,12,11,17,0.5061639129351977,0.3825383151939671
기준금리동결따른,1,0.1383338263602849,23,12,11,29,0.5061639129351977,0.3825383151939671
낮금리대출받,1,0.1383338263602849,23,12,11,33,0.5061639129351977,0.3825383151939671
경제지표호조보여,1,0.1383338263602849,23,12,11,15,0.5061639129351977,0.3825383151939671
경기부양따른,1,0.1383338263602849,23,12,11,21,0.5061639129351977,0.3825383151939671
기준금리인하반영,1,0.1383338263602849,23,12,11,11,0.5061639129351977,0.3825383151939671
국채가격급락,1,0.1383338263602849,23,12,11,12,0.5061639129351977,0.3825383151939671
부양책필요,1,0.1383338263602849,23,12,11,21,0.5061639129351977,0.3825383151939671
기준금리인상고려,1,0.1383338263602849,23,12,11,22,0.5061639129351977,0.3825383151939671
수요증가,1,0.13758749879426957,384,196,188,309,0.7509820335029509,0.5684256189229534
성장지속,1,0.13714260163752257,192,98,94,125,0.7176064263874448,0.5436557487174862
금리인상통해,1,0.1356164005540319,135,69,66,70,0.6769926600079856,0.5144834101676408
채권시장국고채지표금리내린,1,0.1345546494311578,70,36,34,106,0.5948487708543672,0.45303592583337493
위험해소,1,0.1338791125778147,25,13,12,25,0.509099457447462,0.3882628030755775
금리올리어려울,1,0.1338791125778147,25,13,12,10,0.509099457447462,0.3882628030755775
금리인하베팅하,1,0.1338791125778147,25,13,12,18,0.509099457447462,0.3882628030755775
인플레이션하락,1,0.1338791125778147,25,13,12,11,0.509099457447462,0.3882628030755775
국고채금리떨어진,1,0.1338791125778147,25,13,12,12,0.509099457447462,0.3882628030755775
금리인상시사,1,0.13272991342965113,216,110,106,204,0.7255573049912839,0.5546389215568109
높수익률기록,1,0.13201770468769047,76,39,37,46,0.6032187340637118,0.46178797303327446
성장세이,1,0.13148939208306643,155,79,76,142,0.6915683853001294,0.5299923091328295
유가상승,1,0.13111986519059182,157,80,77,115,0.6928613400917935,0.5313823382452063
지급준비율인상이,1,0.13016643849148135,27,14,13,5,0.5121701268811609,0.3935653954734068
채권가격상승채권강세한의미,1,0.13016643849148135,27,14,13,26,0.5121701268811609,0.3935653954734068
전세가격오르,1,0.13016643849148135,27,14,13,27,0.5121701268811609,0.3935653954734068
글로벌경제회복세이,1,0.13016643849148135,27,14,13,8,0.5121701268811609,0.3935653954734068
금가격오른,1,0.13016643849148135,27,14,13,10,0.5121701268811609,0.3935653954734068
금리내려갈,1,0.12925754379644427,84,43,41,64,0.6139184667931928,0.47262393759853744
수출둔화,1,0.12865550636567358,86,44,42,51,0.6165067442351313,0.475197568602443
고용지표부진,1,0.12865550636567358,86,44,42,59,0.6165067442351313,0.475197568602443
금리급등세진정,1,0.12703601278798238,29,15,14,10,0.5153417517815678,0.3985296737436955
자산가격상승,1,0.12703601278798238,29,15,14,20,0.5153417517815678,0.3985296737436955
채권수익률하락,1,0.12703601278798238,29,15,14,36,0.5153417517815678,0.3985296737436955
채권금리오를,1,0.12703601278798238,29,15,14,34,0.5153417517815678,0.3985296737436955
경기둔화인해,1,0.12703601278798238,29,15,14,21,0.5153417517815678,0.3985296737436955
수출호조따른,1,0.12703601278798238,29,15,14,15,0.5153417517815678,0.3985296737436955
하방위험확대,1,0.12703601278798238,29,15,14,22,0.5153417517815678,0.3985296737436955
물가안정유지,1,0.126829725813568,183,93,90,75,0.7072065828910833,0.547133872492702
불안심리커지,1,0.12474146348493353,102,52,50,78,0.6359107856516575,0.4940661372458487
수요억제,1,0.12437048717333776,31,16,15,14,0.5185881533601623,0.40321672850518614
집값상승,1,0.12437048717333776,31,16,15,24,0.5185881533601623,0.40321672850518614
유가떨어졌,1,0.12437048717333776,31,16,15,15,0.5185881533601623,0.40321672850518614
국고채금리상승마감,1,0.12437048717333776,31,16,15,41,0.5185881533601623,0.40321672850518614
유로화강세보였,1,0.12437048717333776,31,16,15,27,0.5185881533601623,0.40321672850518614
금리인하중단,1,0.12437048717333776,31,16,15,9,0.5185881533601623,0.40321672850518614
실적내,1,0.12437048717333776,31,16,15,30,0.5185881533601623,0.40321672850518614
금리차확대,1,0.12358079730714833,108,55,53,90,0.6425822409118579,0.500427026215398
글로벌경기둔화,1,0.1220817297267871,33,17,16,23,0.5218889339575817,0.4076722281422501
달러화가치떨어지,1,0.1220817297267871,33,17,16,26,0.5218889339575817,0.4076722281422501
달러강세인해,1,0.1220817297267871,33,17,16,26,0.5218889339575817,0.4076722281422501
재정위기확산,1,0.1220817297267871,33,17,16,58,0.5218889339575817,0.4076722281422501
스왑베이시스역전폭확대,1,0.1183795320941019,37,19,18,34,0.5285923093241117,0.4160200011138516
금리낙폭확대,1,0.11687202243679917,39,20,19,37,0.5319714942760534,0.4199605313294964
물가안정,1,0.11400361299652961,301,152,149,176,0.7331750878139203,0.5821715298993401
국채가격올랐,1,0.1133384761821612,45,23,22,22,0.542119314992551,0.43104536428623724
안전자산선호심리강화,1,0.1133384761821612,45,23,22,71,0.542119314992551,0.43104536428623724
채권가격하락,1,0.1133384761821612,45,23,22,56,0.542119314992551,0.43104536428623724
기준금리인상시작,1,0.11241574557809919,47,24,23,48,0.54548537292231,0.4345326235952052
엔화약세따른,1,0.11159261031790924,49,25,24,67,0.5488354796605919,0.4379302421051671
변동성줄어들,1,0.11159261031790924,49,25,24,31,0.5488354796605919,0.4379302421051671
투자늘어나,1,0.11085632033031345,51,26,25,50,0.5521660631799387,0.4412447019458622
모기지금리상승,1,0.11085632033031345,51,26,25,29,0.5521660631799387,0.4412447019458622
경기둔화,1,0.1092022982304961,377,190,187,232,0.7346027545909741,0.5890002379188262
엔화약세보이,1,0.10906841340070605,57,29,28,50,0.5620122828182065,0.4507402327276616
기준금리인상시사,1,0.10906841340070605,57,29,28,49,0.5620122828182065,0.4507402327276616
달러화약세보였,1,0.10815064295125287,61,31,30,42,0.568433259993603,0.4567368388508147
금리동결,1,0.10671332637631648,1154,581,573,854,0.7341382020601813,0.5915975927573008
제로금리유지,1,0.10452345192322299,97,49,48,89,0.6196535077955735,0.5015560999414782
금리인상할,1,0.10409914038121837,109,55,54,83,0.6338991839354691,0.5135267916042325
인플레이션우려,1,0.10362769700159302,129,65,64,76,0.6545740183992224,0.5307809199146752
경제지표부진,1,0.1034720834616798,137,69,68,144,0.6618238344379676,0.5368283751847768
경기위축,1,0.1034340894051815,139,70,69,56,0.6635494901644597,0.5382694246587532
기준금리동결,1,0.10158179091581188,1959,984,975,1738,0.731124799381473,0.5953091782655264
시장금리상승,1,0.09940964090299054,295,148,147,197,0.7239940203518275,0.592093737933282
불확실성해소,1,0.09666376460144566,431,216,215,392,0.7279670749170497,0.5986506647816341
금리인상시작,1,0.08607812223939959,120,60,60,151,0.6363427995857881,0.5345857391149931
금리오를,1,0.08588635213088991,381,190,191,313,0.7208770003673869,0.6058359994694138
금리동결예상,1,0.08422788566224426,104,52,52,105,0.6178693691168744,0.5210032083080751
금리인상가능,1,0.08258161775065842,92,46,46,107,0.6022524704534519,0.5095198134201896
달러약세따른,1,0.08134886231869154,84,42,42,57,0.5909643729730876,0.5012113433985602
기준금리낮추,1,0.08034855866164681,78,39,39,66,0.5820262927434171,0.49462497059641114
금리하락,1,0.08031451422127511,979,487,492,806,0.7184096192857422,0.6105697867480088
국고채금리내린,1,0.08000013441555653,76,38,38,65,0.5789559202019381,0.4923605794756973
금리인상계속,1,0.07964403793122754,74,37,37,26,0.5758397560273104,0.49006134264057677
금리인상단행,1,0.07876667409611504,1032,513,519,703,0.7174701194671188,0.6116723631085512
성장달성,1,0.07774472948712075,64,32,32,37,0.5595676566311679,0.4780353534011747
채권시장우호적작용,1,0.07692755566001752,60,30,30,74,0.5527347126017316,0.472974376010116
달러엔하락,1,0.07607627109492565,56,28,28,31,0.5457162507516545,0.46776842746451525
국제유가급등,1,0.07563757179095965,54,27,27,40,0.5421375324258247,0.46511080222280043
국채선물떨어진,1,0.07473353203682098,50,25,25,66,0.5348415085244231,0.4596858076324025
기업실적개선,1,0.07426798249933197,48,24,24,41,0.5311244388019812,0.4569183096154046
금리하락제한,1,0.07360071089423448,147,73,74,163,0.6536136076204687,0.5630482858409893
시장변동성커질,1,0.07330930689366544,44,22,22,40,0.5235529856135358,0.45127311902171047
성장기대,1,0.07330930689366544,44,22,22,48,0.5235529856135358,0.45127311902171047
시장국고채금리상승거래마쳤,1,0.0728159765597296,42,21,21,39,0.5196990112439198,0.448395403490756
유로화엔화상승,1,0.0728159765597296,42,21,21,16,0.5196990112439198,0.448395403490756
장단기금리차축소,1,0.07259163899684573,141,70,71,98,0.6482423773299906,0.5595545185744562
위험반영,1,0.07231318339008097,40,20,20,31,0.5157998621166725,0.44548095761157425
국채선물오른,1,0.07217328768562159,230,114,116,188,0.6950990272966595,0.6005050302631315
성장주도,1,0.07180082795669196,38,19,19,36,0.5118558205452602,0.44252981862146035
경기둔화우려부각,1,0.07180082795669196,38,19,19,35,0.5118558205452602,0.44252981862146035
수익올렸,1,0.07180082795669196,38,19,19,36,0.5118558205452602,0.44252981862146035
수익내,1,0.0717727341753831,226,112,114,179,0.6936410804227979,0.5997278364416053
마이너스수익률기록,1,0.0712788121118797,36,18,18,38,0.5078672013994673,0.4395420445064051
원자재가격하락따른,1,0.0712788121118797,36,18,18,19,0.5078672013994673,0.4395420445064051
달러화강세보일,1,0.0707470391034486,34,17,17,42,0.5038343528887663,0.43651771470626755
주택가격급락,1,0.0707470391034486,34,17,17,14,0.5038343528887663,0.43651771470626755
수출회복,1,0.0707470391034486,34,17,17,28,0.5038343528887663,0.43651771470626755
외환시장원달러오른,1,0.0707470391034486,34,17,17,65,0.5038343528887663,0.43651771470626755
안전자산선호강화,1,0.07022639759054261,212,105,107,153,0.6879230918651025,0.5966341134211689
소비자물가급등,1,0.07020541369285782,32,16,16,13,0.49975765732761523,0.43345693082013814
물가안정강조,1,0.07020541369285782,32,16,16,15,0.49975765732761523,0.43345693082013814
가계부채증가,1,0.07020541369285782,32,16,16,42,0.49975765732761523,0.43345693082013814
금리상회,1,0.06965384227628824,30,15,15,28,0.4956375318799224,0.4303598173103014
자산늘리,1,0.06965384227628824,30,15,15,36,0.4956375318799224,0.4303598173103014
국가신용등급하향조정,1,0.06965384227628824,30,15,15,21,0.4956375318799224,0.4303598173103014
달러원올랐,1,0.06965384227628824,30,15,15,19,0.4956375318799224,0.4303598173103014
채권스왑스프레드역전폭확대,1,0.06909223300847378,28,14,14,45,0.491474429279822,0.42722652220310914
신용경색해소,1,0.06909223300847378,28,14,14,16,0.491474429279822,0.42722652220310914
위험분산,1,0.06909223300847378,28,14,14,29,0.491474429279822,0.42722652220310914
금리상승않,1,0.06852049592914633,26,13,13,23,0.48726883852581143,0.4240572177849807
금리인상미루,1,0.06852049592914633,26,13,13,24,0.48726883852581143,0.4240572177849807
손실커지,1,0.06852049592914633,26,13,13,12,0.48726883852581143,0.4240572177849807
국고스프레드확대,1,0.06852049592914633,26,13,13,41,0.48726883852581143,0.4240572177849807
위험감소,1,0.06852049592914633,26,13,13,20,0.48726883852581143,0.4240572177849807
외환보유액감소,1,0.06793854309191683,24,12,12,23,0.48302128554520607,0.42085210129164946
금리인상검토,1,0.06793854309191683,24,12,12,28,0.48302128554520607,0.42085210129164946
금리인하기대선반영,1,0.06793854309191683,24,12,12,39,0.48302128554520607,0.42085210129164946
금리인상발표,1,0.06793854309191683,24,12,12,12,0.48302128554520607,0.42085210129164946
변동성장세이어질,1,0.06734628869540749,22,11,11,24,0.47873233382579505,0.41761139558868143
국채선물낮개장,1,0.06734628869540749,22,11,11,5,0.47873233382579505,0.41761139558868143
채권시장강세보일,1,0.06734628869540749,22,11,11,20,0.47873233382579505,0.41761139558868143
대출늘려,1,0.06734628869540749,22,11,11,16,0.47873233382579505,0.41761139558868143
crs금리상승,1,0.06734628869540749,22,11,11,10,0.47873233382579505,0.41761139558868143
원자재가격급등,1,0.06734628869540749,22,11,11,15,0.47873233382579505,0.41761139558868143
금리상승견인,1,0.06734628869540749,22,11,11,21,0.47873233382579505,0.41761139558868143
기준금리인상주장,1,0.0667436492164255,20,10,10,19,0.4744025850115027,0.41433534984119447
이자부담가중,1,0.0667436492164255,20,10,10,16,0.4744025850115027,0.41433534984119447
금리인상가능성높였,1,0.0667436492164255,20,10,10,17,0.4744025850115027,0.41433534984119447
회사채금리내렸,1,0.0667436492164255,20,10,10,18,0.4744025850115027,0.41433534984119447
달러화강세나타내,1,0.0667436492164255,20,10,10,38,0.4744025850115027,0.41433534984119447
경기회복발목잡,1,0.0667436492164255,20,10,10,17,0.4744025850115027,0.41433534984119447
금리인상우려,1,0.0667436492164255,20,10,10,7,0.4744025850115027,0.41433534984119447
인플레이션위험상존,1,0.0667436492164255,20,10,10,17,0.4744025850115027,0.41433534984119447
침체빠지,1,0.0667436492164255,20,10,10,20,0.4744025850115027,0.41433534984119447
경기침체인해,1,0.0667436492164255,20,10,10,16,0.4744025850115027,0.41433534984119447
경기회복찬물끼얹,1,0.0667436492164255,20,10,10,11,0.4744025850115027,0.41433534984119447
경제성장률마이너스기록,1,0.0667436492164255,20,10,10,4,0.4744025850115027,0.41433534984119447
경기지표부진,1,0.0667436492164255,20,10,10,17,0.4744025850115027,0.41433534984119447
국고채금리급락,1,0.06613054354494574,18,9,9,16,0.4700326794587931,0.41102424017062034
손실내,1,0.06613054354494574,18,9,9,13,0.4700326794587931,0.41102424017062034
금리오른다면,1,0.06613054354494574,18,9,9,16,0.4700326794587931,0.41102424017062034
일자리늘,1,0.06613054354494574,18,9,9,9,0.4700326794587931,0.41102424017062034
수입늘어나,1,0.06613054354494574,18,9,9,19,0.4700326794587931,0.41102424017062034
금리인하시작,1,0.06613054354494574,18,9,9,6,0.4700326794587931,0.41102424017062034
경기침체이어지,1,0.06613054354494574,18,9,9,13,0.4700326794587931,0.41102424017062034
금리인상가늠,1,0.06613054354494574,18,9,9,17,0.4700326794587931,0.41102424017062034
경제성장차지,1,0.06613054354494574,18,9,9,5,0.4700326794587931,0.41102424017062034
회복속도둔화,1,0.06613054354494574,18,9,9,18,0.4700326794587931,0.41102424017062034
금가격올랐,1,0.06613054354494574,18,9,9,10,0.4700326794587931,0.41102424017062034
금리하락나타나,1,0.06613054354494574,18,9,9,4,0.4700326794587931,0.41102424017062034
고용늘리,1,0.06613054354494574,18,9,9,16,0.4700326794587931,0.41102424017062034
하방위험증대,1,0.06613054354494574,18,9,9,31,0.4700326794587931,0.41102424017062034
금융불안확산,1,0.06613054354494574,18,9,9,14,0.4700326794587931,0.41102424017062034
통화정책스탠스유지,1,0.06613054354494574,18,9,9,15,0.4700326794587931,0.41102424017062034
금리상승세이어질,1,0.06613054354494574,18,9,9,19,0.4700326794587931,0.41102424017062034
금리인상염두두,1,0.06613054354494574,18,9,9,4,0.4700326794587931,0.41102424017062034
침체따른,1,0.06613054354494574,18,9,9,9,0.4700326794587931,0.41102424017062034
경상수지악화,1,0.06613054354494574,18,9,9,14,0.4700326794587931,0.41102424017062034
금리떨어지,1,0.06564800960513106,180,89,91,115,0.6706505196564311,0.5870245144247705
경기둔화확인,1,0.0655068931206666,16,8,8,10,0.4656232967505115,0.4076783702962568
동일점매출증가,1,0.0655068931206666,16,8,8,13,0.4656232967505115,0.4076783702962568
재무건전성악화,1,0.0655068931206666,16,8,8,10,0.4656232967505115,0.4076783702962568
양적완화인해,1,0.0655068931206666,16,8,8,21,0.4656232967505115,0.4076783702962568
변동성높일,1,0.0655068931206666,16,8,8,11,0.4656232967505115,0.4076783702962568
정치적불확실성해소,1,0.0655068931206666,16,8,8,19,0.4656232967505115,0.4076783702962568
성장동력찾,1,0.0655068931206666,16,8,8,27,0.4656232967505115,0.4076783702962568
성장미치,1,0.0655068931206666,16,8,8,24,0.4656232967505115,0.4076783702962568
gdp하회,1,0.0655068931206666,16,8,8,6,0.4656232967505115,0.4076783702962568
gdp성장률둔화,1,0.0655068931206666,16,8,8,5,0.4656232967505115,0.4076783702962568
cd유통수익률오른,1,0.0655068931206666,16,8,8,10,0.4656232967505115,0.4076783702962568
수익성개선기대,1,0.0655068931206666,16,8,8,2,0.4656232967505115,0.4076783702962568
수요부진따른,1,0.0655068931206666,16,8,8,6,0.4656232967505115,0.4076783702962568
원환율급등,1,0.0655068931206666,16,8,8,8,0.4656232967505115,0.4076783702962568
집값오른,1,0.0655068931206666,16,8,8,5,0.4656232967505115,0.4076783702962568
기준금리내려도,1,0.0655068931206666,16,8,8,8,0.4656232967505115,0.4076783702962568
기준금리인상관련,1,0.0655068931206666,16,8,8,28,0.4656232967505115,0.4076783702962568
금리인상미뤄질,1,0.0655068931206666,16,8,8,30,0.4656232967505115,0.4076783702962568
금리인상이루어지,1,0.0655068931206666,16,8,8,2,0.4656232967505115,0.4076783702962568
경기후퇴,1,0.0655068931206666,16,8,8,4,0.4656232967505115,0.4076783702962568
금리하락세제한,1,0.0655068931206666,16,8,8,15,0.4656232967505115,0.4076783702962568
경제펀더멘털개선,1,0.0655068931206666,16,8,8,4,0.4656232967505115,0.4076783702962568
금리인하기대심리형성,1,0.0655068931206666,16,8,8,6,0.4656232967505115,0.4076783702962568
금리인하없,1,0.0655068931206666,16,8,8,7,0.4656232967505115,0.4076783702962568
내수부양위해,1,0.0655068931206666,16,8,8,15,0.4656232967505115,0.4076783702962568
기준금리인상않,1,0.06509138235311251,107,53,54,78,0.6112275558168339,0.5356092110873604
금리인상이어질,1,0.06275466587901102,99,49,50,55,0.6007276353174225,0.5288821968115238
경기침체따른,1,0.062126408027346924,97,48,49,38,0.5979866883267014,0.5271330123174456
금리급등,1,0.060242902764538586,420,207,213,298,0.7057471552784178,0.6244800346000119
투자위축,1,0.05632838968271159,81,40,41,45,0.5743004099521671,0.5121737141202372
신용스프레드축소,1,0.05550028922135186,246,121,125,183,0.6891744732316094,0.615642011504226
금리인상지지,1,0.055489840048750905,79,39,40,70,0.5711103297425478,0.5101855771610461
금리인상나설,1,0.05530684471535441,303,149,154,257,0.6980757885368186,0.6238354283328065
위험있,1,0.05292872151656458,285,140,145,234,0.6945550190983557,0.6236543880744528
투자심리냉각,1,0.048658326763278525,65,32,33,35,0.5472368075339303,0.49559643726509345
성장할,1,0.048658326763278525,65,32,33,27,0.5472368075339303,0.49559643726509345
경기회복,1,0.04793631375235785,402,197,205,286,0.6978381826414404,0.6329008031568127
투자확대,1,0.04740083981370602,251,123,128,200,0.6852862487828246,0.6221837857578335
금리인상가능성부각,1,0.0463184226231248,61,30,31,57,0.5398878227874965,0.49123761454814985
경제성장률전망하향조정,1,0.0463184226231248,61,30,31,59,0.5398878227874965,0.49123761454814985
경기부양,1,0.045962521440187976,198,97,101,199,0.6676185797224299,0.6078914187569463
미국채금리오른,1,0.04375197053426283,57,28,29,67,0.5322832017542976,0.4868134624829435
대출줄이,1,0.04375197053426283,57,28,29,51,0.5322832017542976,0.4868134624829435
기준금리수준동결,1,0.04339616135356783,102,50,52,98,0.5938968649212447,0.5435508957622691
채권시장강세보였,1,0.0423706845579328,55,27,28,34,0.5283800388758073,0.4845818548110523
인플레이션압력커지,1,0.0409154928799218,53,26,27,37,0.5244063929092581,0.4823405223606201
경기침체,1,0.0409154928799218,53,26,27,47,0.5244063929092581,0.4823405223606201
금리인하할,1,0.0409154928799218,53,26,27,38,0.5244063929092581,0.4823405223606201
금리인상지속,1,0.04004724971180762,258,126,132,157,0.6821281330715215,0.6285016765788309
금리인상가능성커지,1,0.039378767153648964,51,25,26,35,0.5203593484344773,0.4800924450730165
콜금리올리,1,0.039378767153648964,51,25,26,37,0.5203593484344773,0.4800924450730165
소비자물가하락,1,0.03775165525079238,49,24,25,32,0.5162355033682088,0.4778411016546568
경기호전,1,0.03775165525079238,49,24,25,51,0.5162355033682088,0.4778411016546568
경제지표호전,1,0.03775165525079238,49,24,25,38,0.5162355033682088,0.4778411016546568
장단기금리차확대,1,0.03710167166132061,129,63,66,115,0.6178135833972184,0.5726086931621113
이자내,1,0.03617653635239915,88,43,45,90,0.5731140045529658,0.5321639135199417
달러원오르,1,0.036023821045499727,47,23,24,49,0.512030856056711,0.47559056852422604
국제유가하락따른,1,0.034183114729864794,45,22,23,38,0.5077406608136174,0.4733456437411175
비용증가,1,0.034183114729864794,45,22,23,50,0.5077406608136174,0.4733456437411175
시중금리오르,1,0.034183114729864794,45,22,23,30,0.5077406608136174,0.4733456437411175
금리인상관련,1,0.032519273622014566,82,40,42,101,0.563377994251911,0.52696504595909
수출부진지속,1,0.03221515097994532,43,21,22,29,0.5033592412074317,0.47111200362975136
수요부진,1,0.03221515097994532,43,21,22,30,0.5033592412074317,0.47111200362975136
달러강세이끌,1,0.03221515097994532,43,21,22,23,0.5033592412074317,0.47111200362975136
침체벗어나,1,0.03221515097994532,43,21,22,35,0.5033592412074317,0.47111200362975136
금리떨어져,1,0.030102763396490984,41,20,21,35,0.4988797460555364,0.46889640265800847
유가하락따른,1,0.029488012948855502,113,55,58,94,0.5981501955431453,0.5628921972882985
금리인상멈출,1,0.027825290612963904,39,19,20,26,0.49429382664220567,0.4667069312041973
물가상승억제,1,0.027825290612963904,39,19,20,30,0.49429382664220567,0.4667069312041973
완화따른,1,0.02695700843220261,74,36,38,64,0.5495457499453048,0.5197768956608056
금리올려,1,0.026036682658611143,140,68,72,127,0.6206832019245935,0.5881421701461897
경기지표개선,1,0.02535763003605962,37,18,19,37,0.4895912039669756,0.4645533517773934
원유재고감소,1,0.02535763003605962,37,18,19,39,0.4895912039669756,0.4645533517773934
금리낮유지,1,0.02535763003605962,37,18,19,36,0.4895912039669756,0.4645533517773934
수요감소,1,0.025339782603858385,171,83,88,153,0.6414480930244361,0.6086659502962178
경기부양나서,1,0.023818533869940373,70,34,36,49,0.5422363734902479,0.5160919127854714
경제지표호조보인,1,0.022668965661672535,35,17,18,35,0.4847590798924865,0.4624475430240233
달러인덱스하락,1,0.022668965661672535,35,17,18,29,0.4847590798924865,0.4624475430240233
금리하락세보였,1,0.022668965661672535,35,17,18,35,0.4847590798924865,0.4624475430240233
기준금리내려야,1,0.022668965661672535,35,17,18,26,0.4847590798924865,0.4624475430240233
위험감안,1,0.022668965661672535,35,17,18,27,0.4847590798924865,0.4624475430240233
불안심리완화,1,0.02252987957649566,101,49,52,60,0.5813415950477439,0.5547389754938405
양적완화통해,1,0.022144136439222306,68,33,35,59,0.5384763991652012,0.5142317223254772
물가잡,1,0.021310639856479074,192,93,99,143,0.6497818815176531,0.6215605231636075
금리인상그칠,1,0.019721030587718014,33,16,17,28,0.47978132257991407,0.4604040940455368
성장보일,1,0.019721030587718014,33,16,17,21,0.47978132257991407,0.4604040940455368
국고스프레드축소,1,0.019721030587718014,33,16,17,35,0.47978132257991407,0.4604040940455368
채권시장약세보임,1,0.016465692036248925,31,15,16,35,0.4746373187889235,0.45844111178180347
금리인하요구,1,0.016465692036248925,31,15,16,37,0.4746373187889235,0.45844111178180347
호황누리,1,0.016465692036248925,31,15,16,25,0.4746373187889235,0.45844111178180347
국제유가상승,1,0.015645682410293293,91,44,47,77,0.5658228377988356,0.547411496523226
cd금리하락,1,0.01460229264117796,60,29,31,30,0.5226721637322532,0.5067204654350791
지급준비금적수줄어든다,1,0.01460229264117796,60,29,31,68,0.5226721637322532,0.5067204654350791
유가급등,1,0.014124167161686074,89,43,46,44,0.5625400650564941,0.545892995742422
불확실성확대,1,0.013342757576539022,145,70,75,150,0.6170175745804798,0.5996941456953296
잠재성장률상회,1,0.012841527931767516,29,14,15,14,0.46930032307778946,0.4565813358901819
경기회복기대,1,0.012841527931767516,29,14,15,12,0.46930032307778946,0.4565813358901819
수요늘어났,1,0.012841527931767516,29,14,15,37,0.46930032307778946,0.4565813358901819
인플레이션우려제기,1,0.012841527931767516,29,14,15,15,0.46930032307778946,0.4565813358901819
안전자산선호심리자극,1,0.012841527931767516,29,14,15,21,0.46930032307778946,0.4565813358901819
대출감소,1,0.012841527931767516,29,14,15,13,0.46930032307778946,0.4565813358901819
유가넘어서,1,0.012841527931767516,29,14,15,20,0.46930032307778946,0.4565813358901819
금리인하가능성있,1,0.012841527931767516,29,14,15,25,0.46930032307778946,0.4565813358901819
국채수익률상승,1,0.010913512694506577,85,41,44,58,0.5557838679696593,0.5428083799669603
채권금리하락,1,0.010392571294180142,220,106,114,183,0.6536660074724759,0.6390702697831377
양적완화유지,1,0.010211768977149926,56,27,29,86,0.5142620403239367,0.5029607469808719
금리인상않,1,0.009049509609704076,164,79,85,101,0.627324403259027,0.6149650954475483
달러강세진행,1,0.008768864552086919,27,13,14,28,0.4637350273393626,0.45485370629223415
국채가격떨어진,1,0.008768864552086919,27,13,14,9,0.4637350273393626,0.45485370629223415
높수익률기대,1,0.008768864552086919,27,13,14,23,0.4637350273393626,0.45485370629223415
수익줄어들,1,0.008768864552086919,27,13,14,20,0.4637350273393626,0.45485370629223415
소득줄어들,1,0.008768864552086919,27,13,14,11,0.4637350273393626,0.45485370629223415
금리인상기대,1,0.008768864552086919,27,13,14,23,0.4637350273393626,0.45485370629223415
높수익률제공,1,0.008768864552086919,27,13,14,12,0.4637350273393626,0.45485370629223415
경기후퇴막,1,0.008768864552086919,27,13,14,12,0.4637350273393626,0.45485370629223415
소비줄어들,1,0.008768864552086919,27,13,14,18,0.4637350273393626,0.45485370629223415
경기회복세이,1,0.008768864552086919,27,13,14,12,0.4637350273393626,0.45485370629223415
기대심리커졌,1,0.007825063468371862,54,26,28,45,0.5099138757651397,0.5010922874885431
경제부양,1,0.007825063468371862,54,26,28,34,0.5099138757651397,0.5010922874885431
대출확대,1,0.007456903524299285,108,52,56,81,0.5805131872653637,0.5708900471427611
수출감소,1,0.006986525784395958,160,77,83,100,0.6235571521121009,0.613797115380052
국고채상승마감,1,0.0041423981435035895,25,12,13,12,0.45789388614946264,0.453295611911622
국고채수익률내린,1,0.0041423981435035895,25,12,13,16,0.45789388614946264,0.453295611911622
자산건전성개선,1,0.0041423981435035895,25,12,13,21,0.45789388614946264,0.453295611911622
안전자산선호강해,1,0.0041423981435035895,25,12,13,20,0.45789388614946264,0.453295611911622
금리하락따른,1,0.003934805201799341,129,62,67,111,0.5985303107123557,0.5927655583364116
금리낮춘,1,0.002597874547274115,50,24,26,38,0.5008996390293778,0.49740216513649427
미국채수익률하락,1,0.002597874547274115,50,24,26,29,0.5008996390293778,0.49740216513649427
원자재가격상승따른,1,0.002597874547274115,50,24,26,45,0.5008996390293778,0.49740216513649427
성장하,1,0.0013397101997112415,100,48,52,60,0.5683933169849602,0.5658452764097179
국채수익률하락,-1,-0.00027805017489412887,48,23,25,32,0.4962175029844323,0.49559238306064934
달러강세이어질,-1,-0.00027805017489412887,48,23,25,42,0.4962175029844323,0.49559238306064934
경기부양책따른,-1,-0.0011801022709171383,23,11,12,23,0.4517113889702752,0.45195618987858105
회사채스프레드축소,-1,-0.0011801022709171383,23,11,12,21,0.4517113889702752,0.45195618987858105
기대심리강세보였,-1,-0.0011801022709171383,23,11,12,7,0.4517113889702752,0.45195618987858105
금리인상감안,-1,-0.0011801022709171383,23,11,12,8,0.4517113889702752,0.45195618987858105
금리올린다는,-1,-0.0011801022709171383,23,11,12,20,0.4517113889702752,0.45195618987858105
낮금리받,-1,-0.0011801022709171383,23,11,12,33,0.4517113889702752,0.45195618987858105
금리끌어올렸,-1,-0.0011801022709171383,23,11,12,9,0.4517113889702752,0.45195618987858105
국제금융시장안정,-1,-0.0011801022709171383,23,11,12,6,0.4517113889702752,0.45195618987858105
경기부양책힘입,-1,-0.0011801022709171383,23,11,12,25,0.4517113889702752,0.45195618987858105
소득감소,-1,-0.0011801022709171383,23,11,12,10,0.4517113889702752,0.45195618987858105
채권금리상승압력받,-1,-0.0011801022709171383,23,11,12,23,0.4517113889702752,0.45195618987858105
경기낙관,-1,-0.0011801022709171383,23,11,12,14,0.4517113889702752,0.45195618987858105
금리하락세이어질,-1,-0.0011801022709171383,23,11,12,35,0.4517113889702752,0.45195618987858105
경기침체심화,-1,-0.0011801022709171383,23,11,12,19,0.4517113889702752,0.45195618987858105
금리올랐,-1,-0.0018134933662392605,307,147,160,233,0.6617060807649727,0.6629030971968504
근원소비자물가상승,-1,-0.003357641555082558,46,22,24,25,0.4914054741170827,0.49381564905290454
국고채금리내렸,-1,-0.003357641555082558,46,22,24,30,0.4914054741170827,0.49381564905290454
소비증가,-1,-0.003789005972278492,94,45,49,56,0.5586668411447699,0.5618909951682896
엔화약세지속,-1,-0.004772592043648993,69,33,36,45,0.5259223128968948,0.5299980705670274
경제활동위축,-1,-0.006667421178137123,44,21,23,15,0.486451203671462,0.49208060452660507
금리인상제한,-1,-0.007395694144294196,21,10,11,13,0.445094810535091,0.45090128949037744
국고채금리떨어지,-1,-0.007395694144294196,21,10,11,18,0.445094810535091,0.45090128949037744
기준금리인상지지,-1,-0.007395694144294196,21,10,11,12,0.445094810535091,0.45090128949037744
침체이어질,-1,-0.007395694144294196,21,10,11,13,0.445094810535091,0.45090128949037744
금리인하배경설명,-1,-0.007395694144294196,21,10,11,3,0.445094810535091,0.45090128949037744
저금리정책유지,-1,-0.007395694144294196,21,10,11,19,0.445094810535091,0.45090128949037744
원화강세보일,-1,-0.007395694144294196,21,10,11,22,0.445094810535091,0.45090128949037744
금리상승과도,-1,-0.007395694144294196,21,10,11,10,0.445094810535091,0.45090128949037744
달러화레벨높일,-1,-0.007395694144294196,21,10,11,18,0.445094810535091,0.45090128949037744
수익성하락,-1,-0.007395694144294196,21,10,11,22,0.445094810535091,0.45090128949037744
금리하회,-1,-0.007395694144294196,21,10,11,31,0.445094810535091,0.45090128949037744
물가상승막,-1,-0.007395694144294196,21,10,11,13,0.445094810535091,0.45090128949037744
환율하락용인,-1,-0.007395694144294196,21,10,11,22,0.445094810535091,0.45090128949037744
외환시장현물환하락,-1,-0.007395694144294196,21,10,11,25,0.445094810535091,0.45090128949037744
달러화약세돌아서,-1,-0.007395694144294196,21,10,11,5,0.445094810535091,0.45090128949037744
달러화약세보인,-1,-0.007395694144294196,21,10,11,26,0.445094810535091,0.45090128949037744
엔화강세보일,-1,-0.007395694144294196,21,10,11,21,0.445094810535091,0.45090128949037744
국고채금리올랐으며,-1,-0.007395694144294196,21,10,11,8,0.445094810535091,0.45090128949037744
투자줄어들,-1,-0.007395694144294196,21,10,11,16,0.445094810535091,0.45090128949037744
금리상승제한,-1,-0.008245470354173667,245,117,128,243,0.648349611718246,0.6579238480253211
투자심리개선,-1,-0.008579751923472712,201,96,105,187,0.6347308169613766,0.6445343186108146
금융시장안정,-1,-0.008579751923472712,201,96,105,126,0.6347308169613766,0.6445343186108146
금리올릴,-1,-0.008690187712976694,851,406,445,678,0.6614642050565366,0.6718288441937658
원화절상,-1,-0.009635863075996065,65,31,34,51,0.5176376740546276,0.5267430808822733
유동성증가,-1,-0.010239011408592735,42,20,22,37,0.4813397850197203,0.4903973850371028
초저금리유지,-1,-0.010344845348418619,176,84,92,205,0.6221009278287712,0.6339413500825847
경기부진,-1,-0.011505233602509657,86,41,45,56,0.5447658895762738,0.5564231156913547
소비심리위축,-1,-0.011505233602509657,86,41,45,55,0.5447658895762738,0.5564231156913547
금리인상지연,-1,-0.011884302889518805,130,62,68,151,0.5899746853560237,0.6030559538786749
기준금리동결예상,-1,-0.011884302889518805,130,62,68,91,0.5899746853560237,0.6030559538786749
물가상승압력지속,-1,-0.014110440553232184,40,19,21,30,0.4760530567680101,0.48877794394854546
원유재고증가,-1,-0.014110440553232184,40,19,21,36,0.4760530567680101,0.48877794394854546
금리인상늦추,-1,-0.014110440553232184,40,19,21,44,0.4760530567680101,0.48877794394854546
양적완화확대,-1,-0.014110440553232184,40,19,21,53,0.4760530567680101,0.48877794394854546
주택가격하락,-1,-0.014479437325856326,105,50,55,74,0.564794355406105,0.5803190714819181
유로달러상승거래,-1,-0.014785791894277867,19,9,10,16,0.43790864062888085,0.45022115616663666
금리인하기대심리지속,-1,-0.014785791894277867,19,9,10,18,0.43790864062888085,0.45022115616663666
국채선물하락기록,-1,-0.014785791894277867,19,9,10,17,0.43790864062888085,0.45022115616663666
경기회복세나타나,-1,-0.014785791894277867,19,9,10,15,0.43790864062888085,0.45022115616663666
수요줄이,-1,-0.014785791894277867,19,9,10,19,0.43790864062888085,0.45022115616663666
경기회복세따른,-1,-0.014785791894277867,19,9,10,14,0.43790864062888085,0.45022115616663666
변동성줄여,-1,-0.014785791894277867,19,9,10,27,0.43790864062888085,0.45022115616663666
물가상승률지속,-1,-0.014785791894277867,19,9,10,16,0.43790864062888085,0.45022115616663666
금리인상기대따른,-1,-0.014785791894277867,19,9,10,12,0.43790864062888085,0.45022115616663666
부동산가격급락,-1,-0.014785791894277867,19,9,10,10,0.43790864062888085,0.45022115616663666
경제회복위한,-1,-0.014785791894277867,19,9,10,13,0.43790864062888085,0.45022115616663666
실적올리,-1,-0.014785791894277867,19,9,10,11,0.43790864062888085,0.45022115616663666
성장힘입,-1,-0.014785791894277867,19,9,10,14,0.43790864062888085,0.45022115616663666
주택시장둔화,-1,-0.014785791894277867,19,9,10,12,0.43790864062888085,0.45022115616663666
성장잠재력높이,-1,-0.014785791894277867,19,9,10,19,0.43790864062888085,0.45022115616663666
경기회복세지원,-1,-0.014785791894277867,19,9,10,16,0.43790864062888085,0.45022115616663666
경제성장세이,-1,-0.014785791894277867,19,9,10,12,0.43790864062888085,0.45022115616663666
달러원상승따른,-1,-0.014785791894277867,19,9,10,12,0.43790864062888085,0.45022115616663666
금리상승커지,-1,-0.014785791894277867,19,9,10,10,0.43790864062888085,0.45022115616663666
적자전환,-1,-0.014785791894277867,19,9,10,11,0.43790864062888085,0.45022115616663666
국고채상승기록,-1,-0.014785791894277867,19,9,10,14,0.43790864062888085,0.45022115616663666
주택가격상승,-1,-0.015010128220422247,61,29,32,58,0.5089613481716757,0.5235062753150747
금리국고지표물상승거래시작,-1,-0.015010128220422247,61,29,32,75,0.5089613481716757,0.5235062753150747
금리인상가능성제기,-1,-0.015010128220422247,61,29,32,58,0.5089613481716757,0.5235062753150747
금리올렸,-1,-0.015828662246613057,208,99,109,145,0.6327071259721488,0.6518538673836476
유가오르,-1,-0.01809411444091258,80,38,42,43,0.5335671773723112,0.5522083578379031
경제확산,-1,-0.01832787388988688,38,18,20,19,0.47056866863262486,0.48723646345399985
채권시장국채선물오른,-1,-0.01832787388988688,38,18,20,38,0.47056866863262486,0.48723646345399985
전세가격상승,-1,-0.01832787388988688,38,18,20,39,0.47056866863262486,0.48723646345399985
금리인상서두르않,-1,-0.01832787388988688,38,18,20,54,0.47056866863262486,0.48723646345399985
경제둔화,-1,-0.019435482427659467,221,105,116,114,0.6346856967734581,0.6586230433113299
기준금리올리,-1,-0.02027368253298678,392,186,206,331,0.6529934438346967,0.67875749547118
금리인상우려완화,-1,-0.02047099623201043,78,37,41,71,0.5296728983108737,0.5507884861087141
수요늘어나,-1,-0.020473688220347674,219,104,115,158,0.63338659635978,0.6586403095429224
금리인상중단,-1,-0.020713754986566357,257,122,135,146,0.6425677645236012,0.6685082491248945
국채금리상승,-1,-0.02097898217412353,179,85,94,148,0.6169084453351448,0.6421534105228747
국고채금리떨어졌,-1,-0.020995541780922,57,27,30,29,0.4998450260533338,0.5203167752277301
스왑베이시스축소,-1,-0.020995541780922,57,27,30,35,0.4998450260533338,0.5203167752277301
유가상승인한,-1,-0.022947943405454474,36,17,19,19,0.46485881091451187,0.4857898812257704
경제성장이끌,-1,-0.022947943405454474,36,17,19,21,0.46485881091451187,0.4857898812257704
대출억제,-1,-0.022947943405454474,36,17,19,32,0.46485881091451187,0.4857898812257704
금리끌어올릴,-1,-0.022947943405454474,36,17,19,20,0.46485881091451187,0.4857898812257704
금리하락예상,-1,-0.022947943405454474,36,17,19,21,0.46485881091451187,0.4857898812257704
금리인상속도빨라질있,-1,-0.023767316345784106,17,8,9,25,0.42994704620761093,0.45004271334576906
채권시장심리악화,-1,-0.023767316345784106,17,8,9,1,0.42994704620761093,0.45004271334576906
달러엔급락,-1,-0.023767316345784106,17,8,9,4,0.42994704620761093,0.45004271334576906
금리동결전망,-1,-0.023767316345784106,17,8,9,14,0.42994704620761093,0.45004271334576906
물가우려,-1,-0.023767316345784106,17,8,9,13,0.42994704620761093,0.45004271334576906
국고채수익률하락,-1,-0.023767316345784106,17,8,9,6,0.42994704620761093,0.45004271334576906
단기물강세보이,-1,-0.023767316345784106,17,8,9,8,0.42994704620761093,0.45004271334576906
양적완화펴,-1,-0.023767316345784106,17,8,9,16,0.42994704620761093,0.45004271334576906
달러화낙폭축소,-1,-0.023767316345784106,17,8,9,7,0.42994704620761093,0.45004271334576906
소비자신뢰지수하락,-1,-0.023767316345784106,17,8,9,13,0.42994704620761093,0.45004271334576906
완화될,-1,-0.023767316345784106,17,8,9,6,0.42994704620761093,0.45004271334576906
높수익낼,-1,-0.023767316345784106,17,8,9,15,0.42994704620761093,0.45004271334576906
유로화낙폭확대,-1,-0.023767316345784106,17,8,9,3,0.42994704620761093,0.45004271334576906
금리하락마쳤,-1,-0.023767316345784106,17,8,9,11,0.42994704620761093,0.45004271334576906
내수부양,-1,-0.023767316345784106,17,8,9,14,0.42994704620761093,0.45004271334576906
인플레이션밑돌,-1,-0.023767316345784106,17,8,9,11,0.42994704620761093,0.45004271334576906
금리하락세재개,-1,-0.023767316345784106,17,8,9,21,0.42994704620761093,0.45004271334576906
마이너스금리확대,-1,-0.023767316345784106,17,8,9,15,0.42994704620761093,0.45004271334576906
채권시장안정되찾,-1,-0.023767316345784106,17,8,9,4,0.42994704620761093,0.45004271334576906
금리하향안정화,-1,-0.023767316345784106,17,8,9,8,0.42994704620761093,0.45004271334576906
금리인상나선,-1,-0.023767316345784106,17,8,9,10,0.42994704620761093,0.45004271334576906
국고채지표금리하락내린,-1,-0.023767316345784106,17,8,9,15,0.42994704620761093,0.45004271334576906
금리인상선반영,-1,-0.024256772905868806,55,26,29,53,0.4951026673397825,0.5187510423480152
수요약화,-1,-0.024256772905868806,55,26,29,59,0.4951026673397825,0.5187510423480152
성장세지속,-1,-0.024652558259223967,230,109,121,156,0.6338417177861629,0.6646425918337177
성장세둔화,-1,-0.025943393244218238,209,99,110,132,0.6264770770040395,0.6586175796663761
금리오르,-1,-0.025949819407893537,670,317,353,586,0.6497855888956341,0.6831306778920198
금리상승,-1,-0.026144687021167456,1505,712,793,1232,0.6496527545595773,0.6832571746078708
통화정책유지,-1,-0.026189491025866873,171,81,90,135,0.6093781403057724,0.64095669905231
적자기록,-1,-0.02713990497716412,112,53,59,114,0.5645135697861294,0.5948965802978977
엔화강세보였,-1,-0.027722826945271062,53,25,28,28,0.49022476821795696,0.5172119151599148
기준금리인상지연,-1,-0.027722826945271062,53,25,28,40,0.49022476821795696,0.5172119151599148
물가오르않,-1,-0.028040934853028388,34,16,18,25,0.45888845833175274,0.4844585716207466
기대인플레이션상승,-1,-0.028040934853028388,34,16,18,30,0.45888845833175274,0.4844585716207466
기준금리낮춘,-1,-0.028040934853028388,34,16,18,24,0.45888845833175274,0.4844585716207466
달러약세인한,-1,-0.028040934853028388,34,16,18,21,0.45888845833175274,0.4844585716207466
경제성장률하락,-1,-0.028040934853028388,34,16,18,29,0.45888845833175274,0.4844585716207466
유로화약세보이,-1,-0.028040934853028388,34,16,18,31,0.45888845833175274,0.4844585716207466
경기침체막,-1,-0.02875305422080421,91,43,48,45,0.5410807305569499,0.5720447236209595
경제발목잡,-1,-0.03141693055368844,51,24,27,39,0.4851997339991391,0.5157057951309908
성장세기록,-1,-0.033695227901137104,32,15,17,28,0.45261289876256294,0.48326723552899814
신용스프레드줄어들,-1,-0.03498674389641354,15,7,8,12,0.42088216573554643,0.45054991444374337
조달비용낮추,-1,-0.03498674389641354,15,7,8,7,0.42088216573554643,0.45054991444374337
기업실적부진,-1,-0.03498674389641354,15,7,8,12,0.42088216573554643,0.45054991444374337
경기회복확신,-1,-0.03498674389641354,15,7,8,16,0.42088216573554643,0.45054991444374337
금리인하효과나타나,-1,-0.03498674389641354,15,7,8,2,0.42088216573554643,0.45054991444374337
유동성함정빠질,-1,-0.03498674389641354,15,7,8,3,0.42088216573554643,0.45054991444374337
금리떨어뜨릴,-1,-0.03498674389641354,15,7,8,5,0.42088216573554643,0.45054991444374337
기대심리높인,-1,-0.03498674389641354,15,7,8,10,0.42088216573554643,0.45054991444374337
건전성유지,-1,-0.03498674389641354,15,7,8,10,0.42088216573554643,0.45054991444374337
하방경직성확보,-1,-0.03498674389641354,15,7,8,19,0.42088216573554643,0.45054991444374337
유로엔오른,-1,-0.03498674389641354,15,7,8,4,0.42088216573554643,0.45054991444374337
시장심리개선,-1,-0.03498674389641354,15,7,8,17,0.42088216573554643,0.45054991444374337
경기과열억제,-1,-0.03498674389641354,15,7,8,13,0.42088216573554643,0.45054991444374337
건전성높이,-1,-0.03498674389641354,15,7,8,17,0.42088216573554643,0.45054991444374337
통화완화이,-1,-0.03498674389641354,15,7,8,18,0.42088216573554643,0.45054991444374337
금리동결이,-1,-0.03498674389641354,15,7,8,15,0.42088216573554643,0.45054991444374337
경제과열,-1,-0.03498674389641354,15,7,8,13,0.42088216573554643,0.45054991444374337
마이너스성장할,-1,-0.03498674389641354,15,7,8,1,0.42088216573554643,0.45054991444374337
지표금리국고채수익률오른,-1,-0.03498674389641354,15,7,8,7,0.42088216573554643,0.45054991444374337
경제부정적영향줄,-1,-0.03498674389641354,15,7,8,20,0.42088216573554643,0.45054991444374337
위험부담,-1,-0.03498674389641354,15,7,8,11,0.42088216573554643,0.45054991444374337
달러원하락압력받,-1,-0.03498674389641354,15,7,8,29,0.42088216573554643,0.45054991444374337
달러원상승거래,-1,-0.03498674389641354,15,7,8,5,0.42088216573554643,0.45054991444374337
경제회복세나타내,-1,-0.03498674389641354,15,7,8,15,0.42088216573554643,0.45054991444374337
채권시장강세이어지,-1,-0.03498674389641354,15,7,8,11,0.42088216573554643,0.45054991444374337
외국인자금빠져,-1,-0.03498674389641354,15,7,8,8,0.42088216573554643,0.45054991444374337
콜금리목표유지,-1,-0.03498674389641354,15,7,8,6,0.42088216573554643,0.45054991444374337
금리인하기대따른,-1,-0.03498674389641354,15,7,8,11,0.42088216573554643,0.45054991444374337
경제성장견인,-1,-0.03498674389641354,15,7,8,13,0.42088216573554643,0.45054991444374337
국채선물급락,-1,-0.03498674389641354,15,7,8,13,0.42088216573554643,0.45054991444374337
경기하강따른,-1,-0.03498674389641354,15,7,8,5,0.42088216573554643,0.45054991444374337
물가상승압력가중,-1,-0.03498674389641354,15,7,8,8,0.42088216573554643,0.45054991444374337
물가상승인한,-1,-0.03498674389641354,15,7,8,16,0.42088216573554643,0.45054991444374337
경쟁력높이,-1,-0.03536619639405514,49,23,26,50,0.48001389915636505,0.5142400016973089
국고채지표금리내린,-1,-0.03536619639405514,49,23,26,66,0.48001389915636505,0.5142400016973089
경기회복세보이,-1,-0.037149088402057884,66,31,35,46,0.5043501176583819,0.5422420631620822
위험노출,-1,-0.03748265017879082,102,48,54,114,0.5482624169711954,0.5898470135050965
금리인하시사,-1,-0.03960248640527708,47,22,25,41,0.47465104186354284,0.5128229303564192
위험확대,-1,-0.03960248640527708,47,22,25,38,0.47465104186354284,0.5128229303564192
이익증가,-1,-0.03960248640527708,47,22,25,40,0.47465104186354284,0.5128229303564192
위험상존,-1,-0.03960248640527708,47,22,25,41,0.47465104186354284,0.5128229303564192
금리인하가능성반영,-1,-0.040023610575661506,30,14,16,17,0.4459741856781978,0.48224607468343667
지출감소,-1,-0.040023610575661506,30,14,16,11,0.4459741856781978,0.48224607468343667
양적완화단행,-1,-0.040023610575661506,30,14,16,31,0.4459741856781978,0.48224607468343667
단기물금리하락,-1,-0.040023610575661506,30,14,16,18,0.4459741856781978,0.48224607468343667
재정집행,-1,-0.040023610575661506,30,14,16,16,0.4459741856781978,0.48224607468343667
경기반등,-1,-0.040023610575661506,30,14,16,34,0.4459741856781978,0.48224607468343667
고용부진,-1,-0.040023610575661506,30,14,16,21,0.4459741856781978,0.48224607468343667
성장위해서,-1,-0.040023610575661506,30,14,16,36,0.4459741856781978,0.48224607468343667
유로화엔화하락,-1,-0.04416351848134614,45,21,24,26,0.46909175796182667,0.5114642437375032
대출늘릴,-1,-0.04717247121775647,28,13,15,20,0.4388959304075231,0.4814323574788935
금융시장안정찾,-1,-0.04717247121775647,28,13,15,35,0.4388959304075231,0.4814323574788935
달러강세인한,-1,-0.04717247121775647,28,13,15,22,0.4388959304075231,0.4814323574788935
금리인하가능성배제없,-1,-0.04717247121775647,28,13,15,20,0.4388959304075231,0.4814323574788935
채권가격오르,-1,-0.04717247121775647,28,13,15,32,0.4388959304075231,0.4814323574788935
유로화달러화상승,-1,-0.04717247121775647,28,13,15,17,0.4388959304075231,0.4814323574788935
인플레이션기대심리낮추,-1,-0.04717247121775647,28,13,15,29,0.4388959304075231,0.4814323574788935
달러엔오르,-1,-0.04717247121775647,28,13,15,27,0.4388959304075231,0.4814323574788935
수요둔화,-1,-0.04752314605851482,60,28,32,48,0.49018585882896365,0.5380708372664152
기대심리높였,-1,-0.04752314605851482,60,28,32,37,0.49018585882896365,0.5380708372664152
금리하락이끌,-1,-0.05138162488840603,58,27,31,48,0.48519083816487746,0.5367194745362011
투자심리호전,-1,-0.05154643082893606,107,50,57,58,0.5450852048229765,0.6031738879275026
금리떨어졌,-1,-0.05154643082893606,107,50,57,80,0.5450852048229765,0.6031738879275026
달러원하락,-1,-0.052094293679029846,139,65,74,118,0.5724719360755307,0.6341747983994898
수요위축,-1,-0.052094293679029846,139,65,74,85,0.5724719360755307,0.6341747983994898
금리인상반영,-1,-0.053432319176764276,73,34,39,48,0.504855133719652,0.5607712616460704
달러강세지속,-1,-0.053953938044771554,105,49,56,97,0.5416392920221587,0.6022586271973609
장기금리오르,-1,-0.05533554140242092,26,12,14,30,0.43127546231075264,0.48087252807624564
재정적자확대,-1,-0.05533554140242092,26,12,14,18,0.43127546231075264,0.48087252807624564
금리인상없,-1,-0.05533554140242092,26,12,14,17,0.43127546231075264,0.48087252807624564
고용늘어나,-1,-0.05533554140242092,26,12,14,17,0.43127546231075264,0.48087252807624564
금리인하카드꺼내,-1,-0.05533554140242092,26,12,14,21,0.43127546231075264,0.48087252807624564
경기침체인한,-1,-0.05533554140242092,26,12,14,19,0.43127546231075264,0.48087252807624564
달러강세재개,-1,-0.05533554140242092,26,12,14,26,0.43127546231075264,0.48087252807624564
채권시장약세보이,-1,-0.05533554140242092,26,12,14,25,0.43127546231075264,0.48087252807624564
성장기록,-1,-0.055475112426269346,56,26,30,43,0.4800408396161459,0.5353956973470143
원달러상승,-1,-0.05680512798655446,71,33,38,63,0.5003305788346798,0.5595145440854594
물가상승따른,-1,-0.05680512798655446,71,33,38,58,0.5003305788346798,0.5595145440854594
수출부진,-1,-0.058021315042138144,86,40,46,70,0.5184339874378586,0.5811744547657257
안전자산선호약화,-1,-0.059003405542143006,101,47,54,98,0.5345248696305105,0.6003935348317346
콜금리동결,-1,-0.05971266479921755,264,123,141,104,0.617372568432096,0.6944372101912456
안전자산선호따른,-1,-0.059829305325126536,54,25,29,41,0.47472229537667177,0.5341052534977426
인플레이션우려커지,-1,-0.059829305325126536,54,25,29,31,0.47472229537667177,0.5341052534977426
수요유지,-1,-0.060293533480284434,39,18,21,36,0.4509745141382511,0.5078593648080075
고용증가,-1,-0.060293533480284434,39,18,21,27,0.4509745141382511,0.5078593648080075
금리하락압력작용,-1,-0.060293533480284434,39,18,21,39,0.4509745141382511,0.5078593648080075
cd금리상승,-1,-0.060483032705021755,146,68,78,77,0.5721871515090716,0.6446063621328089
시장금리하락,-1,-0.060483032705021755,146,68,78,124,0.5721871515090716,0.6446063621328089
달러강세지지,-1,-0.06103722435974779,84,39,45,42,0.5143173842164132,0.5800565223146797
성장예상,-1,-0.06165389657861131,99,46,53,63,0.5308515010705572,0.5994448514804134
금리인상결정,-1,-0.0623735438198868,129,60,69,87,0.5583119666551164,0.6313641667806418
고용개선,-1,-0.06447404335543594,52,24,28,43,0.4692193336773429,0.5328546190501341
환율하락막,-1,-0.06477508638537366,24,11,13,19,0.422971684554863,0.4806250735726024
달러원오를,-1,-0.06477508638537366,24,11,13,23,0.422971684554863,0.4806250735726024
유로화반등,-1,-0.06477508638537366,24,11,13,26,0.422971684554863,0.4806250735726024
은행채스프레드확대,-1,-0.06477508638537366,24,11,13,14,0.422971684554863,0.4806250735726024
대출규제강화,-1,-0.06477508638537366,24,11,13,10,0.422971684554863,0.4806250735726024
엔화올랐,-1,-0.06477508638537366,24,11,13,9,0.422971684554863,0.4806250735726024
금리차줄어들,-1,-0.06477508638537366,24,11,13,15,0.422971684554863,0.4806250735726024
금리상승영향받,-1,-0.06477508638537366,24,11,13,29,0.422971684554863,0.4806250735726024
변동성커지,-1,-0.06573357084932008,170,79,91,143,0.5833581470698899,0.664149073007297
가산금리상승,-1,-0.06670877950950893,37,17,20,18,0.4443370650996029,0.506865462163148
환율급등따른,-1,-0.06670877950950893,37,17,20,21,0.4443370650996029,0.506865462163148
경쟁력약화,-1,-0.06670877950950893,37,17,20,24,0.4443370650996029,0.506865462163148
국고채하락,-1,-0.06670877950950893,37,17,20,24,0.4443370650996029,0.506865462163148
수급여건개선,-1,-0.06670877950950893,37,17,20,39,0.4443370650996029,0.506865462163148
소비늘리,-1,-0.06670877950950893,37,17,20,25,0.4443370650996029,0.506865462163148
위험직면,-1,-0.06670877950950893,37,17,20,19,0.4443370650996029,0.506865462163148
crs금리하락,-1,-0.06670877950950893,37,17,20,33,0.4443370650996029,0.506865462163148
소비자물가상승,-1,-0.06715808109043331,252,117,135,185,0.6101618453428432,0.6966534440955698
달러화급등,-1,-0.06744409454471967,80,37,43,80,0.5057840991762264,0.5778115222609282
물가상승압력작용,-1,-0.06796621832073724,65,30,35,34,0.48600601264648324,0.5557990074880237
달러화가치하락,-1,-0.06944419724507267,50,23,27,34,0.4635132686344264,0.5316511041258947
금리인상늦춰질,-1,-0.0720876997737383,63,29,34,67,0.48095217578716476,0.5545894026279217
기준금리올렸,-1,-0.07234686751984054,106,49,57,84,0.5316001464271003,0.6133110709456209
금리인상재개,-1,-0.07379540937370244,35,16,19,35,0.4373183065899501,0.506007445396696
유가떨어지,-1,-0.07379540937370244,35,16,19,26,0.4373183065899501,0.506007445396696
달러엔오른,-1,-0.07379540937370244,35,16,19,26,0.4373183065899501,0.506007445396696
불확실성계속,-1,-0.07379540937370244,35,16,19,26,0.4373183065899501,0.506007445396696
재정지출확대,-1,-0.07379540937370244,35,16,19,26,0.4373183065899501,0.506007445396696
투자심리위축,-1,-0.07420326852794079,686,317,369,445,0.616205658365603,0.7135768425357024
수출호조보이,-1,-0.07441330494260001,76,35,41,56,0.4968168610048626,0.5755653439561711
안전자산선호,-1,-0.07478079776773339,48,22,26,51,0.45758195136364166,0.5305029761318246
지급준비율인상,-1,-0.07514282430763486,214,99,115,126,0.595329205969408,0.6907040528577951
인플레이션억제,-1,-0.07532349252684323,240,111,129,128,0.6020863108757522,0.6987972902714968
국채가격상승,-1,-0.07541888415903097,132,61,71,65,0.5525281854106863,0.641401738440491
금리인하이뤄질,-1,-0.07585577498025264,22,10,12,23,0.41378563874535795,0.4807644488183268
채권시장부담되,-1,-0.07585577498025264,22,10,12,10,0.41378563874535795,0.4807644488183268
엔화강세따른,-1,-0.07585577498025264,22,10,12,13,0.41378563874535795,0.4807644488183268
성장통해,-1,-0.07585577498025264,22,10,12,21,0.41378563874535795,0.4807644488183268
경기부양책시행,-1,-0.07585577498025264,22,10,12,11,0.41378563874535795,0.4807644488183268
외환시장변동성확대,-1,-0.07585577498025264,22,10,12,22,0.41378563874535795,0.4807644488183268
높변동성보일,-1,-0.07585577498025264,22,10,12,17,0.41378563874535795,0.4807644488183268
달러약세인해,-1,-0.07585577498025264,22,10,12,16,0.41378563874535795,0.4807644488183268
신용등급떨어지,-1,-0.07585577498025264,22,10,12,9,0.41378563874535795,0.4807644488183268
자금유입확대,-1,-0.07585577498025264,22,10,12,35,0.41378563874535795,0.4807644488183268
지급준비금적수증가,-1,-0.07964880111018036,87,40,47,108,0.506998721982654,0.5935737755683207
연방기금금리선물오,-1,-0.08018456611277713,128,59,69,43,0.5463817185717745,0.6403712480710428
완화위해,-1,-0.08203472885174501,72,33,39,64,0.48736671651744756,0.5733335822661586
수요늘어난,-1,-0.08612400598158265,70,32,38,52,0.4824419843339922,0.5722288453741141
채권금리떨어지,-1,-0.08675740346119787,44,20,24,17,0.44493240460923983,0.5284116210388773
불안심리확산,-1,-0.08753329574052504,109,50,59,88,0.5252503862409069,0.6247741004092234
장기금리하락,-1,-0.08781932095336586,122,56,66,116,0.5366749579107664,0.6387310745785225
경기둔화이어지,-1,-0.0891011585985052,20,9,11,12,0.40342821406305934,0.4813864592019845
기준금리인하나서,-1,-0.0891011585985052,20,9,11,13,0.40342821406305934,0.4813864592019845
높수익얻,-1,-0.0891011585985052,20,9,11,31,0.40342821406305934,0.4813864592019845
순이익내,-1,-0.0891011585985052,20,9,11,8,0.40342821406305934,0.4813864592019845
경제성장저해,-1,-0.0891011585985052,20,9,11,15,0.40342821406305934,0.4813864592019845
금리상승세재개,-1,-0.0891011585985052,20,9,11,27,0.40342821406305934,0.4813864592019845
달러약세심화,-1,-0.0891011585985052,20,9,11,12,0.40342821406305934,0.4813864592019845
실업률유지,-1,-0.0891011585985052,20,9,11,16,0.40342821406305934,0.4813864592019845
이익줄,-1,-0.0891011585985052,20,9,11,22,0.40342821406305934,0.4813864592019845
장기물강세보이,-1,-0.0891011585985052,20,9,11,27,0.40342821406305934,0.4813864592019845
소비위축따른,-1,-0.0891011585985052,20,9,11,5,0.40342821406305934,0.4813864592019845
금리상승억제,-1,-0.0891011585985052,20,9,11,15,0.40342821406305934,0.4813864592019845
금리폭락,-1,-0.0891011585985052,20,9,11,2,0.40342821406305934,0.4813864592019845
재무안정성저하,-1,-0.0891011585985052,20,9,11,25,0.40342821406305934,0.4813864592019845
고용개선따른,-1,-0.0891011585985052,20,9,11,13,0.40342821406305934,0.4813864592019845
경제회복,-1,-0.08981368206282903,209,96,113,198,0.5837440792155694,0.6975466522213654
경제성장세지속,-1,-0.09052590875296851,31,14,17,24,0.4218389383757472,0.5048012516109389
비농업고용자수증가,-1,-0.09052590875296851,31,14,17,17,0.4218389383757472,0.5048012516109389
스왑베이시스역전폭축소,-1,-0.09052590875296851,31,14,17,32,0.4218389383757472,0.5048012516109389
채권시장약세보였,-1,-0.09052590875296851,31,14,17,30,0.4218389383757472,0.5048012516109389
국고채금리하락,-1,-0.09249028089821076,218,100,118,146,0.5846787763325997,0.7024408311674757
금리내려,-1,-0.0941542814456724,79,36,43,91,0.48908283768877964,0.5895643161433677
채권시장국채가격오른,-1,-0.09610891858460002,116,53,63,68,0.5263394695800553,0.6369803010959413
양적완화축소따른,-1,-0.09671653385803203,53,24,29,88,0.4530414946507986,0.5489466584544831
물가오를,-1,-0.0972775259175549,90,41,49,61,0.4999231325191547,0.606438444163724
재무구조개선,-1,-0.09817985490679182,77,35,42,51,0.48430459142993953,0.5885623372339573
경기회복뒷받침,-1,-0.09971261072923321,64,29,35,55,0.4667557631141304,0.5689924440030912
수출호조세지속,-1,-0.1005437995925782,29,13,16,9,0.41317121127977446,0.5045163944931224
달러화강세나타냈,-1,-0.1005437995925782,29,13,16,15,0.41317121127977446,0.5045163944931224
투자줄,-1,-0.1005437995925782,29,13,16,14,0.41317121127977446,0.5045163944931224
높수익기대,-1,-0.1005437995925782,29,13,16,18,0.41317121127977446,0.5045163944931224
모기지금리하락,-1,-0.1005437995925782,29,13,16,19,0.41317121127977446,0.5045163944931224
고용늘,-1,-0.1005437995925782,29,13,16,23,0.41317121127977446,0.5045163944931224
채권시장강세이,-1,-0.1005437995925782,29,13,16,19,0.41317121127977446,0.5045163944931224
유로달러하락거래,-1,-0.1005437995925782,29,13,16,31,0.41317121127977446,0.5045163944931224
시중금리하락,-1,-0.10092268852640196,40,18,22,20,0.4309856704690113,0.5266718954383605
임금상승,-1,-0.10092268852640196,40,18,22,30,0.4309856704690113,0.5266718954383605
금리동결따른,-1,-0.10092268852640196,40,18,22,34,0.4309856704690113,0.5266718954383605
장기물하락,-1,-0.10092268852640196,40,18,22,41,0.4309856704690113,0.5266718954383605
고용지표악화,-1,-0.10092268852640196,40,18,22,24,0.4309856704690113,0.5266718954383605
수요회복,-1,-0.10092268852640196,40,18,22,31,0.4309856704690113,0.5266718954383605
경제지표악화,-1,-0.10239010202814336,75,34,41,43,0.479392763061121,0.5875639801434799
양적완화종료,-1,-0.10239010202814336,75,34,41,116,0.479392763061121,0.5875639801434799
금리상승요인작용,-1,-0.10239010202814336,75,34,41,57,0.479392763061121,0.5875639801434799
서부텍사스산원유가격오른,-1,-0.10267058993678058,51,23,28,32,0.44680824918206463,0.5479372185179034
기준금리인하예상,-1,-0.10267058993678058,51,23,28,53,0.44680824918206463,0.5479372185179034
소비늘어나,-1,-0.10267058993678058,51,23,28,33,0.44680824918206463,0.5479372185179034
국채선물내린,-1,-0.10475366932791808,62,28,34,64,0.46118371459987767,0.5679504399671048
수익올릴,-1,-0.10475366932791808,62,28,34,51,0.46118371459987767,0.5679504399671048
국채선물하락거래,-1,-0.10529273141170936,18,8,10,16,0.39146412658693985,0.48261557510769654
성장해,-1,-0.10529273141170936,18,8,10,10,0.39146412658693985,0.48261557510769654
gdp부진,-1,-0.10529273141170936,18,8,10,18,0.39146412658693985,0.48261557510769654
소비심리회복,-1,-0.10529273141170936,18,8,10,17,0.39146412658693985,0.48261557510769654
국채수익률상승기록,-1,-0.10529273141170936,18,8,10,23,0.39146412658693985,0.48261557510769654
경기하강막,-1,-0.10529273141170936,18,8,10,7,0.39146412658693985,0.48261557510769654
엔화가치떨어지,-1,-0.10529273141170936,18,8,10,17,0.39146412658693985,0.48261557510769654
재고늘어나,-1,-0.10529273141170936,18,8,10,12,0.39146412658693985,0.48261557510769654
금리인상가능성열려,-1,-0.10529273141170936,18,8,10,23,0.39146412658693985,0.48261557510769654
채권시장강세보인,-1,-0.10529273141170936,18,8,10,17,0.39146412658693985,0.48261557510769654
엔화약세인한,-1,-0.10529273141170936,18,8,10,18,0.39146412658693985,0.48261557510769654
금리상승세이어지,-1,-0.10529273141170936,18,8,10,9,0.39146412658693985,0.48261557510769654
기준금리동결점쳤,-1,-0.10529273141170936,18,8,10,7,0.39146412658693985,0.48261557510769654
금리인상가능성배제,-1,-0.10529273141170936,18,8,10,3,0.39146412658693985,0.48261557510769654
주택담보대출금리인상,-1,-0.10529273141170936,18,8,10,12,0.39146412658693985,0.48261557510769654
금리빠질,-1,-0.10529273141170936,18,8,10,10,0.39146412658693985,0.48261557510769654
물가떨어지,-1,-0.10529273141170936,18,8,10,14,0.39146412658693985,0.48261557510769654
원화절하,-1,-0.10529273141170936,18,8,10,19,0.39146412658693985,0.48261557510769654
위험줄여,-1,-0.10529273141170936,18,8,10,8,0.39146412658693985,0.48261557510769654
금리인상놓,-1,-0.10529273141170936,18,8,10,19,0.39146412658693985,0.48261557510769654
미국채금리떨어졌,-1,-0.10529273141170936,18,8,10,15,0.39146412658693985,0.48261557510769654
금리인하통해,-1,-0.10669658003207305,97,44,53,54,0.5016995525494108,0.6202758047655882
인플레이션완화,-1,-0.10835034533817911,108,49,59,68,0.5114780555073758,0.6344825058180019
수출늘리,-1,-0.10905365827007962,38,17,21,25,0.4233997262129229,0.5259696426346963
달러화반락,-1,-0.10905365827007962,38,17,21,37,0.4233997262129229,0.5259696426346963
유로화급락,-1,-0.10905365827007962,38,17,21,19,0.4233997262129229,0.5259696426346963
금리인상나서않,-1,-0.10905365827007962,38,17,21,27,0.4233997262129229,0.5259696426346963
투자늘릴,-1,-0.10905365827007962,38,17,21,24,0.4233997262129229,0.5259696426346963
인플레이션우려증폭,-1,-0.10905365827007962,38,17,21,23,0.4233997262129229,0.5259696426346963
변동성커졌,-1,-0.10905365827007962,38,17,21,42,0.4233997262129229,0.5259696426346963
채권수익률상승,-1,-0.10905365827007962,38,17,21,43,0.4233997262129229,0.5259696426346963
금리인상하않,-1,-0.10906857476193343,49,22,27,44,0.44030206773891956,0.5469831242624015
적자확대,-1,-0.10906857476193343,49,22,27,41,0.44030206773891956,0.5469831242624015
엔화하락,-1,-0.11009383277173435,60,27,33,65,0.4554160266575348,0.5669330688529596
경제성장률하향조정,-1,-0.11009383277173435,60,27,33,45,0.4554160266575348,0.5669330688529596
국고채하락기록,-1,-0.1120152105812211,27,12,15,26,0.4036887849236707,0.50449616922492
침체이어지,-1,-0.1120152105812211,27,12,15,12,0.4036887849236707,0.50449616922492
금리인상가능성높이,-1,-0.1120152105812211,27,12,15,22,0.4036887849236707,0.50449616922492
국채가격하락부추겼,-1,-0.1120152105812211,27,12,15,14,0.4036887849236707,0.50449616922492
통화완화종료,-1,-0.1120152105812211,27,12,15,17,0.4036887849236707,0.50449616922492
대출축소,-1,-0.1120152105812211,27,12,15,12,0.4036887849236707,0.50449616922492
시장금리급락,-1,-0.1120152105812211,27,12,15,15,0.4036887849236707,0.50449616922492
채권시장강세지지,-1,-0.1120152105812211,27,12,15,25,0.4036887849236707,0.50449616922492
금리오,-1,-0.1120152105812211,27,12,15,13,0.4036887849236707,0.50449616922492
금리인하않,-1,-0.11506158801192312,104,47,57,40,0.5035361466805152,0.6331683968640744
경상수지흑자지속,-1,-0.11597004572290481,47,21,26,60,0.43348985911723065,0.5460926160197096
위험증가,-1,-0.11597004572290481,47,21,26,36,0.43348985911723065,0.5460926160197096
물가상승률둔화,-1,-0.11597004572290481,47,21,26,30,0.43348985911723065,0.5460926160197096
금리높이,-1,-0.11597004572290481,47,21,26,27,0.43348985911723065,0.5460926160197096
수익성유지,-1,-0.11597004572290481,47,21,26,25,0.43348985911723065,0.5460926160197096
자산증가,-1,-0.11804972060584162,36,16,20,33,0.41531283921507045,0.5254022931685337
경상수지흑자기록,-1,-0.11804972060584162,36,16,20,31,0.41531283921507045,0.5254022931685337
채권금리상승,-1,-0.12087946060654398,241,109,132,236,0.5705110172511076,0.7258904498639217
인플레이션우려부각,-1,-0.12140816997967219,67,30,37,35,0.458226004208615,0.5836497205576219
금리인하통한,-1,-0.12140816997967219,67,30,37,25,0.458226004208615,0.5836497205576219
엔화강세보이,-1,-0.12154131582120586,78,35,43,78,0.4717599043720824,0.6010502954643614
국고채오른,-1,-0.12222561358373019,100,45,55,33,0.49521899130658115,0.6318146323695241
금리인상통한,-1,-0.12344629755658831,45,20,25,43,0.426331951712289,0.5452748545526894
투자심리악화,-1,-0.1253174757119654,153,69,84,95,0.5345863876279927,0.6863320577151139
원달러급등,-1,-0.12532271690037267,25,11,14,24,0.39317809868860154,0.5047895158988037
완화통해,-1,-0.12532271690037267,25,11,14,21,0.39317809868860154,0.5047895158988037
침체벗어나못하,-1,-0.12532271690037267,25,11,14,17,0.39317809868860154,0.5047895158988037
국고채금리국고지표물내린,-1,-0.12532271690037267,25,11,14,32,0.39317809868860154,0.5047895158988037
불확실성줄,-1,-0.12532271690037267,25,11,14,12,0.39317809868860154,0.5047895158988037
매수심리확산,-1,-0.12565459419154912,16,7,9,2,0.3772097408852239,0.4846145224006787
완화나설,-1,-0.12565459419154912,16,7,9,31,0.3772097408852239,0.4846145224006787
달러원하락압력작용,-1,-0.12565459419154912,16,7,9,10,0.3772097408852239,0.4846145224006787
은행대출늘,-1,-0.12565459419154912,16,7,9,9,0.3772097408852239,0.4846145224006787
유로화오,-1,-0.12565459419154912,16,7,9,11,0.3772097408852239,0.4846145224006787
기준금리인상인한,-1,-0.12565459419154912,16,7,9,20,0.3772097408852239,0.4846145224006787
채권금리내렸,-1,-0.12565459419154912,16,7,9,9,0.3772097408852239,0.4846145224006787
설비투자개선,-1,-0.12565459419154912,16,7,9,22,0.3772097408852239,0.4846145224006787
경기회복될,-1,-0.12565459419154912,16,7,9,7,0.3772097408852239,0.4846145224006787
단기금리인상,-1,-0.12565459419154912,16,7,9,12,0.3772097408852239,0.4846145224006787
금리낮추않,-1,-0.12565459419154912,16,7,9,15,0.3772097408852239,0.4846145224006787
기준금리인하기대심리커지,-1,-0.12565459419154912,16,7,9,12,0.3772097408852239,0.4846145224006787
기준금리인상다가오,-1,-0.12565459419154912,16,7,9,11,0.3772097408852239,0.4846145224006787
금리인상앞당길,-1,-0.12565459419154912,16,7,9,13,0.3772097408852239,0.4846145224006787
기준금리하락,-1,-0.12565459419154912,16,7,9,10,0.3772097408852239,0.4846145224006787
금리인상더불,-1,-0.12565459419154912,16,7,9,24,0.3772097408852239,0.4846145224006787
엔화절상,-1,-0.12565459419154912,16,7,9,18,0.3772097408852239,0.4846145224006787
자산가격하락,-1,-0.12565459419154912,16,7,9,9,0.3772097408852239,0.4846145224006787
물가상승우려,-1,-0.12565459419154912,16,7,9,10,0.3772097408852239,0.4846145224006787
금리인하기대남,-1,-0.12565459419154912,16,7,9,13,0.3772097408852239,0.4846145224006787
물가오르,-1,-0.12691262860315644,173,78,95,144,0.5441829381635157,0.7009184681657735
통화정책불확실성해소,-1,-0.12807663260827784,34,15,19,35,0.4066326123559554,0.5249902859824787
지표물국고채금리내린,-1,-0.12807663260827784,34,15,19,16,0.4066326123559554,0.5249902859824787
소비둔화,-1,-0.12807663260827784,34,15,19,24,0.4066326123559554,0.5249902859824787
신용등급하향,-1,-0.12807663260827784,34,15,19,35,0.4066326123559554,0.5249902859824787
채권금리올랐,-1,-0.12807663260827784,34,15,19,34,0.4066326123559554,0.5249902859824787
금리내려야,-1,-0.1282537008913095,54,24,30,44,0.4367476757443759,0.5640736834935655
경제성장촉진,-1,-0.1282537008913095,54,24,30,21,0.4367476757443759,0.5640736834935655
금리상승마감,-1,-0.1282537008913095,54,24,30,51,0.4367476757443759,0.5640736834935655
매출감소,-1,-0.1282537008913095,54,24,30,34,0.4367476757443759,0.5640736834935655
금리인상고려,-1,-0.1303697903807317,85,38,47,54,0.4745182048290549,0.6154957664462972
고용자수증가,-1,-0.1315834494894077,43,19,24,39,0.4187804177522328,0.5445400108612628
수익성개선,-1,-0.13200667390841148,127,57,70,102,0.5126312802589092,0.6671479772034579
달러화상승압력받,-1,-0.13516446315193686,52,23,29,42,0.4299895513053059,0.5632019437539652
금리낮수준유지,-1,-0.13516446315193686,52,23,29,33,0.4299895513053059,0.5632019437539652
경기회복위한,-1,-0.13628665640013993,72,32,40,59,0.4557993955371095,0.5983726846660243
경기부양위한,-1,-0.13682281742531743,319,143,176,275,0.5681926717324425,0.7467368783502341
기준금리올릴,-1,-0.13853485153724165,326,146,180,332,0.5673114051648458,0.748182189291012
국고채금리상승,-1,-0.13908313995328803,203,91,112,139,0.5477889476380786,0.7232427644043752
수출증가율둔화,-1,-0.13934714568697404,32,14,18,28,0.3972407132377678,0.5247568716036457
유가오를,-1,-0.13934714568697404,32,14,18,20,0.3972407132377678,0.5247568716036457
cds프리미엄급등,-1,-0.13934714568697404,32,14,18,11,0.3972407132377678,0.5247568716036457
국채선물하락마감,-1,-0.13934714568697404,32,14,18,22,0.3972407132377678,0.5247568716036457
변동성줄,-1,-0.13934714568697404,32,14,18,33,0.3972407132377678,0.5247568716036457
수요줄어들,-1,-0.13972875338994806,163,73,90,107,0.5305398823236832,0.701390748647926
재정적자줄이,-1,-0.14048656313390884,41,18,23,44,0.4107768769192043,0.5438993516712126
경제부담될,-1,-0.14100108576528347,23,10,13,22,0.38134172572852165,0.5054547044679759
연방기금금리선물시장오,-1,-0.14100108576528347,23,10,13,21,0.38134172572852165,0.5054547044679759
국채가격하락압력가했,-1,-0.14100108576528347,23,10,13,13,0.38134172572852165,0.5054547044679759
글로벌경제둔화,-1,-0.14100108576528347,23,10,13,27,0.38134172572852165,0.5054547044679759
금융시장확산,-1,-0.14100108576528347,23,10,13,11,0.38134172572852165,0.5054547044679759
하향압력받,-1,-0.14100108576528347,23,10,13,16,0.38134172572852165,0.5054547044679759
가산금리올려,-1,-0.14100108576528347,23,10,13,9,0.38134172572852165,0.5054547044679759
경기회복세유지,-1,-0.14100108576528347,23,10,13,19,0.38134172572852165,0.5054547044679759
금리인하유도,-1,-0.14100108576528347,23,10,13,13,0.38134172572852165,0.5054547044679759
금리인상한,-1,-0.14100108576528347,23,10,13,15,0.38134172572852165,0.5054547044679759
금리상승세출발,-1,-0.14100108576528347,23,10,13,20,0.38134172572852165,0.5054547044679759
경제지표개선,-1,-0.14244446362046936,141,63,78,166,0.5157782886427345,0.6856598963190239
달러엔상승,-1,-0.1424968899886765,90,40,50,66,0.47256607073977724,0.6282820472130471
금리인상인해,-1,-0.14259552351731375,50,22,28,36,0.42291289824502765,0.5623806659824441
금리안정,-1,-0.14501645693483756,99,44,55,85,0.48013570451383747,0.6416348143312248
위험줄이,-1,-0.14702807355137582,88,39,49,88,0.46767560605333386,0.6275548458048756
국고채금리하락마감,-1,-0.14740303820181233,68,30,38,46,0.4442854807669031,0.596625166469316
기대심리커지,-1,-0.14789162664496103,186,83,103,171,0.5355285206579834,0.7198720902642769
유동성확대,-1,-0.15028521303796194,39,17,22,47,0.40224958833910196,0.5433653101272858
시장신뢰회복,-1,-0.15028521303796194,39,17,22,39,0.40224958833910196,0.5433653101272858
채권금리급락,-1,-0.15028521303796194,39,17,22,27,0.40224958833910196,0.5433653101272858
변동성확대,-1,-0.1509492646441919,605,269,336,513,0.5605404124785508,0.7582154738184287
경제성장률상향조정,-1,-0.15213910692414834,30,13,17,26,0.38698347407948125,0.5247283659162879
경기부진지속,-1,-0.15213910692414834,30,13,17,29,0.38698347407948125,0.5247283659162879
미국채금리상승,-1,-0.15415598242448902,124,55,69,169,0.4960406052258977,0.6753842601246793
매수심리위축,-1,-0.15567830068244282,252,112,140,200,0.5476918972807938,0.7480369336373114
금리내리,-1,-0.15857788873235623,447,198,249,336,0.55475377546689,0.7621946959155713
경기부양나설,-1,-0.15916551277201607,55,24,31,37,0.42041669353471156,0.5783204382042249
대외여건개선,-1,-0.15982208182243163,21,9,12,8,0.36775479672294514,0.5065605213831134
달러화강세이,-1,-0.15982208182243163,21,9,12,20,0.36775479672294514,0.5065605213831134
원자재가격급락,-1,-0.15982208182243163,21,9,12,17,0.36775479672294514,0.5065605213831134
유로화엔화강세나타냈,-1,-0.15982208182243163,21,9,12,9,0.36775479672294514,0.5065605213831134
유동성악화,-1,-0.15982208182243163,21,9,12,16,0.36775479672294514,0.5065605213831134
국고채금리국고지표물하락출발,-1,-0.15982208182243163,21,9,12,18,0.36775479672294514,0.5065605213831134
고변동성확대,-1,-0.15982208182243163,21,9,12,10,0.36775479672294514,0.5065605213831134
양적완화시작,-1,-0.15982208182243163,21,9,12,25,0.36775479672294514,0.5065605213831134
고용사정개선,-1,-0.15982208182243163,21,9,12,12,0.36775479672294514,0.5065605213831134
금리수준하락,-1,-0.15982208182243163,21,9,12,19,0.36775479672294514,0.5065605213831134
고용감소,-1,-0.16114113771586946,37,16,21,20,0.3931095600151051,0.5429515237263043
소비늘,-1,-0.16114113771586946,37,16,21,32,0.3931095600151051,0.5429515237263043
금리올라,-1,-0.16286169810096485,138,61,77,86,0.5003407224900464,0.6934992792065263
양적완화따른,-1,-0.16460685865714542,109,48,61,114,0.47705080505989694,0.663590739427563
금리인하하,-1,-0.16652941924466014,62,27,35,26,0.42541426690711304,0.5941039414178744
환율급락따른,-1,-0.16682257290024238,28,12,16,7,0.37565829851081967,0.5249342709356868
유동성줄이,-1,-0.16682257290024238,28,12,16,32,0.37565829851081967,0.5249342709356868
채권시장국채가격떨어진,-1,-0.16682257290024238,28,12,16,11,0.37565829851081967,0.5249342709356868
실적감소,-1,-0.168788284081396,44,19,25,26,0.39934232012178195,0.5602886135949608
침체빠진,-1,-0.168788284081396,44,19,25,11,0.39934232012178195,0.5602886135949608
물가급등,-1,-0.168788284081396,44,19,25,22,0.39934232012178195,0.5602886135949608
불안심리커졌,-1,-0.17325892190821035,35,15,20,24,0.3832452885985727,0.5426728091479426
엔화약세보였,-1,-0.17325892190821035,35,15,20,33,0.3832452885985727,0.5426728091479426
생산자물가상승,-1,-0.17325892190821035,35,15,20,39,0.3832452885985727,0.5426728091479426
기준금리동결전망,-1,-0.17325892190821035,35,15,20,36,0.3832452885985727,0.5426728091479426
시장기준금리동결,-1,-0.17325892190821035,35,15,20,24,0.3832452885985727,0.5426728091479426
비농업고용증가,-1,-0.17325892190821035,35,15,20,29,0.3832452885985727,0.5426728091479426
달러화오를,-1,-0.17325892190821035,35,15,20,31,0.3832452885985727,0.5426728091479426
금리인하나설,-1,-0.17333667403406894,141,62,79,122,0.4953429936182577,0.701514727753648
원화강세지속,-1,-0.1736987036434371,60,26,34,67,0.4186199979208919,0.5933002322810981
금리낮췄,-1,-0.1736987036434371,60,26,34,53,0.4186199979208919,0.5933002322810981
경기부양위해,-1,-0.17434328581892744,421,185,236,323,0.5429152940814923,0.7704832534931644
시장금리오를,-1,-0.17545192862705528,51,22,29,38,0.4055120637989045,0.5768021907389592
경기회복지속,-1,-0.17545192862705528,51,22,29,44,0.4055120637989045,0.5768021907389592
국채가격오른,-1,-0.17781311882667383,94,41,53,46,0.4548262465976849,0.6501038149803907
국제유가오르,-1,-0.17916387541387313,42,18,24,29,0.3905166673732777,0.5597408164510272
인플레이션우려완화,-1,-0.18090333121462876,128,56,72,62,0.4815868391970366,0.6927576952220956
달러화반등,-1,-0.18179138887256474,110,48,62,71,0.46695593079386166,0.6729443281422544
신뢰회복,-1,-0.18227171341659476,101,44,57,58,0.4586923792147541,0.6616916827420487
인플레이션상승,-1,-0.18285214202616018,92,40,52,84,0.44970940499832357,0.6495116419718561
불안심리해소,-1,-0.18285214202616018,92,40,52,54,0.44970940499832357,0.6495116419718561
경제지표부진따른,-1,-0.18294242500028435,19,8,11,17,0.35179294512968806,0.5081864914822547
국채금리급락,-1,-0.18294242500028435,19,8,11,13,0.35179294512968806,0.5081864914822547
경제성장따른,-1,-0.18294242500028435,19,8,11,16,0.35179294512968806,0.5081864914822547
비용줄어들,-1,-0.18294242500028435,19,8,11,14,0.35179294512968806,0.5081864914822547
금리변동성커질,-1,-0.18294242500028435,19,8,11,11,0.35179294512968806,0.5081864914822547
매출늘어난,-1,-0.18294242500028435,19,8,11,17,0.35179294512968806,0.5081864914822547
금리영향줄,-1,-0.18294242500028435,19,8,11,17,0.35179294512968806,0.5081864914822547
경쟁력유지,-1,-0.18294242500028435,19,8,11,13,0.35179294512968806,0.5081864914822547
인플레이션압력억제,-1,-0.18294242500028435,19,8,11,7,0.35179294512968806,0.5081864914822547
신뢰높이,-1,-0.18294242500028435,19,8,11,12,0.35179294512968806,0.5081864914822547
경기회복되,-1,-0.18294242500028435,19,8,11,10,0.35179294512968806,0.5081864914822547
중소기업대출증가,-1,-0.18294242500028435,19,8,11,3,0.35179294512968806,0.5081864914822547
가계부채늘어난,-1,-0.18294242500028435,19,8,11,14,0.35179294512968806,0.5081864914822547
실적전망하향조정,-1,-0.18294242500028435,19,8,11,11,0.35179294512968806,0.5081864914822547
달러화올라서,-1,-0.18294242500028435,19,8,11,8,0.35179294512968806,0.5081864914822547
금리동결이어질,-1,-0.18390152215102284,26,11,15,26,0.36299367895379153,0.5254070904242923
달러강세요인작용,-1,-0.18390152215102284,26,11,15,23,0.36299367895379153,0.5254070904242923
금리인상가능성언급,-1,-0.18390152215102284,26,11,15,25,0.36299367895379153,0.5254070904242923
금리상승세제한,-1,-0.18390152215102284,26,11,15,31,0.36299367895379153,0.5254070904242923
외환보유액증가,-1,-0.18390152215102284,26,11,15,28,0.36299367895379153,0.5254070904242923
선행지수상승,-1,-0.18390152215102284,26,11,15,11,0.36299367895379153,0.5254070904242923
대외여건악화,-1,-0.18390152215102284,26,11,15,15,0.36299367895379153,0.5254070904242923
금리인하하않,-1,-0.18390152215102284,26,11,15,15,0.36299367895379153,0.5254070904242923
회사채수익률내린,-1,-0.18390152215102284,26,11,15,10,0.36299367895379153,0.5254070904242923
환율하락제한,-1,-0.18390152215102284,26,11,15,17,0.36299367895379153,0.5254070904242923
경제위축,-1,-0.1865808904760219,65,28,37,51,0.41735966568892297,0.607454812578897
실적개선기대,-1,-0.18690117611318202,33,14,19,41,0.372515573828782,0.5425450230644442
지급준비율인상따른,-1,-0.18690117611318202,33,14,19,16,0.372515573828782,0.5425450230644442
성장세확대,-1,-0.18690117611318202,33,14,19,27,0.372515573828782,0.5425450230644442
금리하방경직성강화,-1,-0.18690117611318202,33,14,19,27,0.372515573828782,0.5425450230644442
수출감소세지속,-1,-0.18690117611318202,33,14,19,30,0.372515573828782,0.5425450230644442
기준금리동결가진,-1,-0.18690117611318202,33,14,19,29,0.372515573828782,0.5425450230644442
안정적수익추구,-1,-0.18690117611318202,33,14,19,27,0.372515573828782,0.5425450230644442
대출늘어나,-1,-0.18809111447615812,90,39,51,65,0.4444503842082504,0.6489098606230228
유가반등,-1,-0.18950685840005832,56,24,32,56,0.40412376948779394,0.5917644331396769
cds프리미엄상승,-1,-0.18950685840005832,56,24,32,33,0.40412376948779394,0.5917644331396769
유로달러내린,-1,-0.19059445395622898,40,17,23,36,0.38108117468397573,0.5592817699778477
인플레이션압력강화,-1,-0.19059445395622898,40,17,23,16,0.38108117468397573,0.5592817699778477
통화정책완화,-1,-0.19354415387607782,88,38,50,61,0.4390414391969232,0.6482987246994434
기대심리확대,-1,-0.19446070040403518,47,20,27,47,0.3889811639558975,0.5754721329154343
투자심리회복,-1,-0.19532485883973316,154,67,87,125,0.48816835615514653,0.7235099109761755
경제성장,-1,-0.19738627240245132,177,77,100,128,0.49761789556759944,0.740679869091482
금리상승대비,-1,-0.198266516037084,54,23,31,53,0.3963568930054046,0.5910381953693729
단기금리하락,-1,-0.198266516037084,54,23,31,24,0.3963568930054046,0.5910381953693729
성장세나타내,-1,-0.2018994978200206,61,26,35,37,0.4032871794364768,0.6059349897602445
시장상승유로달러하락거래,-1,-0.20241051570035162,31,13,18,39,0.3607396105296828,0.542584723546099
금리높일,-1,-0.2040799187598319,24,10,14,16,0.3486193713823096,0.5261815077243271
높수익률추구,-1,-0.2040799187598319,24,10,14,10,0.3486193713823096,0.5261815077243271
성장세이어지,-1,-0.2040799187598319,24,10,14,29,0.3486193713823096,0.5261815077243271
완화이,-1,-0.2040799187598319,24,10,14,18,0.3486193713823096,0.5261815077243271
잠재성장률밑돌,-1,-0.2040799187598319,24,10,14,15,0.3486193713823096,0.5261815077243271
위안화절하,-1,-0.2040799187598319,24,10,14,24,0.3486193713823096,0.5261815077243271
금융시장충격받,-1,-0.2040799187598319,24,10,14,19,0.3486193713823096,0.5261815077243271
금리내려온,-1,-0.2040799187598319,24,10,14,12,0.3486193713823096,0.5261815077243271
실업률낮추,-1,-0.2040799187598319,24,10,14,29,0.3486193713823096,0.5261815077243271
장기금리오르않,-1,-0.2040799187598319,24,10,14,9,0.3486193713823096,0.5261815077243271
금리낮추,-1,-0.20425311047832262,307,133,174,253,0.517833335728018,0.7818632865027718
주택시장침체따른,-1,-0.20524281919893683,45,19,26,11,0.37996888490981745,0.5748900927091797
불확실성커질,-1,-0.20524281919893683,45,19,26,51,0.37996888490981745,0.5748900927091797
경기회복세이어지,-1,-0.20769507430774026,52,22,30,34,0.38819192584784473,0.5903436866380882
달러강세따른,-1,-0.21070193481859734,114,49,65,98,0.4516298028126713,0.6911436340331101
금리인상막,-1,-0.2121753748601175,17,7,10,17,0.33250979223530047,0.5104202693273859
유동성증가따른,-1,-0.2121753748601175,17,7,10,8,0.33250979223530047,0.5104202693273859
인플레이션우려덜,-1,-0.2121753748601175,17,7,10,3,0.33250979223530047,0.5104202693273859
유동성줄,-1,-0.2121753748601175,17,7,10,15,0.33250979223530047,0.5104202693273859
금리인상앞당겨,-1,-0.2121753748601175,17,7,10,14,0.33250979223530047,0.5104202693273859
경제성장지지,-1,-0.2121753748601175,17,7,10,10,0.33250979223530047,0.5104202693273859
위험자산이동,-1,-0.2121753748601175,17,7,10,16,0.33250979223530047,0.5104202693273859
실적상회,-1,-0.2121753748601175,17,7,10,9,0.33250979223530047,0.5104202693273859
지출늘어나,-1,-0.2121753748601175,17,7,10,18,0.33250979223530047,0.5104202693273859
유로확대,-1,-0.2121753748601175,17,7,10,9,0.33250979223530047,0.5104202693273859
금리상승반영,-1,-0.2121753748601175,17,7,10,23,0.33250979223530047,0.5104202693273859
금리내려간,-1,-0.2121753748601175,17,7,10,28,0.33250979223530047,0.5104202693273859
시장금리동결,-1,-0.2121753748601175,17,7,10,14,0.33250979223530047,0.5104202693273859
하향압력작용,-1,-0.2121753748601175,17,7,10,7,0.33250979223530047,0.5104202693273859
높금리거래,-1,-0.2121753748601175,17,7,10,9,0.33250979223530047,0.5104202693273859
금리부담커지,-1,-0.2121753748601175,17,7,10,8,0.33250979223530047,0.5104202693273859
채권금리떨어졌,-1,-0.2121753748601175,17,7,10,13,0.33250979223530047,0.5104202693273859
높수익률얻,-1,-0.2121753748601175,17,7,10,11,0.33250979223530047,0.5104202693273859
성장정체,-1,-0.2121753748601175,17,7,10,21,0.33250979223530047,0.5104202693273859
신용위험커지,-1,-0.2121753748601175,17,7,10,7,0.33250979223530047,0.5104202693273859
금리인하효과지켜볼,-1,-0.2121753748601175,17,7,10,23,0.33250979223530047,0.5104202693273859
금리인상확인,-1,-0.2121753748601175,17,7,10,17,0.33250979223530047,0.5104202693273859
높이자받,-1,-0.2121753748601175,17,7,10,10,0.33250979223530047,0.5104202693273859
성장세유지,-1,-0.21338628214525313,190,82,108,140,0.49133171362353795,0.756133218856295
채권시장국고채지표금리오른,-1,-0.21398757798589907,89,38,51,107,0.4273414585994145,0.6584836797763916
완화적통화정책유지,-1,-0.21545655464192381,73,31,42,72,0.40949555354156525,0.6329287488498451
시장금리오르,-1,-0.21637171948706146,96,41,55,81,0.432556132355588,0.6698547637416543
경제지표호조보이,-1,-0.21637171948706146,96,41,55,86,0.432556132355588,0.6698547637416543
금리인상늦출,-1,-0.21705864826130794,43,18,25,32,0.3703637353959491,0.5743700311460805
달러화상승폭확대,-1,-0.21705864826130794,43,18,25,28,0.3703637353959491,0.5743700311460805
달러화오르,-1,-0.2174360746185855,36,15,21,59,0.35995214538100745,0.5586652287809533
금리하락세이,-1,-0.2174360746185855,36,15,21,25,0.35995214538100745,0.5586652287809533
기준금리인상가능,-1,-0.2174360746185855,36,15,21,37,0.35995214538100745,0.5586652287809533
집값하락,-1,-0.2174360746185855,36,15,21,30,0.35995214538100745,0.5586652287809533
달러약세이어질,-1,-0.22024201928873766,29,12,17,16,0.34768322706231064,0.5428084884161511
인플레이션둔화,-1,-0.22024201928873766,29,12,17,18,0.34768322706231064,0.5428084884161511
엔화강세나타내,-1,-0.22024201928873766,29,12,17,16,0.34768322706231064,0.5428084884161511
경제부담줄,-1,-0.22024201928873766,29,12,17,20,0.34768322706231064,0.5428084884161511
물가상승률감안,-1,-0.22024201928873766,29,12,17,20,0.34768322706231064,0.5428084884161511
기준금리상승,-1,-0.22024201928873766,29,12,17,18,0.34768322706231064,0.5428084884161511
고용지표개선,-1,-0.22102099174329692,64,27,37,75,0.3956277797805943,0.6186711164458787
투자증가,-1,-0.22102099174329692,64,27,37,77,0.3956277797805943,0.6186711164458787
금리인하기대약화,-1,-0.2246300907644757,78,33,45,57,0.4094186794428038,0.6451109287919404
수요늘어날,-1,-0.22493405393994237,131,56,75,116,0.45459133232377064,0.7167464478255703
기준금리인하나설,-1,-0.22836963441966662,22,9,13,25,0.33202137172336305,0.5272922825560956
통화완화나서,-1,-0.22836963441966662,22,9,13,14,0.33202137172336305,0.5272922825560956
국채선물상승거래마쳤,-1,-0.22836963441966662,22,9,13,19,0.33202137172336305,0.5272922825560956
높성장률기록,-1,-0.22836963441966662,22,9,13,17,0.33202137172336305,0.5272922825560956
성장기여,-1,-0.22836963441966662,22,9,13,24,0.33202137172336305,0.5272922825560956
수익올린,-1,-0.22836963441966662,22,9,13,14,0.33202137172336305,0.5272922825560956
기준금리인하기대,-1,-0.22836963441966662,22,9,13,27,0.33202137172336305,0.5272922825560956
이자부담줄어들,-1,-0.22836963441966662,22,9,13,30,0.33202137172336305,0.5272922825560956
경제성장률떨어지,-1,-0.22836963441966662,22,9,13,13,0.33202137172336305,0.5272922825560956
엔화가치하락,-1,-0.22836963441966662,22,9,13,18,0.33202137172336305,0.5272922825560956
환율하락요인작용,-1,-0.22836963441966662,22,9,13,15,0.33202137172336305,0.5272922825560956
신용위험나타내,-1,-0.22836963441966662,22,9,13,8,0.33202137172336305,0.5272922825560956
투자부진,-1,-0.22836963441966662,22,9,13,17,0.33202137172336305,0.5272922825560956
소비자물가하회,-1,-0.22836963441966662,22,9,13,9,0.33202137172336305,0.5272922825560956
장기물금리하락,-1,-0.22894121599710293,48,20,28,45,0.37046915166977235,0.5890613028425278
위험안,-1,-0.22894121599710293,48,20,28,34,0.37046915166977235,0.5890613028425278
금리인하기대심리약화,-1,-0.22894121599710293,48,20,28,25,0.37046915166977235,0.5890613028425278
기준금리올려야,-1,-0.22896362979045903,55,23,32,42,0.3797040136189974,0.6037736351365972
위험대비,-1,-0.22962118659645303,62,26,36,49,0.38807910364364495,0.6179468812016853
부양책나올,-1,-0.23008384053236863,41,17,24,33,0.3600761107075622,0.5739166495381545
금리내릴,-1,-0.2312383714342776,309,132,177,224,0.497860619785873,0.7954627534621
엔화상승,-1,-0.2329589063111257,83,35,48,58,0.4095344214864074,0.656719039998631
달러화강세보인,-1,-0.2333975988850533,34,14,20,42,0.34797731454415176,0.5585248085005662
베이시스축소,-1,-0.2333975988850533,34,14,20,14,0.34797731454415176,0.5585248085005662
시장금리반등,-1,-0.2333975988850533,34,14,20,24,0.34797731454415176,0.5585248085005662
유로화상승,-1,-0.23413385538026543,90,38,52,51,0.41573706106091396,0.6683219361349035
gdp증가,-1,-0.23798982361383592,118,50,68,72,0.4369392124771135,0.7081568571366615
금리반등,-1,-0.23868030295598697,125,53,72,131,0.4414656263428142,0.7165396368791254
장기금리상승,-1,-0.23868030295598697,125,53,72,123,0.4414656263428142,0.7165396368791254
연체율상승,-1,-0.23879049775569106,60,25,35,48,0.38019107376351996,0.6172293709530424
저성장지속,-1,-0.2393551316996737,53,22,31,40,0.371038409855853,0.6030910732496944
지표금리상승거래,-1,-0.24099891118022254,46,19,27,68,0.36078942122907276,0.5884785713185609
국채금리상승마감,-1,-0.24099891118022254,46,19,27,62,0.36078942122907276,0.5884785713185609
완화위한,-1,-0.24099891118022254,46,19,27,32,0.36078942122907276,0.5884785713185609
원자재가격상승,-1,-0.24099891118022254,46,19,27,31,0.36078942122907276,0.5884785713185609
기준금리인상어려울,-1,-0.2410121368978747,27,11,16,20,0.33303971605582383,0.5432316473962919
주택담보대출금리상승,-1,-0.2410121368978747,27,11,16,12,0.33303971605582383,0.5432316473962919
통화긴축지속,-1,-0.2410121368978747,27,11,16,13,0.33303971605582383,0.5432316473962919
채권시장강세이끌,-1,-0.2410121368978747,27,11,16,23,0.33303971605582383,0.5432316473962919
금리인하,-1,-0.24165147576667378,1589,674,915,1039,0.4926481081792956,0.80466406314007
수익성악화,-1,-0.24435188242332628,144,61,83,128,0.4494840321256474,0.7383816871881975
금리상승이어질,-1,-0.24453664203878078,39,16,23,32,0.34899737072109366,0.5735340631170938
금리폭등,-1,-0.24453664203878078,39,16,23,22,0.34899737072109366,0.5735340631170938
실업률하락,-1,-0.24851072917891148,121,51,70,113,0.43221411450354935,0.7163173285771486
채권시장부담작용,-1,-0.24859585352047453,58,24,34,33,0.3719301192148392,0.6165191118282678
차입금늘,-1,-0.25051761513294357,15,6,9,11,0.3084246599010987,0.5133476333132712
대출한도늘리,-1,-0.25051761513294357,15,6,9,14,0.3084246599010987,0.5133476333132712
비용내,-1,-0.25051761513294357,15,6,9,2,0.3084246599010987,0.5133476333132712
수요강화,-1,-0.25051761513294357,15,6,9,13,0.3084246599010987,0.5133476333132712
은행수익성개선,-1,-0.25051761513294357,15,6,9,6,0.3084246599010987,0.5133476333132712
신용경색우려부각,-1,-0.25051761513294357,15,6,9,8,0.3084246599010987,0.5133476333132712
기준금리인하인해,-1,-0.25051761513294357,15,6,9,13,0.3084246599010987,0.5133476333132712
고용지표호조보여,-1,-0.25051761513294357,15,6,9,9,0.3084246599010987,0.5133476333132712
금리인하기대확산,-1,-0.25051761513294357,15,6,9,3,0.3084246599010987,0.5133476333132712
소비투자심리위축,-1,-0.25051761513294357,15,6,9,10,0.3084246599010987,0.5133476333132712
고용호조보이,-1,-0.25051761513294357,15,6,9,5,0.3084246599010987,0.5133476333132712
달러원올라서,-1,-0.25051761513294357,15,6,9,3,0.3084246599010987,0.5133476333132712
경제회복따른,-1,-0.25051761513294357,15,6,9,8,0.3084246599010987,0.5133476333132712
금융시장영향줄,-1,-0.25051761513294357,15,6,9,13,0.3084246599010987,0.5133476333132712
성장세보인,-1,-0.25051761513294357,15,6,9,14,0.3084246599010987,0.5133476333132712
설비투자부진,-1,-0.25051761513294357,15,6,9,12,0.3084246599010987,0.5133476333132712
국채선물상승나타내,-1,-0.25051761513294357,15,6,9,12,0.3084246599010987,0.5133476333132712
가동률하락,-1,-0.25051761513294357,15,6,9,14,0.3084246599010987,0.5133476333132712
가산금리낮추,-1,-0.25051761513294357,15,6,9,14,0.3084246599010987,0.5133476333132712
안정적수익내,-1,-0.25051761513294357,15,6,9,7,0.3084246599010987,0.5133476333132712
금리하락세이어지,-1,-0.25051761513294357,15,6,9,17,0.3084246599010987,0.5133476333132712
인플레이션낮출,-1,-0.25051761513294357,15,6,9,13,0.3084246599010987,0.5133476333132712
물가상승률넘,-1,-0.25051761513294357,15,6,9,7,0.3084246599010987,0.5133476333132712
금리하락마감,-1,-0.2505862522357263,51,21,30,50,0.3618930403901415,0.602429473029393
국채선물상승,-1,-0.25155679586174384,32,13,19,37,0.3348140063932036,0.5585060640821736
엔화강세지속,-1,-0.25155679586174384,32,13,19,20,0.3348140063932036,0.5585060640821736
듀레이션축소,-1,-0.25155679586174384,32,13,19,30,0.3348140063932036,0.5585060640821736
침체빠질,-1,-0.25155679586174384,32,13,19,24,0.3348140063932036,0.5585060640821736
성장세회복이어지,-1,-0.25155679586174384,32,13,19,25,0.3348140063932036,0.5585060640821736
물가상승압력커지,-1,-0.25155679586174384,32,13,19,19,0.3348140063932036,0.5585060640821736
미국채금리급등,-1,-0.25421601068485156,44,18,26,45,0.35046385076341846,0.5879374926888347
금리인하지속,-1,-0.25421601068485156,44,18,26,23,0.35046385076341846,0.5879374926888347
국고채금리급등,-1,-0.25421601068485156,44,18,26,22,0.35046385076341846,0.5879374926888347
금리인상가능성반영,-1,-0.25687239694014197,63,26,37,69,0.373046951670308,0.6293844240552157
달러화강세보였,-1,-0.25687239694014197,63,26,37,51,0.373046951670308,0.6293844240552157
투자늘렸,-1,-0.2582723825922697,20,8,12,24,0.31247383942538487,0.5287696130912409
국채금리넘어서,-1,-0.2582723825922697,20,8,12,10,0.31247383942538487,0.5287696130912409
유가하락부추겼,-1,-0.2582723825922697,20,8,12,14,0.31247383942538487,0.5287696130912409
금리상승세타,-1,-0.2582723825922697,20,8,12,6,0.31247383942538487,0.5287696130912409
금리상승압력가중,-1,-0.2582723825922697,20,8,12,8,0.31247383942538487,0.5287696130912409
글로벌경제성장,-1,-0.2582723825922697,20,8,12,16,0.31247383942538487,0.5287696130912409
국채선물하락보이,-1,-0.2582723825922697,20,8,12,23,0.31247383942538487,0.5287696130912409
기준금리인하통한,-1,-0.2582723825922697,20,8,12,21,0.31247383942538487,0.5287696130912409
경상수지흑자따른,-1,-0.2582723825922697,20,8,12,30,0.31247383942538487,0.5287696130912409
금리인상연기,-1,-0.2582723825922697,20,8,12,33,0.31247383942538487,0.5287696130912409
유로화올랐,-1,-0.2582723825922697,20,8,12,16,0.31247383942538487,0.5287696130912409
물가상승이어질,-1,-0.2582723825922697,20,8,12,5,0.31247383942538487,0.5287696130912409
경상수지적자기록,-1,-0.2582723825922697,20,8,12,13,0.31247383942538487,0.5287696130912409
채권금리상승제한,-1,-0.2582723825922697,20,8,12,20,0.31247383942538487,0.5287696130912409
신규실업수당청구줄어든,-1,-0.2582723825922697,20,8,12,13,0.31247383942538487,0.5287696130912409
엔화약세나타냈,-1,-0.2582723825922697,20,8,12,12,0.31247383942538487,0.5287696130912409
경기하강,-1,-0.2591153321028926,56,23,33,18,0.3632578115033496,0.6158163517978175
부채줄이,-1,-0.26069113529959975,37,15,22,49,0.33699511796018955,0.5732253371081178
cd금리오를,-1,-0.26069113529959975,37,15,22,9,0.33699511796018955,0.5732253371081178
듀레이션확대,-1,-0.26277638615995336,49,20,29,38,0.3522098630033063,0.6017894440934185
불확실성커졌,-1,-0.26433812984845984,68,28,40,66,0.37432002410061477,0.6417140069003682
시장변동성확대,-1,-0.2643948981451786,115,48,67,115,0.41751124678305895,0.7158459376928318
높변동성보이,-1,-0.2655738224468712,25,10,15,28,0.3164032935235332,0.5438660131663406
위험피하,-1,-0.2655738224468712,25,10,15,28,0.3164032935235332,0.5438660131663406
장기시장금리하락,-1,-0.2655738224468712,25,10,15,16,0.3164032935235332,0.5438660131663406
신용등급하락,-1,-0.2655738224468712,25,10,15,41,0.3164032935235332,0.5438660131663406
내수부진따른,-1,-0.2655738224468712,25,10,15,19,0.3164032935235332,0.5438660131663406
기대심리커질,-1,-0.2655738224468712,25,10,15,29,0.3164032935235332,0.5438660131663406
수익확보,-1,-0.2655738224468712,25,10,15,37,0.3164032935235332,0.5438660131663406
주택시장냉각,-1,-0.2655738224468712,25,10,15,13,0.3164032935235332,0.5438660131663406
위험부각,-1,-0.2667742699379577,61,25,36,58,0.3647966356910978,0.6286691053814873
경쟁력확보,-1,-0.2667742699379577,61,25,36,42,0.3647966356910978,0.6286691053814873
국고금리상승,-1,-0.26878746799440456,42,17,25,44,0.33939929384293355,0.5874391124101233
투자줄이,-1,-0.26878746799440456,42,17,25,28,0.33939929384293355,0.5874391124101233
국채금리하락,-1,-0.26925181100610884,153,64,89,162,0.43727432089373397,0.7576000137945978
달러화상승,-1,-0.27020364314242906,172,72,100,166,0.4449304238978595,0.7724462252535875
높금리받,-1,-0.2704404994172608,54,22,32,43,0.35413005610691445,0.615120957493297
금리상승이어지,-1,-0.2724416731049104,30,12,18,22,0.32021403807638255,0.5586135427588091
유로화약세보였,-1,-0.2724416731049104,30,12,18,11,0.32021403807638255,0.5586135427588091
국채선물상승마감,-1,-0.2724416731049104,30,12,18,18,0.32021403807638255,0.5586135427588091
인플레이션압력완화,-1,-0.27557513513044474,182,76,106,59,0.4448238901961023,0.7812624283638633
침체지속,-1,-0.2760687103723173,47,19,28,32,0.3419211023557973,0.601170944284628
금리급락,-1,-0.2761750729480703,137,57,80,84,0.4240903919837184,0.7458136957040595
수요늘,-1,-0.2764911912045904,194,81,113,155,0.4479675946286294,0.7883431541126489
시장금리급등,-1,-0.2772211932094527,104,43,61,49,0.40077718229874054,0.7064106688203818
기준금리낮출,-1,-0.27736211490600093,59,24,35,40,0.3561550158633256,0.6279509244017305
달러강세이어지,-1,-0.27736211490600093,59,24,35,55,0.3561550158633256,0.6279509244017305
금리인하필요,-1,-0.2788953730490321,35,14,21,31,0.3239073176501895,0.572991803947558
국채가격떨어졌,-1,-0.28267931858747797,52,21,31,27,0.34449615407454465,0.6144322808497628
경기둔화우려,-1,-0.28267931858747797,52,21,31,22,0.34449615407454465,0.6144322808497628
금리상승세지속,-1,-0.28291035263823283,83,34,49,63,0.3786396976220261,0.675668293083144
국고채금리올랐,-1,-0.28365235457960913,64,26,38,60,0.35823746309216575,0.6402917938524031
금리끌어내렸,-1,-0.28495397608480166,40,16,24,31,0.3274845804790297,0.5869832337502815
내수부진,-1,-0.28495397608480166,40,16,24,29,0.3274845804790297,0.5869832337502815
금리떨어진,-1,-0.2856631394386576,95,39,56,58,0.3879061435858071,0.6963553446681526
수출증가,-1,-0.28604186760348616,152,63,89,135,0.42532971427662813,0.7641658059715544
금리인하단행,-1,-0.2868767680104609,698,289,409,374,0.4585173926493491,0.8252895697641264
금리낮출,-1,-0.2921524730406574,112,46,66,86,0.39728785195722627,0.7233507125488146
위험남,-1,-0.29426112884002387,62,25,37,50,0.34965525263616976,0.6395640506611303
장기물강세보였,-1,-0.29513380574305415,23,9,14,18,0.29723326707963243,0.5447158976535225
장기금리급등,-1,-0.29513380574305415,23,9,14,23,0.29723326707963243,0.5447158976535225
적자내,-1,-0.29513380574305415,23,9,14,17,0.29723326707963243,0.5447158976535225
경쟁력강화위한,-1,-0.29513380574305415,23,9,14,14,0.29723326707963243,0.5447158976535225
국고채수익률오른,-1,-0.29513380574305415,23,9,14,19,0.29723326707963243,0.5447158976535225
안전자산선호심리강해,-1,-0.29513380574305415,23,9,14,22,0.29723326707963243,0.5447158976535225
금리인상단행어려울,-1,-0.29513380574305415,23,9,14,16,0.29723326707963243,0.5447158976535225
손실커질,-1,-0.29513380574305415,23,9,14,9,0.29723326707963243,0.5447158976535225
채권가격떨어지,-1,-0.29513380574305415,23,9,14,23,0.29723326707963243,0.5447158976535225
위험경고,-1,-0.29513380574305415,23,9,14,11,0.29723326707963243,0.5447158976535225
경제약화,-1,-0.29513380574305415,23,9,14,9,0.29723326707963243,0.5447158976535225
부동산가격상승따른,-1,-0.29513380574305415,23,9,14,10,0.29723326707963243,0.5447158976535225
원자재가격하락,-1,-0.29595978109307075,50,20,30,34,0.33429772585171613,0.6137489867350977
경기회복힘입,-1,-0.29609513159527123,18,7,11,19,0.28893848182745524,0.5306294920653979
물가전망하향조정,-1,-0.29609513159527123,18,7,11,28,0.28893848182745524,0.5306294920653979
생산자물가하락,-1,-0.29609513159527123,18,7,11,20,0.28893848182745524,0.5306294920653979
비농업고용창출감소,-1,-0.29609513159527123,18,7,11,4,0.28893848182745524,0.5306294920653979
잠재성장률높이,-1,-0.29609513159527123,18,7,11,14,0.28893848182745524,0.5306294920653979
달러화레벨낮췄,-1,-0.29609513159527123,18,7,11,19,0.28893848182745524,0.5306294920653979
기준금리인상하,-1,-0.29609513159527123,18,7,11,12,0.28893848182745524,0.5306294920653979
완화적스탠스유지,-1,-0.29609513159527123,18,7,11,11,0.28893848182745524,0.5306294920653979
금리인상멈추,-1,-0.29609513159527123,18,7,11,19,0.28893848182745524,0.5306294920653979
gdp갭마이너스지속,-1,-0.29609513159527123,18,7,11,12,0.28893848182745524,0.5306294920653979
경제부담주,-1,-0.29609513159527123,18,7,11,17,0.28893848182745524,0.5306294920653979
금가격오르,-1,-0.29609513159527123,18,7,11,14,0.28893848182745524,0.5306294920653979
금리하락고시,-1,-0.29609513159527123,18,7,11,8,0.28893848182745524,0.5306294920653979
환율방어위한,-1,-0.29609513159527123,18,7,11,17,0.28893848182745524,0.5306294920653979
확장국면진입,-1,-0.29609513159527123,18,7,11,20,0.28893848182745524,0.5306294920653979
가계부채증가따른,-1,-0.29609513159527123,18,7,11,17,0.28893848182745524,0.5306294920653979
금리인하기대반영,-1,-0.2967584971062358,28,11,17,23,0.30386218718357205,0.5588474268746684
금융시장변동성커지,-1,-0.2967584971062358,28,11,17,37,0.30386218718357205,0.5588474268746684
경제지표호조보였,-1,-0.2967584971062358,28,11,17,22,0.30386218718357205,0.5588474268746684
경제지표약화,-1,-0.2967584971062358,28,11,17,13,0.30386218718357205,0.5588474268746684
금리인하기대심리유지,-1,-0.2967584971062358,28,11,17,41,0.30386218718357205,0.5588474268746684
실적호전,-1,-0.2967584971062358,28,11,17,26,0.30386218718357205,0.5588474268746684
기준금리인상선반영,-1,-0.2967584971062358,28,11,17,20,0.30386218718357205,0.5588474268746684
장기금리낮추,-1,-0.2967584971062358,28,11,17,23,0.30386218718357205,0.5588474268746684
지급준비율올리,-1,-0.2967584971062358,28,11,17,13,0.30386218718357205,0.5588474268746684
기준금리내려갈,-1,-0.2967584971062358,28,11,17,17,0.30386218718357205,0.5588474268746684
엔화약세나타내,-1,-0.2967584971062358,28,11,17,19,0.30386218718357205,0.5588474268746684
물가안정목표달성,-1,-0.2967584971062358,28,11,17,14,0.30386218718357205,0.5588474268746684
조달금리상승,-1,-0.2967584971062358,28,11,17,10,0.30386218718357205,0.5588474268746684
환율상승따른,-1,-0.29715823418251275,98,40,58,51,0.38318103864460024,0.7053435983294065
물가상승압력완화,-1,-0.2993608669717758,67,27,40,28,0.35219365529683133,0.6514402250925981
수요확대,-1,-0.2993904417418517,122,50,72,99,0.3994729355915902,0.7389389732700817
원화가치상승,-1,-0.29959635559926334,33,13,20,30,0.3095351489963788,0.5728320611310643
무역수지흑자기록,-1,-0.29959635559926334,33,13,20,21,0.3095351489963788,0.5728320611310643
금가격하락,-1,-0.29959635559926334,33,13,20,16,0.3095351489963788,0.5728320611310643
기준금리내려,-1,-0.3030152590879396,38,15,23,30,0.3145868110342115,0.586567844851251
시장변동성커지,-1,-0.3030152590879396,38,15,23,29,0.3145868110342115,0.586567844851251
투자심리약화,-1,-0.3030152590879396,38,15,23,28,0.3145868110342115,0.586567844851251
수익증가,-1,-0.3030152590879396,38,15,23,31,0.3145868110342115,0.586567844851251
신용경색완화,-1,-0.30432151414645536,96,39,57,42,0.37698674890881567,0.7049388867431081
비용늘어나,-1,-0.3066885994912917,43,17,26,33,0.31919602821170984,0.5999934511538817
달러화엔화하락,-1,-0.3066885994912917,43,17,26,26,0.31919602821170984,0.5999934511538817
금리내렸,-1,-0.30716755181490907,241,99,142,190,0.4356268739347126,0.8197136288708038
경제회복세보이,-1,-0.30995288002950216,65,26,39,45,0.34369270531693824,0.650709149840983
경제상황악화,-1,-0.3104344446449091,48,19,29,23,0.3234675013074863,0.6130688300547441
변동성줄이,-1,-0.3104344446449091,48,19,29,43,0.3234675013074863,0.6130688300547441
신용등급하향조정,-1,-0.3115207884895633,106,43,63,89,0.3803625984670412,0.7226352091376825
채권금리오르,-1,-0.3140123982302835,70,28,42,87,0.3466128601477756,0.6621562846962614
금융시장안정위한,-1,-0.31414645598720736,53,21,32,31,0.3274669885926617,0.6257665007705824
성장위해,-1,-0.3177951901803332,75,30,45,45,0.34943101228973994,0.6731635531376433
유동성확보,-1,-0.3193069223188505,133,54,79,92,0.3929979224431919,0.7596404778657992
차입금증가,-1,-0.32131574044267797,80,32,48,56,0.35214949790513084,0.6837316373733379
채권시장강세지속,-1,-0.3233476603740477,36,14,22,32,0.300547177319816,0.5861883216061845
집값떨어지,-1,-0.3233476603740477,36,14,22,27,0.300547177319816,0.5861883216061845
금리인하있,-1,-0.3233476603740477,36,14,22,20,0.300547177319816,0.5861883216061845
지출늘리,-1,-0.32337447441594414,31,12,19,29,0.29363473284054653,0.572740501713291
채권스왑스프레드축소,-1,-0.32337447441594414,31,12,19,26,0.29363473284054653,0.572740501713291
미국채금리올랐,-1,-0.32337447441594414,31,12,19,30,0.29363473284054653,0.572740501713291
수익올리,-1,-0.32455780358253383,68,27,41,60,0.33820959151530067,0.6614280644952929
위험완화,-1,-0.3245879169910121,85,34,51,79,0.35477069197532857,0.6938628175799219
손실확대,-1,-0.3254662627933379,26,10,16,16,0.2853581298202158,0.5592005479811164
변동폭커지,-1,-0.3254662627933379,26,10,16,8,0.2853581298202158,0.5592005479811164
기준금리동결결정,-1,-0.3254662627933379,26,10,16,19,0.2853581298202158,0.5592005479811164
금리하락기대,-1,-0.3254662627933379,26,10,16,19,0.2853581298202158,0.5592005479811164
양적완화통한,-1,-0.3254662627933379,26,10,16,15,0.2853581298202158,0.5592005479811164
수요줄어든,-1,-0.32846498155730885,51,20,31,24,0.3168153210498783,0.62502088637568
금리내리않,-1,-0.33084023428613885,56,22,34,28,0.32132209794716265,0.6372931798701177
소비자물가상승률기록,-1,-0.33084023428613885,56,22,34,64,0.32132209794716265,0.6372931798701177
무역수지적자확대,-1,-0.3314368659115723,21,8,13,18,0.27480900676031295,0.5457711784627527
금융시장변동성커질,-1,-0.3314368659115723,21,8,13,25,0.27480900676031295,0.5457711784627527
달러화가치떨어질,-1,-0.3314368659115723,21,8,13,7,0.27480900676031295,0.5457711784627527
시장금리인하,-1,-0.3314368659115723,21,8,13,12,0.27480900676031295,0.5457711784627527
채권시장강세나타냈,-1,-0.3314368659115723,21,8,13,10,0.27480900676031295,0.5457711784627527
물가상승압력확대,-1,-0.3314368659115723,21,8,13,15,0.27480900676031295,0.5457711784627527
국제금융시장불안완화,-1,-0.3314368659115723,21,8,13,2,0.27480900676031295,0.5457711784627527
매출줄,-1,-0.3314368659115723,21,8,13,17,0.27480900676031295,0.5457711784627527
금리인하힘입,-1,-0.3314368659115723,21,8,13,6,0.27480900676031295,0.5457711784627527
부채늘,-1,-0.3314368659115723,21,8,13,14,0.27480900676031295,0.5457711784627527
수급양호,-1,-0.3314368659115723,21,8,13,44,0.27480900676031295,0.5457711784627527
소매판매증가,-1,-0.33329701034869286,61,24,37,77,0.3255174098701376,0.6491824717467365
경기회복위해,-1,-0.33544935670929144,105,42,63,64,0.36433078760128806,0.7301116741308898
채권가격상승,-1,-0.33576019553417424,66,26,40,60,0.32944994095404323,0.6606729671580255
금리급등따른,-1,-0.3376670310993103,110,44,66,71,0.3665017512052603,0.738138153749082
미국채금리오르,-1,-0.34405699227684694,49,19,30,47,0.3055176905531198,0.6242604745663798
금리인상마무리,-1,-0.34433646025788534,39,15,24,34,0.2929066073184186,0.5988712681290337
성장세약화,-1,-0.34433646025788534,39,15,24,44,0.2929066073184186,0.5988712681290337
자금사정악화,-1,-0.34433646025788534,39,15,24,17,0.2929066073184186,0.5988712681290337
금리인하인해,-1,-0.34433646025788534,39,15,24,19,0.2929066073184186,0.5988712681290337
인플레이션압력증가,-1,-0.3449579038429804,54,21,33,29,0.31087166458369475,0.6364976426083865
소비자물가오를,-1,-0.34550454624876226,16,6,10,14,0.25992896087015305,0.5328541363464783
투자매력높이,-1,-0.34550454624876226,16,6,10,16,0.25992896087015305,0.5328541363464783
인플레이션기대심리잡,-1,-0.34550454624876226,16,6,10,12,0.25992896087015305,0.5328541363464783
금리인하이어지,-1,-0.34550454624876226,16,6,10,13,0.25992896087015305,0.5328541363464783
성장중시,-1,-0.34550454624876226,16,6,10,11,0.25992896087015305,0.5328541363464783
이익늘어날,-1,-0.34550454624876226,16,6,10,13,0.25992896087015305,0.5328541363464783
하방위험커지,-1,-0.34550454624876226,16,6,10,27,0.25992896087015305,0.5328541363464783
침체보이,-1,-0.34550454624876226,16,6,10,10,0.25992896087015305,0.5328541363464783
경기상승,-1,-0.34550454624876226,16,6,10,8,0.25992896087015305,0.5328541363464783
기준금리올려도,-1,-0.34550454624876226,16,6,10,22,0.25992896087015305,0.5328541363464783
부양책사용,-1,-0.34550454624876226,16,6,10,13,0.25992896087015305,0.5328541363464783
디플레이션벗어나,-1,-0.34550454624876226,16,6,10,24,0.25992896087015305,0.5328541363464783
금리상승세진정,-1,-0.34550454624876226,16,6,10,19,0.25992896087015305,0.5328541363464783
내수부진지속,-1,-0.34550454624876226,16,6,10,14,0.25992896087015305,0.5328541363464783
재할인율인상,-1,-0.34550454624876226,16,6,10,24,0.25992896087015305,0.5328541363464783
원화강세이어지,-1,-0.34550454624876226,16,6,10,22,0.25992896087015305,0.5328541363464783
단기물강세보였,-1,-0.34550454624876226,16,6,10,9,0.25992896087015305,0.5328541363464783
엔화약세진행,-1,-0.34550454624876226,16,6,10,13,0.25992896087015305,0.5328541363464783
실물경제개선,-1,-0.34550454624876226,16,6,10,5,0.25992896087015305,0.5328541363464783
유로화내려앉,-1,-0.34550454624876226,16,6,10,12,0.25992896087015305,0.5328541363464783
양적완화줄어들,-1,-0.34550454624876226,16,6,10,9,0.25992896087015305,0.5328541363464783
금리인상신호나올,-1,-0.34550454624876226,16,6,10,13,0.25992896087015305,0.5328541363464783
미국채가격영향하락출발예상,-1,-0.34550454624876226,16,6,10,29,0.25992896087015305,0.5328541363464783
미국채수익률급등,-1,-0.34550454624876226,16,6,10,9,0.25992896087015305,0.5328541363464783
교역조건악화,-1,-0.34550454624876226,16,6,10,8,0.25992896087015305,0.5328541363464783
경기침체겪,-1,-0.34642726690659986,34,13,21,27,0.2851766419108303,0.5858363182776772
이중침체빠질,-1,-0.34642726690659986,34,13,21,23,0.2851766419108303,0.5858363182776772
매출액증가,-1,-0.35099062511306445,29,11,18,25,0.2759085606242572,0.5727051599839041
달러강세나타나,-1,-0.35099062511306445,29,11,18,39,0.2759085606242572,0.5727051599839041
금리변동성커지,-1,-0.35099062511306445,29,11,18,19,0.2759085606242572,0.5727051599839041
순이자마진개선,-1,-0.35099062511306445,29,11,18,14,0.2759085606242572,0.5727051599839041
금리인하예상,-1,-0.3537067213548397,111,44,67,74,0.3569031082804996,0.7454259847922623
순이익감소,-1,-0.35855254540814596,99,39,60,76,0.34524054986856684,0.7290995545818639
금리하락반전,-1,-0.35988396423394997,24,9,15,16,0.2641978050171953,0.5596536936156766
달러강세완화,-1,-0.35988396423394997,24,9,15,24,0.2641978050171953,0.5596536936156766
소비자물가올랐,-1,-0.35988396423394997,24,9,15,13,0.2641978050171953,0.5596536936156766
경기모멘텀약화,-1,-0.35988396423394997,24,9,15,21,0.2641978050171953,0.5596536936156766
수주감소,-1,-0.35988396423394997,24,9,15,22,0.2641978050171953,0.5596536936156766
인플레이션압력높일,-1,-0.35988396423394997,24,9,15,10,0.2641978050171953,0.5596536936156766
듀레이션줄여,-1,-0.35988396423394997,24,9,15,10,0.2641978050171953,0.5596536936156766
금리인하압박,-1,-0.35988396423394997,24,9,15,24,0.2641978050171953,0.5596536936156766
금리올리어렵,-1,-0.35988396423394997,24,9,15,15,0.2641978050171953,0.5596536936156766
물가하락,-1,-0.36105654537668386,67,26,41,61,0.31554158806456656,0.6702163617616893
국채금리급등,-1,-0.36105654537668386,67,26,41,71,0.31554158806456656,0.6702163617616893
금리인하결정,-1,-0.36105654537668386,67,26,41,34,0.31554158806456656,0.6702163617616893
금리인하가능성열,-1,-0.36106347548749096,109,43,66,57,0.35084276084051186,0.7452085803619142
국채가격상승견인,-1,-0.3611109251076706,47,18,29,16,0.2935010738386881,0.6234797029280853
실업률상승,-1,-0.3628278663662464,77,30,47,59,0.3241603470681276,0.691329729899028
금리인상예고,-1,-0.36304657099872817,42,16,26,33,0.2863522867908117,0.611004407165447
시장금리인상,-1,-0.36304657099872817,42,16,26,38,0.2863522867908117,0.611004407165447
소비위축,-1,-0.3632125087820347,166,66,100,105,0.37833541647083957,0.8075815237822488
수급상황개선,-1,-0.3666392125942075,37,14,23,14,0.2780944159879448,0.5983128854292867
지표물국고채금리오른,-1,-0.3666392125942075,37,14,23,32,0.2780944159879448,0.5983128854292867
기준금리인하단행,-1,-0.36949545095108094,112,44,68,78,0.3474627271808554,0.7525028003993158
금리내려갔,-1,-0.3728597540297368,32,12,20,38,0.26825233900483564,0.5854982237076831
기준금리낮춰,-1,-0.3728597540297368,32,12,20,19,0.26825233900483564,0.5854982237076831
경제지표양호,-1,-0.3728597540297368,32,12,20,40,0.26825233900483564,0.5854982237076831
기준금리인하,-1,-0.3741347800822339,2139,844,1295,1510,0.39313737232124235,0.860618640998329
양적완화발표,-1,-0.37507505041125433,55,21,34,51,0.2947659380467123,0.6466834875040588
수요줄어드,-1,-0.3770504580017193,19,7,12,18,0.24818459002944077,0.5469952807637963
cd금리떨어지,-1,-0.3770504580017193,19,7,12,16,0.24818459002944077,0.5469952807637963
국고채금리내렸으며,-1,-0.3770504580017193,19,7,12,9,0.24818459002944077,0.5469952807637963
비용늘,-1,-0.3770504580017193,19,7,12,13,0.24818459002944077,0.5469952807637963
기준금리인상앞당길,-1,-0.3770504580017193,19,7,12,9,0.24818459002944077,0.5469952807637963
금리인하기대강화,-1,-0.3770504580017193,19,7,12,9,0.24818459002944077,0.5469952807637963
엔화강세보인,-1,-0.3770504580017193,19,7,12,12,0.24818459002944077,0.5469952807637963
단기물하락,-1,-0.3770504580017193,19,7,12,19,0.24818459002944077,0.5469952807637963
국채매입늘리,-1,-0.3770504580017193,19,7,12,20,0.24818459002944077,0.5469952807637963
금리올리못할,-1,-0.3770504580017193,19,7,12,16,0.24818459002944077,0.5469952807637963
경기둔화따른,-1,-0.379075061298104,140,55,85,96,0.35690702429800203,0.790335332925412
매수심리강화,-1,-0.37985092763831774,45,17,28,21,0.28068349717243013,0.6226712337376537
수익성떨어지,-1,-0.3834489223891263,27,10,17,25,0.2559990871603638,0.5727045555756084
회사채신용스프레드축소,-1,-0.3834489223891263,27,10,17,37,0.2559990871603638,0.5727045555756084
irs금리하락,-1,-0.3834489223891263,27,10,17,12,0.2559990871603638,0.5727045555756084
금리하락확대,-1,-0.3834489223891263,27,10,17,23,0.2559990871603638,0.5727045555756084
금리인하단행않,-1,-0.39187641467670953,35,13,22,31,0.26195293914880213,0.5977393817036284
달러화강세지지받,-1,-0.39187641467670953,35,13,22,24,0.26195293914880213,0.5977393817036284
소비감소,-1,-0.39187641467670953,35,13,22,28,0.26195293914880213,0.5977393817036284
금융안정유의,-1,-0.39891973856741103,66,25,41,53,0.2924323271771221,0.6784997927695281
유동성개선,-1,-0.40054388039655553,43,16,27,26,0.26697393924425106,0.6218254796515796
영업이익증가,-1,-0.40054388039655553,43,16,27,40,0.26697393924425106,0.6218254796515796
금리인하이,-1,-0.40054388039655553,43,16,27,39,0.26697393924425106,0.6218254796515796
통화완화지속,-1,-0.40054388039655553,43,16,27,50,0.26697393924425106,0.6218254796515796
자금사정개선,-1,-0.4018384266483579,22,8,14,15,0.23976272536408702,0.5601682464405182
장기물상승,-1,-0.4018384266483579,22,8,14,25,0.23976272536408702,0.5601682464405182
금리인하그칠,-1,-0.4018384266483579,22,8,14,8,0.23976272536408702,0.5601682464405182
디플레이션우려,-1,-0.4018384266483579,22,8,14,18,0.23976272536408702,0.5601682464405182
금리하락주도,-1,-0.4018384266483579,22,8,14,15,0.23976272536408702,0.5601682464405182
달러화상승압력가했,-1,-0.4018384266483579,22,8,14,14,0.23976272536408702,0.5601682464405182
안전자산선호심리부각,-1,-0.4018384266483579,22,8,14,12,0.23976272536408702,0.5601682464405182
산업생산부진,-1,-0.4034172762698116,30,11,19,23,0.24951666092871164,0.5851530164371741
경기회복조짐보이,-1,-0.4034172762698116,30,11,19,9,0.24951666092871164,0.5851530164371741
하방위험상존,-1,-0.4034172762698116,30,11,19,29,0.24951666092871164,0.5851530164371741
금리하락세지속,-1,-0.4061156309349684,79,30,49,99,0.3000449186058694,0.7081951416482706
금리인상가능성있,-1,-0.4086171846870865,38,14,24,40,0.25670122701516446,0.6095283772576959
통화긴축중단,-1,-0.4086171846870865,38,14,24,30,0.25670122701516446,0.6095283772576959
금리빠지,-1,-0.4086171846870865,38,14,24,36,0.25670122701516446,0.6095283772576959
장기물금리상승,-1,-0.4088528015925055,51,19,32,36,0.2714115964975314,0.644821539213453
가계부채늘어나,-1,-0.412873704379514,64,24,40,45,0.28245961687700766,0.6775788772509574
금리인하따른,-1,-0.4137439324363148,199,77,122,135,0.35244772689298437,0.8472425006291866
금리인하가능성시사,-1,-0.416580315072558,59,22,37,40,0.2754296518241686,0.6666435102466189
금리상승세보였,-1,-0.42064849428162465,33,12,21,25,0.24429370402541983,0.5971312121072763
경기침체빠질,-1,-0.42064849428162465,33,12,21,22,0.24429370402541983,0.5971312121072763
금가격상승,-1,-0.42064849428162465,33,12,21,22,0.24429370402541983,0.5971312121072763
유로화급등,-1,-0.42064849428162465,33,12,21,22,0.24429370402541983,0.5971312121072763
수입줄,-1,-0.42064849428162465,33,12,21,21,0.24429370402541983,0.5971312121072763
임금오르,-1,-0.4220744401770016,25,9,16,12,0.23349069183532184,0.5727030854314005
시장기준금리인하,-1,-0.4220744401770016,25,9,16,20,0.23349069183532184,0.5727030854314005
수요계속,-1,-0.4220744401770016,25,9,16,26,0.23349069183532184,0.5727030854314005
시장금리상승따른,-1,-0.4220744401770016,25,9,16,22,0.23349069183532184,0.5727030854314005
경기회복이끌,-1,-0.4220744401770016,25,9,16,12,0.23349069183532184,0.5727030854314005
위험헤지,-1,-0.4235070946640612,41,15,26,25,0.2522731151944925,0.6209300071715284
금리끌어올리,-1,-0.4235070946640612,41,15,26,30,0.2522731151944925,0.6209300071715284
기준금리내릴,-1,-0.4252611510638796,154,59,95,131,0.33206967781457597,0.8208329810502831
유가급등따른,-1,-0.42777286772055134,62,23,39,35,0.2720487192165479,0.6766012692833558
원달러하락,-1,-0.43305045040486834,57,21,36,53,0.264195474297501,0.6656172891690602
금리인하인한,-1,-0.43573900491197637,36,13,23,25,0.24001946131789278,0.6087195018525893
신용등급상향,-1,-0.43573900491197637,36,13,23,32,0.24001946131789278,0.6087195018525893
자산매입줄이,-1,-0.4357683796723276,17,6,11,20,0.2161820348250876,0.5483044604026396
원화강세베팅하,-1,-0.4357683796723276,17,6,11,11,0.2161820348250876,0.5483044604026396
주택시장안정,-1,-0.4357683796723276,17,6,11,2,0.2161820348250876,0.5483044604026396
주문증가,-1,-0.4357683796723276,17,6,11,12,0.2161820348250876,0.5483044604026396
경기뚜렷회복세보이,-1,-0.4357683796723276,17,6,11,5,0.2161820348250876,0.5483044604026396
경기둔화우려완화,-1,-0.4357683796723276,17,6,11,16,0.2161820348250876,0.5483044604026396
양적완화할,-1,-0.4357683796723276,17,6,11,14,0.2161820348250876,0.5483044604026396
성장이어질,-1,-0.4357683796723276,17,6,11,10,0.2161820348250876,0.5483044604026396
금리상승마쳤,-1,-0.4357683796723276,17,6,11,7,0.2161820348250876,0.5483044604026396
금리인상나타날,-1,-0.4357683796723276,17,6,11,11,0.2161820348250876,0.5483044604026396
경기회복않,-1,-0.4357683796723276,17,6,11,7,0.2161820348250876,0.5483044604026396
부동산가격하락,-1,-0.4368665615112912,44,16,28,16,0.24850270457335766,0.631987711135909
수요줄,-1,-0.43825526145822635,96,36,60,65,0.29379670194513685,0.7497434510755935
물가상승률하락,-1,-0.4390796437785002,28,10,18,23,0.2286832022041755,0.584769298999709
소비자물가올라,-1,-0.4390796437785002,28,10,18,18,0.2286832022041755,0.584769298999709
금리인하반영,-1,-0.4390796437785002,28,10,18,34,0.2286832022041755,0.584769298999709
금리인하될,-1,-0.4390796437785002,28,10,18,20,0.2286832022041755,0.584769298999709
달러화가치상승,-1,-0.43990256025174823,52,19,33,49,0.25536017399390953,0.6543155065806863
위험관리,-1,-0.443012080460626,73,27,46,53,0.2732998003144263,0.7056996406810258
금리상승확대,-1,-0.443012080460626,73,27,46,52,0.2732998003144263,0.7056996406810258
회사채수익률오른,-1,-0.44911588370721045,39,14,25,26,0.23647585955111347,0.619968789886846
집값오르,-1,-0.4535775280657829,63,23,40,43,0.25845943551244316,0.6852200898636518
물가상승률목표달성,-1,-0.4538417204789803,20,7,13,11,0.21134162617640517,0.5606747205775063
달러강세심화,-1,-0.4538417204789803,20,7,13,28,0.21134162617640517,0.5606747205775063
수급부담덜,-1,-0.4538417204789803,20,7,13,4,0.21134162617640517,0.5606747205775063
소비자물가상승률상승,-1,-0.4538417204789803,20,7,13,18,0.21134162617640517,0.5606747205775063
경쟁력강화위해,-1,-0.4538417204789803,20,7,13,10,0.21134162617640517,0.5606747205775063
침체인해,-1,-0.4538417204789803,20,7,13,11,0.21134162617640517,0.5606747205775063
비용낮추,-1,-0.4538417204789803,20,7,13,9,0.21134162617640517,0.5606747205775063
시장불확실성커지,-1,-0.4538417204789803,20,7,13,8,0.21134162617640517,0.5606747205775063
물가올라,-1,-0.4538417204789803,20,7,13,24,0.21134162617640517,0.5606747205775063
금리내려왔,-1,-0.4538417204789803,20,7,13,11,0.21134162617640517,0.5606747205775063
안전자산선호심리약화,-1,-0.4538417204789803,20,7,13,17,0.21134162617640517,0.5606747205775063
높금리제공,-1,-0.4599259268292648,50,18,32,42,0.24246344828857946,0.6531820738971397
성장위한,-1,-0.4650679579416812,74,27,47,85,0.2614518349334012,0.7135868091658648
수급악화,-1,-0.4664739802142872,34,12,22,20,0.22190861303740064,0.607833815557697
채권시장안정,-1,-0.4664739802142872,34,12,22,23,0.22190861303740064,0.607833815557697
집값오를,-1,-0.4664739802142872,34,12,22,29,0.22190861303740064,0.607833815557697
재정지출확대따른,-1,-0.46859173834820367,23,8,15,6,0.20793440834589053,0.5726443575656417
부채늘리,-1,-0.46859173834820367,23,8,15,9,0.20793440834589053,0.5726443575656417
성장계속,-1,-0.46859173834820367,23,8,15,11,0.20793440834589053,0.5726443575656417
채권매수심리위축,-1,-0.47007041148805295,61,22,39,46,0.24746903618101332,0.6841044193483758
마이너스성장기록,-1,-0.47190773144725495,45,16,29,20,0.23099297441316421,0.6415725186501392
재무안정성유지,-1,-0.47190773144725495,45,16,29,12,0.23099297441316421,0.6415725186501392
순이자마진하락,-1,-0.47780912945397236,37,13,24,26,0.21947628500265828,0.6189212814241417
경제성장지속,-1,-0.47920268134067123,56,20,36,39,0.2378865902612902,0.6732610224009659
국채수익률급등,-1,-0.48106822381605907,26,9,17,14,0.20545800963216035,0.5843012427412594
기준금리인하통해,-1,-0.48106822381605907,26,9,17,19,0.20545800963216035,0.5843012427412594
연체율하락,-1,-0.48106822381605907,26,9,17,15,0.20545800963216035,0.5843012427412594
경기과열막,-1,-0.48106822381605907,26,9,17,28,0.20545800963216035,0.5843012427412594
대출줄어들,-1,-0.48106822381605907,26,9,17,20,0.20545800963216035,0.5843012427412594
설비투자감소,-1,-0.48106822381605907,26,9,17,23,0.20545800963216035,0.5843012427412594
국채가격하락,-1,-0.4814969067596305,117,43,74,60,0.2797715683738729,0.7965271975746301
내수위축,-1,-0.4817410704616669,48,17,31,28,0.2288503427670777,0.651964555488645
불안심리확대,-1,-0.4879757988630835,40,14,26,35,0.2174860596877375,0.6297447185717505
인플레이션잡,-1,-0.48875478654107596,99,36,63,84,0.26530024617433146,0.7697627157130806
듀레이션줄이,-1,-0.49073562847457,51,18,33,47,0.2270108346559772,0.6620991361682326
양적완화나설,-1,-0.49073562847457,51,18,33,49,0.2270108346559772,0.6620991361682326
경기부양책나올,-1,-0.4918989225795024,29,10,19,13,0.20361822168561214,0.5956914364178257
채권시장변동성확대,-1,-0.4918989225795024,29,10,19,22,0.20361822168561214,0.5956914364178257
양적완화시행,-1,-0.49349662517639914,86,31,55,66,0.2540679446709994,0.7464180723729021
기준금리내렸,-1,-0.49432699348951825,102,37,65,59,0.26375561177309914,0.7765783970448809
기대심리확산,-1,-0.49949791202103433,97,35,62,83,0.25768878564309144,0.7691774750702696
국고채금리오른,-1,-0.4995596899692918,89,32,57,70,0.25256936585678413,0.7540202558117215
경기침체이어질,-1,-0.5014833588778829,32,11,21,9,0.20223152061283428,0.6068401259451248
금리내려가,-1,-0.5083946808642349,127,46,81,95,0.26776243105237507,0.8184829771302226
매출증가,-1,-0.50988757000933,103,37,66,57,0.25502432721655,0.7826850579302482
유동성확보위한,-1,-0.5100888799964488,35,12,23,13,0.20117759701487442,0.6177612810178363
달러화올랐,-1,-0.5100888799964488,35,12,23,32,0.20117759701487442,0.6177612810178363
수요증가따른,-1,-0.5100888799964488,35,12,23,23,0.20117759701487442,0.6177612810178363
경기악화,-1,-0.5106556314332384,95,34,61,79,0.2498938770751923,0.768529289493014
경제지표상회,-1,-0.5130057554914447,15,5,10,6,0.17755418205401052,0.5495327109628421
침체빠졌,-1,-0.5130057554914447,15,5,10,12,0.17755418205401052,0.5495327109628421
내수부진심화,-1,-0.5130057554914447,15,5,10,3,0.17755418205401052,0.5495327109628421
성장무게두,-1,-0.5130057554914447,15,5,10,5,0.17755418205401052,0.5495327109628421
부양책제시,-1,-0.5130057554914447,15,5,10,11,0.17755418205401052,0.5495327109628421
물가안정달성,-1,-0.5130057554914447,15,5,10,13,0.17755418205401052,0.5495327109628421
단기물금리오르,-1,-0.5130057554914447,15,5,10,15,0.17755418205401052,0.5495327109628421
발행금리낮추,-1,-0.5130057554914447,15,5,10,13,0.17755418205401052,0.5495327109628421
금리내린다고,-1,-0.5130057554914447,15,5,10,15,0.17755418205401052,0.5495327109628421
실적올린,-1,-0.5130057554914447,15,5,10,8,0.17755418205401052,0.5495327109628421
성장둔화인한,-1,-0.5130057554914447,15,5,10,1,0.17755418205401052,0.5495327109628421
국고채수익률상승,-1,-0.5130057554914447,15,5,10,10,0.17755418205401052,0.5495327109628421
증시하락압력받,-1,-0.5130057554914447,15,5,10,5,0.17755418205401052,0.5495327109628421
지급준비율낮추,-1,-0.5130057554914447,15,5,10,14,0.17755418205401052,0.5495327109628421
성장전망,-1,-0.5130057554914447,15,5,10,16,0.17755418205401052,0.5495327109628421
디플레이션우려제기,-1,-0.5130057554914447,15,5,10,12,0.17755418205401052,0.5495327109628421
경기부양책고려,-1,-0.5130057554914447,15,5,10,4,0.17755418205401052,0.5495327109628421
수신증가,-1,-0.5130057554914447,15,5,10,9,0.17755418205401052,0.5495327109628421
기대인플레이션하락,-1,-0.5130057554914447,15,5,10,31,0.17755418205401052,0.5495327109628421
유가하락인한,-1,-0.5130057554914447,15,5,10,29,0.17755418205401052,0.5495327109628421
위험전이,-1,-0.5130057554914447,15,5,10,22,0.17755418205401052,0.5495327109628421
기준금리내리않,-1,-0.5130057554914447,15,5,10,16,0.17755418205401052,0.5495327109628421
금리상승커졌,-1,-0.5130057554914447,15,5,10,6,0.17755418205401052,0.5495327109628421
금리인하나선,-1,-0.5130057554914447,15,5,10,26,0.17755418205401052,0.5495327109628421
금리인하반대,-1,-0.5130057554914447,15,5,10,17,0.17755418205401052,0.5495327109628421
성장세예상,-1,-0.5192063407179407,18,6,12,12,0.17824744032096565,0.5610552679089645
대출늘어날,-1,-0.5192063407179407,18,6,12,17,0.17824744032096565,0.5610552679089645
기준금리인상될,-1,-0.5192063407179407,18,6,12,11,0.17824744032096565,0.5610552679089645
단기금리급등,-1,-0.5192063407179407,18,6,12,18,0.17824744032096565,0.5610552679089645
금리강세보였,-1,-0.5192063407179407,18,6,12,9,0.17824744032096565,0.5610552679089645
성장지지,-1,-0.5192063407179407,18,6,12,7,0.17824744032096565,0.5610552679089645
소비자심리지수하락,-1,-0.5192063407179407,18,6,12,19,0.17824744032096565,0.5610552679089645
스프레드축소따른,-1,-0.5192063407179407,18,6,12,16,0.17824744032096565,0.5610552679089645
엔화떨어졌,-1,-0.5192063407179407,18,6,12,14,0.17824744032096565,0.5610552679089645
투자늘어난,-1,-0.5192063407179407,18,6,12,9,0.17824744032096565,0.5610552679089645
금리빠졌,-1,-0.5192063407179407,18,6,12,19,0.17824744032096565,0.5610552679089645
주택가격떨어지,-1,-0.5192063407179407,18,6,12,14,0.17824744032096565,0.5610552679089645
국고채입찰부진,-1,-0.5192063407179407,18,6,12,16,0.17824744032096565,0.5610552679089645
물가상승요인작용,-1,-0.5192063407179407,18,6,12,13,0.17824744032096565,0.5610552679089645
금리인하검토,-1,-0.5192063407179407,18,6,12,15,0.17824744032096565,0.5610552679089645
아파트가격하락,-1,-0.5192063407179407,18,6,12,7,0.17824744032096565,0.5610552679089645
성장둔화따른,-1,-0.5192063407179407,18,6,12,12,0.17824744032096565,0.5610552679089645
금리상승세보이,-1,-0.5250572806746227,41,14,27,36,0.19976390309063455,0.6389477831039744
수신늘,-1,-0.5251472882723649,21,7,14,16,0.17892677674781537,0.5724417609438578
위험대응,-1,-0.5251472882723649,21,7,14,26,0.17892677674781537,0.5724417609438578
설비투자늘어나,-1,-0.5251472882723649,21,7,14,16,0.17892677674781537,0.5724417609438578
국채수익률오를,-1,-0.5251472882723649,21,7,14,13,0.17892677674781537,0.5724417609438578
유로화반락,-1,-0.5251472882723649,21,7,14,7,0.17892677674781537,0.5724417609438578
금리상승고시,-1,-0.5251472882723649,21,7,14,16,0.17892677674781537,0.5724417609438578
연방기금금리선물기준금리인하,-1,-0.5251472882723649,21,7,14,8,0.17892677674781537,0.5724417609438578
금리인하주장,-1,-0.5269536489005453,55,19,36,60,0.21156510045103757,0.6802408989638435
소비회복,-1,-0.5269536489005453,55,19,36,39,0.21156510045103757,0.6802408989638435
경제지표둔화,-1,-0.5269536489005453,55,19,36,41,0.21156510045103757,0.6802408989638435
수급부담작용,-1,-0.5308383906893248,24,8,16,20,0.1795924195497011,0.583683172685651
경제주체심리개선,-1,-0.5308383906893248,24,8,16,8,0.1795924195497011,0.583683172685651
금리인하기대유지,-1,-0.5308383906893248,24,8,16,30,0.1795924195497011,0.583683172685651
소비자물가상승률물가안정목표유지,-1,-0.5308383906893248,24,8,16,29,0.1795924195497011,0.583683172685651
내외금리차축소,-1,-0.5308383906893248,24,8,16,14,0.1795924195497011,0.583683172685651
저축늘리,-1,-0.5308383906893248,24,8,16,15,0.1795924195497011,0.583683172685651
달러화가치급락,-1,-0.5308383906893248,24,8,16,20,0.1795924195497011,0.583683172685651
금리인상해도,-1,-0.5362891460530798,27,9,18,23,0.18024459627301237,0.5947710735039529
달러약세부추기,-1,-0.5362891460530798,27,9,18,20,0.18024459627301237,0.5947710735039529
달러화낙폭확대,-1,-0.5362891460530798,27,9,18,26,0.18024459627301237,0.5947710735039529
투자늘어날,-1,-0.5362891460530798,27,9,18,26,0.18024459627301237,0.5947710735039529
금리상승이끌,-1,-0.5377721331002385,47,16,31,34,0.1989642789990618,0.659275934322088
이자부담덜,-1,-0.5377721331002385,47,16,31,39,0.1989642789990618,0.659275934322088
기준금리하회,-1,-0.5415087555169285,30,10,20,50,0.1808835335652256,0.605697624870194
고용지표호조보이,-1,-0.5434682361700274,50,17,33,51,0.1987203669304685,0.6691189678847707
수입증가,-1,-0.5434682361700274,50,17,33,48,0.1987203669304685,0.6691189678847707
기준금리내리,-1,-0.5434742634703029,235,84,151,147,0.2681701878241577,0.9029815216723485
가계부채늘,-1,-0.5465061225913027,33,11,22,39,0.18150945696115653,0.6164555794143711
달러약세진행,-1,-0.5465061225913027,33,11,22,22,0.18150945696115653,0.6164555794143711
유동성공급확대,-1,-0.551289853978323,36,12,24,16,0.18212259068494902,0.6270382779353916
금융위기확산,-1,-0.551289853978323,36,12,24,19,0.18212259068494902,0.6270382779353916
공적자금투입,-1,-0.5537802325729552,56,19,37,33,0.1984520079519688,0.6881598464145364
crs금리급락,-1,-0.5558682617492693,39,13,26,13,0.18272315746712994,0.6374396436216693
금리급락따른,-1,-0.5584672218299764,59,20,39,34,0.198402070491841,0.6973560916265079
gdp성장,-1,-0.5602493666793493,42,14,28,28,0.1833113783760642,0.6476541737437811
유로달러오른,-1,-0.5644409025711714,45,15,30,28,0.18388747266315605,0.657676929082225
금리변동성확대,-1,-0.5653413659042779,104,36,68,85,0.22292339314229753,0.7993940566504498
원화강세보이,-1,-0.5759512425753306,54,18,36,49,0.18554515816404057,0.6865533307523152
달러원급등,-1,-0.5860075352672451,63,21,42,53,0.18710139530621767,0.7135770893600749
달러원급락,-1,-0.587310434683048,28,9,19,33,0.15783661983926153,0.6043534593664937
소매판매감소,-1,-0.5876179918784098,31,10,21,22,0.16045707901073702,0.6149624129769254
시장금리떨어지,-1,-0.5876179918784098,31,10,21,15,0.16045707901073702,0.6149624129769254
적자줄이,-1,-0.5879314701603017,25,8,17,14,0.15474355780594992,0.5936312730990628
경제회복위해,-1,-0.5879314701603017,25,8,17,21,0.15474355780594992,0.5936312730990628
금리상승막,-1,-0.5879314701603017,25,8,17,19,0.15474355780594992,0.5936312730990628
인플레이션위험남,-1,-0.5885576090512932,34,11,23,5,0.16272399392509468,0.6254382117911078
국제유가반등,-1,-0.5885576090512932,34,11,23,27,0.16272399392509468,0.6254382117911078
gdp감소,-1,-0.5885576090512932,34,11,23,24,0.16272399392509468,0.6254382117911078
기준금리낮수준유지,-1,-0.5899428780850318,22,7,15,4,0.15099657128824948,0.5828226901618745
금리인상전망따른,-1,-0.5899428780850318,22,7,15,23,0.15099657128824948,0.5828226901618745
국고채상승,-1,-0.5899428780850318,22,7,15,18,0.15099657128824948,0.5828226901618745
기준금리밑돌,-1,-0.5899428780850318,22,7,15,14,0.15099657128824948,0.5828226901618745
완화적통화정책지속,-1,-0.5899428780850318,22,7,15,27,0.15099657128824948,0.5828226901618745
기준금리떨어지,-1,-0.5899428780850318,22,7,15,22,0.15099657128824948,0.5828226901618745
수입줄어들,-1,-0.5899428780850318,22,7,15,16,0.15099657128824948,0.5828226901618745
경기둔화막,-1,-0.5916023068493441,40,13,27,29,0.16649887240403244,0.6459318782375919
금융시장안정위해,-1,-0.59198670032482,69,23,46,30,0.18808527796185762,0.7305369457854672
금리상승압력커질,-1,-0.5941007553654551,19,6,13,23,0.1463055018814805,0.5719658048234354
스프레드확대따른,-1,-0.5941007553654551,19,6,13,8,0.1463055018814805,0.5719658048234354
일자리늘어나,-1,-0.5941007553654551,19,6,13,17,0.1463055018814805,0.5719658048234354
금리인하실시,-1,-0.5941007553654551,19,6,13,28,0.1463055018814805,0.5719658048234354
인플레이션기대억제,-1,-0.5941007553654551,19,6,13,13,0.1463055018814805,0.5719658048234354
신용경색확산,-1,-0.5941007553654551,19,6,13,8,0.1463055018814805,0.5719658048234354
고용지표밑돌,-1,-0.5941007553654551,19,6,13,10,0.1463055018814805,0.5719658048234354
위험내포,-1,-0.5941007553654551,19,6,13,10,0.1463055018814805,0.5719658048234354
기준금리인상전망,-1,-0.5941007553654551,19,6,13,7,0.1463055018814805,0.5719658048234354
적자축소,-1,-0.5941007553654551,19,6,13,10,0.1463055018814805,0.5719658048234354
채권시장강세보이,-1,-0.5975620100738785,49,16,33,35,0.17091941226313598,0.6753747066345134
성장세이어질,-1,-0.5975620100738785,49,16,33,23,0.17091941226313598,0.6753747066345134
금리내린,-1,-0.5979839838041064,241,83,158,191,0.23239628144517507,0.9194979550873018
금리상승압력작용,-1,-0.5999791256960978,78,26,52,73,0.18948467292780352,0.7543765584111104
부채비율상승,-1,-0.6017263574821565,16,5,11,13,0.14017618372890928,0.561118394182284
고용지표오,-1,-0.6017263574821565,16,5,11,2,0.14017618372890928,0.561118394182284
채권금리올라가,-1,-0.6017263574821565,16,5,11,18,0.14017618372890928,0.561118394182284
금리하락압력지속,-1,-0.6017263574821565,16,5,11,11,0.14017618372890928,0.561118394182284
유로화강세지지받,-1,-0.6017263574821565,16,5,11,13,0.14017618372890928,0.561118394182284
채권시장확산,-1,-0.6017263574821565,16,5,11,10,0.14017618372890928,0.561118394182284
환율하락인한,-1,-0.6017263574821565,16,5,11,15,0.14017618372890928,0.561118394182284
가계부채늘어날,-1,-0.6017263574821565,16,5,11,24,0.14017618372890928,0.561118394182284
금리인하진행,-1,-0.6017263574821565,16,5,11,14,0.14017618372890928,0.561118394182284
모기지금리낮추,-1,-0.6017263574821565,16,5,11,3,0.14017618372890928,0.561118394182284
지급준비율내리,-1,-0.6017263574821565,16,5,11,11,0.14017618372890928,0.561118394182284
완화정책나올,-1,-0.6017263574821565,16,5,11,6,0.14017618372890928,0.561118394182284
유가강세보였,-1,-0.6017263574821565,16,5,11,4,0.14017618372890928,0.561118394182284
달러강세영향받,-1,-0.6017263574821565,16,5,11,14,0.14017618372890928,0.561118394182284
소득줄,-1,-0.6017263574821565,16,5,11,15,0.14017618372890928,0.561118394182284
원화강세막,-1,-0.6017263574821565,16,5,11,16,0.14017618372890928,0.561118394182284
소비늘릴,-1,-0.6017263574821565,16,5,11,13,0.14017618372890928,0.561118394182284
기준금리인하따른,-1,-0.617760295203146,79,26,53,90,0.18058694303511966,0.7605934868309212
경기침체지속,-1,-0.6250442445765854,41,13,28,25,0.15165233702936262,0.6540046593395809
주택담보대출증가,-1,-0.6256644906303519,53,17,36,38,0.16018409415037643,0.6922010611541313
수출위축,-1,-0.630060032736578,32,10,22,22,0.14224315924591843,0.6236212646776655
소비늘어날,-1,-0.630060032736578,32,10,22,17,0.14224315924591843,0.6236212646776655
양적완화하,-1,-0.630060032736578,32,10,22,21,0.14224315924591843,0.6236212646776655
성장도모,-1,-0.630060032736578,32,10,22,16,0.14224315924591843,0.6236212646776655
금리인하고려,-1,-0.6338905149272354,29,9,20,28,0.13810745275231612,0.6132298456401204
채권시장강세이어질,-1,-0.6395118425327322,26,8,18,20,0.13321310978275785,0.60274013498549
경제성장위해,-1,-0.6395118425327322,26,8,18,25,0.13321310978275785,0.60274013498549
달러화엔화오른,-1,-0.6395118425327322,26,8,18,20,0.13321310978275785,0.60274013498549
재무안정성개선,-1,-0.6395118425327322,26,8,18,18,0.13321310978275785,0.60274013498549
금리인하위한,-1,-0.6395118425327322,26,8,18,12,0.13321310978275785,0.60274013498549
스왑베이시스확대,-1,-0.6428859806191625,104,34,70,66,0.17890253565404385,0.8187575421657967
민간소비증가,-1,-0.6476767531775487,23,7,16,9,0.1272965598704643,0.592181373744565
경제전망하향조정,-1,-0.6476767531775487,23,7,16,32,0.1272965598704643,0.592181373744565
성장모멘텀약화,-1,-0.6476767531775487,23,7,16,18,0.1272965598704643,0.592181373744565
경기부양책발표,-1,-0.6592620473489011,39,12,27,26,0.13460015494678018,0.6518820298016429
달러화약세보일,-1,-0.6592620473489011,39,12,27,29,0.13460015494678018,0.6518820298016429
기준금리인상가능성배제없,-1,-0.6595665289184902,20,6,14,15,0.11995816917201614,0.5815928928750219
달러인덱스상승,-1,-0.6595665289184902,20,6,14,38,0.11995816917201614,0.5815928928750219
경기둔화대응,-1,-0.6595665289184902,20,6,14,17,0.11995816917201614,0.5815928928750219
수출부진따른,-1,-0.6595665289184902,20,6,14,17,0.11995816917201614,0.5815928928750219
시스템리스크확산,-1,-0.6595665289184902,20,6,14,4,0.11995816917201614,0.5815928928750219
채권시장국고채금리오른,-1,-0.6595665289184902,20,6,14,18,0.11995816917201614,0.5815928928750219
금융시장충격줄,-1,-0.6595665289184902,20,6,14,23,0.11995816917201614,0.5815928928750219
엔화유로화상승,-1,-0.6595665289184902,20,6,14,22,0.11995816917201614,0.5815928928750219
달러약세부추겼,-1,-0.6633629456148258,36,11,25,22,0.1306298507198287,0.6419001574311723
수출증가세둔화,-1,-0.6687900703834306,33,10,23,21,0.1260976956653657,0.6317800884789686
수요늘리,-1,-0.6687900703834306,33,10,23,26,0.1260976956653657,0.6317800884789686
높금리주,-1,-0.6717314441465796,58,18,40,38,0.14119814772220632,0.7149977717482497
하방경직성유지,-1,-0.6753719596769163,52,16,36,36,0.1358680947439665,0.6971936567329174
수출줄,-1,-0.6759701461295642,30,9,21,38,0.12085940135323209,0.6215381706561854
재정지출늘리,-1,-0.6759701461295642,30,9,21,11,0.12085940135323209,0.6215381706561854
양적완화나서,-1,-0.6759701461295642,30,9,21,38,0.12085940135323209,0.6215381706561854
성장보,-1,-0.6771275592781312,17,5,12,7,0.11056714176943218,0.5710292235387417
gdp하락,-1,-0.6771275592781312,17,5,12,4,0.11056714176943218,0.5710292235387417
금리인하기대커지,-1,-0.6771275592781312,17,5,12,23,0.11056714176943218,0.5710292235387417
금리인하동참,-1,-0.6771275592781312,17,5,12,16,0.11056714176943218,0.5710292235387417
서부텍사스산원유가격떨어진,-1,-0.6771275592781312,17,5,12,10,0.11056714176943218,0.5710292235387417
상품가격하락,-1,-0.6771275592781312,17,5,12,14,0.11056714176943218,0.5710292235387417
기준금리인하가능,-1,-0.6771275592781312,17,5,12,15,0.11056714176943218,0.5710292235387417
수출감소세확대,-1,-0.6771275592781312,17,5,12,3,0.11056714176943218,0.5710292235387417
고성장종목종목수매매보,-1,-0.6771275592781312,17,5,12,1,0.11056714176943218,0.5710292235387417
실적호조보인,-1,-0.6771275592781312,17,5,12,19,0.11056714176943218,0.5710292235387417
인플레이션확대,-1,-0.6771275592781312,17,5,12,6,0.11056714176943218,0.5710292235387417
국고채스프레드축소,-1,-0.6771275592781312,17,5,12,16,0.11056714176943218,0.5710292235387417
국채선물상승거래,-1,-0.6771275592781312,17,5,12,14,0.11056714176943218,0.5710292235387417
채권시장강세요인작용,-1,-0.6771275592781312,17,5,12,19,0.11056714176943218,0.5710292235387417
금리밑돌,-1,-0.6855059557865107,27,8,19,26,0.11471793729755793,0.6111943906729023
채권수익률급등,-1,-0.6855059557865107,27,8,19,7,0.11471793729755793,0.6111943906729023
경제지표호조따른,-1,-0.6855059557865107,27,8,19,34,0.11471793729755793,0.6111943906729023
침체빠져,-1,-0.6855059557865107,27,8,19,12,0.11471793729755793,0.6111943906729023
기준금리내린,-1,-0.6872308341627549,135,43,92,117,0.1636126859542813,0.8773714127521456
베이시스확대,-1,-0.689959148007179,40,12,28,32,0.12170087859554736,0.6593926489412102
물가상승률기록,-1,-0.6981818690774517,53,16,37,41,0.12588893053458614,0.7039603966042524
경기후퇴따른,-1,-0.6982704722550213,24,7,17,11,0.10739908442791132,0.6007733289104246
지정학적리스크확대,-1,-0.6982704722550213,24,7,17,23,0.10739908442791132,0.6007733289104246
환율방어위해,-1,-0.7038692826941155,34,10,24,36,0.11184914303741723,0.6395222610490044
적자지속,-1,-0.7038692826941155,34,10,24,16,0.11184914303741723,0.6395222610490044
금리인하가능성열려,-1,-0.7038692826941155,34,10,24,25,0.11184914303741723,0.6395222610490044
금융위기수준회복,-1,-0.7136457509335387,31,9,22,33,0.10585752383908181,0.6293842018692435
경제성장률유지,-1,-0.7155617543109549,21,6,15,10,0.09851460378127387,0.590305180875637
경제불확실성커지,-1,-0.7155617543109549,21,6,15,15,0.09851460378127387,0.590305180875637
재무구조개선위해,-1,-0.7155617543109549,21,6,15,13,0.09851460378127387,0.590305180875637
기준금리인상위한,-1,-0.7155617543109549,21,6,15,39,0.09851460378127387,0.590305180875637
금리인하기대어렵,-1,-0.7155617543109549,21,6,15,14,0.09851460378127387,0.590305180875637
달러화하락압력가할,-1,-0.7260774421895015,28,8,20,23,0.09892405938420581,0.6191310815470855
금융안정위한,-1,-0.7393574796533992,18,5,13,12,0.08750981990257002,0.5798261976586001
금리인상가능성강하시사,-1,-0.7393574796533992,18,5,13,10,0.08750981990257002,0.5798261976586001
가계부채줄이,-1,-0.7393574796533992,18,5,13,15,0.08750981990257002,0.5798261976586001
대출규제완화,-1,-0.7393574796533992,18,5,13,7,0.08750981990257002,0.5798261976586001
금리인하보,-1,-0.7393574796533992,18,5,13,15,0.08750981990257002,0.5798261976586001
고용지표양호,-1,-0.7393574796533992,18,5,13,24,0.08750981990257002,0.5798261976586001
재무구조개선위한,-1,-0.7393574796533992,18,5,13,6,0.08750981990257002,0.5798261976586001
기대심리강화,-1,-0.7393574796533992,18,5,13,17,0.08750981990257002,0.5798261976586001
국채가격상승폭제한,-1,-0.7393574796533992,18,5,13,11,0.08750981990257002,0.5798261976586001
소비자물가상승률물가안정목표안정,-1,-0.7420228777259963,25,7,18,26,0.09080771996430823,0.6087805616897465
금리상승압력받,-1,-0.7433475508093006,65,19,46,75,0.11094044592442422,0.748130924897837
물가올랐,-1,-0.7471318779971219,32,9,23,13,0.09285460193760128,0.6368496864945428
금리인하가능성제기,-1,-0.7528689447469974,39,11,28,25,0.0943031207939864,0.6638588289243271
지급준비율인하,-1,-0.7571992662296114,92,27,65,42,0.11419846825112762,0.8201634378708925
인플레이션압력높이,-1,-0.7615601652095847,29,8,21,13,0.08548704353548686,0.6266529479522217
경기상승세이,-1,-0.7615601652095847,29,8,21,6,0.08548704353548686,0.6266529479522217
스프레드축소지속,-1,-0.762675036862152,22,6,16,13,0.08119613920138394,0.5983514977165261
금리동결주장,-1,-0.762675036862152,22,6,16,23,0.08119613920138394,0.5983514977165261
손실줄이,-1,-0.762675036862152,22,6,16,15,0.08119613920138394,0.5983514977165261
소비자물가상승률머물,-1,-0.7727039451625446,15,4,11,8,0.07360599080603682,0.5693760184819021
위험되,-1,-0.7727039451625446,15,4,11,14,0.07360599080603682,0.5693760184819021
높이자주,-1,-0.7727039451625446,15,4,11,7,0.07360599080603682,0.5693760184819021
장기물약세보이,-1,-0.7727039451625446,15,4,11,14,0.07360599080603682,0.5693760184819021
금리인하기대심리반영,-1,-0.7727039451625446,15,4,11,19,0.07360599080603682,0.5693760184819021
국채선물올라,-1,-0.7727039451625446,15,4,11,20,0.07360599080603682,0.5693760184819021
시장변동성줄어들,-1,-0.7727039451625446,15,4,11,11,0.07360599080603682,0.5693760184819021
금융시장악화,-1,-0.7727039451625446,15,4,11,15,0.07360599080603682,0.5693760184819021
주택담보대출금리하락,-1,-0.7727039451625446,15,4,11,3,0.07360599080603682,0.5693760184819021
시장금리하락제한,-1,-0.7727039451625446,15,4,11,10,0.07360599080603682,0.5693760184819021
영업이익감소,-1,-0.7794821180314945,26,7,19,28,0.07702546269209178,0.6163344038413622
금리인상반대,-1,-0.7794821180314945,26,7,19,25,0.07702546269209178,0.6163344038413622
주택가격하락따른,-1,-0.7794821180314945,26,7,19,18,0.07702546269209178,0.6163344038413622
이자부담줄여,-1,-0.7896749181696379,19,5,14,13,0.06970070165716552,0.5878611626382267
달러약세요인작용,-1,-0.7896749181696379,19,5,14,14,0.06970070165716552,0.5878611626382267
기준금리인하결정,-1,-0.7896749181696379,19,5,14,11,0.06970070165716552,0.5878611626382267
위험될,-1,-0.7990261668646027,41,11,30,47,0.07635639550241877,0.6772033081896314
유로화달러화낮진나타냈,-1,-0.801860181312702,23,6,17,12,0.06725667800786594,0.605902730104514
인플레이션압력커질,-1,-0.801860181312702,23,6,17,13,0.06725667800786594,0.605902730104514
변동성완화,-1,-0.811326702548409,27,7,20,43,0.06559306683036714,0.6235307420053049
국고금리하락,-1,-0.8113425461292098,38,10,28,36,0.0702079882562218,0.6674617339755521
가계부채늘리,-1,-0.8251471688344485,16,4,12,12,0.055900271265663805,0.5773171859603007
환율변동성커지,-1,-0.8251471688344485,16,4,12,30,0.055900271265663805,0.5773171859603007
대출강화,-1,-0.8251471688344485,16,4,12,15,0.055900271265663805,0.5773171859603007
기대심리줄어든,-1,-0.8251471688344485,16,4,12,11,0.055900271265663805,0.5773171859603007
기준금리밑도,-1,-0.8251471688344485,16,4,12,12,0.055900271265663805,0.5773171859603007
기준금리인하실시,-1,-0.8251471688344485,16,4,12,16,0.055900271265663805,0.5773171859603007
재정확대,-1,-0.8251471688344485,16,4,12,9,0.055900271265663805,0.5773171859603007
저평가확대,-1,-0.8251471688344485,16,4,12,4,0.055900271265663805,0.5773171859603007
완화지속,-1,-0.8251471688344485,16,4,12,23,0.055900271265663805,0.5773171859603007
디플레이션우려커지,-1,-0.8251471688344485,16,4,12,20,0.055900271265663805,0.5773171859603007
물가상승률유지,-1,-0.8251471688344485,16,4,12,21,0.055900271265663805,0.5773171859603007
성장세회복지원,-1,-0.8255858997295129,35,9,26,16,0.06349414264405179,0.6575338030286131
경기회복지연따른,-1,-0.8298453896722253,20,5,15,4,0.05597075963987916,0.5953602079124914
고용지표호조보인,-1,-0.8298453896722253,20,5,15,12,0.05597075963987916,0.5953602079124914
수익줄,-1,-0.8298453896722253,20,5,15,16,0.05597075963987916,0.5953602079124914
달러엔오를,-1,-0.8298453896722253,20,5,15,15,0.05597075963987916,0.5953602079124914
국고채스프레드확대,-1,-0.8298453896722253,20,5,15,15,0.05597075963987916,0.5953602079124914
이자부담,-1,-0.8298453896722253,20,5,15,34,0.05597075963987916,0.5953602079124914
금리끌어내리,-1,-0.830419199019397,50,13,37,42,0.0669145340492326,0.7143749584669178
엔화유로화하락,-1,-0.8342128133872655,24,6,18,31,0.056039465857007684,0.6130780769273396
물가안정목표하회,-1,-0.8342128133872655,24,6,18,18,0.056039465857007684,0.6130780769273396
유동성확보위해,-1,-0.8382740027210164,28,7,21,19,0.056106437807197346,0.6304403378220089
시장매수심리위축,-1,-0.8608192594825734,25,6,19,20,0.04699437277968638,0.6199618594767299
하방위험커졌,-1,-0.8608192594825734,25,6,19,16,0.04699437277968638,0.6199618594767299
금리인하이어질,-1,-0.8617060666055439,21,5,16,11,0.04535986259027613,0.6024717729848817
잠재성장률하회,-1,-0.8617060666055439,21,5,16,14,0.04535986259027613,0.6024717729848817
고용지표호조보일,-1,-0.8618441904910651,33,8,25,17,0.04917952842512511,0.6538975555921585
유가급등인해,-1,-0.8645559620304252,17,4,13,3,0.04306039271953171,0.5846932650711353
글로벌경제완만회복세지속,-1,-0.8645559620304252,17,4,13,25,0.04306039271953171,0.5846932650711353
금리하락베팅하,-1,-0.8645559620304252,17,4,13,13,0.04306039271953171,0.5846932650711353
금융위기해소,-1,-0.8645559620304252,17,4,13,11,0.04306039271953171,0.5846932650711353
경기침체대응,-1,-0.8645559620304252,17,4,13,10,0.04306039271953171,0.5846932650711353
경쟁력강화,-1,-0.8734177217539195,65,16,49,49,0.05294286003794132,0.7721258449885583
침체막,-1,-0.88267199630872,26,6,20,12,0.03967427148177213,0.6266144911980972
만장일치기준금리동결,-1,-0.88267199630872,26,6,20,41,0.03967427148177213,0.6266144911980972
이익늘어나,-1,-0.8869281229869359,22,5,17,10,0.037116410132550924,0.6092952074226907
경기위축의미,-1,-0.8869281229869359,22,5,17,6,0.037116410132550924,0.6092952074226907
유가상승인해,-1,-0.8940851414038959,18,4,14,4,0.033671870293819905,0.5916865882751203
침체심화,-1,-0.8940851414038959,18,4,14,4,0.033671870293819905,0.5916865882751203
위험처했,-1,-0.8940851414038959,18,4,14,8,0.033671870293819905,0.5916865882751203
재무구조악화,-1,-0.8940851414038959,18,4,14,23,0.033671870293819905,0.5916865882751203
지급준비율올린,-1,-0.8940851414038959,18,4,14,8,0.033671870293819905,0.5916865882751203
경상수지흑자줄어들,-1,-0.8940851414038959,18,4,14,18,0.033671870293819905,0.5916865882751203
변동성확대대비,-1,-0.8940851414038959,18,4,14,16,0.033671870293819905,0.5916865882751203
시중금리떨어지,-1,-0.8940851414038959,18,4,14,10,0.033671870293819905,0.5916865882751203
발행시장위축,-1,-0.8940851414038959,18,4,14,10,0.033671870293819905,0.5916865882751203
침체국면접어들,-1,-0.906923455258324,23,5,18,20,0.030667356882311925,0.6158981624698497
수요증가힘입,-1,-0.906923455258324,23,5,18,19,0.030667356882311925,0.6158981624698497
경기하강위험남,-1,-0.9162830040654761,19,4,15,2,0.02672838104659984,0.5984103181959212
변동성장세예상,-1,-0.9162830040654761,19,4,15,11,0.02672838104659984,0.5984103181959212
금리인하선반영,-1,-0.9162830040654761,19,4,15,15,0.02672838104659984,0.5984103181959212
달러약세유도,-1,-0.9228343354713411,24,5,19,13,0.025581670685973952,0.622327423929817
달러강세진정,-1,-0.9303489741343478,15,3,12,15,0.021515761221526618,0.5806649291497175
금리인하나섰,-1,-0.9303489741343478,15,3,12,15,0.021515761221526618,0.5806649291497175
금리인하여력있,-1,-0.9303489741343478,15,3,12,7,0.021515761221526618,0.5806649291497175
달러화절상,-1,-0.9303489741343478,15,3,12,15,0.021515761221526618,0.5806649291497175
성장세보여,-1,-0.9330871904494616,20,4,16,26,0.021526494232628826,0.6049364432945094
비용감소,-1,-0.9459259379910102,21,4,17,6,0.017576676517251824,0.6113117679429156
주택시장회복,-1,-0.9459259379910102,21,4,17,12,0.017576676517251824,0.6113117679429156
원화가치떨어지,-1,-0.9459259379910102,21,4,17,14,0.017576676517251824,0.6113117679429156
경기악화않,-1,-0.9472643035589577,16,3,13,6,0.016469675292529344,0.5872515930277338
금리인상이루어질,-1,-0.9472643035589577,16,3,13,11,0.016469675292529344,0.5872515930277338
경기둔화우려반영,-1,-0.9472643035589577,16,3,13,13,0.016469675292529344,0.5872515930277338
금리인하확신,-1,-0.9472643035589577,16,3,13,6,0.016469675292529344,0.5872515930277338
금리인상우려부각,-1,-0.9472643035589577,16,3,13,21,0.016469675292529344,0.5872515930277338
유가올라,-1,-0.954105786549928,27,5,22,5,0.015666497606930552,0.6408564661731704
물가억제,-1,-0.9593323113497161,17,3,14,11,0.012890915054229471,0.5936804561763177
달러화상승출발,-1,-0.9593323113497161,17,3,14,13,0.012890915054229471,0.5936804561763177
달러강세반영,-1,-0.9593323113497161,17,3,14,15,0.012890915054229471,0.5936804561763177
경상수지흑자줄이,-1,-0.9593323113497161,17,3,14,6,0.012890915054229471,0.5936804561763177
성장잠재력확충,-1,-0.968106899687797,18,3,15,22,0.010294967708364354,0.5999923305629274
높금리적용,-1,-0.9832679782232212,21,3,18,10,0.005802807415435536,0.6184336394389343
주택담보대출금리오르,-1,-0.9861953574810212,22,3,19,11,0.004930310162589898,0.624451537832548
변동성확대따른,-1,-0.9864653501702143,15,2,13,10,0.0045644595242033395,0.5883218419310524
차입금확대,-1,-0.9895552839483271,16,2,14,3,0.0036820697638901864,0.5945189643430833
양적완화시사,-1,-0.9895552839483271,16,2,14,17,0.0036820697638901864,0.5945189643430833
유가반락,-1,-0.9918139298266355,17,2,15,12,0.0030347944991732526,0.6006631618788152
금리내려도,-1,-0.9918139298266355,17,2,15,22,0.0030347944991732526,0.6006631618788152
불확실성증대따른,-1,-0.9918139298266355,17,2,15,11,0.0030347944991732526,0.6006631618788152
실업률급등,-1,-0.9966125555684442,21,2,19,8,0.001647503889968687,0.6247757177190202
경제성장률상회,-1,-0.9972583589737591,22,2,20,10,0.0014586448808927908,0.630693186388716
기준금리하향조정,-1,-0.9994811527556992,53,4,49,14,0.000935716591246348,0.7807126660375394
유로화달러화하락,-1,-0.9997585540343985,16,1,15,14,0.0006367308812222709,0.6008810627347921
수출증가세보이,-1,-0.9997585540343985,16,1,15,8,0.0006367308812222709,0.6008810627347921
금리인하지연,-1,-0.9997585540343985,16,1,15,7,0.0006367308812222709,0.6008810627347921
원화강세이어졌,-1,-1.0,17,1,16,1,0.0005698063107193604,0.6069421949249204
국제유가오른,-1,-1.0,17,1,16,6,0.0005698063107193604,0.6069421949249204
