word,label,polarity,count,pos_count,neg_count,neu_count,pos_score,neg_score
원유가격올랐,1,1.0,21,21,0,3,0.6358414404345344,1.856493087953138e-05
경제본상승세빨랐,1,0.999999234807436,19,19,0,0,0.6276182189573187,1.856493087953138e-05
고성장아니성장능력비해서,1,0.999999234807436,19,19,0,0,0.6276182189573187,1.856493087953138e-05
금리인상부동산가격영향주아니,1,0.9999980340594008,16,16,0,0,0.6151344765915683,1.856493087953138e-05
규제다르금리인상부동산가격,1,0.9999980340594008,16,16,0,0,0.6151344765915683,1.856493087953138e-05
상환능력유지,1,0.9999976191049087,15,15,0,5,0.6109350188915867,1.856493087953138e-05
금리낮아니,1,0.9997138796842815,20,19,1,5,0.6276093986746254,0.0001081129915251723
성장안될,1,0.9996379593607037,18,17,1,0,0.619304378207547,0.00013019616438236654
플러스성장세이,1,0.9995866433618998,17,16,1,1,0.6151225029100912,0.00014510412657156354
성장경로불확실성상존,1,0.99858149895015,21,19,2,10,0.6275743485992089,0.0004636956242586757
경기회복세되,1,0.9976245236326997,18,16,2,18,0.6150652634230065,0.0007492792792358017
통화정책금융완화유지,1,0.9970197124283953,25,22,3,21,0.6398242772084741,0.0009734242180753168
경제성장률상승,1,0.9963546081789176,16,14,2,7,0.6066150639607211,0.0011252776737743755
지정학적리스크커지,1,0.9953282216684585,15,13,2,19,0.6023529554430825,0.0014277485538168688
수요측면물가상승압력높,1,0.9953282216684585,15,13,2,9,0.6023529554430825,0.0014277485538168688
미국채금리낮,1,0.9953282216684585,15,13,2,7,0.6023529554430825,0.0014277485538168688
금리인상나타나,1,0.9909706419332716,19,16,3,8,0.6148695336704467,0.0028061579230128416
잠재성장률밑도,1,0.9885333140610382,18,15,3,13,0.6106046273885889,0.0035384129471098713
인플레이션우려상존,1,0.9866375849116491,45,37,8,32,0.697863455133451,0.004713763040352062
금리올려서,1,0.9852204018715474,28,23,5,29,0.643481340061784,0.0048088311712294945
고용호조,1,0.9851324916792674,17,14,3,10,0.6062961572005069,0.004557986919948999
경제성장가능,1,0.9851324916792674,17,14,3,14,0.6062961572005069,0.004557986919948999
수요측면물가상승압력,1,0.9843473715185631,33,27,6,28,0.6594327097509523,0.005220286738918199
연방기금금리목표유지,1,0.9834377138381383,22,18,4,22,0.622966632998964,0.00521953833255401
내수증가,1,0.9834377138381383,22,18,4,10,0.622966632998964,0.00521953833255401
물가상승압력이어질,1,0.9802683622252939,16,13,3,6,0.6019315137822554,0.006014596038444744
기준금리인상이어질,1,0.9802683622252939,16,13,3,13,0.6019315137822554,0.006014596038444744
금리올라야,1,0.9802683622252939,16,13,3,12,0.6019315137822554,0.006014596038444744
경제물가안정견조,1,0.9802683622252939,16,13,3,0,0.6019315137822554,0.006014596038444744
높변동성,1,0.9802683622252939,16,13,3,9,0.6019315137822554,0.006014596038444744
콜금리목표인상,1,0.9796430496932504,56,45,11,9,0.7263985297385306,0.007489997793697417
적자나,1,0.9793447056079749,21,17,4,7,0.6186894447195422,0.006473596305181292
금융완화,1,0.9748318799557925,63,50,13,37,0.7433107908744674,0.009493673061320628
임금상승압력높,1,0.9731214207557559,15,12,3,5,0.5974894818110761,0.008155712445893751
성장세미약하,1,0.9731214207557559,15,12,3,22,0.5974894818110761,0.008155712445893751
달러화엔화움직여낮,1,0.9731214207557559,15,12,3,13,0.5974894818110761,0.008155712445893751
단기금리올리,1,0.9663452366567136,19,15,4,3,0.6099440025690186,0.010456010981663766
이자부담늘어날,1,0.964956763196527,28,22,6,18,0.6387342575402277,0.011408560859897771
경기해외위험요인상존,1,0.9614496360132205,23,18,5,9,0.6222638803026099,0.01224671176964416
유동성위험낮,1,0.9578892541589452,27,21,6,20,0.6344312906925681,0.013662410297479647
채권발행증가,1,0.9578892541589452,27,21,6,31,0.6344312906925681,0.013662410297479647
순자산증가,1,0.9578892541589452,27,21,6,20,0.6344312906925681,0.013662410297479647
연체율낮수준,1,0.9559302585369576,18,14,4,13,0.6054330503141633,0.013657285192990922
금리부담커진,1,0.9559302585369576,18,14,4,7,0.6054330503141633,0.013657285192990922
경제회복지연,1,0.9559302585369576,18,14,4,13,0.6054330503141633,0.013657285192990922
부동산가격잡,1,0.9536960900600513,56,43,13,12,0.7180487074206461,0.0170371862249251
국채선물높,1,0.9517620027061846,22,17,5,17,0.6178136992201838,0.015285556439526638
경기상승세,1,0.9500752907556296,47,36,11,11,0.6925068577096354,0.017747278035679395
금리인상실시,1,0.94710356081169,30,23,7,20,0.6421215654885235,0.017461017377441976
경기상승이어지,1,0.94710356081169,30,23,7,7,0.6421215654885235,0.017461017377441976
이자부담커질,1,0.9458387852161585,34,26,8,22,0.6540149749838751,0.018221029375369985
비용줄여,1,0.9412319312094117,17,13,4,16,0.6007798617385037,0.018203135784667836
원화약세요인작용,1,0.9412319312094117,17,13,4,13,0.6007798617385037,0.018203135784667836
성장될,1,0.9370508471146444,29,22,7,9,0.6377279572548594,0.020740651587672364
부동산잡,1,0.9284368504346305,40,30,10,19,0.6688718210481882,0.024837978539763262
국제원자재가격오르,1,0.923219524289902,24,18,6,7,0.6209669412183937,0.024805929289569435
수출주상승,1,0.9201708375455766,16,12,4,9,0.5959167913733846,0.024789039422886624
달러강세자극,1,0.9201708375455766,16,12,4,18,0.5959167913733846,0.024789039422886624
금리인상이르,1,0.9201708375455766,16,12,4,7,0.5959167913733846,0.024789039422886624
집값안정위해,1,0.9201708375455766,16,12,4,5,0.5959167913733846,0.024789039422886624
부도위험나타내,1,0.9201708375455766,16,12,4,9,0.5959167913733846,0.024789039422886624
기대수익률높,1,0.9201708375455766,16,12,4,7,0.5959167913733846,0.024789039422886624
경제호조,1,0.9158349253212095,35,26,9,13,0.6528008288436952,0.028693953604239535
기준금리인상나서,1,0.9134282416375388,46,34,12,33,0.6833324048342702,0.030933103044993568
금리높여,1,0.9128356247490859,31,23,8,39,0.6408078181697506,0.029215584152137722
경기회복유지,1,0.9092146506116183,27,20,7,14,0.6286080503320444,0.029905745218342668
국제원자재가격상승,1,0.9046571100351424,23,17,6,13,0.616202370020424,0.030859938032980337
달러화엔화급락,1,0.8985633249901868,19,14,5,6,0.6035846708754554,0.03226206127439027
성장이룰,1,0.8985633249901868,19,14,5,12,0.6035846708754554,0.03226206127439027
유동성늘,1,0.8985633249901868,19,14,5,10,0.6035846708754554,0.03226206127439027
위안화절상따른,1,0.8985633249901868,19,14,5,10,0.6035846708754554,0.03226206127439027
금융완화유지,1,0.8918625899573236,79,57,22,70,0.7608289070351464,0.04350524834566339
기준금리인상결정,1,0.8911217355785108,72,52,20,40,0.7449083330977363,0.04290334835616464
금리인상다가오,1,0.8900388596381084,26,19,7,22,0.6238239165003931,0.036307374394180636
조달금리낮출,1,0.8896302961742566,15,11,4,13,0.5907302285366047,0.0345164150011061
채권발행감소,1,0.8896302961742566,15,11,4,4,0.5907302285366047,0.0345164150011061
기준금리인상인해,1,0.8896302961742566,15,11,4,12,0.5907302285366047,0.0345164150011061
금리인하신호주,1,0.8896302961742566,15,11,4,4,0.5907302285366047,0.0345164150011061
경기회복세뚜렷해,1,0.8896302961742566,15,11,4,19,0.5907302285366047,0.0345164150011061
금리인상미룰,1,0.8896302961742566,15,11,4,22,0.5907302285366047,0.0345164150011061
금융시장높변동성,1,0.8896302961742566,15,11,4,21,0.5907302285366047,0.0345164150011061
채권시장따르통안하락,1,0.8896302961742566,15,11,4,13,0.5907302285366047,0.0345164150011061
물가상승률안정,1,0.8896302961742566,15,11,4,8,0.5907302285366047,0.0345164150011061
국채선물시장국채선물상승,1,0.8776383982143701,29,21,8,43,0.631392564671411,0.04115979257951648
수출높증가세,1,0.8776383982143701,29,21,8,13,0.631392564671411,0.04115979257951648
제조업하락,1,0.86717978924691,18,13,5,18,0.5983304501795393,0.04257385363854772
콜금리올렸,1,0.86717978924691,18,13,5,7,0.5983304501795393,0.04257385363854772
물가올리,1,0.86717978924691,18,13,5,10,0.5983304501795393,0.04257385363854772
금리인상일시적,1,0.86717978924691,18,13,5,13,0.5983304501795393,0.04257385363854772
금융완화줄여,1,0.86717978924691,18,13,5,21,0.5983304501795393,0.04257385363854772
실업률떨어질,1,0.86717978924691,18,13,5,20,0.5983304501795393,0.04257385363854772
높성장,1,0.86717978924691,18,13,5,13,0.5983304501795393,0.04257385363854772
성장전망하향조정,1,0.86717978924691,18,13,5,18,0.5983304501795393,0.04257385363854772
경기회복세강화,1,0.8661526464406692,25,18,7,27,0.6188332144942325,0.044397505272652155
가산금리올리,1,0.8542370943830113,28,20,8,17,0.626410746217436,0.04925466435738745
고용부진따른,1,0.8542370943830113,28,20,8,33,0.626410746217436,0.04925466435738745
부동산가격급등,1,0.8507053473729431,38,27,11,17,0.6537527608490855,0.05275002594259912
호주달러강세보이,1,0.8498644708127776,21,15,6,6,0.6059496154382388,0.049190503611109784
성장경로벗어나,1,0.8498644708127776,21,15,6,29,0.6059496154382388,0.049190503611109784
위안화가치하락,1,0.8364282326911749,24,17,7,12,0.6135719004364278,0.05466214458050208
달러화약세나타내,1,0.8364282326911749,24,17,7,13,0.6135719004364278,0.05466214458050208
금리인상남,1,0.8364282326911749,24,17,7,16,0.6135719004364278,0.05466214458050208
금리인상필요성제기,1,0.8364282326911749,24,17,7,1,0.6135719004364278,0.05466214458050208
국채수익률오르,1,0.8364043494670972,34,24,10,13,0.6414357452805967,0.05715357410148637
기준금리상향조정,1,0.8322381900463234,82,57,25,78,0.7563830272101015,0.06926849289063725
낮금리발행,1,0.8259037385368033,27,19,8,26,0.621180573840215,0.05923883216158811
부동산가격안정위해,1,0.8259037385368033,27,19,8,11,0.621180573840215,0.05923883216158811
경기침체우려커지,1,0.8247070352584815,17,12,5,3,0.592611643517954,0.05694000959673524
경기회복세찬물끼얹,1,0.8247070352584815,17,12,5,15,0.592611643517954,0.05694000959673524
경상수지흑자축소,1,0.8247070352584815,17,12,5,19,0.592611643517954,0.05694000959673524
성장어렵,1,0.8247070352584815,17,12,5,14,0.592611643517954,0.05694000959673524
금리낮자금,1,0.8247070352584815,17,12,5,8,0.592611643517954,0.05694000959673524
펀더멘털양호,1,0.8247070352584815,17,12,5,42,0.592611643517954,0.05694000959673524
변동성높이,1,0.8247070352584815,17,12,5,18,0.592611643517954,0.05694000959673524
경제성장률밑돌,1,0.8247070352584815,17,12,5,9,0.592611643517954,0.05694000959673524
경제부담되,1,0.8247070352584815,17,12,5,15,0.592611643517954,0.05694000959673524
유가떨어질,1,0.8247070352584815,17,12,5,16,0.592611643517954,0.05694000959673524
수익개선,1,0.8247070352584815,17,12,5,12,0.592611643517954,0.05694000959673524
낙찰금리낮수준,1,0.8247070352584815,17,12,5,6,0.592611643517954,0.05694000959673524
자금유입증가,1,0.810952868672949,33,23,10,30,0.6363005223606926,0.06643396820445611
경기선행지수반등,1,0.8101724670130206,20,14,6,7,0.6002670555670221,0.06295759749806108
경제회복세이,1,0.8101724670130206,20,14,6,16,0.6002670555670221,0.06295759749806108
경기불확실성커지,1,0.8101724670130206,20,14,6,12,0.6002670555670221,0.06295759749806108
이자부담증가,1,0.8101724670130206,20,14,6,13,0.6002670555670221,0.06295759749806108
달러화엔화상승,1,0.8053831678972019,58,40,18,36,0.6988513444250796,0.07534539837894674
자금유입둔화,1,0.7995842643815976,23,16,7,22,0.6079497839323104,0.06771490346713728
통화정책경제견조성장,1,0.7995842643815976,23,16,7,8,0.6079497839323104,0.06771490346713728
소비자물가상승률전망,1,0.7995842643815976,23,16,7,18,0.6079497839323104,0.06771490346713728
금리인상카드꺼내,1,0.7995842643815976,23,16,7,10,0.6079497839323104,0.06771490346713728
국채선물급등,1,0.7917383006806116,26,18,8,18,0.6156308848578282,0.07156605591787307
통화완화강화,1,0.7917383006806116,26,18,8,24,0.6156308848578282,0.07156605591787307
호황누렸,1,0.7917383006806116,26,18,8,12,0.6156308848578282,0.07156605591787307
국제유가급락,1,0.7884131442115265,57,39,18,40,0.6942223718090086,0.08214275170022561
경기회복세둔화,1,0.7859393508600307,69,47,22,26,0.7211187907594905,0.08644209273007783
금리안정적,1,0.785855046668305,29,20,9,30,0.6232892900421443,0.07474800079391436
인플레이션기대심리높,1,0.785855046668305,29,20,9,29,0.6232892900421443,0.07474800079391436
장기금리낮수준,1,0.781413084551807,32,22,10,13,0.6309093332071398,0.0774233882168062
경기회복기대심리높,1,0.7755189444758974,38,26,12,27,0.6459891242548899,0.08168118119543566
이자부담늘어나,1,0.7736264644206705,41,28,13,31,0.6534320313779812,0.08340753985364607
경제영향줄,1,0.7736264644206705,41,28,13,18,0.6534320313779812,0.08340753985364607
금리인상필요,1,0.7706043620976268,170,113,57,99,0.8772960022324262,0.113670973058263
경기개선기대심리높,1,0.7677198461351384,16,11,5,11,0.5861842883315369,0.0770319966439151
유로화오르,1,0.7677198461351384,16,11,5,12,0.5861842883315369,0.0770319966439151
재고줄어들,1,0.7677198461351384,16,11,5,14,0.5861842883315369,0.0770319966439151
국제유가급등따른,1,0.7677198461351384,16,11,5,9,0.5861842883315369,0.0770319966439151
자산축소시작,1,0.7677198461351384,16,11,5,36,0.5861842883315369,0.0770319966439151
매입양적완화조치,1,0.7677198461351384,16,11,5,4,0.5861842883315369,0.0770319966439151
외환시장안정위한,1,0.7677198461351384,16,11,5,11,0.5861842883315369,0.0770319966439151
단기금리올라가,1,0.7677198461351384,16,11,5,5,0.5861842883315369,0.0770319966439151
양적완화중단,1,0.7677198461351384,16,11,5,23,0.5861842883315369,0.0770319966439151
경제호전,1,0.7677198461351384,16,11,5,30,0.5861842883315369,0.0770319966439151
유로화강세나타내,1,0.7677198461351384,16,11,5,12,0.5861842883315369,0.0770319966439151
유로화가치상승,1,0.7677198461351384,16,11,5,12,0.5861842883315369,0.0770319966439151
엔화강세저지,1,0.7677198461351384,16,11,5,13,0.5861842883315369,0.0770319966439151
기업실적호조힘입,1,0.7595659569947801,19,13,6,8,0.5940006304387198,0.08117300008583549
불확실성해소따른,1,0.7595659569947801,19,13,6,23,0.5940006304387198,0.08117300008583549
중소기업대출늘어나,1,0.7542703821948495,22,15,7,6,0.6018383275599175,0.08430874242775632
경제성장률떨어질,1,0.7542703821948495,22,15,7,16,0.6018383275599175,0.08430874242775632
엔화급락,1,0.7542703821948495,22,15,7,11,0.6018383275599175,0.08430874242775632
금리인상보,1,0.7542703821948495,22,15,7,23,0.6018383275599175,0.08430874242775632
경제완만한회복세이,1,0.7542703821948495,22,15,7,6,0.6018383275599175,0.08430874242775632
불확실성줄이,1,0.7542703821948495,22,15,7,19,0.6018383275599175,0.08430874242775632
기준금리인하주장,1,0.7486270802910426,28,19,9,26,0.6174573572463176,0.08876821921589562
양적완화줄이,1,0.7486270802910426,28,19,9,41,0.6174573572463176,0.08876821921589562
안정적성장,1,0.7473079985645987,31,21,10,24,0.6252025456151594,0.09042144338747617
수출높신장세,1,0.7465154687306597,40,27,13,12,0.6480561515753628,0.09406325085567693
경제안정,1,0.7465154687306597,40,27,13,34,0.6480561515753628,0.09406325085567693
인플레이션억제위한,1,0.7189084368211867,42,28,14,25,0.6500091874756005,0.10629966760634353
미국채가격하락,1,0.7110150789878547,33,22,11,25,0.6269589272251126,0.10589488411991449
경제충격줄,1,0.7110150789878547,33,22,11,28,0.6269589272251126,0.10589488411991449
채권시장오,1,0.7082109166762678,30,20,10,19,0.6191028444423496,0.10575573453823593
인플레이션유지,1,0.7082109166762678,30,20,10,23,0.6191028444423496,0.10575573453823593
성장이루,1,0.7082109166762678,30,20,10,14,0.6191028444423496,0.10575573453823593
성장보였,1,0.705315543552751,27,18,9,10,0.6111645226885734,0.1056144194362571
견조성장세유지,1,0.705315543552751,27,18,9,17,0.6111645226885734,0.1056144194362571
채권투자심리위축,1,0.7023260072498037,24,16,8,34,0.6031466318185397,0.10547090533350219
달러화강세나타낼,1,0.7023260072498037,24,16,8,16,0.6031466318185397,0.10547090533350219
실적올렸,1,0.7023260072498037,24,16,8,22,0.6031466318185397,0.10547090533350219
투자수요증가,1,0.7023260072498037,24,16,8,5,0.6031466318185397,0.10547090533350219
외환시장안정위해,1,0.6992392595139738,21,14,7,9,0.5950519849714935,0.10532515828343902
달러화엔화움직여높,1,0.6992392595139738,21,14,7,15,0.5950519849714935,0.10532515828343902
금리인상가능성남,1,0.6992392595139738,21,14,7,20,0.5950519849714935,0.10532515828343902
경상수지흑자이,1,0.6992392595139738,21,14,7,13,0.5950519849714935,0.10532515828343902
달러원떨어지,1,0.6992392595139738,21,14,7,26,0.5950519849714935,0.10532515828343902
위험선호강화,1,0.6992392595139738,21,14,7,56,0.5950519849714935,0.10532515828343902
물가오른,1,0.6992392595139738,21,14,7,12,0.5950519849714935,0.10532515828343902
금리인상속도늦출,1,0.6960521538407483,18,12,6,10,0.586883538324718,0.10517714387145256
유로화달러화오른,1,0.6960521538407483,18,12,6,17,0.586883538324718,0.10517714387145256
금리낮대출,1,0.6960521538407483,18,12,6,11,0.586883538324718,0.10517714387145256
이자낮추,1,0.6960521538407483,18,12,6,11,0.586883538324718,0.10517714387145256
아파트가격오르,1,0.6960521538407483,18,12,6,19,0.586883538324718,0.10517714387145256
금리인상예정,1,0.6960521538407483,18,12,6,13,0.586883538324718,0.10517714387145256
가격변동성확대,1,0.6960521538407483,18,12,6,9,0.586883538324718,0.10517714387145256
회사채수익률상승,1,0.6960521538407483,18,12,6,8,0.586883538324718,0.10517714387145256
재정악화,1,0.6960521538407483,18,12,6,14,0.586883538324718,0.10517714387145256
수익성확보,1,0.6927614431499078,15,10,5,13,0.5786443904588278,0.10502682721307892
고용호조불구하,1,0.6927614431499078,15,10,5,9,0.5786443904588278,0.10502682721307892
기준금리인상이어지,1,0.6927614431499078,15,10,5,10,0.5786443904588278,0.10502682721307892
irs스프레드확대스왑레이트나타냈,1,0.6927614431499078,15,10,5,7,0.5786443904588278,0.10502682721307892
높수익률보였,1,0.6927614431499078,15,10,5,7,0.5786443904588278,0.10502682721307892
불확실성확대따른,1,0.6927614431499078,15,10,5,10,0.5786443904588278,0.10502682721307892
유가원유재고감소,1,0.6927614431499078,15,10,5,11,0.5786443904588278,0.10502682721307892
은행채신용스프레드확대,1,0.6927614431499078,15,10,5,12,0.5786443904588278,0.10502682721307892
유로화약세,1,0.6927614431499078,15,10,5,17,0.5786443904588278,0.10502682721307892
국가부도위험나타내,1,0.6927614431499078,15,10,5,12,0.5786443904588278,0.10502682721307892
금리인상강력하,1,0.6927614431499078,15,10,5,4,0.5786443904588278,0.10502682721307892
실업률개선,1,0.6927614431499078,15,10,5,10,0.5786443904588278,0.10502682721307892
민간채권수익률민평하락,1,0.6927614431499078,15,10,5,16,0.5786443904588278,0.10502682721307892
미국채irs스프레드확대,1,0.6927614431499078,15,10,5,7,0.5786443904588278,0.10502682721307892
성장세힘입,1,0.6927614431499078,15,10,5,18,0.5786443904588278,0.10502682721307892
위안화변동폭확대,1,0.6927614431499078,15,10,5,13,0.5786443904588278,0.10502682721307892
단기금리하방경직성유지,1,0.6927614431499078,15,10,5,4,0.5786443904588278,0.10502682721307892
경기회복모멘텀둔화,1,0.6881435179692321,41,27,14,26,0.6442151603184626,0.11901000311919886
불확실성줄어들,1,0.6830027453313543,38,25,13,25,0.6364581588687948,0.11987982636360882
건설투자부진,1,0.6709889959855349,32,21,11,18,0.6206107857761776,0.12219635928574897
cd금리급등,1,0.6683810807298374,46,30,16,9,0.6536377765181667,0.12992196429335284
주문감소,1,0.6638001958054689,29,19,10,23,0.6125093107448356,0.1237682134169986
원자재가격오르,1,0.6638001958054689,29,19,10,17,0.6125093107448356,0.1237682134169986
기준금리인상통해,1,0.6618043221281549,43,28,15,34,0.6459290826921333,0.13145363936516827
역외환율상승반영,1,0.6554918472500755,26,17,9,11,0.6042755345003712,0.1257492530020689
금리인상현실화,1,0.6554918472500755,26,17,9,50,0.6042755345003712,0.1257492530020689
부동산가격상승,1,0.6529058389052242,51,33,18,28,0.6629739640637418,0.13921721634368123
시장심리안정,1,0.6463361099740486,37,24,13,33,0.6301274762258933,0.13536184067332416
대출줄,1,0.6456527544227226,23,15,8,10,0.5958901138053837,0.12830763181268587
인플레이션압력줄어들,1,0.6456527544227226,23,15,8,11,0.5958901138053837,0.12830763181268587
gdp상회,1,0.6456527544227226,23,15,8,18,0.5958901138053837,0.12830763181268587
금리상승압력제한적,1,0.6456527544227226,23,15,8,21,0.5958901138053837,0.12830763181268587
금리인상가능성따른,1,0.6336237205803923,20,13,7,35,0.5873191968193618,0.1317170671105989
자금유입계속,1,0.6336237205803923,20,13,7,14,0.5873191968193618,0.1317170671105989
일자리감소,1,0.6336237205803923,20,13,7,8,0.5873191968193618,0.1317170671105989
경제성장뒷받침,1,0.6336237205803923,20,13,7,11,0.5873191968193618,0.1317170671105989
달러약세반영,1,0.6336237205803923,20,13,7,17,0.5873191968193618,0.1317170671105989
비용부담,1,0.6336237205803923,20,13,7,37,0.5873191968193618,0.1317170671105989
듀레이션늘리,1,0.6327790132858393,53,34,19,36,0.6646626054901309,0.1494836414736001
주택가격오르,1,0.6264064843064838,31,20,11,26,0.6137455919701729,0.1409773944354977
경기모멘텀둔화,1,0.6264064843064838,31,20,11,44,0.6137455919701729,0.1409773944354977
매출늘,1,0.6264064843064838,31,20,11,24,0.6137455919701729,0.1409773944354977
경기선행지수상승,1,0.6184104795400391,79,50,29,50,0.7145392180356903,0.16847012020349914
경기지표호조보이,1,0.6182773101177808,17,11,6,17,0.5784999470266046,0.13645434924292138
금리인상압력높,1,0.6182773101177808,17,11,6,17,0.5784999470266046,0.13645434924292138
실적줄,1,0.6182773101177808,17,11,6,13,0.5784999470266046,0.13645434924292138
양적완화언급,1,0.6182773101177808,17,11,6,20,0.5784999470266046,0.13645434924292138
낙찰금리높수준,1,0.6182773101177808,17,11,6,20,0.5784999470266046,0.13645434924292138
경제지표호조보일,1,0.6182773101177808,17,11,6,11,0.5784999470266046,0.13645434924292138
대출증가세둔화,1,0.6182773101177808,17,11,6,15,0.5784999470266046,0.13645434924292138
물가안정하,1,0.6182773101177808,17,11,6,14,0.5784999470266046,0.13645434924292138
달러강세견인,1,0.6182773101177808,17,11,6,12,0.5784999470266046,0.13645434924292138
경제호조나타내,1,0.6182773101177808,17,11,6,10,0.5784999470266046,0.13645434924292138
주택담보대출금리올랐,1,0.6182773101177808,17,11,6,11,0.5784999470266046,0.13645434924292138
금리상승세돌아섰,1,0.6182773101177808,17,11,6,16,0.5784999470266046,0.13645434924292138
국채발행증가따른,1,0.6182773101177808,17,11,6,3,0.5784999470266046,0.13645434924292138
변동성줄어드,1,0.6182773101177808,17,11,6,7,0.5784999470266046,0.13645434924292138
소비자물가오른,1,0.6182773101177808,17,11,6,11,0.5784999470266046,0.13645434924292138
금리인상유력,1,0.6182773101177808,17,11,6,32,0.5784999470266046,0.13645434924292138
경제견조성장,1,0.6063320990841461,36,23,13,14,0.6233482542283458,0.15276077433498172
자본유출우려,1,0.5989896025811154,25,16,9,31,0.5966068715619934,0.14961775844036687
물가상승유발,1,0.5989896025811154,25,16,9,15,0.5966068715619934,0.14961775844036687
기대심리축소,1,0.5989896025811154,25,16,9,18,0.5966068715619934,0.14961775844036687
실적증가,1,0.5962628347427208,57,36,21,58,0.6678912928155076,0.16892131252206205
환율상승,1,0.5929386224201572,33,21,12,23,0.6149095119819113,0.15712877638573602
국고채지표금리오른,1,0.5870436114903392,80,50,30,78,0.71071253254096,0.18492336257052341
유가급락,1,0.584382045680329,85,53,32,69,0.7190656316572985,0.18861875513426504
물가상승압력커질,1,0.5817221757798381,46,29,17,30,0.642622183862463,0.1699306755049598
자산축소,1,0.580634868313562,22,14,8,28,0.5876300300300911,0.15589994546995342
글로벌경제회복세,1,0.580634868313562,22,14,8,10,0.5876300300300911,0.15589994546995342
변동성줄어든,1,0.580634868313562,22,14,8,13,0.5876300300300911,0.15589994546995342
기대심리유지,1,0.5785511479039964,38,24,14,48,0.6246279494535488,0.16675867976279504
경기둔화인한,1,0.5785511479039964,38,24,14,20,0.6246279494535488,0.16675867976279504
금리인상둘러싼,1,0.5785511479039964,38,24,14,30,0.6246279494535488,0.16675867976279504
물가안정세유지,1,0.5785511479039964,38,24,14,8,0.6246279494535488,0.16675867976279504
기준금리인상신중,1,0.5772874044496199,30,19,11,29,0.6062354576915241,0.16246367088910665
하방위험요인작용,1,0.5772874044496199,30,19,11,5,0.6062354576915241,0.16246367088910665
경제타격줄,1,0.5772874044496199,30,19,11,21,0.6062354576915241,0.16246367088910665
달러화떨어지,1,0.5772874044496199,30,19,11,24,0.6062354576915241,0.16246367088910665
금리인상기대높,1,0.5772874044496199,30,19,11,23,0.6062354576915241,0.16246367088910665
비용상승,1,0.5772874044496199,30,19,11,21,0.6062354576915241,0.16246367088910665
금리변동성축소,1,0.5772874044496199,30,19,11,19,0.6062354576915241,0.16246367088910665
기준금리오를,1,0.5741054965371812,51,32,19,69,0.6521810393446889,0.17644783506037293
인플레이션기대심리확산,1,0.5684434782420287,43,27,16,9,0.6343596157081086,0.17453528361633378
실업수당청구증가,1,0.5642364835326883,61,38,23,37,0.6709617819580868,0.18690647827494963
물가상승압력높,1,0.5633211860183869,159,97,62,143,0.8157728185728328,0.22785632340965484
환율상승요인작용,1,0.5630534589068148,35,22,13,20,0.6160284061667677,0.1721999851396395
금리올린,1,0.5628325075359906,149,91,58,102,0.8048667682558682,0.2251320246918301
물가안정위해,1,0.5620158341306447,129,79,50,105,0.7806003974115987,0.21886658031456396
금리인하기대심리높,1,0.5612355913496354,48,30,18,36,0.6440449933892205,0.18099089180636202
경제침체,1,0.5612355913496354,48,30,18,39,0.6440449933892205,0.18099089180636202
콜금리올릴,1,0.5612355913496354,48,30,18,14,0.6440449933892205,0.18099089180636202
경제성장률전망낮추,1,0.5586627770915427,27,17,10,17,0.5972669409087314,0.16910792654780415
금리동결전망,1,0.5586627770915427,27,17,10,23,0.5972669409087314,0.16910792654780415
경제여건악화,1,0.5586627770915427,27,17,10,12,0.5972669409087314,0.16910792654780415
가격변수변동성확대,1,0.5586627770915427,27,17,10,12,0.5972669409087314,0.16910792654780415
금리인상불가피하,1,0.5586627770915427,27,17,10,21,0.5972669409087314,0.16910792654780415
금리인상신호보내,1,0.5572916841351025,19,12,7,10,0.5782365101569147,0.16437284429965002
기준금리인상이,1,0.5572916841351025,19,12,7,9,0.5782365101569147,0.16437284429965002
물가상승인해,1,0.5572916841351025,19,12,7,6,0.5782365101569147,0.16437284429965002
금리하락나타날,1,0.5572916841351025,19,12,7,7,0.5782365101569147,0.16437284429965002
국고채권금리오른,1,0.5572916841351025,19,12,7,28,0.5782365101569147,0.16437284429965002
실업수당청구늘어난,1,0.5572916841351025,19,12,7,10,0.5782365101569147,0.16437284429965002
국채선물가격상승,1,0.5572916841351025,19,12,7,15,0.5782365101569147,0.16437284429965002
수출호조,1,0.5560607150839696,53,33,20,19,0.6536413806613914,0.1864718162599586
글로벌경제회복,1,0.5560607150839696,53,33,20,45,0.6536413806613914,0.1864718162599586
주택담보대출늘,1,0.5534511704197478,40,25,15,34,0.6258726610304133,0.17990096116608312
금리인상임박했,1,0.5468806030345519,45,28,17,38,0.635693484474182,0.18619954166859048
채권수익률하락,1,0.5468806030345519,45,28,17,46,0.635693484474182,0.18619954166859048
유로화하락압력받,1,0.545056513356998,32,20,12,21,0.6071485542591402,0.17876509134924737
금리하락압력받,1,0.545056513356998,32,20,12,31,0.6071485542591402,0.17876509134924737
통화가치급락,1,0.545056513356998,32,20,12,30,0.6071485542591402,0.17876509134924737
콜금리인상,1,0.5421170730320024,450,270,180,232,0.912579019958523,0.27094537386782475
금리수준유지,1,0.5391340483615863,110,67,43,86,0.7491876478522225,0.22431712281602292
원화강세이어질,1,0.5363612212603115,37,23,14,18,0.6171226204574549,0.18622202513211086
기준금리수준유지,1,0.5363296736529755,411,246,165,400,0.909062008706215,0.2743415260968929
금리인하기대낮,1,0.5360086759882368,24,15,9,16,0.5879071130808299,0.17758161804273115
경기회복저해,1,0.5360086759882368,24,15,9,21,0.5879071130808299,0.17758161804273115
금리내릴없,1,0.5360086759882368,24,15,9,20,0.5879071130808299,0.17758161804273115
국고채금리오르,1,0.5360086759882368,24,15,9,26,0.5879071130808299,0.17758161804273115
물가끌어올리,1,0.5360086759882368,24,15,9,27,0.5879071130808299,0.17758161804273115
달러강세부추기,1,0.5360086759882368,24,15,9,8,0.5879071130808299,0.17758161804273115
기준금리인상따른,1,0.5309566242212351,178,107,71,116,0.8250482182440833,0.2527561295464352
실업률낮수준,1,0.5262621906171261,16,10,6,14,0.5681882827094947,0.1763488503008574
업황부진,1,0.5262621906171261,16,10,6,11,0.5681882827094947,0.1763488503008574
물가압력완화,1,0.5262621906171261,16,10,6,1,0.5681882827094947,0.1763488503008574
관망심리확산,1,0.5262621906171261,16,10,6,10,0.5681882827094947,0.1763488503008574
낮수익률오른,1,0.5262621906171261,16,10,6,10,0.5681882827094947,0.1763488503008574
부양책쓰,1,0.5262621906171261,16,10,6,24,0.5681882827094947,0.1763488503008574
경기불확실성높,1,0.5262621906171261,16,10,6,8,0.5681882827094947,0.1763488503008574
통화량늘리,1,0.5262621906171261,16,10,6,13,0.5681882827094947,0.1763488503008574
금리변동위험헤지,1,0.5262621906171261,16,10,6,1,0.5681882827094947,0.1763488503008574
불안심리덜,1,0.5262621906171261,16,10,6,7,0.5681882827094947,0.1763488503008574
장단기금리차줄어들,1,0.5262621906171261,16,10,6,11,0.5681882827094947,0.1763488503008574
인플레이션우려반영,1,0.5262621906171261,16,10,6,11,0.5681882827094947,0.1763488503008574
내외금리차확대,1,0.5262621906171261,16,10,6,11,0.5681882827094947,0.1763488503008574
수출늘어날,1,0.5238395362762736,29,18,11,13,0.5979144046593177,0.18682034352083274
채권가격올랐,1,0.5238395362762736,29,18,11,21,0.5979144046593177,0.18682034352083274
자산건전성악화,1,0.5166659034767198,34,21,13,20,0.6080529538301113,0.193762079964827
금리하향안정,1,0.5166659034767198,34,21,13,12,0.6080529538301113,0.193762079964827
금리인상이,1,0.5093488159221471,59,36,23,43,0.6578766820483847,0.21384367964279577
고용호조따른,1,0.5089497294618577,54,33,21,49,0.6481681332893917,0.21091500962089305
성장이,1,0.5089497294618577,54,33,21,53,0.6481681332893917,0.21091500962089305
금리인하효과지켜보,1,0.5077065790882787,21,13,8,9,0.5779879428760525,0.18870978093172147
채권시장강세보임,1,0.5077065790882787,21,13,8,23,0.5779879428760525,0.18870978093172147
금리상승유발,1,0.5077065790882787,21,13,8,11,0.5779879428760525,0.18870978093172147
채권시장국채가격상승,1,0.5077065790882787,21,13,8,11,0.5779879428760525,0.18870978093172147
경제과열막,1,0.5077065790882787,21,13,8,4,0.5779879428760525,0.18870978093172147
금리인상어려운,1,0.5077065790882787,21,13,8,14,0.5779879428760525,0.18870978093172147
내구재주문감소,1,0.5077065790882787,21,13,8,27,0.5779879428760525,0.18870978093172147
민평금리높수준,1,0.4983788961317268,26,16,10,19,0.588207552678375,0.19690271437482354
달러화떨어졌,1,0.4983788961317268,26,16,10,15,0.588207552678375,0.19690271437482354
금리인상위한,1,0.49589793640913093,61,37,24,91,0.6592529070985955,0.22214427885114135
경기개선따른,1,0.49589793640913093,61,37,24,39,0.6592529070985955,0.22214427885114135
고용지표상회,1,0.49368183000850463,31,19,12,14,0.5985784246010216,0.20288628803729206
경제침체빠질,1,0.49368183000850463,31,19,12,29,0.5985784246010216,0.20288628803729206
경기회복기대커지,1,0.49368183000850463,31,19,12,25,0.5985784246010216,0.20288628803729206
내수개선,1,0.49368183000850463,31,19,12,28,0.5985784246010216,0.20288628803729206
달러원떨어진,1,0.49368183000850463,31,19,12,22,0.5985784246010216,0.20288628803729206
물가상승률고려,1,0.49158284310748623,36,22,14,38,0.6089655579852935,0.20755416205047092
연방기금금리재할인율인하,1,0.49158284310748623,36,22,14,0,0.6089655579852935,0.20755416205047092
기준금리인상필요,1,0.4910491306092668,41,25,16,20,0.6192925038854264,0.2113710697343671
단기금리오르,1,0.4910491306092668,41,25,16,22,0.6192925038854264,0.2113710697343671
cd금리오르,1,0.4812950756646348,92,55,37,40,0.7088909504374926,0.24821187163018563
구조개선,1,0.4791723392259921,75,45,30,67,0.6808994281652428,0.23972991886146744
양적완화축소,1,0.4739153550679267,189,111,78,272,0.8170884621407933,0.2916187047439814
물가상승압력,1,0.4736739428443415,94,56,38,67,0.7101622000707423,0.2536145695796825
금리인상직접적,1,0.47116323689107853,18,11,7,22,0.5671945962863069,0.20387109959660937
역외차액결제선물환환율반영오른,1,0.47116323689107853,18,11,7,12,0.5671945962863069,0.20387109959660937
낮금리제시,1,0.47116323689107853,18,11,7,12,0.5671945962863069,0.20387109959660937
위험회피심리완화,1,0.47116323689107853,18,11,7,15,0.5671945962863069,0.20387109959660937
은행채금리상승,1,0.47116323689107853,18,11,7,7,0.5671945962863069,0.20387109959660937
금리인상단기적,1,0.47116323689107853,18,11,7,18,0.5671945962863069,0.20387109959660937
위험자산투자,1,0.47116323689107853,18,11,7,11,0.5671945962863069,0.20387109959660937
안전자산선호부각,1,0.47116323689107853,18,11,7,17,0.5671945962863069,0.20387109959660937
위험선호심리살아나,1,0.47116323689107853,18,11,7,11,0.5671945962863069,0.20387109959660937
경기회복둔화,1,0.47116323689107853,18,11,7,12,0.5671945962863069,0.20387109959660937
경기호조보이,1,0.47116323689107853,18,11,7,12,0.5671945962863069,0.20387109959660937
금리인상나섰,1,0.47116323689107853,18,11,7,21,0.5671945962863069,0.20387109959660937
수요감소따른,1,0.47116323689107853,18,11,7,16,0.5671945962863069,0.20387109959660937
회사채금리올랐,1,0.47116323689107853,18,11,7,28,0.5671945962863069,0.20387109959660937
기준금리올라갈,1,0.47116323689107853,18,11,7,17,0.5671945962863069,0.20387109959660937
cd금리급락,1,0.47116323689107853,18,11,7,13,0.5671945962863069,0.20387109959660937
경제안정적성장,1,0.47116323689107853,18,11,7,25,0.5671945962863069,0.20387109959660937
경기둔화이어질,1,0.47116323689107853,18,11,7,16,0.5671945962863069,0.20387109959660937
금리인상기대약화,1,0.47116323689107853,18,11,7,16,0.5671945962863069,0.20387109959660937
물가안정세보이,1,0.4693341953476229,38,23,15,14,0.609897752728282,0.2202521138561237
기대심리높여,1,0.46743926147172177,33,20,13,18,0.5992776124208272,0.21746998282110072
성장높,1,0.46743926147172177,33,20,13,19,0.5992776124208272,0.21746998282110072
cd금리올랐,1,0.46743926147172177,33,20,13,18,0.5992776124208272,0.21746998282110072
경제충격주,1,0.46743926147172177,33,20,13,15,0.5992776124208272,0.21746998282110072
경제낙관적,1,0.46743926147172177,33,20,13,26,0.5992776124208272,0.21746998282110072
금리인상나,1,0.46717899640567095,23,14,9,14,0.5778282458962093,0.20982596004508697
민간소비위축,1,0.46717899640567095,23,14,9,15,0.5778282458962093,0.20982596004508697
기준금리동결유지,1,0.46717899640567095,23,14,9,25,0.5778282458962093,0.20982596004508697
성장보이,1,0.46717899640567095,23,14,9,39,0.5778282458962093,0.20982596004508697
엔화오르,1,0.46717899640567095,23,14,9,9,0.5778282458962093,0.20982596004508697
자금난덜,1,0.46717899640567095,23,14,9,8,0.5778282458962093,0.20982596004508697
업황개선,1,0.46717899640567095,23,14,9,14,0.5778282458962093,0.20982596004508697
금리인상우려커지,1,0.46717899640567095,23,14,9,17,0.5778282458962093,0.20982596004508697
달러화하락압력가했,1,0.4664709705328334,28,17,11,22,0.5885655035302177,0.21411224248366498
실업수당청구줄어든,1,0.4664709705328334,28,17,11,15,0.5885655035302177,0.21411224248366498
통화가치하락,1,0.4664709705328334,28,17,11,43,0.5885655035302177,0.21411224248366498
금리수준상승,1,0.4664709705328334,28,17,11,29,0.5885655035302177,0.21411224248366498
채권시장국채선물내린,1,0.4652863656365611,72,43,29,82,0.6728959268343857,0.2455322742204381
통화정책완화유지,1,0.46336638084798953,55,33,22,51,0.6421561752185565,0.23546541239366703
수출개선,1,0.46336638084798953,55,33,22,44,0.6421561752185565,0.23546541239366703
금리인상가능성열,1,0.4591100199220641,124,73,51,142,0.7475994923468033,0.27710918960671993
인플레이션우려따른,1,0.4557087453512825,62,37,25,31,0.6534910928487024,0.2443189077817953
기준금리유지,1,0.45554917718963317,443,257,186,402,0.8862325078270101,0.3314667491978752
경제회복세,1,0.4543354390867387,45,27,18,45,0.6214942447613951,0.23316245254601747
국가신용등급상향조정,1,0.449512319421576,40,24,16,47,0.6108569012841676,0.23196626320338676
양적완화단행,1,0.449512319421576,40,24,16,44,0.6108569012841676,0.23196626320338676
유가올랐,1,0.449512319421576,40,24,16,31,0.6108569012841676,0.23196626320338676
수출호조힘입,1,0.44471684272556344,52,31,21,42,0.6331471250563403,0.2433298382666076
금리하락요인작용,1,0.44471684272556344,52,31,21,44,0.6331471250563403,0.2433298382666076
콜금리목표수준유지,1,0.444632249344739,64,38,26,41,0.6548075059012508,0.25170738168070933
경제성장률상향조정,1,0.4444737407010797,35,21,14,28,0.6000232266583723,0.23073949206477554
기대인플레이션높,1,0.4444737407010797,35,21,14,24,0.6000232266583723,0.23073949206477554
금리인상맞물려,1,0.4444737407010797,35,21,14,27,0.6000232266583723,0.23073949206477554
신용경색우려완화,1,0.4444737407010797,35,21,14,31,0.6000232266583723,0.23073949206477554
글로벌경기회복따른,1,0.4392116656191405,30,18,12,35,0.5890000192222906,0.22948155949141272
시장금리상승제한,1,0.4392116656191405,30,18,12,27,0.5890000192222906,0.22948155949141272
경제성장위한,1,0.4392116656191405,30,18,12,18,0.5890000192222906,0.22948155949141272
금리하락견인,1,0.4392116656191405,30,18,12,46,0.5890000192222906,0.22948155949141272
국고채금리떨어진,1,0.4392116656191405,30,18,12,16,0.5890000192222906,0.22948155949141272
경기회복반영,1,0.4392116656191405,30,18,12,19,0.5890000192222906,0.22948155949141272
가계부채안정적관리,1,0.4392116656191405,30,18,12,11,0.5890000192222906,0.22948155949141272
금리동결유지,1,0.4385380670641641,47,28,19,27,0.6226191123946194,0.24298501652267696
물가안정목표,1,0.4385380670641641,47,28,19,38,0.6226191123946194,0.24298501652267696
투자매력높,1,0.43803317760525773,78,46,32,59,0.6768816622186318,0.264491997216075
금리인상가능성높,1,0.43702534047221175,316,182,134,248,0.8645006890770897,0.3386473172550652
달러화오,1,0.433717849852866,25,15,10,14,0.5777947777104945,0.22819188898330903
공공요금인상,1,0.433717849852866,25,15,10,11,0.5777947777104945,0.22819188898330903
높금리제시,1,0.433717849852866,25,15,10,30,0.5777947777104945,0.22819188898330903
채권시장약세,1,0.433717849852866,25,15,10,28,0.5777947777104945,0.22819188898330903
성장성있,1,0.433717849852866,25,15,10,17,0.5777947777104945,0.22819188898330903
단기물상승,1,0.433717849852866,25,15,10,25,0.5777947777104945,0.22819188898330903
달러화오른,1,0.433717849852866,25,15,10,28,0.5777947777104945,0.22819188898330903
국채금리떨어진,1,0.433717849852866,25,15,10,17,0.5777947777104945,0.22819188898330903
이익감소,1,0.43177145209973355,42,25,17,44,0.6118474533843561,0.2428005386253027
금리상승압력,1,0.43177145209973355,42,25,17,43,0.6118474533843561,0.2428005386253027
통화정책완화적,1,0.43163964599860694,54,32,22,55,0.63437397222908,0.2518213430882288
경기회복세,1,0.4286534404053235,203,117,86,160,0.8125118909026283,0.3249070650599799
재무구조유지,1,0.4279838500166666,20,12,8,11,0.5664157093491502,0.22686990858134862
금리올리쉽,1,0.4279838500166666,20,12,8,18,0.5664157093491502,0.22686990858134862
채권투자확대,1,0.4279838500166666,20,12,8,15,0.5664157093491502,0.22686990858134862
경쟁력떨어지,1,0.4279838500166666,20,12,8,17,0.5664157093491502,0.22686990858134862
원화강세보였,1,0.4279838500166666,20,12,8,13,0.5664157093491502,0.22686990858134862
기대심리올랐,1,0.4279838500166666,20,12,8,20,0.5664157093491502,0.22686990858134862
금리인상가능성상존,1,0.4279838500166666,20,12,8,10,0.5664157093491502,0.22686990858134862
취업자증가,1,0.4279838500166666,20,12,8,26,0.5664157093491502,0.22686990858134862
달러강세부추겼,1,0.4279838500166666,20,12,8,14,0.5664157093491502,0.22686990858134862
경제성장미치,1,0.4279838500166666,20,12,8,18,0.5664157093491502,0.22686990858134862
금리넘어서,1,0.4279838500166666,20,12,8,15,0.5664157093491502,0.22686990858134862
금리인하기대심리확대,1,0.4279838500166666,20,12,8,10,0.5664157093491502,0.22686990858134862
수출늘어난,1,0.4279838500166666,20,12,8,14,0.5664157093491502,0.22686990858134862
주택판매가격감소,1,0.4242556572233822,37,22,15,39,0.600821454013826,0.24285287697119048
경기상승따른,1,0.4242556572233822,37,22,15,19,0.600821454013826,0.24285287697119048
불확실성증가,1,0.4242556572233822,37,22,15,35,0.600821454013826,0.24285287697119048
기준금리인상이뤄질,1,0.4242556572233822,37,22,15,29,0.600821454013826,0.24285287697119048
재고감소,1,0.4230294424487808,75,44,31,41,0.6686057544291927,0.27106022938909685
금리낙폭축소,1,0.42200103372562014,15,9,6,12,0.5548717342189087,0.22551505237575661
미국채금리하락불구하,1,0.42200103372562014,15,9,6,9,0.5548717342189087,0.22551505237575661
실물지표개선,1,0.42200103372562014,15,9,6,15,0.5548717342189087,0.22551505237575661
금리하락어렵,1,0.42200103372562014,15,9,6,20,0.5548717342189087,0.22551505237575661
연체율증가,1,0.42200103372562014,15,9,6,12,0.5548717342189087,0.22551505237575661
소비확대,1,0.42200103372562014,15,9,6,11,0.5548717342189087,0.22551505237575661
자산늘어나,1,0.42200103372562014,15,9,6,11,0.5548717342189087,0.22551505237575661
국제유가상승세,1,0.42200103372562014,15,9,6,6,0.5548717342189087,0.22551505237575661
억제위해기준금리인상,1,0.42200103372562014,15,9,6,11,0.5548717342189087,0.22551505237575661
금리수준낮추,1,0.42200103372562014,15,9,6,16,0.5548717342189087,0.22551505237575661
완화정책유지,1,0.42200103372562014,15,9,6,21,0.5548717342189087,0.22551505237575661
안전자산선호인해,1,0.42200103372562014,15,9,6,9,0.5548717342189087,0.22551505237575661
경제낙관적전망,1,0.42200103372562014,15,9,6,9,0.5548717342189087,0.22551505237575661
금리인상길,1,0.42200103372562014,15,9,6,9,0.5548717342189087,0.22551505237575661
낮금리인해,1,0.42200103372562014,15,9,6,9,0.5548717342189087,0.22551505237575661
기준금리인상중단,1,0.42200103372562014,15,9,6,7,0.5548717342189087,0.22551505237575661
서부텍사스산원유가격높,1,0.42200103372562014,15,9,6,4,0.5548717342189087,0.22551505237575661
인플레이션기대높,1,0.42200103372562014,15,9,6,13,0.5548717342189087,0.22551505237575661
금리인상가능성낮추,1,0.42200103372562014,15,9,6,10,0.5548717342189087,0.22551505237575661
금리상승기다리,1,0.42200103372562014,15,9,6,6,0.5548717342189087,0.22551505237575661
경기꺾이,1,0.42200103372562014,15,9,6,15,0.5548717342189087,0.22551505237575661
물가안정두,1,0.42200103372562014,15,9,6,11,0.5548717342189087,0.22551505237575661
기대심리증대,1,0.42200103372562014,15,9,6,17,0.5548717342189087,0.22551505237575661
금리인상앞두,1,0.4217210983989277,140,81,59,138,0.755215505241287,0.3071493365855713
경기회복따른,1,0.4204869197236427,246,141,105,187,0.8343689052288468,0.3403609204594584
달러화엔화거래올랐,1,0.41959071857977603,56,33,23,33,0.63561074097284,0.25984710140661504
유로화강세견인,1,0.4157341201522571,32,19,13,14,0.5895203828242337,0.2432666498618072
유가급락따른,1,0.4157341201522571,32,19,13,26,0.5895203828242337,0.2432666498618072
산업생산증가,1,0.4112738914828209,153,88,65,117,0.7653190864817128,0.31922643481747115
매수심리회복,1,0.41103908399083333,51,30,21,35,0.6249273250514144,0.2608141978589679
금리인상있,1,0.41062774248180256,169,97,72,115,0.7799558725306637,0.3258378468217625
금리낮춰,1,0.4076811409498544,116,67,49,95,0.7230713370765307,0.30421893447409704
성장유지,1,0.4069794663331008,72,42,30,61,0.6600471299832181,0.2781702305126105
낮금리유지,1,0.40635007643037313,39,23,16,29,0.6016750174696057,0.25395256317719317
주택담보대출늘어나,1,0.40635007643037313,39,23,16,22,0.6016750174696057,0.25395256317719317
채권가격급락,1,0.40576818064221665,27,16,11,17,0.5779031574301142,0.2442591430960362
순차입금증가,1,0.40576818064221665,27,16,11,18,0.5779031574301142,0.2442591430960362
달러원내린,1,0.40576818064221665,27,16,11,24,0.5779031574301142,0.2442591430960362
경기침체우려,1,0.40576818064221665,27,16,11,19,0.5779031574301142,0.2442591430960362
금리하락우호적,1,0.40576818064221665,27,16,11,18,0.5779031574301142,0.2442591430960362
경기둔화우려불구하,1,0.40576818064221665,27,16,11,11,0.5779031574301142,0.2442591430960362
고용자수감소,1,0.401415018102552,46,27,19,28,0.613930689744682,0.26219920673418673
인플레이션우려불구하,1,0.401415018102552,46,27,19,14,0.613930689744682,0.26219920673418673
대출늘리,1,0.4010293768993216,111,64,47,73,0.7148227868651656,0.30556921448429897
기대심리약화,1,0.40004752909734975,81,47,34,76,0.672512711819368,0.28815579710433264
성장둔화,1,0.39966444743270446,184,105,79,108,0.7886148371329619,0.338211071970279
경제성장률낮,1,0.39894561619319013,74,43,31,60,0.6613522404405432,0.284117781573103
인플레이션낮,1,0.398237562353029,67,39,28,35,0.6498767815320601,0.2796582817547317
설비투자증가,1,0.398237562353029,67,39,28,28,0.6498767815320601,0.2796582817547317
성장경로불확실성높,1,0.3981445597957922,60,35,25,66,0.6381156809283809,0.2746578849461769
성장뒷받침,1,0.3953494879306274,34,20,14,22,0.5901296497940116,0.25569429004913347
달러화상승폭제한,1,0.3953494879306274,34,20,14,27,0.5901296497940116,0.25569429004913347
유로화강세나타냈,1,0.3953494879306274,34,20,14,10,0.5901296497940116,0.25569429004913347
국제유가상승따른,1,0.3953494879306274,34,20,14,24,0.5901296497940116,0.25569429004913347
국제유가하락,1,0.39461155943361526,204,116,88,150,0.801256119355666,0.347779750097708
인플레이션낮추,1,0.39353361086571015,22,13,9,10,0.5658832628058718,0.24624536354099893
기준금리낮유지,1,0.39353361086571015,22,13,9,29,0.5658832628058718,0.24624536354099893
자산감소,1,0.39353361086571015,22,13,9,17,0.5658832628058718,0.24624536354099893
지급준비금적수늘,1,0.39353361086571015,22,13,9,19,0.5658832628058718,0.24624536354099893
통화완화따른,1,0.39353361086571015,22,13,9,29,0.5658832628058718,0.24624536354099893
국채수익률낮수준,1,0.39353361086571015,22,13,9,13,0.5658832628058718,0.24624536354099893
경기둔화감안,1,0.39353361086571015,22,13,9,10,0.5658832628058718,0.24624536354099893
금리올라간,1,0.39353361086571015,22,13,9,21,0.5658832628058718,0.24624536354099893
금리인하가능성낮추,1,0.39353361086571015,22,13,9,6,0.5658832628058718,0.24624536354099893
이익내,1,0.39318038658338317,83,48,35,54,0.6738037797692066,0.2934523404798708
금리인상우려높,1,0.3904009785251177,41,24,17,21,0.60258430303334,0.2641639303662966
경상수지흑자유지,1,0.3904009785251177,41,24,17,38,0.60258430303334,0.2641639303662966
근원인플레이션상승,1,0.3904009785251177,41,24,17,26,0.60258430303334,0.2641639303662966
경제악화,1,0.3885649397058517,62,36,26,38,0.6393837451746963,0.2815120545970247
연방기금금리동결,1,0.3885649397058517,62,36,26,61,0.6393837451746963,0.2815120545970247
금리인상이어지,1,0.3883497322750935,48,28,20,39,0.6150240373004544,0.2709240837802829
금리인상가능성시사,1,0.38759452306245734,201,114,87,175,0.7967044383504307,0.3515805649001195
변동성커질,1,0.3862116533687028,219,124,95,200,0.8075947001242612,0.35754730093019843
저금리유지,1,0.3845095305762527,351,198,153,326,0.8523855443961981,0.37888916316626037
금리상승인해,1,0.382149359869417,29,17,12,33,0.5781564148018515,0.25841890740470014
소득늘,1,0.382149359869417,29,17,12,37,0.5781564148018515,0.25841890740470014
통화증가높,1,0.382149359869417,29,17,12,8,0.5781564148018515,0.25841890740470014
금리상승되돌리,1,0.382149359869417,29,17,12,29,0.5781564148018515,0.25841890740470014
기준금리인상하,1,0.382149359869417,29,17,12,22,0.5781564148018515,0.25841890740470014
환율안정위해,1,0.382149359869417,29,17,12,26,0.5781564148018515,0.25841890740470014
국채금리오른,1,0.37776588831847824,57,33,24,43,0.6285411643593377,0.2838323869757238
소득늘어나,1,0.3775126591196636,36,21,15,20,0.5908269800526285,0.26695929507534394
채권매입축소,1,0.3772656956818303,17,10,7,14,0.5532566226361848,0.250127504999501
미국채가격영향상승출발,1,0.3772656956818303,17,10,7,26,0.5532566226361848,0.250127504999501
금리격차확대,1,0.3772656956818303,17,10,7,12,0.5532566226361848,0.250127504999501
고용회복,1,0.3772656956818303,17,10,7,9,0.5532566226361848,0.250127504999501
집값올랐,1,0.3772656956818303,17,10,7,20,0.5532566226361848,0.250127504999501
국채금리높수준,1,0.3772656956818303,17,10,7,13,0.5532566226361848,0.250127504999501
달러화급락따른,1,0.3772656956818303,17,10,7,6,0.5532566226361848,0.250127504999501
경기부담줄,1,0.3772656956818303,17,10,7,9,0.5532566226361848,0.250127504999501
통화가치상승,1,0.3772656956818303,17,10,7,12,0.5532566226361848,0.250127504999501
금리인상의미,1,0.3772656956818303,17,10,7,10,0.5532566226361848,0.250127504999501
수익성회복,1,0.3772656956818303,17,10,7,10,0.5532566226361848,0.250127504999501
금리인상힘실,1,0.3772656956818303,17,10,7,23,0.5532566226361848,0.250127504999501
달러엔내린,1,0.3772656956818303,17,10,7,19,0.5532566226361848,0.250127504999501
달러화하락세이,1,0.3772656956818303,17,10,7,14,0.5532566226361848,0.250127504999501
성장발목잡,1,0.3772656956818303,17,10,7,11,0.5532566226361848,0.250127504999501
가계대출증가세둔화,1,0.3772656956818303,17,10,7,11,0.5532566226361848,0.250127504999501
농산물가격급등,1,0.3772656956818303,17,10,7,5,0.5532566226361848,0.250127504999501
조달금리낮추,1,0.3772656956818303,17,10,7,20,0.5532566226361848,0.250127504999501
안전자산선호심화,1,0.3772656956818303,17,10,7,9,0.5532566226361848,0.250127504999501
금리인하지지,1,0.3772656956818303,17,10,7,5,0.5532566226361848,0.250127504999501
국고채권금리하락,1,0.3772656956818303,17,10,7,24,0.5532566226361848,0.250127504999501
국고채금리국고지표물하락,1,0.3772656956818303,17,10,7,16,0.5532566226361848,0.250127504999501
양적완화종료앞두,1,0.3772656956818303,17,10,7,15,0.5532566226361848,0.250127504999501
투자우호적,1,0.3772656956818303,17,10,7,7,0.5532566226361848,0.250127504999501
수익늘,1,0.3772656956818303,17,10,7,15,0.5532566226361848,0.250127504999501
성장세높,1,0.3772656956818303,17,10,7,13,0.5532566226361848,0.250127504999501
금리레벨낮,1,0.3772656956818303,17,10,7,22,0.5532566226361848,0.250127504999501
자산늘,1,0.3772656956818303,17,10,7,11,0.5532566226361848,0.250127504999501
금리인상부담덜,1,0.3772656956818303,17,10,7,12,0.5532566226361848,0.250127504999501
양적완화실시,1,0.37645186134021125,50,29,21,74,0.616150877078705,0.2790909113842926
수출줄어들,1,0.37611668392954534,43,25,18,19,0.6035481467404838,0.2735959418895217
물가오름세확대,1,0.37611668392954534,43,25,18,19,0.6035481467404838,0.2735959418895217
실업률떨어지,1,0.37611668392954534,43,25,18,38,0.6035481467404838,0.2735959418895217
대출증가,1,0.37376539325642444,132,75,57,118,0.7313647166780041,0.3333556400939572
금리인상신중,1,0.37146692263236325,107,61,46,94,0.701036747777237,0.3212422018446663
금리인하나서,1,0.37146692263236325,107,61,46,73,0.701036747777237,0.3212422018446663
내수회복,1,0.3713198964309423,66,38,28,40,0.6419489274885013,0.2942662175667627
경제성장둔화,1,0.3666946291022317,145,82,63,116,0.7426269272436518,0.34408105621661933
인플레이션우려높,1,0.3655755379368997,52,30,22,45,0.61730978276771,0.2867580325972434
경기회복세감안,1,0.3655465237889908,24,14,10,18,0.5655985885511131,0.26275430148423734
경제성장률,1,0.3655465237889908,24,14,10,22,0.5655985885511131,0.26275430148423734
금리낮춰야,1,0.3655465237889908,24,14,10,20,0.5655985885511131,0.26275430148423734
성장그칠,1,0.3655465237889908,24,14,10,21,0.5655985885511131,0.26275430148423734
콜금리수준유지,1,0.3655465237889908,24,14,10,14,0.5655985885511131,0.26275430148423734
소비자기대지수하락,1,0.3655465237889908,24,14,10,9,0.5655985885511131,0.26275430148423734
수출늘어나,1,0.36353233204210444,68,39,29,55,0.6432447075183547,0.30021687721294915
제로금리정책유지,1,0.36197005340453803,31,18,13,17,0.57855051104895,0.2709957990589173
유동성늘어나,1,0.36179138890970286,38,22,16,20,0.5916091656755963,0.2772264852545746
실적양호,1,0.36179138890970286,38,22,16,56,0.5916091656755963,0.2772264852545746
가계대출늘어나,1,0.36179138890970286,38,22,16,22,0.5916091656755963,0.2772264852545746
실적개선,1,0.3598399113460644,187,105,82,188,0.7765733347862298,0.3655365264868069
인플레이션억제위해,1,0.3582184496596996,104,59,45,86,0.6932225226040392,0.3275197944720948
소비심리개선,1,0.35559714322529334,54,31,23,53,0.6184990022363669,0.29397659970014145
금융시장변동성확대,1,0.35494422927095526,124,70,54,127,0.7163323336306726,0.3409865605686069
성장따른,1,0.35146573586444885,63,36,27,46,0.6323211764406791,0.30339752035748274
미국채금리하락,1,0.34886744532692227,347,193,154,349,0.8377940450224368,0.4043742423081726
금리인상가능성,1,0.3484327835262855,90,51,39,66,0.6717070689004173,0.3245307577992764
외환시장안정,1,0.3478411196662967,40,23,17,26,0.5924716280800874,0.2866343375186152
글로벌경기둔화따른,1,0.3464114758318828,56,32,24,30,0.6197165825155957,0.30079145472738184
채산성악화,1,0.3445544268978582,33,19,14,16,0.5790776430790733,0.2822543023788875
물가올라가,1,0.3445544268978582,33,19,14,14,0.5790776430790733,0.2822543023788875
유동성줄어들,1,0.3445544268978582,33,19,14,28,0.5790776430790733,0.2822543023788875
금리올라갔,1,0.3445544268978582,33,19,14,15,0.5790776430790733,0.2822543023788875
기준금리인상늦춰질,1,0.3445544268978582,33,19,14,29,0.5790776430790733,0.2822543023788875
금리상향조정,1,0.3445544268978582,33,19,14,17,0.5790776430790733,0.2822543023788875
역외환율하락,1,0.34313181462378495,19,11,8,29,0.5521081119371989,0.26997842661027854
금융위기낮수준,1,0.34313181462378495,19,11,8,15,0.5521081119371989,0.26997842661027854
국채가격반등,1,0.34313181462378495,19,11,8,10,0.5521081119371989,0.26997842661027854
기준금리인상가능성제기,1,0.34313181462378495,19,11,8,10,0.5521081119371989,0.26997842661027854
금리오른다,1,0.34313181462378495,19,11,8,17,0.5521081119371989,0.26997842661027854
금리인상두,1,0.34313181462378495,19,11,8,31,0.5521081119371989,0.26997842661027854
수출증가힘입,1,0.34313181462378495,19,11,8,14,0.5521081119371989,0.26997842661027854
기업실적양호,1,0.34313181462378495,19,11,8,10,0.5521081119371989,0.26997842661027854
경기회복기대심리커지,1,0.34313181462378495,19,11,8,23,0.5521081119371989,0.26997842661027854
금융시장오,1,0.34313181462378495,19,11,8,12,0.5521081119371989,0.26997842661027854
유로화약세나타냈,1,0.34313181462378495,19,11,8,16,0.5521081119371989,0.26997842661027854
금리상승나타나,1,0.34313181462378495,19,11,8,18,0.5521081119371989,0.26997842661027854
인플레이션높,1,0.342925434202364,121,68,53,66,0.7089805874217997,0.346850573880195
성장세보이,1,0.342925434202364,121,68,53,105,0.7089805874217997,0.346850573880195
금리인상가능성약화,1,0.34242721579582547,26,15,11,20,0.5655486014768133,0.2769926637329299
채권시장부담될,1,0.34242721579582547,26,15,11,21,0.5655486014768133,0.2769926637329299
유동성위축,1,0.34242721579582547,26,15,11,11,0.5655486014768133,0.2769926637329299
부동산가격오르,1,0.34242721579582547,26,15,11,20,0.5655486014768133,0.2769926637329299
원달러오르,1,0.34242721579582547,26,15,11,28,0.5655486014768133,0.2769926637329299
급등따른이익실현,1,0.34242721579582547,26,15,11,13,0.5655486014768133,0.2769926637329299
금리인상진행,1,0.34105591485821307,49,28,21,51,0.6067425377072077,0.2980926020718333
기준금리낮췄,1,0.34105591485821307,49,28,21,30,0.6067425377072077,0.2980926020718333
금리인상없,1,0.3404093467137277,254,141,113,176,0.8075649317707305,0.3973374410608082
연방기금금리인하,1,0.33999853730524165,103,58,45,46,0.6863730019829064,0.33802257608921665
견조성장세,1,0.33538529105311476,42,24,18,23,0.5934090658863936,0.2952989404774136
물가안정,1,0.33386540745119064,499,276,223,321,0.8439404959656658,0.42141109120940634
경기둔화우려커지,1,0.33007137484662596,60,34,26,48,0.6222285275257851,0.31336261338511034
경기선행지수하락,1,0.3297316659648628,98,55,43,64,0.6767916580466622,0.34110125619916604
불확실성완화,1,0.32957257013101615,193,107,86,164,0.7693332089158514,0.3878803848579726
금리인상우려,1,0.32938549351107826,35,20,15,29,0.5797282076368279,0.29240852300469755
외환보유액감소,1,0.3242002180192898,44,25,19,36,0.5944158725511615,0.3033176743971039
이자부담커지,1,0.3242002180192898,44,25,19,14,0.5944158725511615,0.3033176743971039
금리매력높,1,0.3242002180192898,44,25,19,22,0.5944158725511615,0.3033176743971039
금리인상가능성배제없,1,0.3242002180192898,44,25,19,47,0.5944158725511615,0.3033176743971039
기준금리인상가능성높,1,0.3232989272785882,133,74,59,89,0.7153593005401606,0.36576820027119766
일자리늘리,1,0.32304209876407297,28,16,12,13,0.5657140969992172,0.2894194937401715
금리인상뒷받침,1,0.32304209876407297,28,16,12,19,0.5657140969992172,0.2894194937401715
수출늘,1,0.32277318551002687,62,35,27,32,0.6235186771752269,0.3191838995359649
유동성축소,1,0.32257860360764834,53,30,23,57,0.6090932524778172,0.3119348712231056
단기금리상승,1,0.3207598378436991,113,63,50,91,0.6923782053937416,0.3560290065296699
저금리계속,1,0.3163404157223204,21,12,9,19,0.5513830237591972,0.2863301051721783
매출늘어나,1,0.3163404157223204,21,12,9,11,0.5513830237591972,0.2863301051721783
경기회복불구하,1,0.3163404157223204,21,12,9,14,0.5513830237591972,0.2863301051721783
통화긴축단행,1,0.3163404157223204,21,12,9,19,0.5513830237591972,0.2863301051721783
국제유가넘어서,1,0.3163404157223204,21,12,9,14,0.5513830237591972,0.2863301051721783
듀레이션유지,1,0.3163404157223204,21,12,9,18,0.5513830237591972,0.2863301051721783
주택담보대출증가세둔화,1,0.3163404157223204,21,12,9,9,0.5513830237591972,0.2863301051721783
인플레이션안정적,1,0.3163404157223204,21,12,9,19,0.5513830237591972,0.2863301051721783
위험자산선호도높,1,0.3163404157223204,21,12,9,22,0.5513830237591972,0.2863301051721783
금리오른다면,1,0.3163404157223204,21,12,9,16,0.5513830237591972,0.2863301051721783
금리인상가늠,1,0.3163404157223204,21,12,9,20,0.5513830237591972,0.2863301051721783
국채가격하락압력받,1,0.31606350240876946,37,21,16,24,0.580491956583368,0.30163173858428016
수입늘,1,0.31606350240876946,37,21,16,37,0.580491956583368,0.30163173858428016
금리인상가시화,1,0.31606350240876946,37,21,16,34,0.580491956583368,0.30163173858428016
낮금리자금조달,1,0.31606350240876946,37,21,16,45,0.580491956583368,0.30163173858428016
금리올라도,1,0.31606350240876946,37,21,16,34,0.580491956583368,0.30163173858428016
국제유가급등,1,0.31560774534564495,84,47,37,56,0.6538145122944856,0.3400752757477391
기준금리올려,1,0.314458187595944,55,31,24,42,0.6103249647119217,0.31826581989572944
금리올려야,1,0.3118892024005686,176,97,79,149,0.7499053306926222,0.39328648660982735
금리올라가,1,0.31121779030643704,200,110,90,145,0.7667198610325866,0.4027032041953121
기준금리올린,1,0.3108033660387477,119,66,53,94,0.6958742663983951,0.36582855985750423
금리인상따른,1,0.3099024745108565,533,292,241,436,0.8347366479432867,0.4397057106243088
경상수지적자,1,0.3096309208268184,66,37,29,48,0.626156990261059,0.3300325140297371
신용등급유지,1,0.30696820918641343,57,32,25,54,0.6115898983509641,0.32425686822567956
경기둔화심화,1,0.3065729343300132,30,17,13,11,0.5660740187250568,0.30038694293042645
성장세나타낼,1,0.3065729343300132,30,17,13,29,0.5660740187250568,0.30038694293042645
채권시장영향줄,1,0.3065729343300132,30,17,13,15,0.5660740187250568,0.30038694293042645
기준금리인상가능성열,1,0.3065729343300132,30,17,13,20,0.5660740187250568,0.30038694293042645
비용줄일,1,0.3065729343300132,30,17,13,24,0.5660740187250568,0.30038694293042645
물가안정강조,1,0.30427582351435767,39,22,17,21,0.5813586633263275,0.3100646155629969
재고증가,1,0.30283028208859597,101,56,45,71,0.6719912595818295,0.35954604868576046
투자감소,1,0.30003811621646626,59,33,26,43,0.6128849391451335,0.3299416399779748
기준금리인상있,1,0.2966019349270941,50,28,22,39,0.5977967730069459,0.3242556198589566
대출늘렸,1,0.29480081520488843,23,13,10,15,0.5510292512381447,0.3000700885072573
경제지표호조나타내,1,0.29480081520488843,23,13,10,34,0.5510292512381447,0.3000700885072573
원화강세인한,1,0.29480081520488843,23,13,10,19,0.5510292512381447,0.3000700885072573
유로상승,1,0.29480081520488843,23,13,10,16,0.5510292512381447,0.3000700885072573
높수익올릴,1,0.29480081520488843,23,13,10,17,0.5510292512381447,0.3000700885072573
국제유가떨어지,1,0.29480081520488843,23,13,10,17,0.5510292512381447,0.3000700885072573
물가상승세,1,0.29480081520488843,23,13,10,15,0.5510292512381447,0.3000700885072573
금리끌어내릴,1,0.29480081520488843,23,13,10,13,0.5510292512381447,0.3000700885072573
불확실성높이,1,0.293775185969144,41,23,18,46,0.582318493564856,0.31782190368703966
대출늘어난,1,0.293775185969144,41,23,18,38,0.582318493564856,0.31782190368703966
금리올린다면,1,0.293775185969144,41,23,18,41,0.582318493564856,0.31782190368703966
기준금리인상가능성시사,1,0.293775185969144,41,23,18,38,0.582318493564856,0.31782190368703966
지급준비금적수줄,1,0.293775185969144,41,23,18,38,0.582318493564856,0.31782190368703966
마이너스수익률,1,0.2936073506980723,61,34,27,57,0.6142071183854291,0.33534945672985794
기준금리오르,1,0.2936073506980723,61,34,27,58,0.6142071183854291,0.33534945672985794
변동폭확대,1,0.29336112180358365,83,46,37,55,0.6456849670950218,0.3527259690959686
경제개선,1,0.28944436253745387,109,60,49,108,0.6770542606131955,0.37304180099477374
경제성장률둔화,1,0.288594491340294,135,74,61,110,0.704757572753518,0.3890264587314306
수입감소,1,0.2879629588260486,74,41,33,46,0.6316119116952895,0.3491305734046347
불확실성해소,1,0.28596665122474985,564,306,258,522,0.8248399856499655,0.457927369393357
기준금리인상어렵,1,0.28436387533981566,43,24,19,36,0.5833621975088581,0.3249977548206173
수출회복,1,0.28436387533981566,43,24,19,38,0.5833621975088581,0.3249977548206173
인플레이션우려,1,0.28250501323761723,208,113,95,138,0.7597606049495662,0.42498562614003843
금리인상기정사실화,1,0.2819613418976574,54,30,24,47,0.6002990159766559,0.3361848452318226
집값잡,1,0.28012954249928335,34,19,15,30,0.5672953261637146,0.31896792249570943
소비자물가상회,1,0.28012954249928335,34,19,15,29,0.5672953261637146,0.31896792249570943
금리인하기정사실화,1,0.28012954249928335,34,19,15,23,0.5672953261637146,0.31896792249570943
가계대출증가,1,0.2789214860263718,78,43,35,78,0.6344008369757629,0.35763469214618826
경제지표호조보임,1,0.2782502367735402,16,9,7,11,0.5349552121881979,0.30201278580684215
채권시장강세출발,1,0.2782502367735402,16,9,7,14,0.5349552121881979,0.30201278580684215
경상수지개선,1,0.2782502367735402,16,9,7,11,0.5349552121881979,0.30201278580684215
금리수준경기부양적,1,0.2782502367735402,16,9,7,2,0.5349552121881979,0.30201278580684215
금리높점,1,0.2782502367735402,16,9,7,15,0.5349552121881979,0.30201278580684215
경기부양책쓰,1,0.2782502367735402,16,9,7,11,0.5349552121881979,0.30201278580684215
침체계속,1,0.2782502367735402,16,9,7,8,0.5349552121881979,0.30201278580684215
기준금리인상우려높,1,0.2782502367735402,16,9,7,8,0.5349552121881979,0.30201278580684215
낮금리높,1,0.2782502367735402,16,9,7,18,0.5349552121881979,0.30201278580684215
물가상승률낮추,1,0.2782502367735402,16,9,7,13,0.5349552121881979,0.30201278580684215
금리차줄,1,0.2782502367735402,16,9,7,19,0.5349552121881979,0.30201278580684215
경기회복촉진,1,0.2782502367735402,16,9,7,12,0.5349552121881979,0.30201278580684215
변동성낮,1,0.2782502367735402,16,9,7,26,0.5349552121881979,0.30201278580684215
경기회복세나타내,1,0.2782502367735402,16,9,7,8,0.5349552121881979,0.30201278580684215
날외환시장현물환하락,1,0.2782502367735402,16,9,7,6,0.5349552121881979,0.30201278580684215
유로축소,1,0.2782502367735402,16,9,7,5,0.5349552121881979,0.30201278580684215
수출호조불구하,1,0.2782502367735402,16,9,7,13,0.5349552121881979,0.30201278580684215
설비투자회복,1,0.2782502367735402,16,9,7,5,0.5349552121881979,0.30201278580684215
원화강세용인,1,0.2782502367735402,16,9,7,13,0.5349552121881979,0.30201278580684215
성장이어지,1,0.2782502367735402,16,9,7,10,0.5349552121881979,0.30201278580684215
가계대출금리하락,1,0.2782502367735402,16,9,7,21,0.5349552121881979,0.30201278580684215
대출증가높,1,0.2782502367735402,16,9,7,7,0.5349552121881979,0.30201278580684215
경제성장하,1,0.2782502367735402,16,9,7,13,0.5349552121881979,0.30201278580684215
기준금리올랐,1,0.2782502367735402,16,9,7,6,0.5349552121881979,0.30201278580684215
소비줄일,1,0.2782502367735402,16,9,7,9,0.5349552121881979,0.30201278580684215
고용확대,1,0.2782502367735402,16,9,7,16,0.5349552121881979,0.30201278580684215
인플레이션압력낮추,1,0.2782502367735402,16,9,7,11,0.5349552121881979,0.30201278580684215
기준금리인상앞당겨질,1,0.2782502367735402,16,9,7,31,0.5349552121881979,0.30201278580684215
달러화약세보이,1,0.2775558111142331,104,57,47,79,0.6670542414321298,0.3771573894646463
마이너스금리도입,1,0.27715453921717303,173,94,79,120,0.7336025342787454,0.41514501782805063
엔화대해선상승,1,0.2771300748322454,25,14,11,15,0.550996079435023,0.3118247123322319
투자안정적,1,0.2771300748322454,25,14,11,16,0.550996079435023,0.3118247123322319
물가상승률넘,1,0.2771300748322454,25,14,11,16,0.550996079435023,0.3118247123322319
금리인상따른부담,1,0.2771300748322454,25,14,11,6,0.550996079435023,0.3118247123322319
유가하락긍정적,1,0.2771300748322454,25,14,11,7,0.550996079435023,0.3118247123322319
금리올라서,1,0.2771300748322454,25,14,11,24,0.550996079435023,0.3118247123322319
재정지급준비금적수증가,1,0.2771300748322454,25,14,11,33,0.550996079435023,0.3118247123322319
양적완화축소시작,1,0.2771300748322454,25,14,11,52,0.550996079435023,0.3118247123322319
금리상승과도,1,0.2771300748322454,25,14,11,14,0.550996079435023,0.3118247123322319
국제금융시장변동성확대,1,0.2771300748322454,25,14,11,30,0.550996079435023,0.3118247123322319
시장금리낮수준,1,0.2771300748322454,25,14,11,19,0.550996079435023,0.3118247123322319
금리인상부정적,1,0.2771300748322454,25,14,11,26,0.550996079435023,0.3118247123322319
투자얻있무위험차익,1,0.2771300748322454,25,14,11,24,0.550996079435023,0.3118247123322319
고용지표호조보였,1,0.2771300748322454,25,14,11,11,0.550996079435023,0.3118247123322319
달러화약세,1,0.2771300748322454,25,14,11,28,0.550996079435023,0.3118247123322319
달러화떨어질,1,0.2771300748322454,25,14,11,12,0.550996079435023,0.3118247123322319
금리인상될,1,0.27682232629942916,67,37,30,50,0.6183091686875912,0.3501524643425826
건전성악화,1,0.2758821639711604,45,25,20,50,0.5844811950163105,0.3316699019616127
자산매입축소,1,0.2758821639711604,45,25,20,53,0.5844811950163105,0.3316699019616127
위험자산,1,0.2745702691235552,106,58,48,106,0.6683550361648795,0.38034303556415255
지표금리하락,1,0.2708213705803113,82,45,37,91,0.6372146345452381,0.36557069206401444
침체겪,1,0.2695350148624178,58,32,26,31,0.6029567234396154,0.34687812047399025
성장세회복,1,0.2695350148624178,58,32,26,59,0.6029567234396154,0.34687812047399025
가산금리하락,1,0.2693640200521872,36,20,16,27,0.5681194227978493,0.32695691920603615
수주증가,1,0.2681997579904134,47,26,21,34,0.5856675974109598,0.3379029305805447
금리인상유지,1,0.2670786095583191,84,46,38,47,0.638627564158282,0.36934926159919934
미국채수익률상승,1,0.26301390639133504,73,40,33,60,0.6225637722887098,0.36322040214437656
금리인상검토,1,0.26238437693111494,27,15,12,30,0.5512378621105242,0.322042126466707
금리올린다고,1,0.26238437693111494,27,15,12,37,0.5512378621105242,0.322042126466707
상승폭장기금리하락,1,0.26238437693111494,27,15,12,30,0.5512378621105242,0.322042126466707
금리인하베팅하,1,0.26238437693111494,27,15,12,18,0.5512378621105242,0.322042126466707
금리상승가능성높,1,0.26238437693111494,27,15,12,16,0.5512378621105242,0.322042126466707
채권시장국채가격올랐,1,0.26238437693111494,27,15,12,33,0.5512378621105242,0.322042126466707
실적호조힘입,1,0.26238437693111494,27,15,12,13,0.5512378621105242,0.322042126466707
소비줄이,1,0.26120940879886545,49,27,22,37,0.5869141928534585,0.3437508406913435
실업률높,1,0.26120940879886545,49,27,22,35,0.5869141928534585,0.3437508406913435
수입물가상승,1,0.25985803386495565,38,21,17,34,0.569063871950344,0.3342637401380379
주택가격급락,1,0.25985803386495565,38,21,17,15,0.569063871950344,0.3342637401380379
금리인하기대선반영,1,0.25985803386495565,38,21,17,50,0.569063871950344,0.3342637401380379
현금확보,1,0.25985803386495565,38,21,17,25,0.569063871950344,0.3342637401380379
환율하락,1,0.25508918893517474,77,42,35,58,0.6254571986221398,0.3711603032683498
견조성장세보이,1,0.2549204254233255,18,10,8,14,0.5338658027271217,0.31692229210009926
금융시장개선,1,0.2549204254233255,18,10,8,5,0.5338658027271217,0.31692229210009926
국고금리차축소,1,0.2549204254233255,18,10,8,17,0.5338658027271217,0.31692229210009926
국채선물시장국채선물하락,1,0.2549204254233255,18,10,8,26,0.5338658027271217,0.31692229210009926
내수확대,1,0.2549204254233255,18,10,8,7,0.5338658027271217,0.31692229210009926
통화긴축이어질,1,0.2549204254233255,18,10,8,10,0.5338658027271217,0.31692229210009926
유가급등불구하,1,0.2549204254233255,18,10,8,7,0.5338658027271217,0.31692229210009926
국채하락,1,0.2549204254233255,18,10,8,12,0.5338658027271217,0.31692229210009926
달러원반등,1,0.2549204254233255,18,10,8,24,0.5338658027271217,0.31692229210009926
실적밑돌,1,0.2549204254233255,18,10,8,12,0.5338658027271217,0.31692229210009926
시장금리올라가,1,0.2549204254233255,18,10,8,11,0.5338658027271217,0.31692229210009926
재정적자,1,0.2549204254233255,18,10,8,22,0.5338658027271217,0.31692229210009926
부동산시장안정위해,1,0.2549204254233255,18,10,8,5,0.5338658027271217,0.31692229210009926
국채금리올라,1,0.2549204254233255,18,10,8,13,0.5338658027271217,0.31692229210009926
경기회복세진행,1,0.2549204254233255,18,10,8,12,0.5338658027271217,0.31692229210009926
신용등급하락따른,1,0.2549204254233255,18,10,8,3,0.5338658027271217,0.31692229210009926
기준금리인상,1,0.254876556096451,4159,2228,1931,3270,0.8114343736236563,0.481742357387183
금융시장안정되찾,1,0.25482209123960087,51,28,23,27,0.5882144117588898,0.3492590593200986
물가낮수준,1,0.25482209123960087,51,28,23,44,0.5882144117588898,0.3492590593200986
지표금리오른,1,0.25406006589965324,64,35,29,56,0.6071671647012407,0.36110034595731183
금리상승따른,1,0.25203460879892625,254,136,118,245,0.769298148999709,0.45950867131304535
금리인상앞당겨질,1,0.24990060733134034,29,16,13,42,0.5517149096812016,0.33104851374400723
비농업고용감소,1,0.24990060733134034,29,16,13,8,0.5517149096812016,0.33104851374400723
기준금리인상어려울,1,0.2495789058584843,66,36,30,38,0.6086171402708261,0.3654425175013178
달러원오른,1,0.2495789058584843,66,36,30,42,0.6086171402708261,0.3654425175013178
유동성증가,1,0.2489633267211686,53,29,24,41,0.5895622823337104,0.3544660281676377
근원소비자물가상승,1,0.24799749798951076,81,44,37,53,0.62837995496315,0.37858311681172463
성장가능,1,0.24746889462835298,179,96,83,104,0.725485520999241,0.4375792931084444
국고채내린,1,0.2453822752017103,68,37,31,48,0.6100855908219207,0.3696137426493055
마이너스금리,1,0.2453822752017103,68,37,31,47,0.6100855908219207,0.3696137426493055
유로화달러화상승,1,0.24384001148707868,42,23,19,28,0.5712583187901447,0.34722783751358055
경기회복이어지,1,0.24384001148707868,42,23,19,16,0.5712583187901447,0.34722783751358055
유동성떨어지,1,0.24357035147486816,55,30,25,38,0.5909523823157232,0.35940446262791315
부채늘어나,1,0.24357035147486816,55,30,25,43,0.5909523823157232,0.35940446262791315
기대심리높이,1,0.24144373644871497,70,38,32,51,0.6115699853608983,0.3736280278366555
수요커지,1,0.23920054254752898,31,17,14,27,0.5523932558231781,0.3390854955964759
전원기준금리동결,1,0.23920054254752898,31,17,14,11,0.5523932558231781,0.3390854955964759
기준금리인하없,1,0.23920054254752898,31,17,14,36,0.5523932558231781,0.3390854955964759
안전자산선호나타나,1,0.23920054254752898,31,17,14,29,0.5523932558231781,0.3390854955964759
물가안정위한,1,0.2386510427105084,87,47,40,69,0.6327935276596536,0.388891983208024
회사채금리상승,1,0.2385899148773083,57,31,26,76,0.5923797905151724,0.36410235580278344
불안심리커지,1,0.23807688885933054,121,65,56,90,0.6711677339992471,0.41297779922151473
회사채신용스프레드확대,1,0.23703189096596167,44,24,20,43,0.5724844140756356,0.35303773752262324
국채가격내린,1,0.23675978910437512,20,11,9,6,0.5333423542237584,0.3290894047204858
기준금리인상늦출,1,0.23675978910437512,20,11,9,17,0.5333423542237584,0.3290894047204858
달러화레벨낮추,1,0.23675978910437512,20,11,9,16,0.5333423542237584,0.3290894047204858
순이익늘어날,1,0.23675978910437512,20,11,9,13,0.5333423542237584,0.3290894047204858
금리인상해야,1,0.23675978910437512,20,11,9,9,0.5333423542237584,0.3290894047204858
경기회복세뚜렷하,1,0.23675978910437512,20,11,9,13,0.5333423542237584,0.3290894047204858
인플레이션넘어서,1,0.23675978910437512,20,11,9,2,0.5333423542237584,0.3290894047204858
고용악화따른,1,0.23675978910437512,20,11,9,5,0.5333423542237584,0.3290894047204858
경기둔화우려커진,1,0.23675978910437512,20,11,9,8,0.5333423542237584,0.3290894047204858
투자늘려,1,0.23675978910437512,20,11,9,25,0.5333423542237584,0.3290894047204858
차입금감소,1,0.23675978910437512,20,11,9,25,0.5333423542237584,0.3290894047204858
달러화약세나타냈,1,0.23675978910437512,20,11,9,13,0.5333423542237584,0.3290894047204858
금리인상오,1,0.23675978910437512,20,11,9,18,0.5333423542237584,0.3290894047204858
달러화급락,1,0.23582986817811769,89,48,41,67,0.6342675123528339,0.39213504994080084
불확실성커지,1,0.23207124155993486,203,108,95,177,0.7344211468188766,0.4576796857928107
고용시장개선,1,0.23095707630806106,76,41,35,89,0.6160963967117788,0.38484650947481247
하방위험작용,1,0.23087326576328726,46,25,21,45,0.573782742081087,0.3584786137148688
외환시장원달러내린,1,0.22993120484945329,33,18,15,40,0.5532440265046941,0.3463351107008552
금리올리,1,0.22708972292632335,1171,620,551,1027,0.798254476508406,0.5027184821510211
국채금리오르,1,0.22527624983272587,48,26,22,54,0.5751445000476947,0.36359702750058154
경기회복맞물려,1,0.22223556775070086,22,12,10,13,0.5332720174597784,0.3392907911135253
내수회복따른,1,0.22223556775070086,22,12,10,6,0.5332720174597784,0.3392907911135253
통화정책스탠스유지,1,0.22223556775070086,22,12,10,23,0.5332720174597784,0.3392907911135253
지급준비율인상통해,1,0.22223556775070086,22,12,10,10,0.5332720174597784,0.3392907911135253
대외불확실성커지,1,0.22223556775070086,22,12,10,16,0.5332720174597784,0.3392907911135253
경제성장률하회,1,0.22223556775070086,22,12,10,13,0.5332720174597784,0.3392907911135253
달러엔시장하락,1,0.22223556775070086,22,12,10,19,0.5332720174597784,0.3392907911135253
변동폭커질,1,0.22223556775070086,22,12,10,17,0.5332720174597784,0.3392907911135253
대출심사강화,1,0.22182665585428896,35,19,16,33,0.5542427209727341,0.3529366973022018
노동시장개선,1,0.22182665585428896,35,19,16,51,0.5542427209727341,0.3529366973022018
고성장,1,0.22182665585428896,35,19,16,16,0.5542427209727341,0.3529366973022018
소비자물가안정,1,0.22182665585428896,35,19,16,21,0.5542427209727341,0.3529366973022018
유가상승따른,1,0.21726810831777454,105,56,49,61,0.6459673033492463,0.41530466760043083
금리인상하,1,0.21682378244749967,147,78,69,147,0.686906036244734,0.4420369456502472
신용스프레드축소,1,0.21664645212624478,315,166,149,242,0.7717985969009105,0.4968517433971105
채권시장국채가격높,1,0.2154880203146361,52,28,24,36,0.5780279617954421,0.37301561403806255
모기지금리상승,1,0.21521846033329206,69,37,32,39,0.6015041782136907,0.38838486859268584
금리인상강하,1,0.21468285576100632,37,20,17,35,0.5553685302854366,0.3589984794005629
금리인상점치,1,0.21468285576100632,37,20,17,14,0.5553685302854366,0.3589984794005629
성장촉진,1,0.21468285576100632,37,20,17,28,0.5553685302854366,0.3589984794005629
금리인상지지,1,0.2145130188425095,88,47,41,82,0.6253158050975485,0.4043573730318615
기준금리수준동결,1,0.21363906456147252,130,69,61,143,0.6701469103568798,0.434141634433776
금리인상이뤄질,1,0.2135018595881064,109,58,51,90,0.6488384799525618,0.42045824044777497
인플레이션위험상존,1,0.21036438914956213,24,13,11,20,0.5335667617002106,0.348039051607759
순이익줄어들,1,0.21036438914956213,24,13,11,24,0.5335667617002106,0.348039051607759
기준금리인상고려,1,0.21036438914956213,24,13,11,23,0.5335667617002106,0.348039051607759
유동성유지,1,0.21036438914956213,24,13,11,23,0.5335667617002106,0.348039051607759
서비스업생산증가,1,0.21036438914956213,24,13,11,6,0.5335667617002106,0.348039051607759
금리수준부담,1,0.21036438914956213,24,13,11,25,0.5335667617002106,0.348039051607759
기준금리인상반영,1,0.21003164027477683,92,49,43,64,0.6283963608244905,0.41018068922666273
금리상승세이,1,0.20834070547470684,39,21,18,25,0.556603737381022,0.3646056485542585
요인완화,1,0.20834070547470684,39,21,18,28,0.556603737381022,0.3646056485542585
투자늘,1,0.20721558406024387,56,30,26,45,0.5810822149829487,0.38153648807478663
금리인상늦,1,0.20721558406024387,56,30,26,58,0.5810822149829487,0.38153648807478663
금리인상시사,1,0.2065229497591179,324,170,154,290,0.7687914756187273,0.5055166657527491
원유재고감소,1,0.20395202073620533,77,41,36,68,0.6078978355523147,0.40187266982745184
소비늘,1,0.20354297188801174,58,31,27,37,0.5826599875788113,0.3855171494554768
수익감소,1,0.20354297188801174,58,31,27,48,0.5826599875788113,0.3855171494554768
원화강세따른,1,0.20354297188801174,58,31,27,62,0.5826599875788113,0.3855171494554768
소비개선,1,0.20267434715551724,41,22,19,44,0.55793320725955,0.36982609293420127
경기둔화우려따른,1,0.20267434715551724,41,22,19,33,0.55793320725955,0.36982609293420127
달러화하락압력받,1,0.20218652985395402,100,53,47,60,0.6345175031211753,0.4210180361637593
높수익률,1,0.20218652985395402,100,53,47,73,0.6345175031211753,0.4210180361637593
환율하락따른,1,0.20063189683737837,150,79,71,83,0.6823430592179105,0.45422089312208874
기준금리인상가능성커지,1,0.20048752162375494,26,14,12,13,0.5341578559767577,0.3556842123669473
금리하락불구하,1,0.20048752162375494,26,14,12,20,0.5341578559767577,0.3556842123669473
자산매입유지,1,0.20048752162375494,26,14,12,60,0.5341578559767577,0.3556842123669473
금리하회,1,0.20048752162375494,26,14,12,43,0.5341578559767577,0.3556842123669473
안전자산선호,1,0.20042413450953855,102,54,48,99,0.6360346659045747,0.4235777213252605
경제안정적,1,0.2001354246989575,60,32,28,37,0.5842654962645556,0.38933529447747106
변동성축소,1,0.19920545772657205,81,43,38,91,0.6111337729997305,0.40802897383837217
금리인상,1,0.19766092386952638,5191,2714,2477,3835,0.7835991055449351,0.524861853883234
cds프리미엄하락,1,0.19758292545122047,43,23,20,35,0.5593439614282587,0.3747145220394355
금리인하어려울,1,0.19758292545122047,43,23,20,17,0.5593439614282587,0.3747145220394355
금리상회,1,0.19758292545122047,43,23,20,38,0.5593439614282587,0.3747145220394355
경기둔화반영,1,0.19758292545122047,43,23,20,16,0.5593439614282587,0.3747145220394355
달러화하락,1,0.19751007762683548,331,173,158,289,0.7656927994221832,0.5130290632703913
국가신용등급하향조정,1,0.1929846767719401,45,24,21,28,0.560824825810235,0.37931548022990114
기준금리인상앞두,1,0.1929846767719401,45,24,21,44,0.560824825810235,0.37931548022990114
금리반락,1,0.1929846767719401,45,24,21,47,0.560824825810235,0.37931548022990114
순이익늘어난,1,0.192147495141598,28,15,13,24,0.534991294117516,0.3624725434142472
완화적수준,1,0.192147495141598,28,15,13,24,0.534991294117516,0.3624725434142472
금리올릴없,1,0.192147495141598,28,15,13,30,0.534991294117516,0.3624725434142472
성장가능성높,1,0.192147495141598,28,15,13,18,0.534991294117516,0.3624725434142472
금리올리어려울,1,0.192147495141598,28,15,13,10,0.534991294117516,0.3624725434142472
심리지표개선,1,0.192147495141598,28,15,13,26,0.534991294117516,0.3624725434142472
crs금리상승,1,0.192147495141598,28,15,13,11,0.534991294117516,0.3624725434142472
견조성장,1,0.1912471980242887,66,35,31,24,0.5892109977031822,0.3999548350310944
채권시장국고채금리하락,1,0.1912471980242887,66,35,31,61,0.5892109977031822,0.3999548350310944
기대심리높,1,0.18997658067961343,407,212,195,364,0.7726286489353029,0.5258428921514422
변동성높,1,0.1892634662394106,91,48,43,115,0.61923872179645,0.4220712010794649
금리인하기대높,1,0.188812616448659,47,25,22,44,0.5623661405185826,0.38366557891359154
기준금리동결,1,0.18779718231059106,3204,1668,1536,2710,0.7785249682779115,0.5322559299671331
단기물금리상승,1,0.1850168038747826,30,16,14,31,0.5360242714355217,0.36858190368385996
자산줄이,1,0.1850168038747826,30,16,14,15,0.5360242714355217,0.36858190368385996
순이익늘,1,0.1850168038747826,30,16,14,28,0.5360242714355217,0.36858190368385996
경제부담작용,1,0.1850168038747826,30,16,14,20,0.5360242714355217,0.36858190368385996
경상수지적자확대,1,0.1850168038747826,30,16,14,9,0.5360242714355217,0.36858190368385996
수익줄어들,1,0.1850168038747826,30,16,14,22,0.5360242714355217,0.36858190368385996
원화약세따른,1,0.1850168038747826,30,16,14,22,0.5360242714355217,0.36858190368385996
고용지표호전,1,0.1850168038747826,30,16,14,12,0.5360242714355217,0.36858190368385996
인플레이션안정,1,0.1850113429814686,49,26,23,39,0.5639595207906881,0.38779517133306596
실적전망하향조정,1,0.1850113429814686,49,26,23,32,0.5639595207906881,0.38779517133306596
불확실성증대,1,0.18394880577146133,72,38,34,59,0.594285908876075,0.40954835489555685
채권시장우호적작용,1,0.18394880577146133,72,38,34,81,0.594285908876075,0.40954835489555685
실적부진,1,0.18371809154560004,126,66,60,112,0.6535748358150444,0.4506220625443452
유가하락,1,0.1823885841693449,281,146,135,220,0.7450302294972312,0.5150930455132462
성장이끌,1,0.18153463652312896,51,27,24,39,0.565597659833109,0.3917296242499257
금리인하기대,1,0.1799963327065739,103,54,49,89,0.628838049730604,0.43691677275496127
금리인상인한,1,0.1799963327065739,103,54,49,45,0.628838049730604,0.43691677275496127
엔화유로화강세나타냈,1,0.17885483783560896,32,17,15,15,0.5372225400073776,0.3741437169352501
금리하락세보이,1,0.17885483783560896,32,17,15,34,0.5372225400073776,0.3741437169352501
원화약세보이,1,0.17885483783560896,32,17,15,30,0.5372225400073776,0.3741437169352501
경기회복지원,1,0.17885483783560896,32,17,15,30,0.5372225400073776,0.3741437169352501
자산늘리,1,0.17885483783560896,32,17,15,36,0.5372225400073776,0.3741437169352501
달러화강세보이,1,0.17866607555519387,105,55,50,117,0.6304131306037618,0.4392166810055919
펀더멘털개선,1,0.17785311965218376,78,41,37,79,0.5994259603221793,0.41832933335472333
수요확보,1,0.17617281888784198,15,8,7,25,0.5099536647191358,0.35712477068417386
투자매력떨어지,1,0.17617281888784198,15,8,7,10,0.5099536647191358,0.35712477068417386
유가떨어져,1,0.17617281888784198,15,8,7,15,0.5099536647191358,0.35712477068417386
금리인하가능성없,1,0.17617281888784198,15,8,7,9,0.5099536647191358,0.35712477068417386
cd금리올라갈,1,0.17617281888784198,15,8,7,4,0.5099536647191358,0.35712477068417386
금리인하가능성높이,1,0.17617281888784198,15,8,7,12,0.5099536647191358,0.35712477068417386
유로달러오르,1,0.17617281888784198,15,8,7,5,0.5099536647191358,0.35712477068417386
경기낙관적,1,0.17617281888784198,15,8,7,25,0.5099536647191358,0.35712477068417386
금리하락세보임,1,0.17617281888784198,15,8,7,16,0.5099536647191358,0.35712477068417386
대출낮금리,1,0.17617281888784198,15,8,7,13,0.5099536647191358,0.35712477068417386
국채선물오르,1,0.17617281888784198,15,8,7,14,0.5099536647191358,0.35712477068417386
절대금리낮,1,0.17617281888784198,15,8,7,4,0.5099536647191358,0.35712477068417386
기준금리인상늦추,1,0.17617281888784198,15,8,7,14,0.5099536647191358,0.35712477068417386
엔화강세이끌,1,0.17617281888784198,15,8,7,7,0.5099536647191358,0.35712477068417386
물가안정도모,1,0.17617281888784198,15,8,7,16,0.5099536647191358,0.35712477068417386
채권가격떨어질,1,0.17617281888784198,15,8,7,6,0.5099536647191358,0.35712477068417386
완화정책펴,1,0.17617281888784198,15,8,7,7,0.5099536647191358,0.35712477068417386
금리상승나타날,1,0.17617281888784198,15,8,7,20,0.5099536647191358,0.35712477068417386
신용경색해소위해,1,0.17617281888784198,15,8,7,4,0.5099536647191358,0.35712477068417386
금리인하기대심리커지,1,0.17617281888784198,15,8,7,22,0.5099536647191358,0.35712477068417386
경기부진이어지,1,0.17617281888784198,15,8,7,12,0.5099536647191358,0.35712477068417386
기준금리인상가능성배제없,1,0.17617281888784198,15,8,7,8,0.5099536647191358,0.35712477068417386
기대심리오른,1,0.17617281888784198,15,8,7,6,0.5099536647191358,0.35712477068417386
금리인상관한,1,0.17617281888784198,15,8,7,12,0.5099536647191358,0.35712477068417386
달러원떨어질,1,0.17617281888784198,15,8,7,7,0.5099536647191358,0.35712477068417386
실적개선기대심리높,1,0.17617281888784198,15,8,7,9,0.5099536647191358,0.35712477068417386
경제지표오,1,0.17617281888784198,15,8,7,8,0.5099536647191358,0.35712477068417386
내수회복힘입,1,0.17617281888784198,15,8,7,3,0.5099536647191358,0.35712477068417386
금리인상불가피한,1,0.17617281888784198,15,8,7,8,0.5099536647191358,0.35712477068417386
안전자산선호심리커지,1,0.17617281888784198,15,8,7,8,0.5099536647191358,0.35712477068417386
원화약세보일,1,0.17617281888784198,15,8,7,15,0.5099536647191358,0.35712477068417386
불안정성확대,1,0.17617281888784198,15,8,7,6,0.5099536647191358,0.35712477068417386
견조성장세이,1,0.17617281888784198,15,8,7,15,0.5099536647191358,0.35712477068417386
gdp하회,1,0.17617281888784198,15,8,7,5,0.5099536647191358,0.35712477068417386
하방위험,1,0.17617281888784198,15,8,7,26,0.5099536647191358,0.35712477068417386
불안심리계속,1,0.17617281888784198,15,8,7,8,0.5099536647191358,0.35712477068417386
적자돌아섰,1,0.17617281888784198,15,8,7,11,0.5099536647191358,0.35712477068417386
인플레이션우려인해,1,0.17617281888784198,15,8,7,14,0.5099536647191358,0.35712477068417386
투자늘린,1,0.17617281888784198,15,8,7,10,0.5099536647191358,0.35712477068417386
달러인덱스하락,1,0.1754054053565779,55,29,26,53,0.5689834269179589,0.3990952857373992
채권시장국채선물하락,1,0.1754054053565779,55,29,26,77,0.5689834269179589,0.3990952857373992
수요부진,1,0.1743199538918474,82,43,39,63,0.6028645752682433,0.4238080056690068
인플레이션우려표명,1,0.1734808511167496,34,18,16,16,0.5385584368098587,0.37925706611677573
금리하락쉽,1,0.1734808511167496,34,18,16,20,0.5385584368098587,0.37925706611677573
경제호조보이,1,0.1734808511167496,34,18,16,15,0.5385584368098587,0.37925706611677573
금리인하중단,1,0.1734808511167496,34,18,16,11,0.5385584368098587,0.37925706611677573
달러원올랐,1,0.1734808511167496,34,18,16,20,0.5385584368098587,0.37925706611677573
투자심리안정,1,0.1726918887168456,57,30,27,41,0.5707204985537044,0.4025600432850853
금리올라갈,1,0.17113836359300305,86,45,41,59,0.606299283614969,0.42902689758227924
기준금리인상단행,1,0.17063509022533063,263,136,127,213,0.7328039122648188,0.519081400379927
국고채금리국고지표물오른,1,0.1701789966443672,59,31,28,50,0.5724810098191996,0.40589782162269455
금리인상불구하,1,0.17003797433213275,156,81,75,109,0.6731644161593362,0.4774225289007271
대출늘,1,0.16966357657105635,88,46,42,72,0.6080121757128037,0.4315477379237575
디플레이션우려,1,0.1687564221879354,36,19,17,29,0.5400094109093726,0.38399798900754745
서부텍사스산원유하락,1,0.1687564221879354,36,19,17,48,0.5400094109093726,0.38399798900754745
가계대출늘,1,0.1687564221879354,36,19,17,27,0.5400094109093726,0.38399798900754745
달러강세인해,1,0.1687564221879354,36,19,17,29,0.5400094109093726,0.38399798900754745
회사채금리하락,1,0.16825885627770565,90,47,43,100,0.6097206950543659,0.434013565726795
금리상승인한,1,0.16784594743783465,61,32,29,43,0.5742610845975993,0.4091200589418909
기준금리인상선반영,1,0.16457373818210286,38,20,18,26,0.5415569169299652,0.3884257646048566
침체빠지,1,0.16457373818210286,38,20,18,29,0.5415569169299652,0.3884257646048566
성장모멘텀둔화,1,0.16457373818210286,38,20,18,20,0.5415569169299652,0.3884257646048566
신용등급하락,1,0.16457373818210286,38,20,18,51,0.5415569169299652,0.3884257646048566
물가상승선제적,1,0.16442295343632085,17,9,8,15,0.5098830076295405,0.3658213551395598
경제펀더멘털개선,1,0.16442295343632085,17,9,8,5,0.5098830076295405,0.3658213551395598
양적완화펴,1,0.16442295343632085,17,9,8,16,0.5098830076295405,0.3658213551395598
기준금리내려도,1,0.16442295343632085,17,9,8,8,0.5098830076295405,0.3658213551395598
달러화하락압력가하,1,0.16442295343632085,17,9,8,10,0.5098830076295405,0.3658213551395598
달러화상승우호적,1,0.16442295343632085,17,9,8,20,0.5098830076295405,0.3658213551395598
금리인상많,1,0.16442295343632085,17,9,8,18,0.5098830076295405,0.3658213551395598
기준금리동결이,1,0.16442295343632085,17,9,8,15,0.5098830076295405,0.3658213551395598
달러약세힘입,1,0.16442295343632085,17,9,8,15,0.5098830076295405,0.3658213551395598
경제지표하회,1,0.16442295343632085,17,9,8,17,0.5098830076295405,0.3658213551395598
채권수요증가,1,0.16442295343632085,17,9,8,13,0.5098830076295405,0.3658213551395598
금리차확대따른,1,0.16442295343632085,17,9,8,4,0.5098830076295405,0.3658213551395598
통화완화필요,1,0.16442295343632085,17,9,8,10,0.5098830076295405,0.3658213551395598
경제성장이루,1,0.16442295343632085,17,9,8,7,0.5098830076295405,0.3658213551395598
콜론금리동결,1,0.16442295343632085,17,9,8,18,0.5098830076295405,0.3658213551395598
경제성장긍정적,1,0.16442295343632085,17,9,8,16,0.5098830076295405,0.3658213551395598
경제비관적,1,0.16442295343632085,17,9,8,8,0.5098830076295405,0.3658213551395598
달러엔올랐,1,0.16442295343632085,17,9,8,8,0.5098830076295405,0.3658213551395598
금융위기회복,1,0.16442295343632085,17,9,8,5,0.5098830076295405,0.3658213551395598
금리인상이루어지,1,0.16442295343632085,17,9,8,2,0.5098830076295405,0.3658213551395598
유가상승불구하,1,0.16442295343632085,17,9,8,10,0.5098830076295405,0.3658213551395598
유럽재정위기확산,1,0.16442295343632085,17,9,8,9,0.5098830076295405,0.3658213551395598
집값오른,1,0.16442295343632085,17,9,8,6,0.5098830076295405,0.3658213551395598
금리상승있,1,0.16442295343632085,17,9,8,8,0.5098830076295405,0.3658213551395598
하방위험있,1,0.16084756731924355,40,21,19,36,0.5431855771869908,0.3925872611845122
국채가격급락,1,0.16084756731924355,40,21,19,16,0.5431855771869908,0.3925872611845122
실적악화,1,0.1600298970186418,104,54,50,60,0.6214879978301472,0.4499348135347335
신용스프레드확대,1,0.15989815826775455,274,141,133,253,0.7309866806924685,0.529350990859575
경기개선,1,0.1597028663988711,233,120,113,217,0.71483121095958,0.5178593493613702
유가급등,1,0.159235824280769,147,76,71,76,0.6609141653522311,0.47925821732515916
금리국고지표물하락,1,0.15809351022857965,108,56,52,139,0.624768447510943,0.45411021721556716
엔화강세나타냈,1,0.15750963306202848,42,22,20,18,0.5448825417332142,0.3965200051905814
경기부진따른,1,0.15750963306202848,42,22,20,45,0.5448825417332142,0.3965200051905814
채권시장국고채지표금리하락,1,0.15675827613208537,73,38,35,112,0.5851829126415068,0.4265037866842695
인플레이션압력높,1,0.1565937937198565,202,104,98,144,0.6973867600482022,0.5084536797939659
금리인상나서,1,0.15613322840643917,204,105,99,186,0.6982818265872666,0.5095871222495822
장단기금리차확대,1,0.15556186026596075,159,82,77,150,0.6685646775179785,0.48847202552473945
소비증가,1,0.15545746322908416,114,59,55,77,0.6296060658416517,0.4601061991806302
달러화가치오르,1,0.15532105463132018,19,10,9,24,0.5103434920033261,0.37305525254308364
금리인상준비,1,0.15532105463132018,19,10,9,17,0.5103434920033261,0.37305525254308364
현금흐름개선,1,0.15532105463132018,19,10,9,13,0.5103434920033261,0.37305525254308364
경제커지,1,0.15532105463132018,19,10,9,10,0.5103434920033261,0.37305525254308364
경상수지악화,1,0.15532105463132018,19,10,9,15,0.5103434920033261,0.37305525254308364
달러엔급락,1,0.15532105463132018,19,10,9,5,0.5103434920033261,0.37305525254308364
소비자물가낮수준,1,0.15532105463132018,19,10,9,14,0.5103434920033261,0.37305525254308364
인플레이션밑돌,1,0.15532105463132018,19,10,9,11,0.5103434920033261,0.37305525254308364
경쟁력높,1,0.15532105463132018,19,10,9,12,0.5103434920033261,0.37305525254308364
기준금리인하기대심리약화,1,0.15532105463132018,19,10,9,16,0.5103434920033261,0.37305525254308364
금리인상우려따른,1,0.15532105463132018,19,10,9,17,0.5103434920033261,0.37305525254308364
금리인상임박한,1,0.15532105463132018,19,10,9,14,0.5103434920033261,0.37305525254308364
채권시장심리개선,1,0.15532105463132018,19,10,9,9,0.5103434920033261,0.37305525254308364
미국채가격상승,1,0.15532105463132018,19,10,9,29,0.5103434920033261,0.37305525254308364
주택가격안정,1,0.15532105463132018,19,10,9,12,0.5103434920033261,0.37305525254308364
국채금리높,1,0.15532105463132018,19,10,9,14,0.5103434920033261,0.37305525254308364
일자리늘,1,0.15532105463132018,19,10,9,11,0.5103434920033261,0.37305525254308364
회복속도둔화,1,0.15532105463132018,19,10,9,19,0.5103434920033261,0.37305525254308364
자금유입늘어나,1,0.15532105463132018,19,10,9,10,0.5103434920033261,0.37305525254308364
경기회복늦,1,0.15532105463132018,19,10,9,9,0.5103434920033261,0.37305525254308364
가동률상승,1,0.15532105463132018,19,10,9,14,0.5103434920033261,0.37305525254308364
부동산가격안정,1,0.15532105463132018,19,10,9,11,0.5103434920033261,0.37305525254308364
경기회복세이어질,1,0.15532105463132018,19,10,9,11,0.5103434920033261,0.37305525254308364
금리떨어뜨리,1,0.15532105463132018,19,10,9,11,0.5103434920033261,0.37305525254308364
임금상승따른,1,0.15532105463132018,19,10,9,12,0.5103434920033261,0.37305525254308364
적자보였,1,0.15532105463132018,19,10,9,12,0.5103434920033261,0.37305525254308364
수입늘어나,1,0.15532105463132018,19,10,9,22,0.5103434920033261,0.37305525254308364
대출감소,1,0.1545045915949237,44,23,21,19,0.5466369951856285,0.400254387207101
비용줄이,1,0.1545045915949237,44,23,21,41,0.5466369951856285,0.400254387207101
가산금리인상,1,0.1545045915949237,44,23,21,21,0.5466369951856285,0.400254387207101
금리인상자제,1,0.1545045915949237,44,23,21,23,0.5466369951856285,0.400254387207101
시중금리상승,1,0.15259002766409502,79,41,38,67,0.590697179851824,0.43421503164102515
경제성장률하락,1,0.1493196681648843,48,25,23,39,0.5502830621713898,0.4072232049853644
미국채금리오른,1,0.1493196681648843,48,25,23,77,0.5502830621713898,0.4072232049853644
실업수당청구감소,1,0.1490674812561208,85,44,41,57,0.5961886040754881,0.4414220704016069
금리인상나선,1,0.1480773221070779,21,11,10,11,0.5111971955515553,0.37926097849815316
실적전망상향조정,1,0.1480773221070779,21,11,10,14,0.5111971955515553,0.37926097849815316
위기완화,1,0.1480773221070779,21,11,10,6,0.5111971955515553,0.37926097849815316
지급준비금적수늘어나,1,0.1480773221070779,21,11,10,13,0.5111971955515553,0.37926097849815316
경기하강막,1,0.1480773221070779,21,11,10,8,0.5111971955515553,0.37926097849815316
발행금리높,1,0.1480773221070779,21,11,10,21,0.5111971955515553,0.37926097849815316
금리인상앞둔,1,0.1480773221070779,21,11,10,32,0.5111971955515553,0.37926097849815316
경기회복낙관적,1,0.1480773221070779,21,11,10,20,0.5111971955515553,0.37926097849815316
금리인상서두필요없,1,0.1480773221070779,21,11,10,4,0.5111971955515553,0.37926097849815316
금리인상가능성높였,1,0.1480773221070779,21,11,10,18,0.5111971955515553,0.37926097849815316
경제성장률높이,1,0.1480773221070779,21,11,10,10,0.5111971955515553,0.37926097849815316
금리인상확률높,1,0.1480773221070779,21,11,10,11,0.5111971955515553,0.37926097849815316
기준금리동결따른,1,0.1480773221070779,21,11,10,28,0.5111971955515553,0.37926097849815316
금리하락이어질,1,0.1480773221070779,21,11,10,18,0.5111971955515553,0.37926097849815316
신용등급상승,1,0.1480773221070779,21,11,10,10,0.5111971955515553,0.37926097849815316
달러약세불구하,1,0.1480773221070779,21,11,10,11,0.5111971955515553,0.37926097849815316
금리내려갈,1,0.14700990274592662,89,46,43,68,0.5998216777519515,0.44598422575505275
금리인하가능,1,0.14700990274592662,89,46,43,59,0.5998216777519515,0.44598422575505275
위안화절상,1,0.1462091905715639,142,73,69,126,0.6506459582729969,0.4845657793013407
금리인상단행,1,0.14557369793837793,1360,695,665,924,0.7558802769555029,0.563669999602624
소비지출증가,1,0.14312871198772004,54,28,26,31,0.5559934443176492,0.4166871831253067
부채증가,1,0.14312871198772004,54,28,26,57,0.5559934443176492,0.4166871831253067
투자늘어나,1,0.14312871198772004,54,28,26,53,0.5559934443176492,0.4166871831253067
금리인상가능성커지,1,0.14312871198772004,54,28,26,39,0.5559934443176492,0.4166871831253067
잠재성장률하락,1,0.14218793927191142,23,12,11,29,0.5123482568902089,0.384715542358418
달러약세이어지,1,0.14218793927191142,23,12,11,22,0.5123482568902089,0.384715542358418
경기부양따른,1,0.14218793927191142,23,12,11,22,0.5123482568902089,0.384715542358418
원화강세요인작용,1,0.14218793927191142,23,12,11,15,0.5123482568902089,0.384715542358418
긴장완화,1,0.14218793927191142,23,12,11,12,0.5123482568902089,0.384715542358418
투자줄어들,1,0.14218793927191142,23,12,11,17,0.5123482568902089,0.384715542358418
대출늘려,1,0.14218793927191142,23,12,11,16,0.5123482568902089,0.384715542358418
금리상승견인,1,0.14218793927191142,23,12,11,23,0.5123482568902089,0.384715542358418
국채입찰부진,1,0.14218793927191142,23,12,11,19,0.5123482568902089,0.384715542358418
국채금리올랐,1,0.14218793927191142,23,12,11,30,0.5123482568902089,0.384715542358418
기준금리인상가능성있,1,0.14218793927191142,23,12,11,7,0.5123482568902089,0.384715542358418
유가하락불구하,1,0.14218793927191142,23,12,11,11,0.5123482568902089,0.384715542358418
경제성장차지,1,0.14218793927191142,23,12,11,7,0.5123482568902089,0.384715542358418
금리올려도,1,0.14139379943946895,56,29,27,56,0.5579402626436496,0.4196294901584615
유로화오른,1,0.14139379943946895,56,29,27,26,0.5579402626436496,0.4196294901584615
달러엔오른,1,0.13979372610434293,58,30,28,31,0.5599019332337564,0.42248168729157765
달러원상승,1,0.1385370889258466,249,127,122,174,0.7104605919548183,0.5374632932763599
대외불확실성완화,1,0.13731622763561946,25,13,12,17,0.5137281129848011,0.3896036165205863
금융위기벗어나,1,0.13731622763561946,25,13,12,15,0.5137281129848011,0.3896036165205863
가계대출금리상승,1,0.13731622763561946,25,13,12,15,0.5137281129848011,0.3896036165205863
국고채떨어진,1,0.13731622763561946,25,13,12,21,0.5137281129848011,0.3896036165205863
국고채금리떨어지,1,0.13731622763561946,25,13,12,18,0.5137281129848011,0.3896036165205863
수익성높이,1,0.13731622763561946,25,13,12,21,0.5137281129848011,0.3896036165205863
경기상승,1,0.13731622763561946,25,13,12,15,0.5137281129848011,0.3896036165205863
유가상승세,1,0.13731622763561946,25,13,12,10,0.5137281129848011,0.3896036165205863
완화,1,0.13704758518265248,825,420,405,674,0.7511229300882144,0.569952217168426
유로화하락,1,0.13700804744920103,188,96,92,93,0.6791026538874252,0.5153447414934221
금리차축소,1,0.13567081582573803,64,33,31,88,0.5658445201995601,0.43056910550927846
달러화약세보였,1,0.13567081582573803,64,33,31,46,0.5658445201995601,0.43056910550927846
성장세보일,1,0.13338269029952254,68,35,33,69,0.5698287208843912,0.435626065190385
소비줄,1,0.13322855859653826,27,14,13,17,0.515286487273405,0.39405292455486324
경기회복진행,1,0.13322855859653826,27,14,13,26,0.515286487273405,0.39405292455486324
경기회복세이,1,0.13322855859653826,27,14,13,11,0.515286487273405,0.39405292455486324
채권가격상승채권강세,1,0.13322855859653826,27,14,13,26,0.515286487273405,0.39405292455486324
국채매입확대,1,0.13322855859653826,27,14,13,20,0.515286487273405,0.39405292455486324
금리인상가능성커졌,1,0.13322855859653826,27,14,13,29,0.515286487273405,0.39405292455486324
글로벌경제회복세이,1,0.13322855859653826,27,14,13,9,0.515286487273405,0.39405292455486324
지급준비금적수감소,1,0.1331982817312931,133,68,65,153,0.6368499313439486,0.4870456590283819
채권시장국고채지표금리내린,1,0.13235197296928214,70,36,34,106,0.5718213463753163,0.4380675757395347
국채금리하락,1,0.13056209161495747,528,268,260,562,0.7462326636398234,0.5737685973539451
금리하락컸,1,0.12975767828320528,29,15,14,19,0.5169857011239316,0.39815455815425527
글로벌경기회복,1,0.12975767828320528,29,15,14,35,0.5169857011239316,0.39815455815425527
전세가격오르,1,0.12975767828320528,29,15,14,31,0.5169857011239316,0.39815455815425527
소비자심리지수상승,1,0.12975767828320528,29,15,14,24,0.5169857011239316,0.39815455815425527
금리높채권,1,0.12975767828320528,29,15,14,28,0.5169857011239316,0.39815455815425527
하방경직성강화,1,0.12809400500098667,80,41,39,92,0.581728574472769,0.44953427696263243
경기둔화,1,0.12739270905835198,582,295,287,376,0.7451669613083742,0.576653798531383
금리인하시사,1,0.12738923884065412,82,42,40,58,0.5836904171968836,0.4516969860072321
유가넘어서,1,0.12678066901068585,31,16,15,20,0.5187969726166733,0.40197519692409944
유가떨어졌,1,0.12678066901068585,31,16,15,15,0.5187969726166733,0.40197519692409944
잠재성장률상회,1,0.12678066901068585,31,16,15,15,0.5187969726166733,0.40197519692409944
국채가격하락부추겼,1,0.12678066901068585,31,16,15,15,0.5187969726166733,0.40197519692409944
물가안정유지,1,0.12483886828597579,195,99,96,78,0.6769604450866126,0.5265972822281519
미국채수익률급등,1,0.12420515333450988,33,17,16,13,0.5206979421191158,0.40556475344896564
엔화거래상승,1,0.12420515333450988,33,17,16,18,0.5206979421191158,0.40556475344896564
서부텍사스산원유내린,1,0.12420515333450988,33,17,16,25,0.5206979421191158,0.40556475344896564
경기회복확인,1,0.12420515333450988,33,17,16,22,0.5206979421191158,0.40556475344896564
달러화가치떨어지,1,0.12420515333450988,33,17,16,28,0.5206979421191158,0.40556475344896564
하방위험확대,1,0.12420515333450988,33,17,16,23,0.5206979421191158,0.40556475344896564
성장세보였,1,0.12420515333450988,33,17,16,42,0.5206979421191158,0.40556475344896564
주택가격상승,1,0.1239100882479387,94,48,46,84,0.5952510615497805,0.4639111162375156
금리인상주장,1,0.12213907773327448,102,52,50,104,0.6027146499298391,0.4714200336202957
국채수익률오른,1,0.12196035269104377,35,18,17,25,0.5226709774105976,0.40896132060331775
집값상승,1,0.12196035269104377,35,18,17,36,0.5226709774105976,0.40896132060331775
외환시장원달러오른,1,0.12196035269104377,35,18,17,68,0.5226709774105976,0.40896132060331775
금리인상포함,1,0.12196035269104377,35,18,17,20,0.5226709774105976,0.40896132060331775
실적내,1,0.12196035269104377,35,18,17,30,0.5226709774105976,0.40896132060331775
금리동결,1,0.12186943511278336,1774,897,877,1334,0.7425133581839497,0.5810831333767892
경기침체따른,1,0.12137753376070859,106,54,52,39,0.6063630942230166,0.47500739289982413
제로금리유지,1,0.12137753376070859,106,54,52,104,0.6063630942230166,0.47500739289982413
물가상승,1,0.12039565752003822,376,190,186,293,0.7312383468908411,0.573973618532127
금리인상빨라질,1,0.11999111663848439,37,19,18,42,0.5247019872884306,0.4121944681664383
유로화약세보이,1,0.11999111663848439,37,19,18,32,0.5247019872884306,0.4121944681664383
기준금리만장일치동결,1,0.11999111663848439,37,19,18,66,0.5247019872884306,0.4121944681664383
통화완화종료,1,0.11999111663848439,37,19,18,30,0.5247019872884306,0.4121944681664383
경기회복,1,0.11880744079078065,709,358,351,497,0.7407082972017625,0.5832832425533534
선행지수하락,1,0.11825383085365182,39,20,19,31,0.5267795747623745,0.4152874964601839
자산가격상승,1,0.11825383085365182,39,20,19,32,0.5267795747623745,0.4152874964601839
외환보유액증가,1,0.11825383085365182,39,20,19,40,0.5267795747623745,0.4152874964601839
경제지표호조보인,1,0.11825383085365182,39,20,19,37,0.5267795747623745,0.4152874964601839
지표물국고채금리하락,1,0.11671354805197076,41,21,20,20,0.5288944219270106,0.4182590121554253
국채수익률상승,1,0.11668820946117653,144,73,71,117,0.6379108830188793,0.5044970621054947
양적완화인한,1,0.1153419353616778,43,22,21,19,0.5310388359710623,0.4211240524346632
환율변동성확대,1,0.1153419353616778,43,22,21,29,0.5310388359710623,0.4211240524346632
실질금리마이너스,1,0.11411577917326854,45,23,22,23,0.5332064092419018,0.42389490146236575
국채가격올랐,1,0.11411577917326854,45,23,22,22,0.5332064092419018,0.42389490146236575
연방기금금리인상,1,0.11402690321682352,188,95,93,113,0.6671286736356637,0.530457558186285
금리낙폭확대,1,0.11301587835253901,47,24,23,39,0.5353917613392712,0.42658169301749754
순이익증가,1,0.11258163495659779,226,114,112,203,0.6864762489293142,0.5474418914356063
안전자산선호심리강화,1,0.11202621293251624,49,25,24,77,0.5375903410723415,0.42919286182285304
기대심리낮,1,0.11113331142455274,51,26,25,72,0.539798272692685,0.43173548606272905
금리오른,1,0.11039738497083551,302,152,150,344,0.7118560355236323,0.5701977337210108
유가안정,1,0.10959384029511487,55,28,27,28,0.5442293672381163,0.43663815071550754
통화완화유지,1,0.10777390115615626,61,31,30,52,0.5508765518323594,0.443601927380566
경제성장률전망상향조정,1,0.10639359787743685,67,34,33,63,0.5574798766581,0.45017458362843654
채권시장국고채금리상승,1,0.10639359787743685,67,34,33,74,0.5574798766581,0.45017458362843654
기준금리인상나설,1,0.10639359787743685,67,34,33,66,0.5574798766581,0.45017458362843654
금리인상가능성부각,1,0.1056590416730081,71,36,35,70,0.5618397701862381,0.45436977798947836
달러약세따른,1,0.10342255233579656,91,46,45,64,0.5828868021308887,0.47352720644430957
기준금리인상불구하,1,0.10328959925354875,93,47,46,58,0.584910033587342,0.47529855763497525
금리떨어질,1,0.1029573644868047,99,50,49,78,0.590881408114004,0.4804734372431002
유가상승,1,0.10278978746017486,215,108,107,166,0.6758403930761765,0.5497437395089696
국채가격낮,1,0.10239863559810347,117,59,58,60,0.6078700600283129,0.49484616904420176
성장세이,1,0.10228681964784903,155,78,77,133,0.6390176200138188,0.5203198899052871
금리인상통해,1,0.10223301682446628,139,70,69,75,0.6266830061305672,0.510331917937931
수요증가,1,0.10169625566891938,485,243,242,421,0.7283699755202263,0.5937831911959534
금리인상나설,1,0.08938729379690358,329,164,165,286,0.7056931714789462,0.5897666043670597
금리인상시작,1,0.0884996028370475,152,76,76,185,0.6296653453351716,0.5271705244851375
기준금리올리,1,0.08803053177121734,484,241,243,415,0.7201972875209753,0.6035362697797633
금리인하가능성높,1,0.08764562505920104,142,71,71,104,0.6216398273056087,0.5213478620436429
채권금리급등,1,0.08710391826210317,136,68,68,109,0.6165975326352461,0.5176838477237942
금리차확대,1,0.08595194085087221,124,62,62,109,0.605989671559963,0.5099599151209098
투자늘리,1,0.08595194085087221,124,62,62,107,0.605989671559963,0.5099599151209098
금리인상할,1,0.08575081900940074,122,61,61,88,0.604152787696125,0.5086201523627646
국채수익률하락,1,0.0855470360800048,120,60,60,125,0.602295986750107,0.507265157600797
수익내,1,0.08510655117544963,247,123,124,200,0.6799537046305576,0.5731783186258506
금리인상이어질,1,0.0840443835868403,106,53,53,62,0.5887342794472726,0.4973462207868247
엔화상승,1,0.08381860370526728,104,52,52,83,0.5867154743559256,0.4958662060691701
경기둔화우려,1,0.08264679219062243,94,47,47,51,0.5763123290586475,0.4882245816899225
금리국고지표물상승,1,0.08240371945643132,92,46,46,116,0.5741695501518311,0.48664742874008904
채권가격하락,1,0.08165676090951157,86,43,43,104,0.5676162446160072,0.48181707315437716
채권시장국채선물오른,1,0.08140180410393216,84,42,42,93,0.5653900624525189,0.48017377766732744
금리동결결정,1,0.08114383405635461,82,41,41,62,0.563142971989921,0.47851379397660093
성장견인,1,0.08114383405635461,82,41,41,58,0.563142971989921,0.47851379397660093
콜금리인하,1,0.08061878917169785,78,39,39,33,0.558586013396616,0.4751435403166646
투자심리냉각,1,0.08008149915600926,74,37,37,40,0.5539453092390539,0.47170589568283416
물가안정적,1,0.08008149915600926,74,37,37,37,0.5539453092390539,0.47170589568283416
cds프리미엄상승,1,0.07980822389426878,72,36,36,57,0.5515935546381202,0.4699616838193476
국채선물오른,1,0.07909116399708394,278,138,140,218,0.6870801163070833,0.5862425504903619
이익증가,1,0.07896970133244152,66,33,33,59,0.5444128095611749,0.46462699549014563
시장금리상승,1,0.07821308275810979,363,180,183,242,0.7047160770781457,0.6023535225905654
국채선물떨어진,1,0.07810284356165265,60,30,30,74,0.5370443139069807,0.45913851335295414
대출줄이,1,0.07780753351799263,58,29,29,53,0.5345465817830201,0.457274715698018
금리인하할,1,0.07750902446330477,56,28,28,38,0.5320281405149966,0.455393732699587
콜금리올리,1,0.0772073048986297,54,27,27,40,0.5294890434522572,0.4534955498609362
가산금리상승,1,0.0772073048986297,54,27,27,23,0.5294890434522572,0.4534955498609362
전세가격상승,1,0.07690236379270199,52,26,26,53,0.5269293499452327,0.4515801565811164
달러화엔화거래떨어졌,1,0.07690236379270199,52,26,26,28,0.5269293499452327,0.4515801565811164
경제확산,1,0.07659419059637806,50,25,25,23,0.5243491254578174,0.44964754625935577
cd금리오른,1,0.07659419059637806,50,25,25,28,0.5243491254578174,0.44964754625935577
실적호전,1,0.07659419059637806,50,25,25,35,0.5243491254578174,0.44964754625935577
위안화절하,1,0.07628277525719396,48,24,24,63,0.5217484416789997,0.447697716400145
엔화대해선내린,1,0.07596810823403732,46,23,23,22,0.5191273766336014,0.44573066871892697
금리인상늦추,1,0.07532898361691087,42,21,21,49,0.5138244471785571,0.4417449484446713
기준금리인하불구하,1,0.07532898361691087,42,21,21,41,0.5138244471785571,0.4417449484446713
변동성줄,1,0.07500450963098415,40,20,20,41,0.5111427714789769,0.43972630129518936
경제성장이끌,1,0.0746767512071631,38,19,19,23,0.5084410921458051,0.4376904874249833
신용등급낮기업,1,0.07434570158455256,36,18,18,28,0.5057195205025367,0.4356375312044777
기준금리인하반영,1,0.07434570158455256,36,18,18,23,0.5057195205025367,0.4356375312044777
원자재가격하락따른,1,0.07434570158455256,36,18,18,21,0.5057195205025367,0.4356375312044777
달러화강세보일,1,0.07434570158455256,36,18,18,43,0.5057195205025367,0.4356375312044777
재정위기확산,1,0.07434570158455256,36,18,18,65,0.5057195205025367,0.4356375312044777
물가상승률상승,1,0.07401135460348329,34,17,17,20,0.5029781748457857,0.43356746185675193
비용높,1,0.07401135460348329,34,17,17,18,0.5029781748457857,0.43356746185675193
수요억제,1,0.07367370472066859,32,16,16,16,0.5002171805454719,0.4314803135648047
인플레이션우려제기,1,0.07333274702437964,30,15,15,15,0.4974366701428316,0.42937612557860827
원화가치하락,1,0.07333274702437964,30,15,15,30,0.4974366701428316,0.42937612557860827
주택시장침체,1,0.07333274702437964,30,15,15,17,0.4974366701428316,0.42937612557860827
금리부담,1,0.07333274702437964,30,15,15,23,0.4974366701428316,0.42937612557860827
금리인상확실,1,0.07333274702437964,30,15,15,26,0.4974366701428316,0.42937612557860827
수출호조따른,1,0.07333274702437964,30,15,15,16,0.4974366701428316,0.42937612557860827
채권금리오를,1,0.07333274702437964,30,15,15,38,0.4974366701428316,0.42937612557860827
금리급등세진정,1,0.07333274702437964,30,15,15,11,0.4974366701428316,0.42937612557860827
인플레이션완화,1,0.07325839246415744,143,71,72,78,0.6149314000034538,0.5308742827959065
경기침체이어지,1,0.07298847724961277,28,14,14,19,0.494636783446072,0.42725494232183214
고용늘어나,1,0.07298847724961277,28,14,14,18,0.494636783446072,0.42725494232183214
달러화강세,1,0.07298847724961277,28,14,14,20,0.494636783446072,0.42725494232183214
국채가격떨어진,1,0.07298847724961277,28,14,14,9,0.494636783446072,0.42725494232183214
금리인상적절하,1,0.07298847724961277,28,14,14,35,0.494636783446072,0.42725494232183214
성장위해서,1,0.07298847724961277,28,14,14,27,0.494636783446072,0.42725494232183214
높수익률제공,1,0.07298847724961277,28,14,14,13,0.494636783446072,0.42725494232183214
불확실성높판단,1,0.07298847724961277,28,14,14,25,0.494636783446072,0.42725494232183214
유로화반등,1,0.07298847724961277,28,14,14,31,0.494636783446072,0.42725494232183214
금리인상지연,1,0.07290882255166031,141,70,71,164,0.6132096285829592,0.5297600417790258
손실커지,1,0.07264089179323863,26,13,13,12,0.49181766762348694,0.4251168134981064
지표금리국고채수익률오른,1,0.07264089179323863,26,13,13,7,0.49181766762348694,0.4251168134981064
금리인상미루,1,0.07264089179323863,26,13,13,27,0.49181766762348694,0.4251168134981064
이중침체빠지,1,0.07264089179323863,26,13,13,14,0.49181766762348694,0.4251168134981064
금리확대,1,0.07264089179323863,26,13,13,22,0.49181766762348694,0.4251168134981064
투자확대,1,0.07249032142239042,291,144,147,233,0.6868887714022932,0.5939119013400749
원자재가격급등,1,0.07228998772911432,24,12,12,16,0.48897947729384833,0.42296179419669394
외환시장변동성확대,1,0.07228998772911432,24,12,12,23,0.48897947729384833,0.42296179419669394
국채수익률떨어진,1,0.07228998772911432,24,12,12,10,0.48897947729384833,0.42296179419669394
금융안정위해,1,0.07228998772911432,24,12,12,16,0.48897947729384833,0.42296179419669394
금리상승반영,1,0.07228998772911432,24,12,12,28,0.48897947729384833,0.42296179419669394
양적완화시작,1,0.07228998772911432,24,12,12,36,0.48897947729384833,0.42296179419669394
내구재주문증가,1,0.07228998772911432,24,12,12,12,0.48897947729384833,0.42296179419669394
침체국면벗어나,1,0.07228998772911432,24,12,12,18,0.48897947729384833,0.42296179419669394
장기물강세,1,0.07228998772911432,24,12,12,34,0.48897947729384833,0.42296179419669394
기대심리강세보였,1,0.07228998772911432,24,12,12,8,0.48897947729384833,0.42296179419669394
민간고용증가,1,0.07228998772911432,24,12,12,24,0.48897947729384833,0.42296179419669394
낮금리대출받,1,0.07228998772911432,24,12,12,32,0.48897947729384833,0.42296179419669394
금리상승축소,1,0.07228998772911432,24,12,12,30,0.48897947729384833,0.42296179419669394
금리올린다는,1,0.07228998772911432,24,12,12,20,0.48897947729384833,0.42296179419669394
순이익내,1,0.07193576282313674,22,11,11,8,0.48612237461388147,0.42078994499743355
물가우려,1,0.07193576282313674,22,11,11,23,0.48612237461388147,0.42078994499743355
원화절상따른,1,0.07193576282313674,22,11,11,29,0.48612237461388147,0.42078994499743355
채권시장강세보일,1,0.07193576282313674,22,11,11,23,0.48612237461388147,0.42078994499743355
이익줄,1,0.07193576282313674,22,11,11,23,0.48612237461388147,0.42078994499743355
유로엔하락,1,0.07193576282313674,22,11,11,13,0.48612237461388147,0.42078994499743355
달러화레벨높일,1,0.07193576282313674,22,11,11,19,0.48612237461388147,0.42078994499743355
집값떨어질,1,0.07193576282313674,22,11,11,5,0.48612237461388147,0.42078994499743355
경기침체벗어나,1,0.07193576282313674,22,11,11,18,0.48612237461388147,0.42078994499743355
금리인하배경설명,1,0.07193576282313674,22,11,11,5,0.48612237461388147,0.42078994499743355
경기회복발목잡,1,0.07157821554822474,20,10,10,18,0.48324652936263307,0.4186013320748139
국고지표금리오른,1,0.07157821554822474,20,10,10,8,0.48324652936263307,0.4186013320748139
고용늘리,1,0.07157821554822474,20,10,10,18,0.48324652936263307,0.4186013320748139
성장세나타냈,1,0.07157821554822474,20,10,10,12,0.48324652936263307,0.4186013320748139
영업적자,1,0.07157821554822474,20,10,10,20,0.48324652936263307,0.4186013320748139
신용위험,1,0.07157821554822474,20,10,10,13,0.48324652936263307,0.4186013320748139
달러강세나타날,1,0.07157821554822474,20,10,10,22,0.48324652936263307,0.4186013320748139
순이자마진상승,1,0.07157821554822474,20,10,10,9,0.48324652936263307,0.4186013320748139
소비자신뢰지수상승,1,0.07157821554822474,20,10,10,19,0.48324652936263307,0.4186013320748139
변동성줄여,1,0.07157821554822474,20,10,10,30,0.48324652936263307,0.4186013320748139
변동성높일,1,0.07157821554822474,20,10,10,16,0.48324652936263307,0.4186013320748139
금리인상미뤄질,1,0.07157821554822474,20,10,10,35,0.48324652936263307,0.4186013320748139
금리상승영향받,1,0.07157821554822474,20,10,10,19,0.48324652936263307,0.4186013320748139
물가상승이어지,1,0.07157821554822474,20,10,10,8,0.48324652936263307,0.4186013320748139
채권시장강세보인,1,0.07157821554822474,20,10,10,18,0.48324652936263307,0.4186013320748139
경기침체인해,1,0.07157821554822474,20,10,10,17,0.48324652936263307,0.4186013320748139
원화강세보일,1,0.07157821554822474,20,10,10,24,0.48324652936263307,0.4186013320748139
엔화강세보일,1,0.07157821554822474,20,10,10,20,0.48324652936263307,0.4186013320748139
경제반등,1,0.07157821554822474,20,10,10,22,0.48324652936263307,0.4186013320748139
불확실성확산,1,0.07157821554822474,20,10,10,21,0.48324652936263307,0.4186013320748139
인플레이션기대심리억제,1,0.07157821554822474,20,10,10,25,0.48324652936263307,0.4186013320748139
이자부담가중,1,0.07157821554822474,20,10,10,16,0.48324652936263307,0.4186013320748139
저평가줄어들,1,0.07121734509920596,18,9,9,6,0.48035211902253594,0.41639602730102954
금리상승어렵,1,0.07121734509920596,18,9,9,7,0.48035211902253594,0.41639602730102954
달러화낙폭축소,1,0.07121734509920596,18,9,9,8,0.48035211902253594,0.41639602730102954
경기둔화확인,1,0.07121734509920596,18,9,9,11,0.48035211902253594,0.41639602730102954
침체따른,1,0.07121734509920596,18,9,9,9,0.48035211902253594,0.41639602730102954
금리인하기대심리형성,1,0.07121734509920596,18,9,9,6,0.48035211902253594,0.41639602730102954
모기지금리낮수준,1,0.07121734509920596,18,9,9,5,0.48035211902253594,0.41639602730102954
채권시장국고지표금리오른,1,0.07121734509920596,18,9,9,35,0.48035211902253594,0.41639602730102954
양적완화불구하,1,0.07121734509920596,18,9,9,15,0.48035211902253594,0.41639602730102954
채권금리내렸,1,0.07121734509920596,18,9,9,9,0.48035211902253594,0.41639602730102954
순이익줄어든,1,0.07121734509920596,18,9,9,18,0.48035211902253594,0.41639602730102954
자본빠져나가,1,0.07121734509920596,18,9,9,11,0.48035211902253594,0.41639602730102954
경기침체가속화,1,0.07121734509920596,18,9,9,7,0.48035211902253594,0.41639602730102954
투자선호,1,0.07121734509920596,18,9,9,15,0.48035211902253594,0.41639602730102954
수익성개선기대,1,0.07121734509920596,18,9,9,2,0.48035211902253594,0.41639602730102954
무역수지적자축소,1,0.07121734509920596,18,9,9,6,0.48035211902253594,0.41639602730102954
시장심리악화,1,0.07121734509920596,18,9,9,19,0.48035211902253594,0.41639602730102954
가산금리확대,1,0.07121734509920596,18,9,9,4,0.48035211902253594,0.41639602730102954
이익늘,1,0.07121734509920596,18,9,9,14,0.48035211902253594,0.41639602730102954
금리부담있,1,0.07121734509920596,18,9,9,21,0.48035211902253594,0.41639602730102954
금리인상염두두,1,0.07121734509920596,18,9,9,4,0.48035211902253594,0.41639602730102954
금리상승세이어질,1,0.07121734509920596,18,9,9,20,0.48035211902253594,0.41639602730102954
금리높형성,1,0.07121734509920596,18,9,9,23,0.48035211902253594,0.41639602730102954
금리인상제한적,1,0.07121734509920596,18,9,9,21,0.48035211902253594,0.41639602730102954
외화자금시장스왑하락,1,0.07121734509920596,18,9,9,13,0.48035211902253594,0.41639602730102954
거시경제정책유지,1,0.07121734509920596,18,9,9,18,0.48035211902253594,0.41639602730102954
금융불안확산,1,0.07121734509920596,18,9,9,15,0.48035211902253594,0.41639602730102954
완화적스탠스유지,1,0.07121734509920596,18,9,9,9,0.48035211902253594,0.41639602730102954
하방위험증대,1,0.07121734509920596,18,9,9,33,0.48035211902253594,0.41639602730102954
물가상승압력가중,1,0.07121734509920596,18,9,9,11,0.48035211902253594,0.41639602730102954
성장동력찾,1,0.0708531514075883,16,8,8,28,0.4774393288569718,0.4141741083478706
경제과열,1,0.0708531514075883,16,8,8,15,0.4774393288569718,0.4141741083478706
재무건전성악화,1,0.0708531514075883,16,8,8,11,0.4774393288569718,0.4141741083478706
성장미치,1,0.0708531514075883,16,8,8,24,0.4774393288569718,0.4141741083478706
경기회복세가속화,1,0.0708531514075883,16,8,8,8,0.4774393288569718,0.4141741083478706
국채수익률급락,1,0.0708531514075883,16,8,8,7,0.4774393288569718,0.4141741083478706
단기자금시장안정,1,0.0708531514075883,16,8,8,5,0.4774393288569718,0.4141741083478706
금리인상구체적,1,0.0708531514075883,16,8,8,17,0.4774393288569718,0.4141741083478706
부동산시장안정,1,0.0708531514075883,16,8,8,11,0.4774393288569718,0.4141741083478706
경기비관적,1,0.0708531514075883,16,8,8,7,0.4774393288569718,0.4141741083478706
실적호조보이,1,0.0708531514075883,16,8,8,8,0.4774393288569718,0.4141741083478706
금리인하강하,1,0.0708531514075883,16,8,8,9,0.4774393288569718,0.4141741083478706
cd유통수익률오른,1,0.0708531514075883,16,8,8,11,0.4774393288569718,0.4141741083478706
달러강세제한,1,0.0708531514075883,16,8,8,29,0.4774393288569718,0.4141741083478706
달러화절하,1,0.0708531514075883,16,8,8,9,0.4774393288569718,0.4141741083478706
아파트가격상승,1,0.0708531514075883,16,8,8,15,0.4774393288569718,0.4141741083478706
기업실적악화,1,0.0708531514075883,16,8,8,11,0.4774393288569718,0.4141741083478706
모기지금리떨어졌,1,0.0708531514075883,16,8,8,9,0.4774393288569718,0.4141741083478706
내외금리차확대따른,1,0.0708531514075883,16,8,8,5,0.4774393288569718,0.4141741083478706
물가안정위해서,1,0.0708531514075883,16,8,8,11,0.4774393288569718,0.4141741083478706
대외불확실성높,1,0.0708531514075883,16,8,8,11,0.4774393288569718,0.4141741083478706
채권금리반등,1,0.0708531514075883,16,8,8,22,0.4774393288569718,0.4141741083478706
금리하락세돌아섰,1,0.0708531514075883,16,8,8,18,0.4774393288569718,0.4141741083478706
수요부진따른,1,0.0708531514075883,16,8,8,6,0.4774393288569718,0.4141741083478706
엔달러환율오른,1,0.0708531514075883,16,8,8,18,0.4774393288569718,0.4141741083478706
경기과열억제,1,0.0708531514075883,16,8,8,14,0.4774393288569718,0.4141741083478706
채권시장약세출발,1,0.0708531514075883,16,8,8,18,0.4774393288569718,0.4141741083478706
금리하락세제한,1,0.0708531514075883,16,8,8,15,0.4774393288569718,0.4141741083478706
성장기여도높,1,0.0708531514075883,16,8,8,13,0.4774393288569718,0.4141741083478706
통화정책유지,1,0.06954945485635755,196,97,99,163,0.6474746073422304,0.563151570942186
유가하락따른,1,0.06900541162800233,121,60,61,100,0.5948351192898309,0.5179333946798617
물가상승률낮,1,0.06646144859523617,178,88,90,177,0.6353207383375948,0.5560192584495449
수출둔화,1,0.06360049000973755,99,49,50,55,0.5720329432139678,0.5035156762890162
성장세둔화,1,0.05885356614727266,250,123,127,150,0.6657950825206239,0.591657702597725
엔화하락,1,0.05857019266139574,83,41,42,74,0.553562603874516,0.4922022898780533
채권금리상승,1,0.056878747500906046,389,191,198,386,0.694876514577664,0.619952427773068
국고채하락,1,0.053584647850172695,222,109,113,162,0.6512634187630623,0.584893679333987
엔화약세,1,0.05336947107931245,124,61,63,106,0.589309537819185,0.5294819009540467
금리하락제한,1,0.05323985152577282,173,85,88,183,0.6248785142224157,0.5615858157959541
통화긴축,1,0.05295462428195563,69,34,35,44,0.5359076145026425,0.4819021580323411
달러화가치하락,1,0.05295462428195563,69,34,35,52,0.5359076145026425,0.4819021580323411
경기위축,1,0.052201308301701,169,83,86,72,0.6217699376807547,0.5599570191539155
국고채지표금리하락,1,0.05139256695239758,118,58,60,115,0.5831892476911896,0.5260641663314122
금리인상가능성제기,1,0.05104829086046103,65,32,33,63,0.5305700161109136,0.4789296090471691
지급준비금적수줄어든다,1,0.05104829086046103,65,32,33,71,0.5305700161109136,0.4789296090471691
기대심리커졌,1,0.048964261732812764,61,30,31,51,0.5250847806241921,0.4759625939734264
금리오를,1,0.0481814616677132,409,200,209,333,0.6913631997149511,0.6276695776630759
경제지표호전,1,0.04784520257985969,59,29,30,44,0.522282633622541,0.4744856734643681
원화약세,1,0.04784520257985969,59,29,30,38,0.522282633622541,0.4744856734643681
엔화약세보이,1,0.04784520257985969,59,29,30,52,0.522282633622541,0.4744856734643681
무역수지흑자,1,0.04784520257985969,59,29,30,37,0.522282633622541,0.4744856734643681
채권시장강세보였,1,0.046668068662441886,57,28,29,35,0.5194380955166523,0.47301605626739096
인플레이션우려커지,1,0.046668068662441886,57,28,29,31,0.5194380955166523,0.47301605626739096
경제발목잡,1,0.046668068662441886,57,28,29,40,0.5194380955166523,0.47301605626739096
호황,1,0.045426916600795675,55,27,28,66,0.5165487543002673,0.47155631915036744
금리낮춘,1,0.04411491079024654,53,26,27,41,0.513611818239049,0.47010942102166187
자산증가,1,0.04411491079024654,53,26,27,52,0.513611818239049,0.47010942102166187
달러강세,1,0.04400132176414373,223,109,114,205,0.6460879082516064,0.5914995209794155
고용지표부진,1,0.04297750628236585,139,68,71,91,0.5957364252216816,0.5465221309337679
경제부진,1,0.04272414866056273,51,25,26,54,0.5106240376281431,0.46867877442025896
비용증가,1,0.04272414866056273,51,25,26,62,0.5106240376281431,0.46867877442025896
달러강세이어질,1,0.04272414866056273,51,25,26,46,0.5106240376281431,0.46867877442025896
소비자물가상승률높,1,0.04172170668108022,94,46,48,55,0.5563049282226071,0.511633601957462
채권금리하락,1,0.04015963379573528,355,173,182,299,0.6801619114709619,0.6275051783995989
신용등급상향조정,1,0.03974817525716956,90,44,46,82,0.5514100821561506,0.5091404585950595
이자내,1,0.03974817525716956,90,44,46,93,0.5514100821561506,0.5091404585950595
국고채수익률하락,1,0.03974817525716956,90,44,46,54,0.5514100821561506,0.5091404585950595
성장기대,1,0.0396680496494799,47,23,24,49,0.5044800392543648,0.4658827052376702
금리떨어져,1,0.03797932006489013,45,22,23,39,0.501314010450663,0.46452728440236446
금가격하락,1,0.03797932006489013,45,22,23,28,0.501314010450663,0.46452728440236446
고용지표하회,1,0.03797932006489013,45,22,23,27,0.501314010450663,0.46452728440236446
재무구조개선,1,0.037637649220922276,86,42,44,62,0.5463819451061764,0.5066346310236465
금리하락,1,0.0368655484028968,1849,899,950,1510,0.6908443773458448,0.6415791167003874
금리오르,1,0.03643604815091206,792,385,407,681,0.6905616346444071,0.6418683150643238
금리하락압력작용,1,0.036164260297725015,43,21,22,45,0.49807715168062355,0.46320843070484813
물가높,1,0.036164260297725015,43,21,22,36,0.49807715168062355,0.46320843070484813
경기둔화우려부각,1,0.036164260297725015,43,21,22,37,0.49807715168062355,0.46320843070484813
금리인상중단,1,0.03460274575285127,292,142,150,165,0.66416810802074,0.6196060406213796
가계부채증가,1,0.03420495798265155,41,20,21,56,0.4947617835403517,0.46193369021838915
소비자물가오르,1,0.03420495798265155,41,20,21,26,0.4947617835403517,0.46193369021838915
수요유지,1,0.03420495798265155,41,20,21,38,0.4947617835403517,0.46193369021838915
금리인상재개,1,0.03420495798265155,41,20,21,42,0.4947617835403517,0.46193369021838915
기준금리인상없,1,0.034174510657320134,80,39,41,71,0.5385720693170305,0.5028677578394917
금리상승,1,0.033463295932537385,2505,1216,1289,2234,0.6886605704393013,0.6439224104190986
금리인상멈출,1,0.032079833789784296,39,19,20,29,0.49135856263759253,0.4607120833725855
부양책필요,1,0.032079833789784296,39,19,20,39,0.49135856263759253,0.4607120833725855
금리인상대응,1,0.032079833789784296,39,19,20,23,0.49135856263759253,0.4607120833725855
금리올랐,1,0.03134556276146738,342,166,176,267,0.6725849298815213,0.6315627715683112
안전자산선호강화,1,0.03050393377757077,243,118,125,184,0.6462125218961877,0.6078219318966903
엔화강세,1,0.030284195010838344,74,36,38,49,0.530410116390089,0.4991186561397765
인플레이션하락,1,0.02976264920373972,37,18,19,19,0.4878560085329008,0.4595544806946233
대출억제,1,0.02976264920373972,37,18,19,33,0.4878560085329008,0.4595544806946233
금리상승컸,1,0.02976264920373972,37,18,19,56,0.4878560085329008,0.4595544806946233
콜금리동결,1,0.029676327808106917,365,177,188,154,0.6749402281228474,0.635895412908647
성장달성,1,0.02887542316407976,72,35,37,41,0.5276037014389718,0.497879619989742
산업생산감소,1,0.02887542316407976,72,35,37,45,0.5276037014389718,0.497879619989742
금리유지,1,0.02776075101385156,295,143,152,263,0.660679741755589,0.6248507754617774
양적완화통해,1,0.0274031694279262,70,34,36,64,0.5247510852829332,0.49664886134869
gdp부진,1,0.02722117281264258,35,17,18,28,0.4842398605346419,0.4584740995955497
채권시장약세보였,1,0.02722117281264258,35,17,18,31,0.4842398605346419,0.4584740995955497
급성장,1,0.025862155997047775,68,33,35,49,0.5218499112273525,0.49542845394203877
고용부진,1,0.025862155997047775,68,33,35,48,0.5218499112273525,0.49542845394203877
금리올릴,1,0.024707609266236608,935,452,483,740,0.6830017557820105,0.6499208232010472
채권스왑스프레드역전폭확대,1,0.024415359204542186,33,16,17,52,0.48049218856932063,0.45748717012018925
경기반등,1,0.024415359204542186,33,16,17,40,0.48049218856932063,0.45748717012018925
유로화강세보였,1,0.024415359204542186,33,16,17,27,0.48049218856932063,0.45748717012018925
기준금리인상주장,1,0.024415359204542186,33,16,17,28,0.48049218856932063,0.45748717012018925
수요늘어났,1,0.024415359204542186,33,16,17,39,0.48049218856932063,0.45748717012018925
기준금리인상가능성낮,1,0.024246467341406674,66,32,34,49,0.5188975238386085,0.49422071599480016
서부텍사스산원유오른,1,0.024246467341406674,66,32,34,53,0.5188975238386085,0.49422071599480016
양적완화유지,1,0.024246467341406674,66,32,34,100,0.5188975238386085,0.49422071599480016
기준금리인상지연,1,0.024246467341406674,66,32,34,46,0.5188975238386085,0.49422071599480016
경기부양,1,0.024222297357746392,252,122,130,256,0.6456633673353885,0.6149877946490162
미국채금리상승,1,0.023597418320777885,279,135,144,366,0.6538226546622575,0.6235385327758397
수출부진,1,0.02310432529301032,219,106,113,179,0.6318760418546051,0.6032032570216846
불안심리해소,1,0.02298360492205509,128,62,66,73,0.5763381717292275,0.5503184430992941
금리인상선반영,1,0.022549450116128522,64,31,33,59,0.515890919038765,0.49302824555022556
달러강세인한,1,0.021294818439234753,31,15,16,23,0.4765901412465528,0.4566138404585376
호황누리,1,0.021294818439234753,31,15,16,26,0.4765901412465528,0.4566138404585376
금리인상기대,1,0.021294818439234753,31,15,16,29,0.4765901412465528,0.4566138404585376
안전자산선호심리자극,1,0.021294818439234753,31,15,16,22,0.4765901412465528,0.4566138404585376
생산자물가하락,1,0.021294818439234753,31,15,16,26,0.4765901412465528,0.4566138404585376
투자심리호전,1,0.020901043984135503,124,60,64,65,0.5720018684504855,0.5484582671391492
완화정책,1,0.02076359355064583,62,30,32,71,0.5128266840131709,0.49185396211416216
cd금리하락,1,0.019819688288553516,122,59,63,58,0.5697891525514753,0.5475197648645477
시장금리급등,1,0.019819688288553516,122,59,63,55,0.5697891525514753,0.5475197648645477
국제유가상승,1,0.018710049836625275,120,58,62,95,0.5675459197346279,0.5465761090479175
국채가격상승,1,0.01861676841180282,178,86,92,93,0.6081654753821553,0.5858041431481258
달러강세진행,1,0.01779522995007543,29,14,15,30,0.4725041462961407,0.4558794288935684
금리오,1,0.01779522995007543,29,14,15,14,0.4725041462961407,0.4558794288935684
금리동결이어질,1,0.01779522995007543,29,14,15,26,0.4725041462961407,0.4558794288935684
금리인하가능성배제없,1,0.01779522995007543,29,14,15,21,0.4725041462961407,0.4558794288935684
인플레이션기대심리낮추,1,0.01779522995007543,29,14,15,29,0.4725041462961407,0.4558794288935684
유로화달러화높,1,0.01779522995007543,29,14,15,22,0.4725041462961407,0.4558794288935684
기준금리인하기대심리높,1,0.01779522995007543,29,14,15,25,0.4725041462961407,0.4558794288935684
금리올려,1,0.01756477097150877,147,71,76,135,0.58757452233052,0.5671625293611523
경제성장촉진,1,0.016890139733610088,58,28,30,21,0.5065091757534163,0.48957354696631067
엔화강세보였,1,0.016890139733610088,58,28,30,32,0.5065091757534163,0.48957354696631067
금리우호적,1,0.01647007716773974,87,42,45,76,0.5366567372833638,0.5191491097299981
경제성장세둔화,1,0.01647007716773974,87,42,45,43,0.5366567372833638,0.5191491097299981
투자위축,1,0.01647007716773974,87,42,45,51,0.5366567372833638,0.5191491097299981
금융시장안정,1,0.016453470816193194,228,110,118,143,0.6317363015510525,0.6111471442518016
원화절상,1,0.014961760226722243,85,41,44,64,0.5339205549465235,0.5180627625999098
인플레이션우려강조,1,0.013833146351787784,27,13,14,11,0.4681952628328874,0.45531618643111543
경기후퇴막,1,0.013833146351787784,27,13,14,13,0.4681952628328874,0.45531618643111543
달러화강세나타내,1,0.013833146351787784,27,13,14,40,0.4681952628328874,0.45531618643111543
채권시장국채가격하락,1,0.013833146351787784,27,13,14,26,0.4681952628328874,0.45531618643111543
소득줄어들,1,0.013833146351787784,27,13,14,12,0.4681952628328874,0.45531618643111543
불안정성높,1,0.013833146351787784,27,13,14,28,0.4681952628328874,0.45531618643111543
금리인하가능성,1,0.013833146351787784,27,13,14,5,0.4681952628328874,0.45531618643111543
이익실현매물나와하락,1,0.013833146351787784,27,13,14,14,0.4681952628328874,0.45531618643111543
높수익률기대,1,0.013833146351787784,27,13,14,25,0.4681952628328874,0.45531618643111543
채권가격하락채권약세,1,0.013833146351787784,27,13,14,30,0.4681952628328874,0.45531618643111543
인플레이션압력커지,1,0.012542595352318164,54,26,28,41,0.49990632351962605,0.48741138275347506
경제부양,1,0.012542595352318164,54,26,28,36,0.49990632351962605,0.48741138275347506
소비자물가하락,1,0.011766115231141683,81,39,42,50,0.5283117692599384,0.5159073903339301
불안심리완화,1,0.011380593291735686,108,52,56,66,0.553406246477516,0.5408294945436096
불확실성확대,1,0.010415538821745951,160,77,83,165,0.5923194270826346,0.5799766115163788
금리인상가능성낮,1,0.010415538821745951,160,77,83,156,0.5923194270826346,0.5799766115163788
엔화약세따른,1,0.01015789526250721,52,25,27,67,0.49648232532026804,0.486387121639551
기준금리인상시사,1,0.010070272020010762,79,38,41,76,0.5254351178281433,0.5148414137232329
물가상승세둔화,1,0.00929827091842128,25,12,13,17,0.4636111810305587,0.45496582911145095
기준금리인상지지,1,0.00929827091842128,25,12,13,16,0.4636111810305587,0.45496582911145095
국고채수익률내린,1,0.00929827091842128,25,12,13,17,0.4636111810305587,0.45496582911145095
환율하락막,1,0.00929827091842128,25,12,13,20,0.4636111810305587,0.45496582911145095
금리높회사채,1,0.00929827091842128,25,12,13,30,0.4636111810305587,0.45496582911145095
경제지표호조보여,1,0.00929827091842128,25,12,13,17,0.4636111810305587,0.45496582911145095
달러화약세보인,1,0.00929827091842128,25,12,13,26,0.4636111810305587,0.45496582911145095
유로화강세,1,0.00929827091842128,25,12,13,19,0.4636111810305587,0.45496582911145095
기준금리인하나설,1,0.00929827091842128,25,12,13,26,0.4636111810305587,0.45496582911145095
안전자산선호강해,1,0.00929827091842128,25,12,13,20,0.4636111810305587,0.45496582911145095
국채선물가격하락,1,0.00929827091842128,25,12,13,19,0.4636111810305587,0.45496582911145095
성장하,1,0.008641992593781511,104,50,54,65,0.5484140058666118,0.5388940643542967
경쟁력높이,1,0.007610636812310112,50,24,26,52,0.4929661714620926,0.48540887240969294
초저금리유지,1,0.007140549259460949,204,98,106,241,0.6152819162721411,0.6064192907481709
인플레이션상승,1,0.006580754429741598,127,61,66,107,0.5665340915592892,0.5589990593681561
성장할,1,0.006457849092005752,75,36,39,28,0.5195254857769801,0.5127416843105881
금리떨어지,1,0.0062809468098032895,202,97,105,127,0.6137842842384559,0.6059840146615267
인플레이션우려부각,1,0.00452976390432247,73,35,38,44,0.5164869629860231,0.511712008126474
수요줄어드,1,0.004041640216575715,23,11,12,19,0.4586799915470641,0.4548832593748616
금리인상필요성강조,1,0.004041640216575715,23,11,12,16,0.4586799915470641,0.4548832593748616
외환시장원달러하락,1,0.004041640216575715,23,11,12,26,0.4586799915470641,0.4548832593748616
기대인플레이션높수준,1,0.004041640216575715,23,11,12,17,0.4586799915470641,0.4548832593748616
높변동성보일,1,0.004041640216575715,23,11,12,18,0.4586799915470641,0.4548832593748616
유로엔오른,1,0.004041640216575715,23,11,12,6,0.4586799915470641,0.4548832593748616
금리인상높,1,0.004041640216575715,23,11,12,15,0.4586799915470641,0.4548832593748616
경기낙관,1,0.004041640216575715,23,11,12,16,0.4586799915470641,0.4548832593748616
금리인상제한,1,0.004041640216575715,23,11,12,13,0.4586799915470641,0.4548832593748616
금리끌어올렸,1,0.004041640216575715,23,11,12,9,0.4586799915470641,0.4548832593748616
금리인상감안,1,0.004041640216575715,23,11,12,8,0.4586799915470641,0.4548832593748616
소득심사강화,1,0.004041640216575715,23,11,12,21,0.4586799915470641,0.4548832593748616
금리하락세이어질,1,0.004041640216575715,23,11,12,37,0.4586799915470641,0.4548832593748616
잠재성장률낮,1,0.004041640216575715,23,11,12,26,0.4586799915470641,0.4548832593748616
경기부양책따른,1,0.004041640216575715,23,11,12,23,0.4586799915470641,0.4548832593748616
금리인하요구,1,0.0019453300894913816,46,22,24,43,0.4856172609716179,0.4836206181169125
경기후퇴,1,0.0019453300894913816,46,22,24,21,0.4856172609716179,0.4836206181169125
국고채지표금리내린,1,0.0003960570676300179,69,33,36,94,0.5102260911967155,0.5097048974106867
기준금리낮추,-1,-0.0007044868372210189,92,44,48,71,0.5324786835883707,0.5331066801224267
채권스왑스프레드확대,-1,-0.0012238105639507113,44,21,23,29,0.4817595071542951,0.48282882841793817
경제둔화,-1,-0.0015817799449830972,253,121,132,135,0.630003785314066,0.6318542814363441
수요둔화,-1,-0.0018255169800002191,67,32,35,56,0.5069959227575447,0.508733001971251
유로하락,-1,-0.0021430859087442355,21,10,11,11,0.45330013296265925,0.455142175781951
침체이어질,-1,-0.0021430859087442355,21,10,11,14,0.45330013296265925,0.455142175781951
낮금리받,-1,-0.0021430859087442355,21,10,11,33,0.45330013296265925,0.455142175781951
성장친화적,-1,-0.0021430859087442355,21,10,11,16,0.45330013296265925,0.455142175781951
경기회복찬물끼얹,-1,-0.0021430859087442355,21,10,11,11,0.45330013296265925,0.455142175781951
기준금리인상진행,-1,-0.0021430859087442355,21,10,11,25,0.45330013296265925,0.455142175781951
pmi지수하락,-1,-0.0021430859087442355,21,10,11,11,0.45330013296265925,0.455142175781951
고용개선따른,-1,-0.0021430859087442355,21,10,11,13,0.45330013296265925,0.455142175781951
수익성하락,-1,-0.0021430859087442355,21,10,11,22,0.45330013296265925,0.455142175781951
성장힘입,-1,-0.0021430859087442355,21,10,11,16,0.45330013296265925,0.455142175781951
성장회복,-1,-0.0021430859087442355,21,10,11,16,0.45330013296265925,0.455142175781951
주택시장둔화,-1,-0.0021430859087442355,21,10,11,13,0.45330013296265925,0.455142175781951
투자심리개선,-1,-0.0027049188036699645,228,109,119,219,0.6199896593574745,0.6232088338942892
경기회복세보이,-1,-0.00416252351288382,65,31,34,48,0.5036931936854208,0.5077864303987307
irs금리하락,-1,-0.004659543598439786,42,20,22,32,0.47775859185858816,0.4821200067238928
달러엔하락,-1,-0.005809057652414129,132,63,69,74,0.5634455669878122,0.569897724111563
성장,-1,-0.005856521265102832,1696,808,888,1303,0.6628287556645737,0.6704826097935948
금리인상우려완화,-1,-0.006164225736604245,86,41,45,81,0.5238969013640397,0.530272662557101
지급준비율인상,-1,-0.007727070775482403,382,182,200,212,0.6527164807509066,0.6627279472185419
원달러급등,-1,-0.00840160940334056,40,19,21,42,0.47359452662942103,0.4815076744019085
비농업고용자수증가,-1,-0.00840160940334056,40,19,21,25,0.47359452662942103,0.4815076744019085
수주감소,-1,-0.00840160940334056,40,19,21,36,0.47359452662942103,0.4815076744019085
기대인플레이션상승,-1,-0.00840160940334056,40,19,21,40,0.47359452662942103,0.4815076744019085
유가상승인한,-1,-0.00840160940334056,40,19,21,19,0.47359452662942103,0.4815076744019085
인플레이션낮수준,-1,-0.009227023292497472,61,29,32,55,0.49684797354837046,0.5059841783051751
기준금리동결점쳤,-1,-0.009550464257148339,19,9,10,7,0.447323487718994,0.45584377584025776
경기회복세따른,-1,-0.009550464257148339,19,9,10,14,0.447323487718994,0.45584377584025776
금리낮엔화,-1,-0.009550464257148339,19,9,10,11,0.447323487718994,0.45584377584025776
유로달러시장하락,-1,-0.009550464257148339,19,9,10,17,0.447323487718994,0.45584377584025776
금리인상우호적,-1,-0.009550464257148339,19,9,10,14,0.447323487718994,0.45584377584025776
금가격올랐,-1,-0.009550464257148339,19,9,10,11,0.447323487718994,0.45584377584025776
수요줄이,-1,-0.009550464257148339,19,9,10,20,0.447323487718994,0.45584377584025776
성장있,-1,-0.009550464257148339,19,9,10,26,0.447323487718994,0.45584377584025776
금리인상연속적,-1,-0.009550464257148339,19,9,10,3,0.447323487718994,0.45584377584025776
달러원상승따른,-1,-0.009550464257148339,19,9,10,12,0.447323487718994,0.45584377584025776
지표물오른,-1,-0.009550464257148339,19,9,10,25,0.447323487718994,0.45584377584025776
금리하락나타나,-1,-0.009550464257148339,19,9,10,4,0.447323487718994,0.45584377584025776
디플레이션우려높,-1,-0.009550464257148339,19,9,10,15,0.447323487718994,0.45584377584025776
시장심리개선,-1,-0.009550464257148339,19,9,10,18,0.447323487718994,0.45584377584025776
경제회복위한,-1,-0.009550464257148339,19,9,10,14,0.447323487718994,0.45584377584025776
물가안정기여,-1,-0.009550464257148339,19,9,10,27,0.447323487718994,0.45584377584025776
이자이익증가,-1,-0.009550464257148339,19,9,10,8,0.447323487718994,0.45584377584025776
높수익률얻,-1,-0.009550464257148339,19,9,10,11,0.447323487718994,0.45584377584025776
손실내,-1,-0.009550464257148339,19,9,10,14,0.447323487718994,0.45584377584025776
경기회복세지원,-1,-0.009550464257148339,19,9,10,17,0.447323487718994,0.45584377584025776
원유재고증가,-1,-0.012296163057175735,80,38,42,80,0.514831506261918,0.5275263938077982
금리끌어올릴,-1,-0.012498260961550378,38,18,20,21,0.46924274440483926,0.48100786668860934
실적개선기대,-1,-0.012498260961550378,38,18,20,47,0.46924274440483926,0.48100786668860934
금리인상가능성강하,-1,-0.012498260961550378,38,18,20,23,0.46924274440483926,0.48100786668860934
인플레이션억제,-1,-0.013726250470585288,265,126,139,142,0.6261777135554253,0.6434559674481194
유로달러상승,-1,-0.01458683911108738,141,67,74,122,0.5650189602272994,0.5816098641388769
소비자물가급등,-1,-0.014901554625717406,57,27,30,22,0.4896378676651643,0.5043326785265385
금리인상가능,-1,-0.015993742310595804,139,66,73,165,0.5627826057405514,0.5809402913118834
물가상승따른,-1,-0.01683268006661698,76,36,40,59,0.5084810623704843,0.5257682716658042
고용개선,-1,-0.01683268006661698,76,36,40,69,0.5084810623704843,0.5257682716658042
지표물국고채금리오른,-1,-0.01683268006661698,76,36,40,64,0.5084810623704843,0.5257682716658042
성장보일,-1,-0.01700869559164686,36,17,19,22,0.4646727215989809,0.48063973487349304
금가격오른,-1,-0.01700869559164686,36,17,19,12,0.4646727215989809,0.48063973487349304
금리하락세보였,-1,-0.01700869559164686,36,17,19,34,0.4646727215989809,0.48063973487349304
재정지출확대,-1,-0.01700869559164686,36,17,19,30,0.4646727215989809,0.48063973487349304
채권시장비우호적,-1,-0.01800854279149189,55,26,29,53,0.4858750088467764,0.5035766949924367
유로화달러화움직여낮,-1,-0.01800854279149189,55,26,29,26,0.4858750088467764,0.5035766949924367
달러화엔화높,-1,-0.01800854279149189,55,26,29,31,0.4858750088467764,0.5035766949924367
부도위험높,-1,-0.018616622579672226,17,8,9,17,0.44052552329497496,0.4571307036491034
지표물하락,-1,-0.018616622579672226,17,8,9,15,0.44052552329497496,0.4571307036491034
내수부양,-1,-0.018616622579672226,17,8,9,14,0.44052552329497496,0.4571307036491034
채권시장안정되찾,-1,-0.018616622579672226,17,8,9,4,0.44052552329497496,0.4571307036491034
달러원넘어서,-1,-0.018616622579672226,17,8,9,10,0.44052552329497496,0.4571307036491034
채권시장강세전환,-1,-0.018616622579672226,17,8,9,11,0.44052552329497496,0.4571307036491034
높수익낼,-1,-0.018616622579672226,17,8,9,15,0.44052552329497496,0.4571307036491034
기준금리인하어렵,-1,-0.018616622579672226,17,8,9,18,0.44052552329497496,0.4571307036491034
부진완화,-1,-0.018616622579672226,17,8,9,15,0.44052552329497496,0.4571307036491034
지급준비율인상이,-1,-0.018616622579672226,17,8,9,4,0.44052552329497496,0.4571307036491034
기준금리인하인해,-1,-0.018616622579672226,17,8,9,14,0.44052552329497496,0.4571307036491034
엔달러환율상승,-1,-0.018616622579672226,17,8,9,8,0.44052552329497496,0.4571307036491034
경기회복될,-1,-0.018616622579672226,17,8,9,7,0.44052552329497496,0.4571307036491034
콜금리목표유지,-1,-0.018616622579672226,17,8,9,6,0.44052552329497496,0.4571307036491034
고용자수늘어나,-1,-0.018616622579672226,17,8,9,18,0.44052552329497496,0.4571307036491034
가산금리낮추,-1,-0.018616622579672226,17,8,9,14,0.44052552329497496,0.4571307036491034
금리인상더불,-1,-0.018616622579672226,17,8,9,25,0.44052552329497496,0.4571307036491034
단기물강세보이,-1,-0.018616622579672226,17,8,9,8,0.44052552329497496,0.4571307036491034
유로화낙폭확대,-1,-0.018616622579672226,17,8,9,3,0.44052552329497496,0.4571307036491034
내수부양위해,-1,-0.018616622579672226,17,8,9,15,0.44052552329497496,0.4571307036491034
장단기금리차축소,-1,-0.019002439745219313,175,83,92,139,0.5841926696450459,0.6066812809672111
경기부양나서,-1,-0.019256574000108384,74,35,39,51,0.5052029633016693,0.5249176318622529
수요늘어난,-1,-0.019256574000108384,74,35,39,55,0.5052029633016693,0.5249176318622529
금리하락따른,-1,-0.01953593199111836,114,54,60,109,0.5415575610446655,0.5630054392886806
경제지표부진,-1,-0.02054741212393907,287,136,151,280,0.6279161343391813,0.654106351756975
물가잡,-1,-0.020780687252998975,211,100,111,154,0.6015010633674291,0.6268819915725937
경기회복지연,-1,-0.021281435438517238,112,53,59,71,0.538931591714525,0.5622352828652525
금리수준낮,-1,-0.021322240578986684,53,25,28,45,0.48199299885355407,0.5028756841568115
경기둔화우려높,-1,-0.021322240578986684,53,25,28,29,0.48199299885355407,0.5028756841568115
인플레이션높수준,-1,-0.022006379057462055,34,16,18,18,0.4598460750870462,0.4804263271235699
기준금리낮춘,-1,-0.022006379057462055,34,16,18,25,0.4598460750870462,0.4804263271235699
양적완화종료,-1,-0.022466581906474548,91,43,48,153,0.5198840048392668,0.543651541374471
금리인상서두르,-1,-0.024866869662691138,51,24,27,61,0.47797913630301186,0.5022370731362623
양적완화확대,-1,-0.024866869662691138,51,24,27,58,0.47797913630301186,0.5022370731362623
금리상승제한,-1,-0.025733439622433463,275,130,145,269,0.6213684764886648,0.6540366480015123
변동성커지,-1,-0.026340923616722245,201,95,106,168,0.593404329468205,0.6253620102579293
경기부진,-1,-0.026340923616722245,201,95,106,153,0.593404329468205,0.6253620102579293
금리올렸,-1,-0.02711940966305837,218,103,115,160,0.6006211079285421,0.6339542554533346
경기둔화인해,-1,-0.027583672658837655,32,15,17,22,0.45471388669611873,0.480395611248267
재정집행,-1,-0.027583672658837655,32,15,17,20,0.45471388669611873,0.480395611248267
인플레이션압력낮,-1,-0.027583672658837655,32,15,17,19,0.45471388669611873,0.480395611248267
높수익기대,-1,-0.027583672658837655,32,15,17,19,0.45471388669611873,0.480395611248267
투자줄,-1,-0.027583672658837655,32,15,17,15,0.45471388669611873,0.480395611248267
채권시장약세보임,-1,-0.027583672658837655,32,15,17,35,0.45471388669611873,0.480395611248267
경제회복,-1,-0.028701894211442758,286,135,151,261,0.6223565124658004,0.65897952641314
유로엔상승,-1,-0.030017209593038552,15,7,8,15,0.43254931801655244,0.4592102389665171
물가상승인한,-1,-0.030017209593038552,15,7,8,16,0.43254931801655244,0.4592102389665171
경제부정적영향줄,-1,-0.030017209593038552,15,7,8,20,0.43254931801655244,0.4592102389665171
건전성높이,-1,-0.030017209593038552,15,7,8,18,0.43254931801655244,0.4592102389665171
통화완화이,-1,-0.030017209593038552,15,7,8,18,0.43254931801655244,0.4592102389665171
낮금리거래,-1,-0.030017209593038552,15,7,8,8,0.43254931801655244,0.4592102389665171
유로달러급등,-1,-0.030017209593038552,15,7,8,16,0.43254931801655244,0.4592102389665171
채권시장기준금리동결,-1,-0.030017209593038552,15,7,8,3,0.43254931801655244,0.4592102389665171
수요줄일,-1,-0.030017209593038552,15,7,8,6,0.43254931801655244,0.4592102389665171
순이익줄,-1,-0.030017209593038552,15,7,8,33,0.43254931801655244,0.4592102389665171
건전성유지,-1,-0.030017209593038552,15,7,8,10,0.43254931801655244,0.4592102389665171
인플레이션우려고조,-1,-0.030017209593038552,15,7,8,4,0.43254931801655244,0.4592102389665171
금리인하현실화,-1,-0.030017209593038552,15,7,8,27,0.43254931801655244,0.4592102389665171
금리인하기대따른,-1,-0.030017209593038552,15,7,8,11,0.43254931801655244,0.4592102389665171
경기둔화진행,-1,-0.030017209593038552,15,7,8,5,0.43254931801655244,0.4592102389665171
국채금리상승따른,-1,-0.030017209593038552,15,7,8,12,0.43254931801655244,0.4592102389665171
외환보유액줄어들,-1,-0.030017209593038552,15,7,8,13,0.43254931801655244,0.4592102389665171
경기하강따른,-1,-0.030017209593038552,15,7,8,5,0.43254931801655244,0.4592102389665171
금리상승재료작용,-1,-0.030017209593038552,15,7,8,17,0.43254931801655244,0.4592102389665171
조달비용낮추,-1,-0.030017209593038552,15,7,8,9,0.43254931801655244,0.4592102389665171
제조업지수하락,-1,-0.030017209593038552,15,7,8,14,0.43254931801655244,0.4592102389665171
정제유재고증가,-1,-0.030017209593038552,15,7,8,9,0.43254931801655244,0.4592102389665171
달러화유로화상승,-1,-0.030017209593038552,15,7,8,13,0.43254931801655244,0.4592102389665171
기준금리인상우려,-1,-0.030017209593038552,15,7,8,8,0.43254931801655244,0.4592102389665171
금리떨어뜨릴,-1,-0.030017209593038552,15,7,8,5,0.43254931801655244,0.4592102389665171
기대심리높인,-1,-0.030017209593038552,15,7,8,10,0.43254931801655244,0.4592102389665171
국채가격급등,-1,-0.030017209593038552,15,7,8,11,0.43254931801655244,0.4592102389665171
경기지표호전,-1,-0.030017209593038552,15,7,8,8,0.43254931801655244,0.4592102389665171
부동산경기침체,-1,-0.030017209593038552,15,7,8,7,0.43254931801655244,0.4592102389665171
실업률오르,-1,-0.030017209593038552,15,7,8,9,0.43254931801655244,0.4592102389665171
플러스성장,-1,-0.030017209593038552,15,7,8,11,0.43254931801655244,0.4592102389665171
추이화면번호따르미국채금리오른,-1,-0.030017209593038552,15,7,8,9,0.43254931801655244,0.4592102389665171
경기회복확신,-1,-0.030017209593038552,15,7,8,20,0.43254931801655244,0.4592102389665171
외국인자금빠져,-1,-0.030017209593038552,15,7,8,8,0.43254931801655244,0.4592102389665171
경제성장견인,-1,-0.030017209593038552,15,7,8,13,0.43254931801655244,0.4592102389665171
달러약세이끌,-1,-0.030017209593038552,15,7,8,16,0.43254931801655244,0.4592102389665171
기준금리동결주장,-1,-0.030017209593038552,15,7,8,26,0.43254931801655244,0.4592102389665171
기업수익성악화,-1,-0.030017209593038552,15,7,8,6,0.43254931801655244,0.4592102389665171
실업률증가,-1,-0.030017209593038552,15,7,8,5,0.43254931801655244,0.4592102389665171
기준금리인상시작,-1,-0.030204230704243384,66,31,35,79,0.4912928707191406,0.5217698207599449
경제성장률하향조정,-1,-0.030204230704243384,66,31,35,51,0.4912928707191406,0.5217698207599449
금리상승요인작용,-1,-0.03167471304203795,83,39,44,65,0.5073927625974609,0.5404568175328657
경제활동위축,-1,-0.03276702734339132,47,22,25,16,0.4694931693770479,0.501182150972486
국제유가하락따른,-1,-0.03276702734339132,47,22,25,38,0.4694931693770479,0.501182150972486
수요회복,-1,-0.03276702734339132,47,22,25,34,0.4694931693770479,0.501182150972486
낮금리,-1,-0.03276702734339132,47,22,25,50,0.4694931693770479,0.501182150972486
금리인하없,-1,-0.03295289350964281,100,47,53,63,0.522214394479395,0.5576693073846292
달러약세,-1,-0.03308586635714239,225,106,119,142,0.599768585008993,0.6406594288605328
소비줄어들,-1,-0.033858406932440244,30,14,16,18,0.44921286618050743,0.48058182858175447
환율하락제한,-1,-0.033858406932440244,30,14,16,22,0.44921286618050743,0.48058182858175447
경제성장률높,-1,-0.033858406932440244,30,14,16,32,0.44921286618050743,0.48058182858175447
달러강세이끌,-1,-0.037195172242385,45,21,24,24,0.46498205317857644,0.5007866748194362
금리인하가능성있,-1,-0.037195172242385,45,21,24,32,0.46498205317857644,0.5007866748194362
유가오르,-1,-0.03971373040026904,94,44,50,56,0.5131544538249474,0.5554629655587903
국고채금리떨어졌,-1,-0.040075234076303534,60,28,32,31,0.4798394345204096,0.5197773893811484
물가상승압력낮,-1,-0.040075234076303534,60,28,32,39,0.4798394345204096,0.5197773893811484
금리인하부정적,-1,-0.040075234076303534,60,28,32,43,0.4798394345204096,0.5197773893811484
적자,-1,-0.040240594585551626,262,123,139,244,0.6081766802408785,0.6590146156813251
실업률유지,-1,-0.04098343980980823,28,13,15,23,0.4432597247400929,0.48102730568487395
국채선물급락,-1,-0.04098343980980823,28,13,15,25,0.4432597247400929,0.48102730568487395
달러화거래높,-1,-0.04098343980980823,28,13,15,11,0.4432597247400929,0.48102730568487395
경기모멘텀약화,-1,-0.04098343980980823,28,13,15,22,0.4432597247400929,0.48102730568487395
동일점매출증가,-1,-0.04098343980980823,28,13,15,17,0.4432597247400929,0.48102730568487395
달러강세재개,-1,-0.04098343980980823,28,13,15,28,0.4432597247400929,0.48102730568487395
국채선물낮,-1,-0.04200212864734665,43,20,23,22,0.4602594998651628,0.500495761520494
경기지표개선,-1,-0.04200212864734665,43,20,23,45,0.4602594998651628,0.500495761520494
달러화반락,-1,-0.04200212864734665,43,20,23,42,0.4602594998651628,0.500495761520494
금리안정,-1,-0.042025306002589025,109,51,58,92,0.5247702383865289,0.5706725761849292
경상수지흑자,-1,-0.042025306002589025,109,51,58,117,0.5247702383865289,0.5706725761849292
규제완화,-1,-0.04234712944591623,258,121,137,211,0.605577479419563,0.6589728190964254
실업률하락,-1,-0.043230081383717756,175,82,93,161,0.5695072657916275,0.6208193466697202
수요약화,-1,-0.04376873675373716,58,27,31,64,0.47578034015443443,0.5192077143178682
유로달러하락,-1,-0.0450855291387795,156,73,83,131,0.5570876927654741,0.6095425258704859
침체벗어나,-1,-0.045583533666085696,73,34,39,53,0.4901682674788075,0.536857482905101
국고채금리급등,-1,-0.045583533666085696,73,34,39,46,0.4901682674788075,0.536857482905101
유동성확대,-1,-0.04724444657374838,41,19,22,50,0.45529438780734627,0.5003243198327624
금리낮수준,-1,-0.04753200724816442,233,109,124,167,0.5936656480122668,0.6527569793462081
양적완화축소따른,-1,-0.04770005762439855,56,26,30,93,0.47158078420820965,0.5186948979152757
물가상승률,-1,-0.048338272348179445,216,101,115,173,0.5863808142963471,0.6457897574225199
금리인상늦춰질,-1,-0.04877367840647162,71,33,38,74,0.48646069159757693,0.5362140207855893
불확실성줄,-1,-0.049160927375018204,26,12,14,12,0.43674271543314236,0.4817849049679894
금리인상기대심리높,-1,-0.049160927375018204,26,12,14,16,0.43674271543314236,0.4817849049679894
긴축완화,-1,-0.049160927375018204,26,12,14,15,0.43674271543314236,0.4817849049679894
금리인상계속,-1,-0.0499655894804969,86,40,46,28,0.5001962259255185,0.5526732453293984
원자재가격상승따른,-1,-0.05189598352325342,54,25,29,45,0.46722595762582625,0.518245763674818
경기호전,-1,-0.05189598352325342,54,25,29,52,0.46722595762582625,0.518245763674818
원화가치상승,-1,-0.05189598352325342,54,25,29,49,0.46722595762582625,0.518245763674818
금리인상인해,-1,-0.05189598352325342,54,25,29,36,0.46722595762582625,0.518245763674818
안전자산선호따른,-1,-0.05189598352325342,54,25,29,42,0.46722595762582625,0.518245763674818
달러원오르,-1,-0.05189598352325342,54,25,29,52,0.46722595762582625,0.518245763674818
엔화대해선오른,-1,-0.05212745005920183,69,32,37,26,0.48265046169222403,0.5356030986709315
재할인율인하,-1,-0.052790571273243936,84,39,45,97,0.4967773027886334,0.5520133255303418
채권시장국채가격낮,-1,-0.05294030094186919,131,61,70,93,0.5355048017099183,0.5952255699622707
소비늘리,-1,-0.052990853164629814,39,18,21,30,0.45004852292676994,0.5002897156378322
기준금리인상늦,-1,-0.052990853164629814,39,18,21,31,0.45004852292676994,0.5002897156378322
경기둔화불구하,-1,-0.052990853164629814,39,18,21,22,0.45004852292676994,0.5002897156378322
수요줄어들,-1,-0.053013528744516925,178,83,95,119,0.5651452781941493,0.6282638705730529
속도내,-1,-0.05428980345647638,114,53,61,75,0.5218051133081199,0.5815698232017916
기대심리상승,-1,-0.05573547963655945,82,38,44,73,0.4932782688591396,0.551372105478911
투자심리악화,-1,-0.05614127217935838,174,81,93,109,0.5610129661923312,0.6275946222217141
유로화엔화하락,-1,-0.0563876274348909,52,24,28,28,0.46269853320983056,0.5178679787687267
경기회복긍정적,-1,-0.0563876274348909,52,24,28,49,0.46269853320983056,0.5178679787687267
신용등급하향,-1,-0.0563876274348909,52,24,28,52,0.46269853320983056,0.5178679787687267
국고채금리내렸,-1,-0.0563876274348909,52,24,28,33,0.46269853320983056,0.5178679787687267
국채선물하락,-1,-0.05649330700124611,404,188,216,357,0.6217795530079238,0.6960644280153975
금리상승제한적,-1,-0.05655037639702931,112,52,60,107,0.518902721796395,0.58096326421699
대출확대,-1,-0.05697164159478729,127,59,68,97,0.5302086354712314,0.594123238831136
경기부양책힘입,-1,-0.05866429236419668,24,11,13,25,0.4295085481348451,0.4829213733552258
유동성악화,-1,-0.05866429236419668,24,11,13,17,0.4295085481348451,0.4829213733552258
고용사정개선,-1,-0.05866429236419668,24,11,13,12,0.4295085481348451,0.4829213733552258
국고채금리올랐으며,-1,-0.05866429236419668,24,11,13,8,0.4295085481348451,0.4829213733552258
물가안정중요,-1,-0.05866429236419668,24,11,13,12,0.4295085481348451,0.4829213733552258
엔화강세따른,-1,-0.05866429236419668,24,11,13,14,0.4295085481348451,0.4829213733552258
수출증가율,-1,-0.05866429236419668,24,11,13,8,0.4295085481348451,0.4829213733552258
채권금리상승압력받,-1,-0.05866429236419668,24,11,13,22,0.4295085481348451,0.4829213733552258
금리상승세출발,-1,-0.05866429236419668,24,11,13,21,0.4295085481348451,0.4829213733552258
회사채금리내렸,-1,-0.05866429236419668,24,11,13,23,0.4295085481348451,0.4829213733552258
환율하락용인,-1,-0.05866429236419668,24,11,13,25,0.4295085481348451,0.4829213733552258
금리비우호적,-1,-0.05866429236419668,24,11,13,19,0.4295085481348451,0.4829213733552258
경기침체막,-1,-0.05874497992492966,95,44,51,48,0.5033844748241918,0.5660760045635915
불안심리확산,-1,-0.05906815047641223,125,58,67,101,0.5274935612912648,0.5935724268900067
기준금리내려야,-1,-0.059325769138464546,37,17,20,26,0.44447454013998683,0.5004122749535322
소비둔화,-1,-0.059325769138464546,37,17,20,27,0.44447454013998683,0.5004122749535322
외환시장현물환내린,-1,-0.059325769138464546,37,17,20,25,0.44447454013998683,0.5004122749535322
경기둔화가시화,-1,-0.059325769138464546,37,17,20,29,0.44447454013998683,0.5004122749535322
경쟁력약화,-1,-0.059325769138464546,37,17,20,26,0.44447454013998683,0.5004122749535322
임금상승,-1,-0.0593866659740977,65,30,35,52,0.47468826822622384,0.5344937542771215
달러강세지지,-1,-0.06148287054128032,93,43,50,46,0.500077836190582,0.565455995940252
수출호조보이,-1,-0.0620217917322915,78,36,42,60,0.48601939565667684,0.5501544269749451
금리인상전망,-1,-0.0633275790288993,63,29,34,64,0.4705164610304167,0.5340037202925633
기대심리높였,-1,-0.0633275790288993,63,29,34,41,0.4705164610304167,0.5340037202925633
금리인상쉽,-1,-0.06432502074539859,91,42,49,77,0.4966988376796493,0.5648489820678813
기준금리올릴,-1,-0.06464611113332208,358,166,192,371,0.6114984563850223,0.6958483132483622
신용등급하향조정,-1,-0.06487709091923544,149,69,80,134,0.5406800070200102,0.6155466296904426
지표금리내린,-1,-0.06538408731609058,76,35,41,72,0.4822478450927024,0.5495827668563565
불확실성계속,-1,-0.06635413393147671,35,16,19,30,0.43851302245409174,0.5007159065991093
채권금리올랐,-1,-0.06635413393147671,35,16,19,38,0.43851302245409174,0.5007159065991093
신규실업수당청구증가,-1,-0.06635413393147671,35,16,19,32,0.43851302245409174,0.5007159065991093
달러약세인한,-1,-0.06635413393147671,35,16,19,22,0.43851302245409174,0.5007159065991093
수익성유지,-1,-0.06640994444866932,48,22,26,26,0.4530405312843707,0.5173621261343024
시중금리오르,-1,-0.06640994444866932,48,22,26,34,0.4530405312843707,0.5173621261343024
인플레이션우려완화,-1,-0.0668033910000756,147,68,79,68,0.5382183277006771,0.6151191647478307
금리인하기대약화,-1,-0.06727839405998393,89,41,48,62,0.49324355320407015,0.5642564855140968
경제지표개선,-1,-0.06747156572292456,175,81,94,192,0.5545386644066568,0.6346225411744033
투자심리위축,-1,-0.06826078559657311,792,366,426,545,0.6198013032925868,0.7104355660495069
물가상승률목표,-1,-0.06890838599805604,74,34,40,59,0.4783725861576427,0.5490394399840235
소비부진,-1,-0.06890838599805604,74,34,40,45,0.4783725861576427,0.5490394399840235
금리인상어려울,-1,-0.0695341902484049,130,60,70,113,0.5249577499827932,0.603264389940212
경기하방위험높,-1,-0.06987326950745865,22,10,12,18,0.4213414851278314,0.48452195632789996
금리인하이뤄질,-1,-0.06987326950745865,22,10,12,25,0.4213414851278314,0.48452195632789996
투자매력높판단,-1,-0.06987326950745865,22,10,12,20,0.4213414851278314,0.48452195632789996
금융시장안정적,-1,-0.06987326950745865,22,10,12,25,0.4213414851278314,0.48452195632789996
성장질적,-1,-0.06987326950745865,22,10,12,12,0.4213414851278314,0.48452195632789996
달러화약세돌아서,-1,-0.06987326950745865,22,10,12,7,0.4213414851278314,0.48452195632789996
신용등급떨어지,-1,-0.06987326950745865,22,10,12,11,0.4213414851278314,0.48452195632789996
유통수익률상승,-1,-0.06987326950745865,22,10,12,10,0.4213414851278314,0.48452195632789996
gdp성장률둔화,-1,-0.06987326950745865,22,10,12,5,0.4213414851278314,0.48452195632789996
물가상승막,-1,-0.06987326950745865,22,10,12,13,0.4213414851278314,0.48452195632789996
미국채수익률하락,-1,-0.07035062659993208,87,40,47,58,0.4897076645444958,0.5636801447236675
금리인상반영,-1,-0.07175548728135994,128,59,69,76,0.522194421173562,0.6027736613269028
채권금리떨어지,-1,-0.0720341211629536,46,21,25,19,0.4478569469429142,0.5172548645938614
침체빠진,-1,-0.0720341211629536,46,21,25,11,0.4478569469429142,0.5172548645938614
금리인상통한,-1,-0.0720341211629536,46,21,25,43,0.4478569469429142,0.5172548645938614
경기지표부진,-1,-0.0720341211629536,46,21,25,27,0.4478569469429142,0.5172548645938614
기준금리동결전망,-1,-0.0720341211629536,46,21,25,47,0.4478569469429142,0.5172548645938614
유로화강세보이,-1,-0.0720341211629536,46,21,25,32,0.4478569469429142,0.5172548645938614
스왑베이시스역전폭확대,-1,-0.0720341211629536,46,21,25,41,0.4478569469429142,0.5172548645938614
신용위험낮,-1,-0.07420815029089323,33,15,18,38,0.4320884807774975,0.5012288741155894
채권시장우호적,-1,-0.07451973114617771,338,156,182,303,0.6019458965829392,0.698703533117089
금리인하주장,-1,-0.07455113449185524,98,45,53,105,0.4969620261621327,0.5768808327971968
기준금리인상가능성반영,-1,-0.07455113449185524,98,45,53,68,0.4969620261621327,0.5768808327971968
수요감소,-1,-0.0747702912998156,221,102,119,195,0.5714433876287119,0.6636322819948803
수요늘어나,-1,-0.07641926828519607,232,107,125,172,0.5745506024085542,0.6694571959472708
무역수지적자,-1,-0.07666383901154084,57,26,31,34,0.4570865974249893,0.5328520722021775
엔화강세보이,-1,-0.07688609875735908,83,38,45,80,0.48237452948894044,0.5625831226688506
물가오를,-1,-0.07749057956506744,96,44,52,68,0.493563293234178,0.576332718084588
달러원하락,-1,-0.0778626250284169,230,106,124,192,0.572871400426267,0.6694414764366529
소득증가,-1,-0.07814448697384535,44,20,24,41,0.4423926870807432,0.5172609432979458
유로화상승,-1,-0.07829194557102281,163,75,88,92,0.5410389269027596,0.6327892688888481
달러엔상승,-1,-0.07983902673899401,148,68,80,94,0.5309283680060702,0.6229002315287788
금리인하통한,-1,-0.08059871896824533,68,31,37,25,0.4660420023853322,0.547610322751818
금리하락세,-1,-0.08126462844177895,120,55,65,129,0.5106439960790599,0.6008234830239861
금리인상속도빨라질,-1,-0.08170856207519683,55,25,30,63,0.4522511169147502,0.5325941777788739
달러화상승압력받,-1,-0.08170856207519683,55,25,30,44,0.4522511169147502,0.5325941777788739
금리내려야,-1,-0.08170856207519683,55,25,30,47,0.4522511169147502,0.5325941777788739
기업실적개선,-1,-0.08170856207519683,55,25,30,48,0.4522511169147502,0.5325941777788739
기대심리커지,-1,-0.0824893137148428,198,91,107,194,0.5566146089756607,0.656529111815096
성장성높,-1,-0.08305690934985022,31,14,17,16,0.42510364222327846,0.5019847517192548
기대심리커질,-1,-0.08305690934985022,31,14,17,32,0.42510364222327846,0.5019847517192548
엔화강세나타내,-1,-0.08305690934985022,31,14,17,16,0.42510364222327846,0.5019847517192548
수익확보,-1,-0.08305690934985022,31,14,17,43,0.42510364222327846,0.5019847517192548
기준금리인상전망,-1,-0.08305690934985022,31,14,17,16,0.42510364222327846,0.5019847517192548
달러엔오르,-1,-0.08305690934985022,31,14,17,28,0.42510364222327846,0.5019847517192548
침체이어지,-1,-0.08305690934985022,31,14,17,12,0.42510364222327846,0.5019847517192548
기준금리인하가능성낮,-1,-0.08305690934985022,31,14,17,38,0.42510364222327846,0.5019847517192548
금리인상놓,-1,-0.08333220841443945,20,9,11,19,0.41192868346108347,0.4866967816865709
금리상승커지,-1,-0.08333220841443945,20,9,11,12,0.41192868346108347,0.4866967816865709
금리영향줄,-1,-0.08333220841443945,20,9,11,17,0.41192868346108347,0.4866967816865709
경기침체빠지,-1,-0.08333220841443945,20,9,11,13,0.41192868346108347,0.4866967816865709
경기둔화이어지,-1,-0.08333220841443945,20,9,11,12,0.41192868346108347,0.4866967816865709
높수익얻,-1,-0.08333220841443945,20,9,11,31,0.41192868346108347,0.4866967816865709
실적올리,-1,-0.08333220841443945,20,9,11,11,0.41192868346108347,0.4866967816865709
서부텍사스산원유가격내린,-1,-0.08333220841443945,20,9,11,10,0.41192868346108347,0.4866967816865709
금리인상매파적,-1,-0.08333220841443945,20,9,11,17,0.41192868346108347,0.4866967816865709
소비위축따른,-1,-0.08333220841443945,20,9,11,6,0.41192868346108347,0.4866967816865709
금리인상기대따른,-1,-0.08333220841443945,20,9,11,12,0.41192868346108347,0.4866967816865709
원환율급등,-1,-0.08333220841443945,20,9,11,10,0.41192868346108347,0.4866967816865709
금리상승억제,-1,-0.08333220841443945,20,9,11,16,0.41192868346108347,0.4866967816865709
성장잠재력높이,-1,-0.08333220841443945,20,9,11,20,0.41192868346108347,0.4866967816865709
금리하향안정화,-1,-0.08333220841443945,20,9,11,10,0.41192868346108347,0.4866967816865709
경기회복세나타나,-1,-0.08333220841443945,20,9,11,15,0.41192868346108347,0.4866967816865709
무역수지적자감소,-1,-0.08333220841443945,20,9,11,16,0.41192868346108347,0.4866967816865709
완화적통화정책,-1,-0.08333220841443945,20,9,11,22,0.41192868346108347,0.4866967816865709
가계부채늘어난,-1,-0.08333220841443945,20,9,11,15,0.41192868346108347,0.4866967816865709
경기회복되,-1,-0.08333220841443945,20,9,11,10,0.41192868346108347,0.4866967816865709
기대심리급등,-1,-0.08333220841443945,20,9,11,24,0.41192868346108347,0.4866967816865709
연체율상승,-1,-0.0840095524859984,79,36,43,62,0.47465491130098986,0.561573732195362
수익올렸,-1,-0.08481410666284228,42,19,23,39,0.4366057181803411,0.5173946458623613
물가상승억제,-1,-0.08481410666284228,42,19,23,33,0.4366057181803411,0.5173946458623613
단기물금리하락,-1,-0.08481410666284228,42,19,23,20,0.4366057181803411,0.5173946458623613
금리인하어렵,-1,-0.08481410666284228,42,19,23,28,0.4366057181803411,0.5173946458623613
유가반등,-1,-0.0849258615262164,66,30,36,70,0.46166381138542895,0.5472126112666942
국고채금리내린,-1,-0.0861979076070295,168,77,91,121,0.5389689980786083,0.6404819068887728
금리인하나설,-1,-0.08627842220313431,155,71,84,128,0.5313285731543669,0.6315048591670037
연방기금금리선물오,-1,-0.08627842220313431,155,71,84,51,0.5313285731543669,0.6315048591670037
채권시장국채가격오른,-1,-0.08643709743621009,116,53,63,68,0.5045451928390714,0.5998634897267116
금리인상고려,-1,-0.08660599826478677,103,47,56,63,0.4941519809801807,0.5877067525945613
물가상승률둔화,-1,-0.08711187791180053,53,24,29,38,0.44720237197898605,0.5324108449242541
국고채상승,-1,-0.08765398849310568,192,88,104,126,0.5504880196618828,0.6560924919628491
국채선물내린,-1,-0.08782091722541707,77,35,42,73,0.4706334753617499,0.5611075329586879
주택가격하락,-1,-0.08838443072358126,153,70,83,101,0.5288042875788309,0.6311774086768025
스왑베이시스축소,-1,-0.09041719346446864,88,40,48,54,0.4791651254354174,0.574276693248401
엔화대해선하락,-1,-0.0921319335241596,40,18,22,13,0.43044462838841113,0.5176722706338588
환율급등따른,-1,-0.0921319335241596,40,18,22,22,0.43044462838841113,0.5176722706338588
금리인상가능성배제,-1,-0.0921319335241596,40,18,22,33,0.43044462838841113,0.5176722706338588
경기회복기대,-1,-0.0921319335241596,40,18,22,15,0.43044462838841113,0.5176722706338588
스왑베이시스역전폭축소,-1,-0.0921319335241596,40,18,22,48,0.43044462838841113,0.5176722706338588
금리폭락,-1,-0.0921319335241596,40,18,22,6,0.43044462838841113,0.5176722706338588
수출감소세,-1,-0.0921319335241596,40,18,22,34,0.43044462838841113,0.5176722706338588
기대심리확대,-1,-0.09291816159962019,51,23,28,56,0.4419147435504981,0.5323101785126324
금리인상가능성있,-1,-0.09291816159962019,51,23,28,57,0.4419147435504981,0.5323101785126324
수요높,-1,-0.09291816159962019,51,23,28,69,0.4419147435504981,0.5323101785126324
저금리정책유지,-1,-0.09312045053154083,29,13,16,22,0.41743117343612773,0.5030236018132271
금융시장안정찾,-1,-0.09312045053154083,29,13,16,37,0.41743117343612773,0.5030236018132271
금리인상멈추,-1,-0.09312045053154083,29,13,16,23,0.41743117343612773,0.5030236018132271
기업실적부진,-1,-0.09312045053154083,29,13,16,19,0.41743117343612773,0.5030236018132271
금리인상가능성높이,-1,-0.09312045053154083,29,13,16,24,0.41743117343612773,0.5030236018132271
신용등급전망안정적부정적,-1,-0.09312045053154083,29,13,16,31,0.41743117343612773,0.5030236018132271
유동성줄이,-1,-0.09312045053154083,29,13,16,36,0.41743117343612773,0.5030236018132271
외환시장현물환오른,-1,-0.09312045053154083,29,13,16,52,0.41743117343612773,0.5030236018132271
대출늘릴,-1,-0.09312045053154083,29,13,16,21,0.41743117343612773,0.5030236018132271
경기침체인한,-1,-0.09312045053154083,29,13,16,19,0.41743117343612773,0.5030236018132271
금리떨어졌,-1,-0.0939572762732972,123,56,67,102,0.5052814660020127,0.6099159353533282
기준금리인하가능성높,-1,-0.09435522875560975,62,28,34,48,0.45243098339430354,0.5465597303465738
금리하락이끌,-1,-0.09435522875560975,62,28,34,53,0.45243098339430354,0.5465597303465738
물가높수준,-1,-0.09435522875560975,62,28,34,27,0.45243098339430354,0.5465597303465738
물가급등,-1,-0.09435522875560975,62,28,34,34,0.45243098339430354,0.5465597303465738
경기회복위한,-1,-0.09601322643338495,73,33,40,62,0.46222688413141644,0.5602649965950526
국채선물상승,-1,-0.0961173342891205,346,158,188,375,0.5881113434330206,0.7129992875325919
원화강세,-1,-0.09824312108129529,132,60,72,128,0.5090747974269018,0.6198331579733183
소비심리위축,-1,-0.09932237380338327,95,43,52,59,0.480063339037425,0.585784970885818
금리상승세진정,-1,-0.0998520430829154,18,8,10,21,0.40080022779678953,0.4895896449220456
마이너스금리확대,-1,-0.0998520430829154,18,8,10,20,0.40080022779678953,0.4895896449220456
금리빠질,-1,-0.0998520430829154,18,8,10,10,0.40080022779678953,0.4895896449220456
기준금리인하가능성있,-1,-0.0998520430829154,18,8,10,12,0.40080022779678953,0.4895896449220456
유가하락힘입,-1,-0.0998520430829154,18,8,10,11,0.40080022779678953,0.4895896449220456
자산가격하락,-1,-0.0998520430829154,18,8,10,11,0.40080022779678953,0.4895896449220456
재고늘어나,-1,-0.0998520430829154,18,8,10,14,0.40080022779678953,0.4895896449220456
주택시장위축,-1,-0.0998520430829154,18,8,10,10,0.40080022779678953,0.4895896449220456
수출비중높기업,-1,-0.0998520430829154,18,8,10,12,0.40080022779678953,0.4895896449220456
금리인상앞당겨,-1,-0.0998520430829154,18,8,10,14,0.40080022779678953,0.4895896449220456
소매판매부진,-1,-0.0998520430829154,18,8,10,26,0.40080022779678953,0.4895896449220456
금리하락세재개,-1,-0.0998520430829154,18,8,10,22,0.40080022779678953,0.4895896449220456
성장해,-1,-0.0998520430829154,18,8,10,10,0.40080022779678953,0.4895896449220456
불황,-1,-0.0998520430829154,18,8,10,21,0.40080022779678953,0.4895896449220456
성장형낮,-1,-0.0998520430829154,18,8,10,9,0.40080022779678953,0.4895896449220456
총액대출한도축소,-1,-0.0998520430829154,18,8,10,2,0.40080022779678953,0.4895896449220456
엔원환율하락,-1,-0.0998520430829154,18,8,10,13,0.40080022779678953,0.4895896449220456
채권시장국고채하락,-1,-0.0998520430829154,18,8,10,15,0.40080022779678953,0.4895896449220456
서비스업지수하회,-1,-0.0998520430829154,18,8,10,1,0.40080022779678953,0.4895896449220456
엔화약세인한,-1,-0.0998520430829154,18,8,10,20,0.40080022779678953,0.4895896449220456
채권금리떨어졌,-1,-0.0998520430829154,18,8,10,14,0.40080022779678953,0.4895896449220456
유가떨어지,-1,-0.10020744598981612,38,17,21,26,0.4238459223245948,0.518112452005156
물가상승률하락,-1,-0.10020744598981612,38,17,21,36,0.4238459223245948,0.518112452005156
베이시스축소,-1,-0.10020744598981612,38,17,21,16,0.4238459223245948,0.518112452005156
경제성장세,-1,-0.10020744598981612,38,17,21,36,0.4238459223245948,0.518112452005156
금리수준높,-1,-0.10020744598981612,38,17,21,29,0.4238459223245948,0.518112452005156
물가상승압력작용,-1,-0.10042742929524406,71,32,39,34,0.45782251799062773,0.5598944327714175
금리인하필요,-1,-0.10158196080301862,82,37,45,74,0.4673834781174097,0.5729217398806133
금리급등,-1,-0.10244123122193183,603,274,329,425,0.5950523518448935,0.7306866488447004
경기회복세유지,-1,-0.10469084847233046,27,12,15,19,0.40890142408182095,0.5043934064783796
글로벌경제둔화,-1,-0.10469084847233046,27,12,15,33,0.40890142408182095,0.5043934064783796
기준금리내려가,-1,-0.10469084847233046,27,12,15,29,0.40890142408182095,0.5043934064783796
대출축소,-1,-0.10469084847233046,27,12,15,12,0.40890142408182095,0.5043934064783796
재정적자확대,-1,-0.10469084847233046,27,12,15,21,0.40890142408182095,0.5043934064783796
부양책나오,-1,-0.10469084847233046,27,12,15,22,0.40890142408182095,0.5043934064783796
채권시장약세보이,-1,-0.10469084847233046,27,12,15,30,0.40890142408182095,0.5043934064783796
채권시장국고채지표금리상승,-1,-0.10500515377396946,58,26,32,91,0.442454718316748,0.5461294411139449
금리내려,-1,-0.10564091595534886,80,36,44,93,0.4632358411923369,0.5725154490541796
인플레이션압력강화,-1,-0.10595850192748091,47,21,26,17,0.43049600572787683,0.5323939367151674
기준금리인상가능,-1,-0.10595850192748091,47,21,26,50,0.43049600572787683,0.5323939367151674
국고채오른,-1,-0.10616410919802965,126,57,69,50,0.5000625299878417,0.6186839815738984
달러화급등,-1,-0.10728247231626897,102,46,56,101,0.48118188098446696,0.5966727640664198
원달러상승,-1,-0.10728247231626897,102,46,56,90,0.48118188098446696,0.5966727640664198
순이익감소,-1,-0.10809531076067957,194,88,106,153,0.5382541737016697,0.6685417233329388
금리인상그칠,-1,-0.10917702125167073,36,16,20,31,0.4167303480539781,0.5187365259941933
국고채지표금리상승,-1,-0.11018843077086471,89,40,49,98,0.4685879355310778,0.5844829128154696
수요위축,-1,-0.11034347580493664,146,66,80,96,0.5108431853347574,0.6373890831373725
지급준비금적수증가,-1,-0.11444745332969097,109,49,60,130,0.48246105610297907,0.6070001884123216
물가상승률높,-1,-0.11461938607771738,285,129,156,166,0.5643738614251963,0.7103047962180729
안전자산선호약화,-1,-0.11476724886275369,120,54,66,110,0.49052987604672055,0.6175518634291163
국채금리상승,-1,-0.11695254555777534,543,245,298,547,0.5840303846718844,0.7385280114044009
소비늘어나,-1,-0.1171642326310498,54,24,30,35,0.43156760684452283,0.5459674541402062
소득감소,-1,-0.11816480040483746,25,11,14,17,0.39928383997434264,0.5061517596022356
실업률낮추,-1,-0.11816480040483746,25,11,14,31,0.39928383997434264,0.5061517596022356
잠재성장률밑돌,-1,-0.11816480040483746,25,11,14,15,0.39928383997434264,0.5061517596022356
하향압력받,-1,-0.11816480040483746,25,11,14,17,0.39928383997434264,0.5061517596022356
금리차줄어들,-1,-0.11816480040483746,25,11,14,15,0.39928383997434264,0.5061517596022356
국제금융시장안정,-1,-0.11816480040483746,25,11,14,8,0.39928383997434264,0.5061517596022356
달러원오를,-1,-0.11816480040483746,25,11,14,23,0.39928383997434264,0.5061517596022356
중소기업대출증가,-1,-0.11816480040483746,25,11,14,8,0.39928383997434264,0.5061517596022356
원자재가격급락,-1,-0.11816480040483746,25,11,14,20,0.39928383997434264,0.5061517596022356
국채가격하락압력가했,-1,-0.11816480040483746,25,11,14,15,0.39928383997434264,0.5061517596022356
금리하방경직성강화,-1,-0.11921285490550759,34,15,19,29,0.40899783993753586,0.5195689356352791
유가오를,-1,-0.11921285490550759,34,15,19,23,0.40899783993753586,0.5195689356352791
기준금리인상가능성,-1,-0.11921285490550759,34,15,19,25,0.40899783993753586,0.5195689356352791
발행금리낮,-1,-0.11921285490550759,34,15,19,29,0.40899783993753586,0.5195689356352791
성장저해,-1,-0.11921285490550759,34,15,19,23,0.40899783993753586,0.5195689356352791
주택판매가격증가,-1,-0.11921285490550759,34,15,19,30,0.40899783993753586,0.5195689356352791
수요강화,-1,-0.1206997163951532,16,7,9,13,0.38722012600892003,0.4933897705772814
기준금리인하기대심리커지,-1,-0.1206997163951532,16,7,9,13,0.38722012600892003,0.4933897705772814
외환보유액늘어나,-1,-0.1206997163951532,16,7,9,6,0.38722012600892003,0.4933897705772814
금리인하기대남,-1,-0.1206997163951532,16,7,9,14,0.38722012600892003,0.4933897705772814
리보금리하락,-1,-0.1206997163951532,16,7,9,12,0.38722012600892003,0.4933897705772814
국채금리내린,-1,-0.1206997163951532,16,7,9,19,0.38722012600892003,0.4933897705772814
마이너스성장할,-1,-0.1206997163951532,16,7,9,2,0.38722012600892003,0.4933897705772814
달째동결,-1,-0.1206997163951532,16,7,9,11,0.38722012600892003,0.4933897705772814
인플레이션우려자극,-1,-0.1206997163951532,16,7,9,8,0.38722012600892003,0.4933897705772814
경기둔화가능성높,-1,-0.1206997163951532,16,7,9,13,0.38722012600892003,0.4933897705772814
금리인하효과나타나,-1,-0.1206997163951532,16,7,9,2,0.38722012600892003,0.4933897705772814
금리부담덜,-1,-0.1206997163951532,16,7,9,12,0.38722012600892003,0.4933897705772814
금리하락세이어지,-1,-0.1206997163951532,16,7,9,18,0.38722012600892003,0.4933897705772814
국고채급등,-1,-0.1206997163951532,16,7,9,3,0.38722012600892003,0.4933897705772814
금리인상점쳤,-1,-0.1206997163951532,16,7,9,12,0.38722012600892003,0.4933897705772814
금리동결이,-1,-0.1206997163951532,16,7,9,15,0.38722012600892003,0.4933897705772814
양적완화인해,-1,-0.1206997163951532,16,7,9,23,0.38722012600892003,0.4933897705772814
부양책시행,-1,-0.1206997163951532,16,7,9,17,0.38722012600892003,0.4933897705772814
기대심리높짐,-1,-0.1206997163951532,16,7,9,3,0.38722012600892003,0.4933897705772814
기대심리하락,-1,-0.1206997163951532,16,7,9,19,0.38722012600892003,0.4933897705772814
국고채권금리상승,-1,-0.1206997163951532,16,7,9,25,0.38722012600892003,0.4933897705772814
기준금리인상다가오,-1,-0.1206997163951532,16,7,9,12,0.38722012600892003,0.4933897705772814
수출양호,-1,-0.1206997163951532,16,7,9,8,0.38722012600892003,0.4933897705772814
비용내,-1,-0.1206997163951532,16,7,9,2,0.38722012600892003,0.4933897705772814
고용호조보이,-1,-0.1206997163951532,16,7,9,5,0.38722012600892003,0.4933897705772814
gdp성장률상회,-1,-0.1206997163951532,16,7,9,14,0.38722012600892003,0.4933897705772814
경기회복세불구하,-1,-0.1206997163951532,16,7,9,7,0.38722012600892003,0.4933897705772814
유로화오,-1,-0.1206997163951532,16,7,9,11,0.38722012600892003,0.4933897705772814
성장세보인,-1,-0.1206997163951532,16,7,9,16,0.38722012600892003,0.4933897705772814
물가높오름세,-1,-0.1206997163951532,16,7,9,6,0.38722012600892003,0.4933897705772814
신용등급상향가능성높,-1,-0.1206997163951532,16,7,9,16,0.38722012600892003,0.4933897705772814
금리낮형성,-1,-0.1206997163951532,16,7,9,10,0.38722012600892003,0.4933897705772814
채권금리오른,-1,-0.1206997163951532,16,7,9,11,0.38722012600892003,0.4933897705772814
외환시장달러원오른,-1,-0.1206997163951532,16,7,9,14,0.38722012600892003,0.4933897705772814
재정지출축소,-1,-0.1206997163951532,16,7,9,2,0.38722012600892003,0.4933897705772814
엔화거래높,-1,-0.12117932305275025,105,47,58,48,0.47530722149655497,0.6062186721768129
통화정책완화,-1,-0.12117932305275025,105,47,58,76,0.47530722149655497,0.6062186721768129
양적완화,-1,-0.12121690497521254,266,120,146,257,0.555168108168957,0.7081292426758133
cd금리상승,-1,-0.12201745231211436,202,91,111,132,0.532723799253824,0.6806059760271065
장기금리하락,-1,-0.1225781088422907,180,81,99,154,0.5221682715884598,0.6678799563578829
성장세,-1,-0.12445016379198282,342,154,188,238,0.5676400132566827,0.7288058116220918
국고채수익률상승,-1,-0.1255818008510664,92,41,51,63,0.4621073613233473,0.5946754888933519
외환시장현물환하락,-1,-0.12694432604674855,81,36,45,98,0.4517873575496053,0.5830068024250376
금리높수준,-1,-0.12806675048269456,154,69,85,81,0.5045787925624791,0.6526184867580412
금리인하통해,-1,-0.12838738628158175,101,45,56,57,0.46782133891527933,0.6054712185306611
회사채신용스프레드축소,-1,-0.13022217622968935,41,18,23,69,0.4106008134029606,0.5334008696743424
금리동결따른,-1,-0.13022217622968935,41,18,23,37,0.4106008134029606,0.5334008696743424
환율급락따른,-1,-0.13053569256601383,32,14,18,7,0.4005204518961912,0.5206376599879033
금리인하시작,-1,-0.13053569256601383,32,14,18,10,0.4005204518961912,0.5206376599879033
경제위축,-1,-0.1316242086378917,79,35,44,54,0.4472693989806359,0.5826957731968921
글로벌경기둔화,-1,-0.1328057252403354,59,26,33,39,0.42774605050702347,0.5586026370639118
유로달러내린,-1,-0.1328057252403354,59,26,33,47,0.42774605050702347,0.5586026370639118
기준금리올렸,-1,-0.13321562929015607,119,53,66,92,0.47856689132072827,0.6254923421260727
원달러하락,-1,-0.13395741654730997,88,39,49,75,0.4537691320267705,0.5939777453558384
자금유입확대,-1,-0.13409573445897383,23,10,13,38,0.38825803699946687,0.5083677499370847
금리인하우호적,-1,-0.13409573445897383,23,10,13,18,0.38825803699946687,0.5083677499370847
경기회복더디,-1,-0.13409573445897383,23,10,13,14,0.38825803699946687,0.5083677499370847
신용위험나타내,-1,-0.13409573445897383,23,10,13,9,0.38825803699946687,0.5083677499370847
채권시장부담되,-1,-0.13409573445897383,23,10,13,10,0.38825803699946687,0.5083677499370847
가산금리올려,-1,-0.13409573445897383,23,10,13,10,0.38825803699946687,0.5083677499370847
금융시장확산,-1,-0.13409573445897383,23,10,13,12,0.38825803699946687,0.5083677499370847
기준금리하락,-1,-0.13409573445897383,23,10,13,14,0.38825803699946687,0.5083677499370847
경기침체심화,-1,-0.13409573445897383,23,10,13,20,0.38825803699946687,0.5083677499370847
경기부양책시행,-1,-0.13409573445897383,23,10,13,11,0.38825803699946687,0.5083677499370847
역외환율상승,-1,-0.13409573445897383,23,10,13,19,0.38825803699946687,0.5083677499370847
경제부담될,-1,-0.13409573445897383,23,10,13,22,0.38825803699946687,0.5083677499370847
금리인상한,-1,-0.13409573445897383,23,10,13,15,0.38825803699946687,0.5083677499370847
경기회복가시화,-1,-0.1361324287406005,97,43,54,67,0.45996794240180994,0.6047650258394885
금리인하가능성시사,-1,-0.13841559212184018,86,38,48,53,0.4494225642397819,0.5936558709121559
변동성확대,-1,-0.13842482877318996,798,356,442,690,0.5691012055349164,0.7517571669243984
국고채금리하락,-1,-0.13921006542212222,648,289,359,499,0.5683891268940736,0.7520195561034243
경기회복세이어지,-1,-0.13948123194745743,57,25,32,37,0.4219526720746799,0.5585824152709759
통화정책불확실성해소,-1,-0.139989048667997,39,17,22,39,0.40298504191645446,0.5340257720284355
기준금리낮춰,-1,-0.139989048667997,39,17,22,24,0.40298504191645446,0.5340257720284355
cd금리오를,-1,-0.139989048667997,39,17,22,10,0.40298504191645446,0.5340257720284355
지표금리상승,-1,-0.14043709258337744,66,29,37,96,0.43015297889979215,0.5705492132453432
통화완화,-1,-0.14169002377755424,75,33,42,95,0.43778423657728516,0.5821574188296338
경기부양위한,-1,-0.1432134373590791,334,149,185,293,0.553221926815126,0.7379552734833453
엔화가치상승,-1,-0.14343340271801652,30,13,17,29,0.39113232768802697,0.5219746272889982
채권가격오르,-1,-0.14343340271801652,30,13,17,35,0.39113232768802697,0.5219746272889982
기준금리내려갈,-1,-0.14343340271801652,30,13,17,18,0.39113232768802697,0.5219746272889982
완화적유지,-1,-0.14343340271801652,30,13,17,33,0.39113232768802697,0.5219746272889982
장기금리급등,-1,-0.14343340271801652,30,13,17,32,0.39113232768802697,0.5219746272889982
손실확대,-1,-0.14343340271801652,30,13,17,19,0.39113232768802697,0.5219746272889982
장기금리상승,-1,-0.14393934319209734,182,81,101,157,0.5092747707066804,0.68034071870555
성장세유지,-1,-0.14494256852278764,220,98,122,150,0.524633451369376,0.7022957620792646
불확실성높,-1,-0.1461291082992654,312,139,173,296,0.5477398947246713,0.7350064223089873
금리낮췄,-1,-0.14659526001914525,64,28,36,54,0.42468872635629296,0.5704284280023062
유로화급락,-1,-0.14663829053115907,55,24,31,32,0.4158691490673146,0.558631371324204
경기부양위해,-1,-0.14726051195705991,443,197,246,353,0.5594148842940548,0.7524105880892487
재정적자줄이,-1,-0.1477298789359297,46,20,26,44,0.40606332306048254,0.546677637402307
변동성커졌,-1,-0.1477298789359297,46,20,26,46,0.40606332306048254,0.546677637402307
고용지표악화,-1,-0.1477298789359297,46,20,26,25,0.40606332306048254,0.546677637402307
국고채금리급락,-1,-0.1508487859479214,37,16,21,38,0.39473151869215073,0.5348223583595476
높성장률,-1,-0.1508487859479214,37,16,21,23,0.39473151869215073,0.5348223583595476
경기회복세가시화,-1,-0.1508487859479214,37,16,21,15,0.39473151869215073,0.5348223583595476
수출증가율둔화,-1,-0.1508487859479214,37,16,21,29,0.39473151869215073,0.5348223583595476
엔화약세보였,-1,-0.1508487859479214,37,16,21,33,0.39473151869215073,0.5348223583595476
경제성장,-1,-0.1516875228998027,444,197,247,294,0.556216317282256,0.7549129764823627
금리상승세,-1,-0.15199444869336265,118,52,66,108,0.46631965262518543,0.6333003219192993
경기회복뒷받침,-1,-0.15284030529215742,71,31,40,66,0.4276173990809273,0.5817459515067612
집값오르,-1,-0.15284030529215742,71,31,40,59,0.4276173990809273,0.5817459515067612
채권금리급락,-1,-0.15314409681826724,62,27,35,42,0.4189857836880414,0.5703578521903617
불안심리높,-1,-0.15314409681826724,62,27,35,47,0.4189857836880414,0.5703578521903617
물가상승이어질,-1,-0.15328044231115168,21,9,12,5,0.375367519669948,0.5111237679252103
소비심리회복,-1,-0.15328044231115168,21,9,12,19,0.375367519669948,0.5111237679252103
유로화엔화강세나타냈,-1,-0.15328044231115168,21,9,12,9,0.375367519669948,0.5111237679252103
성장어려울,-1,-0.15328044231115168,21,9,12,7,0.375367519669948,0.5111237679252103
엔화가치떨어지,-1,-0.15328044231115168,21,9,12,18,0.375367519669948,0.5111237679252103
성장정체,-1,-0.15328044231115168,21,9,12,21,0.375367519669948,0.5111237679252103
미국채금리떨어졌,-1,-0.15328044231115168,21,9,12,16,0.375367519669948,0.5111237679252103
달러화강세이,-1,-0.15328044231115168,21,9,12,20,0.375367519669948,0.5111237679252103
부동산가격급락,-1,-0.15328044231115168,21,9,12,10,0.375367519669948,0.5111237679252103
경제지표부진따른,-1,-0.15328044231115168,21,9,12,17,0.375367519669948,0.5111237679252103
성장기여도낮,-1,-0.15328044231115168,21,9,12,9,0.375367519669948,0.5111237679252103
부진실적,-1,-0.15328044231115168,21,9,12,7,0.375367519669948,0.5111237679252103
대외여건개선,-1,-0.15328044231115168,21,9,12,8,0.375367519669948,0.5111237679252103
기준금리인하통한,-1,-0.15328044231115168,21,9,12,21,0.375367519669948,0.5111237679252103
연방기금금리선물시장오,-1,-0.15353723686418386,89,39,50,69,0.4429819855238035,0.6035091047100534
자산건전성개선,-1,-0.1582887287657636,28,12,16,27,0.38061523599485475,0.5236160274482168
달러강세완화,-1,-0.1582887287657636,28,12,16,30,0.38061523599485475,0.5236160274482168
금리내려온,-1,-0.1582887287657636,28,12,16,12,0.38061523599485475,0.5236160274482168
채권시장국채가격떨어진,-1,-0.1582887287657636,28,12,16,11,0.38061523599485475,0.5236160274482168
달러화강세보였,-1,-0.1588862996757101,69,30,39,53,0.4222414372443937,0.5815940178091598
금리동결가능성높,-1,-0.16012671065869055,60,26,34,35,0.41301948591392706,0.5703414204763844
금리인상결정,-1,-0.1619174640904809,168,74,94,105,0.4905889996692283,0.679952628099526
수익증가,-1,-0.1626490556105844,51,22,29,41,0.40268736353315515,0.5589607953346732
장기금리오르,-1,-0.1626490556105844,51,22,29,39,0.40268736353315515,0.5589607953346732
금리높,-1,-0.16283021363130423,292,129,163,220,0.5322477949107927,0.7390755144054473
인플레이션둔화,-1,-0.16301344693556896,35,15,20,22,0.38571976727576274,0.535809361857729
유로화달러화움직여높,-1,-0.16301344693556896,35,15,20,37,0.38571976727576274,0.535809361857729
cds프리미엄급등,-1,-0.16301344693556896,35,15,20,14,0.38571976727576274,0.535809361857729
성장낮,-1,-0.16301344693556896,35,15,20,37,0.38571976727576274,0.535809361857729
만장일치동결,-1,-0.16301344693556896,35,15,20,45,0.38571976727576274,0.535809361857729
물가하락,-1,-0.1631502082024191,94,41,53,78,0.44131891765649145,0.6132152598638103
국고채금리상승,-1,-0.1631608829924278,540,238,302,438,0.5500397115053466,0.7643002091351075
양적완화따른,-1,-0.1632996448694909,112,49,63,121,0.4550391406201504,0.6324737220122504
금리내리,-1,-0.16457275369769842,529,233,296,376,0.5488558392359231,0.7648708619091422
듀레이션확대,-1,-0.16528737812580396,67,29,38,59,0.4166469099770717,0.5814815278371098
흑자전환,-1,-0.16746616744458487,42,18,24,26,0.39068142682806917,0.5476920538718096
달러화오르,-1,-0.16746616744458487,42,18,24,65,0.39068142682806917,0.5476920538718096
부채줄이,-1,-0.16746616744458487,42,18,24,50,0.39068142682806917,0.5476920538718096
국채금리급등,-1,-0.1675032744172208,101,44,57,118,0.4442096097239319,0.6227801732261361
소비자물가상승,-1,-0.16758534581183648,386,170,216,265,0.541205689672634,0.7588964319015102
장기물하락,-1,-0.16759299303854602,58,25,33,59,0.4067614629961566,0.5703832857329469
경기부양나설,-1,-0.16759299303854602,58,25,33,39,0.4067614629961566,0.5703832857329469
달러화엔화하락,-1,-0.16759299303854602,58,25,33,38,0.4067614629961566,0.5703832857329469
외환시장현물환상승,-1,-0.16865432114127088,83,36,47,84,0.42889903828017134,0.6027407071826935
채권가격상승,-1,-0.17147229750354998,108,47,61,110,0.44707892980546204,0.6319455391657943
실업률낮,-1,-0.17207984205625482,65,28,37,47,0.41081321575339635,0.5814113224609198
수요늘어날,-1,-0.17392277427055192,142,62,80,121,0.4683320326331915,0.6653385838512388
유로화엔화상승,-1,-0.1756010083274625,56,24,32,19,0.40017895131800413,0.5704878080926097
민평금리낮수준,-1,-0.1756218627781928,26,11,15,28,0.36867737572952414,0.5256023512453684
달러약세심화,-1,-0.1756218627781928,26,11,15,16,0.36867737572952414,0.5256023512453684
금리높일,-1,-0.1756218627781928,26,11,15,17,0.36867737572952414,0.5256023512453684
엔화올랐,-1,-0.1756218627781928,26,11,15,11,0.36867737572952414,0.5256023512453684
금융시장충격받,-1,-0.1756218627781928,26,11,15,19,0.36867737572952414,0.5256023512453684
회사채수익률내린,-1,-0.1756218627781928,26,11,15,10,0.36867737572952414,0.5256023512453684
금리인하카드꺼내,-1,-0.1756218627781928,26,11,15,20,0.36867737572952414,0.5256023512453684
금리인하기대심리,-1,-0.1756218627781928,26,11,15,23,0.36867737572952414,0.5256023512453684
물가상승압력완화,-1,-0.17618430956433895,72,31,41,30,0.41481001591388356,0.59205774400797
불확실성커졌,-1,-0.17618430956433895,72,31,41,68,0.41481001591388356,0.59205774400797
순이자마진개선,-1,-0.17675483979906537,33,14,19,17,0.37579748777876526,0.537007156133512
물가상승압력커지,-1,-0.17675483979906537,33,14,19,19,0.37579748777876526,0.537007156133512
금리상승이어지,-1,-0.17675483979906537,33,14,19,28,0.37579748777876526,0.537007156133512
금리인상가능성언급,-1,-0.17675483979906537,33,14,19,38,0.37579748777876526,0.537007156133512
지급준비율인상따른,-1,-0.17675483979906537,33,14,19,17,0.37579748777876526,0.537007156133512
주문증가,-1,-0.17675483979906537,33,14,19,19,0.37579748777876526,0.537007156133512
침체국면,-1,-0.17675483979906537,33,14,19,19,0.37579748777876526,0.537007156133512
기준금리인상빨라질,-1,-0.17675483979906537,33,14,19,18,0.37579748777876526,0.537007156133512
금리올라,-1,-0.17684560563498652,149,65,84,94,0.4705865748168271,0.6725848761256642
신용위험도높,-1,-0.17690964080594807,19,8,11,6,0.35994349014687527,0.5145164816943415
역외차액결제선물환환율반영내린,-1,-0.17690964080594807,19,8,11,11,0.35994349014687527,0.5145164816943415
엔화절상,-1,-0.17690964080594807,19,8,11,22,0.35994349014687527,0.5145164816943415
디플레이션벗어나,-1,-0.17690964080594807,19,8,11,26,0.35994349014687527,0.5145164816943415
장기물강세보이,-1,-0.17690964080594807,19,8,11,30,0.35994349014687527,0.5145164816943415
금리인하불가피하,-1,-0.17690964080594807,19,8,11,4,0.35994349014687527,0.5145164816943415
달러화올라서,-1,-0.17690964080594807,19,8,11,9,0.35994349014687527,0.5145164816943415
원화절하,-1,-0.17690964080594807,19,8,11,21,0.35994349014687527,0.5145164816943415
주택가격지수상승,-1,-0.17690964080594807,19,8,11,22,0.35994349014687527,0.5145164816943415
금리상승세이어지,-1,-0.17690964080594807,19,8,11,9,0.35994349014687527,0.5145164816943415
산업활동동향부진,-1,-0.17690964080594807,19,8,11,3,0.35994349014687527,0.5145164816943415
매출부진,-1,-0.17690964080594807,19,8,11,24,0.35994349014687527,0.5145164816943415
물가떨어지,-1,-0.17690964080594807,19,8,11,15,0.35994349014687527,0.5145164816943415
금리인상힘들,-1,-0.17690964080594807,19,8,11,20,0.35994349014687527,0.5145164816943415
물가상승우려,-1,-0.17690964080594807,19,8,11,12,0.35994349014687527,0.5145164816943415
채권시장부담,-1,-0.17690964080594807,19,8,11,13,0.35994349014687527,0.5145164816943415
경제높성장률,-1,-0.17690964080594807,19,8,11,7,0.35994349014687527,0.5145164816943415
달러화오를,-1,-0.17889017006034102,40,17,23,33,0.3820826147645402,0.548401117761373
수출늘리,-1,-0.17889017006034102,40,17,23,28,0.3820826147645402,0.548401117761373
인플레이션우려증폭,-1,-0.17889017006034102,40,17,23,24,0.3820826147645402,0.548401117761373
기준금리낮,-1,-0.17995816409910959,79,34,45,51,0.4187315002026442,0.6023306653973138
내수부진,-1,-0.1814895346833817,129,56,73,74,0.4554134851505184,0.6571733691768887
국채가격오른,-1,-0.1815818983373284,95,41,54,46,0.4309653607027477,0.6220128769345756
수익성개선,-1,-0.182018486270626,163,71,92,121,0.4749228301034444,0.686075871337459
달러강세따른,-1,-0.1823702270930726,120,52,68,102,0.4488714537613436,0.6489138171259065
물가오르,-1,-0.1831571797054925,213,93,120,179,0.4962636999229075,0.7185955792222419
채권시장국채선물상승,-1,-0.1842187330484616,54,23,31,73,0.39323395579021364,0.5706595330130116
경제지표호조보이,-1,-0.1848435740700729,102,44,58,92,0.4343877611129805,0.6311976575195333
금리내릴,-1,-0.1856569810226808,339,148,191,241,0.523411770266438,0.7618381881213685
금리반등,-1,-0.18595228518218376,152,66,86,183,0.46643061689572113,0.6793161077263968
수익성악화,-1,-0.18641374711006997,177,77,100,179,0.47900824329805114,0.698301488686826
수출감소,-1,-0.18663241071043346,243,106,137,162,0.5037201303337406,0.7346593616161895
성장세나타내,-1,-0.18701150754074536,61,26,35,31,0.39833131627515256,0.5814096964340316
국고금리하락,-1,-0.18916870197621438,125,54,71,106,0.4479690974377711,0.656792011115412
채권시장국고채지표금리오른,-1,-0.1919469328906498,91,39,52,107,0.4214991228071617,0.6215555822832018
금리인상늦출,-1,-0.19219388716284969,45,19,26,36,0.3796520246246817,0.5601336744695943
달러화강세나타냈,-1,-0.1924269783565452,31,13,18,20,0.36477004059527285,0.5384375142878336
고용늘,-1,-0.1924269783565452,31,13,18,23,0.36477004059527285,0.5384375142878336
소비자신뢰지수하락,-1,-0.1924269783565452,31,13,18,16,0.36477004059527285,0.5384375142878336
수출호조세,-1,-0.1924269783565452,31,13,18,10,0.36477004059527285,0.5384375142878336
안전자산선호높,-1,-0.1924269783565452,31,13,18,21,0.36477004059527285,0.5384375142878336
선행지수상승,-1,-0.1924269783565452,31,13,18,14,0.36477004059527285,0.5384375142878336
금리하락기대,-1,-0.1924269783565452,31,13,18,22,0.36477004059527285,0.5384375142878336
고용감소,-1,-0.19352624966359577,52,22,30,28,0.38588222701084846,0.5709031537606089
금리인상가능성반영,-1,-0.19461311304488083,98,42,56,93,0.42536176367694106,0.630734910638844
수요늘,-1,-0.19599254442899594,219,95,124,171,0.4896744102370118,0.7281841341077112
기준금리높수준,-1,-0.19615764924876977,24,10,14,18,0.3549218708567403,0.5279778126702391
높수익률추구,-1,-0.19615764924876977,24,10,14,10,0.3549218708567403,0.5279778126702391
성장통해,-1,-0.19615764924876977,24,10,14,21,0.3549218708567403,0.5279778126702391
달러약세인해,-1,-0.19615764924876977,24,10,14,17,0.3549218708567403,0.5279778126702391
고변동성확대,-1,-0.19615764924876977,24,10,14,14,0.3549218708567403,0.5279778126702391
성장세이어지,-1,-0.19615764924876977,24,10,14,32,0.3549218708567403,0.5279778126702391
신규실업수당청구줄어든,-1,-0.19615764924876977,24,10,14,14,0.3549218708567403,0.5279778126702391
금리인상연기,-1,-0.19615764924876977,24,10,14,39,0.3549218708567403,0.5279778126702391
경제성장률떨어지,-1,-0.19615764924876977,24,10,14,15,0.3549218708567403,0.5279778126702391
원자재가격상승,-1,-0.1971832170435882,66,28,38,47,0.39699521807989735,0.5918267724312298
수익올릴,-1,-0.1971832170435882,66,28,38,55,0.39699521807989735,0.5918267724312298
성장위해,-1,-0.19919930837274624,73,31,42,53,0.4020602111629176,0.6018977953577527
매수심리위축,-1,-0.20049199340848634,300,130,170,246,0.506996085710928,0.7610365372505444
금리낮추,-1,-0.2021320498600262,328,142,186,279,0.5100916623013579,0.768304683517142
금리높이,-1,-0.20361853442368716,50,21,29,29,0.3780720095916146,0.5712234519358392
영업이익감소,-1,-0.20361853442368716,50,21,29,54,0.3780720095916146,0.5712234519358392
투자줄이,-1,-0.20399050194820711,43,18,25,29,0.3708418742045035,0.56073450219427
국제유가오르,-1,-0.20399050194820711,43,18,25,29,0.3708418742045035,0.56073450219427
불확실성커질,-1,-0.20409674783345422,57,24,33,58,0.38456518780703924,0.5816138634879652
변동성줄어들,-1,-0.2050725208959111,64,27,37,40,0.39052112838043,0.5918255041422636
순이자마진하락,-1,-0.2050725208959111,64,27,37,41,0.39052112838043,0.5918255041422636
달러화강세보인,-1,-0.2058541729895006,36,15,21,44,0.36251710967081824,0.550283309171086
완화적통화정책유지,-1,-0.20633791723773753,71,30,41,65,0.39606048202810085,0.6018081328147579
신용스프레드줄어들,-1,-0.2068430122284568,17,7,10,12,0.34097605948600823,0.5186550347954207
금리인하긍정적,-1,-0.2068430122284568,17,7,10,10,0.34097605948600823,0.5186550347954207
시중금리낮수준,-1,-0.2068430122284568,17,7,10,13,0.34097605948600823,0.5186550347954207
은행대출늘,-1,-0.2068430122284568,17,7,10,9,0.34097605948600823,0.5186550347954207
원화강세이어지,-1,-0.2068430122284568,17,7,10,24,0.34097605948600823,0.5186550347954207
금리인하효과지켜볼,-1,-0.2068430122284568,17,7,10,23,0.34097605948600823,0.5186550347954207
경제성장지지,-1,-0.2068430122284568,17,7,10,10,0.34097605948600823,0.5186550347954207
채권스왑스프레드역전폭축소,-1,-0.2068430122284568,17,7,10,28,0.34097605948600823,0.5186550347954207
기준금리오른,-1,-0.2068430122284568,17,7,10,10,0.34097605948600823,0.5186550347954207
매수심리확산,-1,-0.2068430122284568,17,7,10,2,0.34097605948600823,0.5186550347954207
유동성함정빠질,-1,-0.2068430122284568,17,7,10,3,0.34097605948600823,0.5186550347954207
금리부담커지,-1,-0.2068430122284568,17,7,10,8,0.34097605948600823,0.5186550347954207
소비자물가증가,-1,-0.2068430122284568,17,7,10,12,0.34097605948600823,0.5186550347954207
하향압력작용,-1,-0.2068430122284568,17,7,10,7,0.34097605948600823,0.5186550347954207
금리상승작,-1,-0.2068430122284568,17,7,10,9,0.34097605948600823,0.5186550347954207
물가상승압력둔화,-1,-0.2068430122284568,17,7,10,6,0.34097605948600823,0.5186550347954207
경제성장세이,-1,-0.2068430122284568,17,7,10,13,0.34097605948600823,0.5186550347954207
민간소비회복,-1,-0.2068430122284568,17,7,10,4,0.34097605948600823,0.5186550347954207
유동성증가따른,-1,-0.2068430122284568,17,7,10,8,0.34097605948600823,0.5186550347954207
유동성줄,-1,-0.2068430122284568,17,7,10,16,0.34097605948600823,0.5186550347954207
민간채권수익률민평상승,-1,-0.2068430122284568,17,7,10,10,0.34097605948600823,0.5186550347954207
위험자산이동,-1,-0.2068430122284568,17,7,10,17,0.34097605948600823,0.5186550347954207
디플레이션우려제기,-1,-0.2068430122284568,17,7,10,12,0.34097605948600823,0.5186550347954207
신용위험커지,-1,-0.2068430122284568,17,7,10,8,0.34097605948600823,0.5186550347954207
금융위기높수준,-1,-0.2068430122284568,17,7,10,9,0.34097605948600823,0.5186550347954207
고용지표호조보여,-1,-0.2068430122284568,17,7,10,9,0.34097605948600823,0.5186550347954207
성장중시,-1,-0.2068430122284568,17,7,10,12,0.34097605948600823,0.5186550347954207
설비투자개선,-1,-0.2068430122284568,17,7,10,23,0.34097605948600823,0.5186550347954207
금리인상어렵,-1,-0.20704532621272131,101,43,58,63,0.4200098960420981,0.6391426221111344
시장변동성확대,-1,-0.20776394021655886,78,33,45,66,0.4012607876501044,0.6115290038677201
고용증가,-1,-0.20776394021655886,78,33,45,49,0.4012607876501044,0.6115290038677201
경제성장률마이너스,-1,-0.21049915137432262,29,12,17,6,0.35238589388989433,0.5401230281275339
채권시장강세지지,-1,-0.21049915137432262,29,12,17,28,0.35238589388989433,0.5401230281275339
역성장,-1,-0.21049915137432262,29,12,17,20,0.35238589388989433,0.5401230281275339
소비자물가올랐,-1,-0.21049915137432262,29,12,17,20,0.35238589388989433,0.5401230281275339
장기시장금리하락,-1,-0.21049915137432262,29,12,17,17,0.35238589388989433,0.5401230281275339
매출증가,-1,-0.2109199213804238,200,86,114,120,0.4725594871535039,0.7249583059745555
기준금리낮수준,-1,-0.21230657199679048,99,42,57,66,0.415280211113465,0.6389374871604502
인플레이션압력증가,-1,-0.21348836082952116,62,26,36,34,0.383734714251519,0.591865719073267
매출액증가,-1,-0.21361528349434733,55,23,32,60,0.3771090174510302,0.5818010466656044
경쟁력확보,-1,-0.21389836481170632,69,29,40,45,0.38980707113315166,0.6017483188240725
고용지표개선,-1,-0.21464235404062026,76,32,44,85,0.39544415553406737,0.6114028909401696
금리인하인해,-1,-0.21703805789273556,41,17,24,19,0.3613173735593166,0.5614527384559299
기준금리인상쉽,-1,-0.21703805789273556,41,17,24,30,0.3613173735593166,0.5614527384559299
금리급등따른,-1,-0.2189186128049483,104,44,60,69,0.4148966423432901,0.6472600104177301
금리변동성커질,-1,-0.22093492982847507,22,9,13,13,0.33879946215892587,0.5307884749645003
성장지지,-1,-0.22093492982847507,22,9,13,8,0.33879946215892587,0.5307884749645003
금리수준하락,-1,-0.22093492982847507,22,9,13,18,0.33879946215892587,0.5307884749645003
금리빠졌,-1,-0.22093492982847507,22,9,13,19,0.33879946215892587,0.5307884749645003
소비자물가오를,-1,-0.22093492982847507,22,9,13,14,0.33879946215892587,0.5307884749645003
수익올린,-1,-0.22093492982847507,22,9,13,14,0.33879946215892587,0.5307884749645003
재무안정성저하,-1,-0.22093492982847507,22,9,13,25,0.33879946215892587,0.5307884749645003
가동률하락,-1,-0.22093492982847507,22,9,13,15,0.33879946215892587,0.5307884749645003
채권시장강세나타냈,-1,-0.22093492982847507,22,9,13,10,0.33879946215892587,0.5307884749645003
성장잠재력높,-1,-0.22093492982847507,22,9,13,18,0.33879946215892587,0.5307884749645003
금융안정,-1,-0.22093492982847507,22,9,13,19,0.33879946215892587,0.5307884749645003
성장기여,-1,-0.22093492982847507,22,9,13,24,0.33879946215892587,0.5307884749645003
금리인하힘입,-1,-0.22093492982847507,22,9,13,6,0.33879946215892587,0.5307884749645003
달러화가치상승,-1,-0.22189804607956487,74,31,43,60,0.3893996488270339,0.6112991488458532
단기금리하락,-1,-0.22192367539873536,67,28,39,35,0.38327693385686584,0.601719835066906
국고채금리올랐,-1,-0.22192367539873536,67,28,39,66,0.38327693385686584,0.601719835066906
금리하락세이,-1,-0.22196353175926564,34,14,20,25,0.3512471451994526,0.5514813764288362
시장금리반등,-1,-0.22196353175926564,34,14,20,27,0.3512471451994526,0.5514813764288362
경제지표양호,-1,-0.22196353175926564,34,14,20,48,0.3512471451994526,0.5514813764288362
엔화급등,-1,-0.22196353175926564,34,14,20,19,0.3512471451994526,0.5514813764288362
성장세회복이어지,-1,-0.22196353175926564,34,14,20,25,0.3512471451994526,0.5514813764288362
생산자물가상승,-1,-0.22249114822718707,60,25,35,64,0.37660377355647645,0.5919495390284497
달러화엔화낮,-1,-0.22249114822718707,60,25,35,38,0.37660377355647645,0.5919495390284497
대출늘어나,-1,-0.22347349518652304,95,40,55,70,0.405410527170703,0.6385467827146579
crs금리하락,-1,-0.22663423647428027,46,19,27,42,0.3608220082425386,0.5721130635577377
엔화가치하락,-1,-0.22663423647428027,46,19,27,35,0.3608220082425386,0.5721130635577377
주택시장침체따른,-1,-0.22663423647428027,46,19,27,12,0.3608220082425386,0.5721130635577377
채권시장강세,-1,-0.22918545696570924,86,36,50,64,0.39492668743628573,0.6295672415534952
채권금리오르,-1,-0.22919861168183475,79,33,46,92,0.3892352299252391,0.6205115044814362
연체율높,-1,-0.23156274752191652,39,16,23,27,0.3509610871096359,0.562295598282503
연체율하락,-1,-0.23156274752191652,39,16,23,38,0.3509610871096359,0.562295598282503
주택시장냉각,-1,-0.23160558416125454,27,11,16,14,0.3383164474811586,0.5420859300076758
경제성장저해,-1,-0.23160558416125454,27,11,16,18,0.3383164474811586,0.5420859300076758
단기물하락,-1,-0.23160558416125454,27,11,16,35,0.3383164474811586,0.5420859300076758
국고채금리국고지표물내린,-1,-0.23160558416125454,27,11,16,28,0.3383164474811586,0.5420859300076758
달러강세요인작용,-1,-0.23160558416125454,27,11,16,26,0.3383164474811586,0.5420859300076758
시장금리오를,-1,-0.23504926387139669,51,21,30,33,0.3608150845708609,0.5823609997601975
금리인하,-1,-0.23555514674931044,2584,1096,1488,1696,0.49650603179687003,0.8022268031945358
금리인하하,-1,-0.23560471620372347,91,38,53,42,0.3949371826903752,0.6381844778446863
달러화반등,-1,-0.23648779906051187,126,53,73,84,0.4187199099924505,0.677881710049344
금리끌어내렸,-1,-0.23985972531266897,44,18,26,33,0.35122557812263056,0.572691335616241
시중금리하락,-1,-0.23985972531266897,44,18,26,25,0.35122557812263056,0.572691335616241
엔화약세나타내,-1,-0.2403444799097565,32,13,19,23,0.33871870508983815,0.5528666007486309
소비자물가하회,-1,-0.2403444799097565,32,13,19,20,0.33871870508983815,0.5528666007486309
시장금리하락,-1,-0.24205375194484036,208,88,120,160,0.4543954634808847,0.7443738785573905
높금리받,-1,-0.24254960238429568,56,23,33,44,0.36115598494086426,0.59225589313198
적자확대,-1,-0.24254960238429568,56,23,33,53,0.36115598494086426,0.59225589313198
국채가격떨어졌,-1,-0.24254960238429568,56,23,33,30,0.36115598494086426,0.59225589313198
경기하강,-1,-0.24254960238429568,56,23,33,21,0.36115598494086426,0.59225589313198
엔화약세힘입,-1,-0.24613948080673198,15,6,9,10,0.3168929363828011,0.5236515662707222
엔화약세이어질,-1,-0.24613948080673198,15,6,9,15,0.3168929363828011,0.5236515662707222
수출경쟁력약화,-1,-0.24613948080673198,15,6,9,19,0.3168929363828011,0.5236515662707222
물가상승률미치,-1,-0.24613948080673198,15,6,9,15,0.3168929363828011,0.5236515662707222
대출한도늘리,-1,-0.24613948080673198,15,6,9,18,0.3168929363828011,0.5236515662707222
가계부채증가세둔화,-1,-0.24613948080673198,15,6,9,16,0.3168929363828011,0.5236515662707222
경제우려,-1,-0.24613948080673198,15,6,9,10,0.3168929363828011,0.5236515662707222
경제회복따른,-1,-0.24613948080673198,15,6,9,8,0.3168929363828011,0.5236515662707222
지급준비율인상단행,-1,-0.24613948080673198,15,6,9,10,0.3168929363828011,0.5236515662707222
금리역전해소,-1,-0.24613948080673198,15,6,9,12,0.3168929363828011,0.5236515662707222
금리인상가능성대두,-1,-0.24613948080673198,15,6,9,12,0.3168929363828011,0.5236515662707222
금리인상가능성희박하,-1,-0.24613948080673198,15,6,9,7,0.3168929363828011,0.5236515662707222
금리인상끝날,-1,-0.24613948080673198,15,6,9,11,0.3168929363828011,0.5236515662707222
미국채금리상승영향받,-1,-0.24613948080673198,15,6,9,10,0.3168929363828011,0.5236515662707222
재고늘,-1,-0.24613948080673198,15,6,9,17,0.3168929363828011,0.5236515662707222
금리인하가능성커지,-1,-0.24613948080673198,15,6,9,12,0.3168929363828011,0.5236515662707222
금리인하기대확산,-1,-0.24613948080673198,15,6,9,3,0.3168929363828011,0.5236515662707222
은행수익성개선,-1,-0.24613948080673198,15,6,9,8,0.3168929363828011,0.5236515662707222
달러원상승우호적,-1,-0.24613948080673198,15,6,9,14,0.3168929363828011,0.5236515662707222
달러원하락압력작용,-1,-0.24613948080673198,15,6,9,10,0.3168929363828011,0.5236515662707222
금리인상완만하,-1,-0.24613948080673198,15,6,9,22,0.3168929363828011,0.5236515662707222
금융시장영향줄,-1,-0.24613948080673198,15,6,9,13,0.3168929363828011,0.5236515662707222
성장동력,-1,-0.24613948080673198,15,6,9,5,0.3168929363828011,0.5236515662707222
수입줄어든,-1,-0.24613948080673198,15,6,9,17,0.3168929363828011,0.5236515662707222
신용경색우려부각,-1,-0.24613948080673198,15,6,9,9,0.3168929363828011,0.5236515662707222
불확실성감소,-1,-0.24613948080673198,15,6,9,12,0.3168929363828011,0.5236515662707222
신용위험있,-1,-0.24613948080673198,15,6,9,10,0.3168929363828011,0.5236515662707222
양적완화연장,-1,-0.24613948080673198,15,6,9,8,0.3168929363828011,0.5236515662707222
소비투자심리위축,-1,-0.24613948080673198,15,6,9,10,0.3168929363828011,0.5236515662707222
수출여건개선,-1,-0.24613948080673198,15,6,9,9,0.3168929363828011,0.5236515662707222
영업이익증가,-1,-0.24631065030313581,68,28,40,84,0.3696977150395921,0.6111317475405363
서부텍사스산원유가격오른,-1,-0.24631065030313581,68,28,40,46,0.3696977150395921,0.6111317475405363
신용경색완화,-1,-0.247066703988853,101,42,59,45,0.39533948077278697,0.6545718742503871
환율상승따른,-1,-0.247066703988853,101,42,59,54,0.39533948077278697,0.6545718742503871
부동산가격하락,-1,-0.24719383521250715,49,20,29,20,0.35185974470681786,0.5827393075227338
확장국면,-1,-0.24719383521250715,49,20,29,45,0.35185974470681786,0.5827393075227338
안전자산선호도높,-1,-0.24784822486753866,37,15,22,36,0.33963013984005463,0.5632695717653201
달러강세이어지,-1,-0.24931791925751212,61,25,36,57,0.361749336036766,0.601835912440397
주택담보대출금리인상,-1,-0.2514899515501434,20,8,12,12,0.31953749162620726,0.5340777319137888
경제성장따른,-1,-0.2514899515501434,20,8,12,16,0.31953749162620726,0.5340777319137888
매출늘어난,-1,-0.2514899515501434,20,8,12,20,0.31953749162620726,0.5340777319137888
대출늘어날,-1,-0.2514899515501434,20,8,12,18,0.31953749162620726,0.5340777319137888
경제성장률전망낮춘,-1,-0.2514899515501434,20,8,12,8,0.31953749162620726,0.5340777319137888
국고금리오른,-1,-0.2514899515501434,20,8,12,4,0.31953749162620726,0.5340777319137888
인플레이션압력억제,-1,-0.2514899515501434,20,8,12,10,0.31953749162620726,0.5340777319137888
부양책없,-1,-0.2514899515501434,20,8,12,13,0.31953749162620726,0.5340777319137888
경쟁력유지,-1,-0.2514899515501434,20,8,12,14,0.31953749162620726,0.5340777319137888
신규주택판매감소,-1,-0.2514899515501434,20,8,12,23,0.31953749162620726,0.5340777319137888
투자늘렸,-1,-0.2514899515501434,20,8,12,25,0.31953749162620726,0.5340777319137888
금리상승세타,-1,-0.2514899515501434,20,8,12,6,0.31953749162620726,0.5340777319137888
환율방어위한,-1,-0.2514899515501434,20,8,12,18,0.31953749162620726,0.5340777319137888
금가격급등,-1,-0.2514899515501434,20,8,12,13,0.31953749162620726,0.5340777319137888
채권스왑확대,-1,-0.2514899515501434,20,8,12,10,0.31953749162620726,0.5340777319137888
시장변동성커지,-1,-0.2514899515501434,20,8,12,16,0.31953749162620726,0.5340777319137888
엔화약세나타냈,-1,-0.2514899515501434,20,8,12,11,0.31953749162620726,0.5340777319137888
금리인상가능성열려,-1,-0.2514899515501434,20,8,12,23,0.31953749162620726,0.5340777319137888
비용줄어들,-1,-0.2514899515501434,20,8,12,17,0.31953749162620726,0.5340777319137888
투자증가,-1,-0.25310999120001143,99,41,58,91,0.39017213318699123,0.654397028729113
금리낮유지,-1,-0.2537828356585625,54,22,32,55,0.3527488411560603,0.592481845144838
불안심리커졌,-1,-0.25448793996187324,42,17,25,38,0.3408522798173325,0.5733637291670115
투자늘릴,-1,-0.25448793996187324,42,17,25,26,0.3408522798173325,0.5733637291670115
국채금리넘어서,-1,-0.25662141605259947,25,10,15,11,0.32212827171567704,0.5443458715164993
내수부진따른,-1,-0.25662141605259947,25,10,15,19,0.32212827171567704,0.5443458715164993
투자매력낮,-1,-0.25662141605259947,25,10,15,25,0.32212827171567704,0.5443458715164993
금융시장불안정,-1,-0.25662141605259947,25,10,15,16,0.32212827171567704,0.5443458715164993
물가상승압력확대,-1,-0.25662141605259947,25,10,15,16,0.32212827171567704,0.5443458715164993
달러화상승,-1,-0.2580535826455529,231,97,134,248,0.45072462121906853,0.7639927025233171
소매판매증가,-1,-0.25940087241813115,97,40,57,123,0.38485287702590465,0.654224092931465
비농업고용증가,-1,-0.2597736554643657,59,24,35,47,0.3538166738478705,0.6019455267669331
모기지금리하락,-1,-0.2604808421231336,47,19,28,28,0.342270645104403,0.5831861638000461
채권수익률상승,-1,-0.2604808421231336,47,19,28,51,0.342270645104403,0.5831861638000461
서부텍사스산원유상승,-1,-0.2615405871726779,30,12,18,25,0.3246656416840183,0.5544487469395352
경제지표약화,-1,-0.2615405871726779,30,12,18,16,0.3246656416840183,0.5544487469395352
유로화약세보였,-1,-0.2615405871726779,30,12,18,11,0.3246656416840183,0.5544487469395352
지급준비율올리,-1,-0.2615405871726779,30,12,18,13,0.3246656416840183,0.5544487469395352
시장금리오르,-1,-0.26267854103005006,109,45,64,93,0.3912235362780847,0.6697474964240213
인플레이션압력완화,-1,-0.2639080704468274,201,84,117,68,0.43702512433052426,0.7501355210580849
경제성장률전망하향조정,-1,-0.2656996971454513,121,50,71,125,0.3971125581731485,0.6842582492146719
금리인하결정,-1,-0.2659569022674674,95,39,56,42,0.379372804073657,0.6540530031876843
금리폭등,-1,-0.2659635986288347,52,21,31,27,0.34381469138107995,0.5927580182157791
신용등급상향,-1,-0.2659635986288347,52,21,31,46,0.34381469138107995,0.5927580182157791
부양책,-1,-0.26621488524527737,180,75,105,111,0.427296807454882,0.7370848568313857
성장세확대,-1,-0.26625410210958445,35,14,21,32,0.3271500095824027,0.5643797598704555
기준금리상승,-1,-0.26625410210958445,35,14,21,21,0.3271500095824027,0.5643797598704555
금리인하신중,-1,-0.26625410210958445,35,14,21,24,0.3271500095824027,0.5643797598704555
주택담보대출증가,-1,-0.2663695196395268,76,31,45,60,0.364462747005628,0.6289056721403449
금리낮출,-1,-0.267000642442799,114,47,67,95,0.3918342006862803,0.6770561847137435
기준금리낮출,-1,-0.270346202864601,69,28,41,44,0.3562938421599462,0.6201001775428565
금리상승이어질,-1,-0.270768508613468,40,16,24,35,0.32958182316670115,0.5741329430263644
유동성공급확대,-1,-0.270768508613468,40,16,24,18,0.32958182316670115,0.5741329430263644
기준금리올려야,-1,-0.2710273448184184,57,23,34,45,0.3454386826862653,0.6020918471084522
엔화거래낮,-1,-0.2710508268701822,119,49,70,66,0.3924862468450369,0.6841293590526725
경기회복위해,-1,-0.2726987928447724,112,46,66,67,0.38696350732829293,0.6769070459292093
금리인하쉽,-1,-0.2757358663877517,62,25,37,41,0.3471117584609279,0.6111953521700921
금리상승확대,-1,-0.2835647911007275,84,34,50,65,0.3604388927939658,0.6455315031921774
대출규제강화,-1,-0.28627711381423937,28,11,17,13,0.3087508757218327,0.5562337434324975
기준금리높,-1,-0.28627711381423937,28,11,17,28,0.3087508757218327,0.5562337434324975
금융시장변동성커지,-1,-0.28627711381423937,28,11,17,37,0.3087508757218327,0.5562337434324975
대외여건악화,-1,-0.28627711381423937,28,11,17,20,0.3087508757218327,0.5562337434324975
금리인하기대심리유지,-1,-0.28627711381423937,28,11,17,46,0.3087508757218327,0.5562337434324975
장기물강세보였,-1,-0.28678067249563344,23,9,14,19,0.30324596241866547,0.5469158818415915
달러화레벨낮췄,-1,-0.28678067249563344,23,9,14,21,0.30324596241866547,0.5469158818415915
이자부담줄어들,-1,-0.28678067249563344,23,9,14,31,0.30324596241866547,0.5469158818415915
안전자산선호심리강해,-1,-0.28678067249563344,23,9,14,24,0.30324596241866547,0.5469158818415915
경쟁력강화위한,-1,-0.28678067249563344,23,9,14,15,0.30324596241866547,0.5469158818415915
비농업고용창출감소,-1,-0.28678067249563344,23,9,14,4,0.30324596241866547,0.5469158818415915
금리상승압력가중,-1,-0.28678067249563344,23,9,14,8,0.30324596241866547,0.5469158818415915
유로화올랐,-1,-0.28678067249563344,23,9,14,16,0.30324596241866547,0.5469158818415915
통화완화나서,-1,-0.28678067249563344,23,9,14,15,0.30324596241866547,0.5469158818415915
금리상승세재개,-1,-0.28678067249563344,23,9,14,29,0.30324596241866547,0.5469158818415915
채권시장심리악화,-1,-0.28678067249563344,23,9,14,1,0.30324596241866547,0.5469158818415915
부동산가격상승따른,-1,-0.28678067249563344,23,9,14,10,0.30324596241866547,0.5469158818415915
채권시장강세이,-1,-0.28724134155520387,33,13,20,21,0.31330702506832886,0.5656288754739873
금리내려갔,-1,-0.28724134155520387,33,13,20,40,0.31330702506832886,0.5656288754739873
적자전환,-1,-0.2890118309137426,38,15,23,30,0.31727064818483514,0.5750001028402891
달러화유로화하락,-1,-0.2901722306490149,18,7,11,18,0.29603606948320915,0.5378764444728384
잠재성장률높이,-1,-0.2901722306490149,18,7,11,15,0.29603606948320915,0.5378764444728384
금리인하진행,-1,-0.2901722306490149,18,7,11,16,0.29603606948320915,0.5378764444728384
높금리거래,-1,-0.2901722306490149,18,7,11,11,0.29603606948320915,0.5378764444728384
인플레이션우려덜,-1,-0.2901722306490149,18,7,11,3,0.29603606948320915,0.5378764444728384
달러원하락압력받,-1,-0.2901722306490149,18,7,11,29,0.29603606948320915,0.5378764444728384
급등국고채금리,-1,-0.2901722306490149,18,7,11,9,0.29603606948320915,0.5378764444728384
금융시장충격주,-1,-0.2901722306490149,18,7,11,24,0.29603606948320915,0.5378764444728384
irs금리상승,-1,-0.2901722306490149,18,7,11,29,0.29603606948320915,0.5378764444728384
금리인하기대커질,-1,-0.2901722306490149,18,7,11,15,0.29603606948320915,0.5378764444728384
경제부담주,-1,-0.2901722306490149,18,7,11,17,0.29603606948320915,0.5378764444728384
소비자물가높수준,-1,-0.2901722306490149,18,7,11,17,0.29603606948320915,0.5378764444728384
엔화약세진행,-1,-0.2901722306490149,18,7,11,13,0.29603606948320915,0.5378764444728384
회사채수익률하락,-1,-0.2901722306490149,18,7,11,13,0.29603606948320915,0.5378764444728384
금리인상앞당길,-1,-0.2901722306490149,18,7,11,14,0.29603606948320915,0.5378764444728384
경기회복힘입,-1,-0.2901722306490149,18,7,11,20,0.29603606948320915,0.5378764444728384
금리인상막,-1,-0.2901722306490149,18,7,11,17,0.29603606948320915,0.5378764444728384
부양책사용,-1,-0.2901722306490149,18,7,11,14,0.29603606948320915,0.5378764444728384
국채수익률낮,-1,-0.2901722306490149,18,7,11,10,0.29603606948320915,0.5378764444728384
소비회복,-1,-0.29057544734948915,65,26,39,43,0.34097063444145614,0.6200650404634056
부양책나올,-1,-0.29124057417699867,43,17,26,34,0.32083164302181866,0.5842899566350072
비용늘어나,-1,-0.29124057417699867,43,17,26,34,0.32083164302181866,0.5842899566350072
투자심리회복,-1,-0.292581775989591,185,76,109,152,0.4116709169849241,0.751925001975977
국채선물시장하락,-1,-0.2937283826738467,48,19,29,28,0.3241006122074549,0.5934627337687022
달러화상승폭확대,-1,-0.2937283826738467,48,19,29,31,0.3241006122074549,0.5934627337687022
소비자물가상승률낮,-1,-0.2944450185417199,99,40,59,79,0.3647341717381185,0.668915498089714
경제지표악화,-1,-0.2985076605676371,92,37,55,52,0.3573137321931999,0.6611686600450977
장기물금리하락,-1,-0.2990406793324014,58,23,35,46,0.3300143738390452,0.6113692868031979
유동성확보,-1,-0.3002803817087353,145,59,86,103,0.38862992240285416,0.7219210168364043
수익올리,-1,-0.30441057444287056,68,27,41,64,0.3353316508011557,0.6286012669999864
금리낮,-1,-0.3049106058367568,506,207,299,361,0.4433189910919433,0.8319470069019891
gdp증가,-1,-0.3075978428829673,201,82,119,105,0.40735715274592893,0.7690058064501439
국고채금리오른,-1,-0.30866088490597476,177,72,105,136,0.3977568229319349,0.7526478508784548
경기회복본격화,-1,-0.30919878810575485,41,16,25,10,0.3087629468069527,0.5849459351729136
연방기금금리선물기준금리인하,-1,-0.30919878810575485,41,16,25,10,0.3087629468069527,0.5849459351729136
기준금리내려,-1,-0.30919878810575485,41,16,25,38,0.3087629468069527,0.5849459351729136
기준금리인하기대,-1,-0.30919878810575485,41,16,25,57,0.3087629468069527,0.5849459351729136
이중침체빠질,-1,-0.30960700061941393,36,14,22,25,0.3037475374321236,0.5759639584682442
집값떨어지,-1,-0.30960700061941393,36,14,22,28,0.3037475374321236,0.5759639584682442
금리인하선반영,-1,-0.30960700061941393,36,14,22,30,0.3037475374321236,0.5759639584682442
국채금리낮,-1,-0.3096624775995286,46,18,28,41,0.3131627657651345,0.5938899050236162
유로화내린,-1,-0.3096624775995286,46,18,28,18,0.3131627657651345,0.5938899050236162
신용경색해소,-1,-0.3096624775995286,46,18,28,26,0.3131627657651345,0.5938899050236162
금리인상반대,-1,-0.3096624775995286,46,18,28,32,0.3131627657651345,0.5938899050236162
금리인하기대심리약화,-1,-0.31068748263319246,51,20,31,28,0.3171146959341085,0.6027496800969327
채권시장변동성확대,-1,-0.31140712256557124,31,12,19,24,0.297839762252798,0.5670157478534451
미국채금리올랐,-1,-0.31140712256557124,31,12,19,31,0.297839762252798,0.5670157478534451
달러약세이어질,-1,-0.31140712256557124,31,12,19,17,0.297839762252798,0.5670157478534451
국고채입찰부진,-1,-0.31140712256557124,31,12,19,26,0.297839762252798,0.5670157478534451
조달금리상승,-1,-0.31140712256557124,31,12,19,10,0.297839762252798,0.5670157478534451
경기회복이끌,-1,-0.31553589619679057,26,10,16,13,0.290547782588086,0.5582206087626541
원환율하락,-1,-0.31553589619679057,26,10,16,14,0.290547782588086,0.5582206087626541
안정적수익추구,-1,-0.31553589619679057,26,10,16,24,0.290547782588086,0.5582206087626541
양적완화통한,-1,-0.31553589619679057,26,10,16,16,0.290547782588086,0.5582206087626541
저성장,-1,-0.31734247939068294,71,28,43,81,0.33014097770476236,0.6368409982688472
금리내렸,-1,-0.318085708028483,263,107,156,210,0.41636234385992293,0.8044903816583097
기대심리확산,-1,-0.3186703641442671,115,46,69,94,0.36014465247481153,0.6967730166112014
금리인하단행,-1,-0.3235918169807114,947,383,564,517,0.4300904254990081,0.8412769178044062
단기금리인상,-1,-0.3238603267299315,21,8,13,12,0.2809061518000775,0.5497951433041536
경상수지흑자따른,-1,-0.3238603267299315,21,8,13,30,0.2809061518000775,0.5497951433041536
기준금리동결불구하,-1,-0.3238603267299315,21,8,13,26,0.2809061518000775,0.5497951433041536
아파트가격하락,-1,-0.3238603267299315,21,8,13,9,0.2809061518000775,0.5497951433041536
실적호조보인,-1,-0.3238603267299315,21,8,13,19,0.2809061518000775,0.5497951433041536
기준금리인상될,-1,-0.3238603267299315,21,8,13,14,0.2809061518000775,0.5497951433041536
채권금리상승제한,-1,-0.3238603267299315,21,8,13,23,0.2809061518000775,0.5497951433041536
유가하락부추겼,-1,-0.3238603267299315,21,8,13,16,0.2809061518000775,0.5497951433041536
하방경직성확보,-1,-0.3238603267299315,21,8,13,26,0.2809061518000775,0.5497951433041536
신용경색확산,-1,-0.3238603267299315,21,8,13,8,0.2809061518000775,0.5497951433041536
침체인해,-1,-0.3238603267299315,21,8,13,11,0.2809061518000775,0.5497951433041536
국제금융시장불안완화,-1,-0.3238603267299315,21,8,13,2,0.2809061518000775,0.5497951433041536
국고채금리내렸으며,-1,-0.3238603267299315,21,8,13,9,0.2809061518000775,0.5497951433041536
소비위축,-1,-0.32456679428528534,181,73,108,115,0.3887449255742724,0.7620612621525467
듀레이션줄이,-1,-0.32619790762388556,54,21,33,50,0.3108764202134064,0.6116415635784361
국채가격상승견인,-1,-0.3263474595799788,49,19,30,18,0.30640087910274,0.6030378143062217
gdp감소,-1,-0.326571517081924,59,23,36,36,0.3149334652774444,0.6201419563162057
설비투자감소,-1,-0.329292977486475,39,15,24,31,0.2956180239984692,0.5856674515401274
경색완화,-1,-0.329292977486475,39,15,24,12,0.2956180239984692,0.5856674515401274
투자심리약화,-1,-0.329292977486475,39,15,24,31,0.2956180239984692,0.5856674515401274
성장세약화,-1,-0.329292977486475,39,15,24,46,0.2956180239984692,0.5856674515401274
경기침체겪,-1,-0.3330452685276257,34,13,21,29,0.2888091303207356,0.5770197479246308
장기물상승,-1,-0.3330452685276257,34,13,21,44,0.2888091303207356,0.5770197479246308
금리상승세보였,-1,-0.3330452685276257,34,13,21,26,0.2888091303207356,0.5770197479246308
침체,-1,-0.33682759386023853,515,207,308,410,0.4195115085676037,0.8453234691789303
경기침체,-1,-0.33770975530650493,224,90,134,135,0.39372277631352515,0.7949391831260327
지표물국고채금리상승,-1,-0.3395322627912484,29,11,18,21,0.2804302730544352,0.5685330900037288
경제지표호조보였,-1,-0.3395322627912484,29,11,18,23,0.2804302730544352,0.5685330900037288
장기금리낮추,-1,-0.3395322627912484,29,11,18,25,0.2804302730544352,0.5685330900037288
경제부담줄,-1,-0.3395322627912484,29,11,18,20,0.2804302730544352,0.5685330900037288
투자늘어날,-1,-0.3395322627912484,29,11,18,28,0.2804302730544352,0.5685330900037288
기준금리인하나서,-1,-0.3395322627912484,29,11,18,13,0.2804302730544352,0.5685330900037288
경기회복조짐보이,-1,-0.3395322627912484,29,11,18,9,0.2804302730544352,0.5685330900037288
금리떨어진,-1,-0.3403716416841359,114,45,69,76,0.3460434534175958,0.7028871093694163
물가상승률전망,-1,-0.3404481973087796,57,22,35,65,0.3052804738381277,0.6201962783611861
금리인상신호나올,-1,-0.3406945029469103,16,6,10,13,0.266730853775416,0.5421822781466269
양적완화줄어들,-1,-0.3406945029469103,16,6,10,11,0.266730853775416,0.5421822781466269
부양책제시,-1,-0.3406945029469103,16,6,10,13,0.266730853775416,0.5421822781466269
하방위험우세,-1,-0.3406945029469103,16,6,10,19,0.266730853775416,0.5421822781466269
지표금리국고채수익률하락,-1,-0.3406945029469103,16,6,10,17,0.266730853775416,0.5421822781466269
하방위험커지,-1,-0.3406945029469103,16,6,10,28,0.266730853775416,0.5421822781466269
투자매력높이,-1,-0.3406945029469103,16,6,10,16,0.266730853775416,0.5421822781466269
기준금리인하어려울,-1,-0.3406945029469103,16,6,10,9,0.266730853775416,0.5421822781466269
금리상승폭,-1,-0.3406945029469103,16,6,10,10,0.266730853775416,0.5421822781466269
신용등급오른,-1,-0.3406945029469103,16,6,10,16,0.266730853775416,0.5421822781466269
적자냈,-1,-0.3406945029469103,16,6,10,16,0.266730853775416,0.5421822781466269
경제침체빠졌,-1,-0.3406945029469103,16,6,10,3,0.266730853775416,0.5421822781466269
실물경제개선,-1,-0.3406945029469103,16,6,10,5,0.266730853775416,0.5421822781466269
미국채가격영향하락출발,-1,-0.3406945029469103,16,6,10,29,0.266730853775416,0.5421822781466269
침체보이,-1,-0.3406945029469103,16,6,10,10,0.266730853775416,0.5421822781466269
국채금리떨어졌,-1,-0.3406945029469103,16,6,10,17,0.266730853775416,0.5421822781466269
소비자물가상승률둔화,-1,-0.3406945029469103,16,6,10,10,0.266730853775416,0.5421822781466269
인플레이션낮출,-1,-0.3406945029469103,16,6,10,14,0.266730853775416,0.5421822781466269
경제상황개선,-1,-0.3406945029469103,16,6,10,30,0.266730853775416,0.5421822781466269
위험자산선호,-1,-0.3406945029469103,16,6,10,23,0.266730853775416,0.5421822781466269
수급부담완화,-1,-0.3406945029469103,16,6,10,10,0.266730853775416,0.5421822781466269
이익늘어날,-1,-0.3406945029469103,16,6,10,13,0.266730853775416,0.5421822781466269
물가상승세확대,-1,-0.3406945029469103,16,6,10,9,0.266730853775416,0.5421822781466269
달러엔환율상승,-1,-0.3406945029469103,16,6,10,14,0.266730853775416,0.5421822781466269
금리인하이어지,-1,-0.3406945029469103,16,6,10,13,0.266730853775416,0.5421822781466269
달러원올라서,-1,-0.3406945029469103,16,6,10,4,0.266730853775416,0.5421822781466269
기준금리인하선반영,-1,-0.3406945029469103,16,6,10,12,0.266730853775416,0.5421822781466269
신용위험높,-1,-0.340834724425676,77,30,47,40,0.3209222615578968,0.6525437890163921
수요줄어든,-1,-0.3415460329604023,52,20,32,25,0.3004051202301892,0.6118094275587777
경제상황악화,-1,-0.3415460329604023,52,20,32,25,0.3004051202301892,0.6118094275587777
유동성개선,-1,-0.3435312530992364,47,18,29,27,0.2949250140387443,0.6033556686339032
소비자물가상승률,-1,-0.3452579367646105,134,53,81,134,0.35414742076226474,0.7273558673544236
통화긴축중단,-1,-0.34678996868631107,42,16,26,31,0.2886392331378445,0.5948801290884548
금리인하따른,-1,-0.34787958850285305,208,83,125,140,0.3822577211600255,0.7897803179001132
기준금리인하,-1,-0.3499678947755708,3164,1261,1903,2212,0.41032736165748085,0.8518148404058279
부채늘리,-1,-0.35066239395075716,24,9,15,10,0.26952143179441423,0.560396524581234
금리인상단행어려울,-1,-0.35066239395075716,24,9,15,17,0.26952143179441423,0.560396524581234
채권가격떨어지,-1,-0.35066239395075716,24,9,15,25,0.26952143179441423,0.560396524581234
달러엔오를,-1,-0.35066239395075716,24,9,15,16,0.26952143179441423,0.560396524581234
실적상회,-1,-0.35066239395075716,24,9,15,18,0.26952143179441423,0.560396524581234
인플레이션압력높일,-1,-0.35066239395075716,24,9,15,11,0.26952143179441423,0.560396524581234
금리인상가능성커진,-1,-0.35066239395075716,24,9,15,17,0.26952143179441423,0.560396524581234
금리올리어렵,-1,-0.35066239395075716,24,9,15,19,0.26952143179441423,0.560396524581234
듀레이션줄여,-1,-0.35066239395075716,24,9,15,11,0.26952143179441423,0.560396524581234
기대심리강화,-1,-0.35066239395075716,24,9,15,18,0.26952143179441423,0.560396524581234
미국채금리급등,-1,-0.3517736053223508,85,33,52,97,0.3202547690834148,0.6675724210647822
설비투자부진,-1,-0.35192812887316693,37,14,23,29,0.2812377561760452,0.5864480386397384
침체빠질,-1,-0.35192812887316693,37,14,23,26,0.2812377561760452,0.5864480386397384
금리인하인한,-1,-0.35192812887316693,37,14,23,25,0.2812377561760452,0.5864480386397384
집값오를,-1,-0.35192812887316693,37,14,23,35,0.2812377561760452,0.5864480386397384
채권스왑스프레드축소,-1,-0.35192812887316693,37,14,23,30,0.2812377561760452,0.5864480386397384
지표물국고채금리내린,-1,-0.35242864710883537,65,25,40,36,0.30491859904968904,0.6365550587636734
유가급등따른,-1,-0.35242864710883537,65,25,40,36,0.30491859904968904,0.6365550587636734
수요확대,-1,-0.35303766747318177,142,56,86,113,0.3532296206697611,0.7384364754562391
수요줄,-1,-0.3532739773662381,100,39,61,68,0.3294510973897578,0.6890986728479112
인플레이션잡,-1,-0.35392578541744546,105,41,64,86,0.3322136941638465,0.6959128211601703
금리인하가능성열,-1,-0.3546147499052721,110,43,67,61,0.3348504159935097,0.7025419260875018
변동성줄이,-1,-0.35829202995360254,50,19,31,47,0.2892462569914397,0.6119936892615492
미국채금리오르,-1,-0.35829202995360254,50,19,31,52,0.2892462569914397,0.6119936892615492
기준금리밑돌,-1,-0.359950144085593,32,12,20,20,0.27221628365461503,0.578157591603936
경기확장,-1,-0.359950144085593,32,12,20,16,0.27221628365461503,0.578157591603936
금리인상속도,-1,-0.359950144085593,32,12,20,43,0.27221628365461503,0.578157591603936
인플레이션위험높,-1,-0.359950144085593,32,12,20,21,0.27221628365461503,0.578157591603936
실적감소,-1,-0.3628303687521224,73,28,45,39,0.30504239809097866,0.6521822364651053
경제회복세보이,-1,-0.3640188881646088,68,26,42,49,0.3005703448442222,0.6443827969648286
금융시장안정위한,-1,-0.36825958594038943,58,22,36,32,0.2902745427601726,0.6284330982296649
기준금리동결가능성높,-1,-0.36859549581318174,40,15,25,12,0.27481737795059547,0.5954314561286861
금리빠지,-1,-0.36859549581318174,40,15,25,37,0.27481737795059547,0.5954314561286861
시장금리급락,-1,-0.36859549581318174,40,15,25,17,0.27481737795059547,0.5954314561286861
자금사정악화,-1,-0.36859549581318174,40,15,25,17,0.27481737795059547,0.5954314561286861
금리인하가능성반영,-1,-0.36859549581318174,40,15,25,21,0.27481737795059547,0.5954314561286861
높유로화달러화낮,-1,-0.3704615759044536,19,7,12,12,0.2541128163897912,0.5529561968067424
금가격오르,-1,-0.3704615759044536,19,7,12,15,0.2541128163897912,0.5529561968067424
높이자받,-1,-0.3704615759044536,19,7,12,10,0.2541128163897912,0.5529561968067424
국채매입늘리,-1,-0.3704615759044536,19,7,12,20,0.2541128163897912,0.5529561968067424
비용늘,-1,-0.3704615759044536,19,7,12,14,0.2541128163897912,0.5529561968067424
주택시장안정,-1,-0.3704615759044536,19,7,12,2,0.2541128163897912,0.5529561968067424
금리강세보였,-1,-0.3704615759044536,19,7,12,9,0.2541128163897912,0.5529561968067424
gdp하락,-1,-0.3704615759044536,19,7,12,4,0.2541128163897912,0.5529561968067424
금리내려간,-1,-0.3704615759044536,19,7,12,31,0.2541128163897912,0.5529561968067424
금리상승요인,-1,-0.3704615759044536,19,7,12,22,0.2541128163897912,0.5529561968067424
외환시장달러화원화환율하락,-1,-0.3704615759044536,19,7,12,14,0.2541128163897912,0.5529561968067424
임금상승률높,-1,-0.3704615759044536,19,7,12,13,0.2541128163897912,0.5529561968067424
시장변동성커질,-1,-0.3704615759044536,19,7,12,24,0.2541128163897912,0.5529561968067424
실적하락,-1,-0.3704615759044536,19,7,12,23,0.2541128163897912,0.5529561968067424
기준금리인하단행,-1,-0.37114822242345524,141,55,86,120,0.3412183433409282,0.7436828981790845
경기둔화따른,-1,-0.37114822242345524,141,55,86,98,0.3412183433409282,0.7436828981790845
모기지금리낮,-1,-0.37264381897918897,27,10,17,11,0.26069783813369113,0.5701641734625562
대출줄어들,-1,-0.37264381897918897,27,10,17,21,0.26069783813369113,0.5701641734625562
금리인하기대어렵,-1,-0.37264381897918897,27,10,17,18,0.26069783813369113,0.5701641734625562
경기과열막,-1,-0.37264381897918897,27,10,17,31,0.26069783813369113,0.5701641734625562
금리인하가능성배제,-1,-0.37264381897918897,27,10,17,24,0.26069783813369113,0.5701641734625562
높변동성보이,-1,-0.37264381897918897,27,10,17,29,0.26069783813369113,0.5701641734625562
소비자물가상승률상승,-1,-0.37264381897918897,27,10,17,21,0.26069783813369113,0.5701641734625562
이자부담,-1,-0.37264381897918897,27,10,17,41,0.26069783813369113,0.5701641734625562
채권시장강세이끌,-1,-0.37264381897918897,27,10,17,23,0.26069783813369113,0.5701641734625562
변동폭커지,-1,-0.37264381897918897,27,10,17,9,0.26069783813369113,0.5701641734625562
수익성떨어지,-1,-0.37264381897918897,27,10,17,25,0.26069783813369113,0.5701641734625562
유로화달러화낮,-1,-0.3766348939482701,48,18,30,32,0.2773267686461945,0.6121890574137744
유로달러오른,-1,-0.3770753560415603,66,25,41,68,0.2915413576607593,0.6442281584998928
금리하락제한적,-1,-0.3770753560415603,66,25,41,77,0.2915413576607593,0.6442281584998928
금리인하기대반영,-1,-0.37760531562248,35,13,22,30,0.26544033947003987,0.5872770354253672
금리인상정당화,-1,-0.37760531562248,35,13,22,20,0.26544033947003987,0.5872770354253672
달러약세진행,-1,-0.37760531562248,35,13,22,24,0.26544033947003987,0.5872770354253672
듀레이션축소,-1,-0.37760531562248,35,13,22,33,0.26544033947003987,0.5872770354253672
수입줄,-1,-0.37760531562248,35,13,22,22,0.26544033947003987,0.5872770354253672
금리인하가능성낮,-1,-0.37856017635227246,99,38,61,97,0.313540595611368,0.695244024051616
국채가격높,-1,-0.3834521627942894,43,16,27,22,0.26931841107887333,0.6040579234183161
고용지표호조보이,-1,-0.384103372308789,56,21,35,51,0.2797465781798414,0.6284061606300171
달러원급등,-1,-0.3865019297864618,102,39,63,79,0.3106115639215848,0.7016798762778046
기준금리내릴,-1,-0.3871461730197936,185,72,113,154,0.34867239074949896,0.7888542795017447
집값하락,-1,-0.3895057932265833,51,19,32,37,0.27269742846912415,0.6204016399162625
금리인하될,-1,-0.39111426335822164,30,11,19,20,0.2536933939553341,0.5793602278832379
성장긍정적,-1,-0.39111426335822164,30,11,19,22,0.2536933939553341,0.5793602278832379
금리인하기대유지,-1,-0.39111426335822164,30,11,19,37,0.2536933939553341,0.5793602278832379
금리변동성커지,-1,-0.39111426335822164,30,11,19,20,0.2536933939553341,0.5793602278832379
금리인상확인,-1,-0.39111426335822164,30,11,19,22,0.2536933939553341,0.5793602278832379
국채금리급락,-1,-0.3930796023528508,38,14,24,37,0.25977392901998736,0.5960073118832285
안전자산선호심리약화,-1,-0.3935114226866555,22,8,14,23,0.24501896157076872,0.5627289713497086
달러엔환율하락,-1,-0.3935114226866555,22,8,14,16,0.24501896157076872,0.5627289713497086
임금상승률낮,-1,-0.3935114226866555,22,8,14,9,0.24501896157076872,0.5627289713497086
채권시장국고채금리오른,-1,-0.3935114226866555,22,8,14,21,0.24501896157076872,0.5627289713497086
금리인하기대강화,-1,-0.3935114226866555,22,8,14,11,0.24501896157076872,0.5627289713497086
경제침체빠지,-1,-0.3935114226866555,22,8,14,17,0.24501896157076872,0.5627289713497086
금리급락,-1,-0.39528317141736746,239,93,146,130,0.3577581077990844,0.8251080626782067
수입증가,-1,-0.3967702531009504,95,36,59,76,0.3001613151608807,0.6947162570820472
산업생산부진,-1,-0.3968076733156256,46,17,29,41,0.26456699719756166,0.6123884251802003
재무안정성유지,-1,-0.3968076733156256,46,17,29,12,0.26456699719756166,0.6123884251802003
투자부진,-1,-0.4012708430016483,54,20,34,42,0.26860623125696237,0.6283717569212841
채권시장부담작용,-1,-0.4059921244852944,62,23,39,37,0.27215087842504737,0.6438839478314328
서부텍사스산원유가격하락,-1,-0.4069435266583358,33,12,21,28,0.24802292115461824,0.5881380204359634
물가상승률감안,-1,-0.4120799204751895,57,21,36,29,0.26497046522031126,0.6361263193188926
내외금리차축소,-1,-0.41209158344825214,25,9,16,17,0.238201897401659,0.5718778964227826
적자내,-1,-0.41209158344825214,25,9,16,18,0.238201897401659,0.5718778964227826
경제약화,-1,-0.41209158344825214,25,9,16,13,0.238201897401659,0.5718778964227826
수요계속,-1,-0.41209158344825214,25,9,16,28,0.238201897401659,0.5718778964227826
국고채수익률오른,-1,-0.41209158344825214,25,9,16,20,0.238201897401659,0.5718778964227826
손실커질,-1,-0.41209158344825214,25,9,16,11,0.238201897401659,0.5718778964227826
금리인상적극적,-1,-0.41209158344825214,25,9,16,17,0.238201897401659,0.5718778964227826
환율하락요인작용,-1,-0.41209158344825214,25,9,16,21,0.238201897401659,0.5718778964227826
가계부채늘어나,-1,-0.4157545816439354,65,24,41,51,0.2689074871617764,0.6513269982051935
양적완화나설,-1,-0.4199275858268058,52,19,33,53,0.25680139429119037,0.6283234844588456
금리인하고려,-1,-0.4207313842304251,36,13,23,40,0.24335724183171922,0.5965926117730844
달러화강세지지받,-1,-0.4207313842304251,36,13,23,24,0.24335724183171922,0.5965926117730844
글로벌경제성장,-1,-0.4207313842304251,36,13,23,24,0.24335724183171922,0.5965926117730844
경기침체빠질,-1,-0.4207313842304251,36,13,23,23,0.24335724183171922,0.5965926117730844
수출증가,-1,-0.42338855447325574,261,100,161,210,0.34250032279498616,0.8450877135438069
금리하락반전,-1,-0.42753983739260915,28,10,18,21,0.23293512190235505,0.5805998357268481
매수심리강화,-1,-0.4301736505031286,47,17,30,21,0.24734838365477718,0.620516369470937
소비감소,-1,-0.4301736505031286,47,17,30,40,0.24734838365477718,0.620516369470937
금리인상나타날,-1,-0.4304009498953356,17,6,11,12,0.22163596564430182,0.5563224689095879
매출액감소,-1,-0.4304009498953356,17,6,11,35,0.22163596564430182,0.5563224689095879
금리인하소극적,-1,-0.4304009498953356,17,6,11,12,0.22163596564430182,0.5563224689095879
발행금리낮추,-1,-0.4304009498953356,17,6,11,13,0.22163596564430182,0.5563224689095879
양적완화할,-1,-0.4304009498953356,17,6,11,14,0.22163596564430182,0.5563224689095879
인플레이션기대심리잡,-1,-0.4304009498953356,17,6,11,12,0.22163596564430182,0.5563224689095879
원화강세불구하,-1,-0.4304009498953356,17,6,11,14,0.22163596564430182,0.5563224689095879
실적올린,-1,-0.4304009498953356,17,6,11,11,0.22163596564430182,0.5563224689095879
기준금리올려도,-1,-0.4304009498953356,17,6,11,22,0.22163596564430182,0.5563224689095879
지표금리급등,-1,-0.4304009498953356,17,6,11,4,0.22163596564430182,0.5563224689095879
경기뚜렷한회복세보이,-1,-0.4304009498953356,17,6,11,5,0.22163596564430182,0.5563224689095879
달러강세영향받,-1,-0.4304009498953356,17,6,11,16,0.22163596564430182,0.5563224689095879
조달금리낮,-1,-0.4304009498953356,17,6,11,18,0.22163596564430182,0.5563224689095879
채권금리올라가,-1,-0.4304009498953356,17,6,11,18,0.22163596564430182,0.5563224689095879
제조업지수상승,-1,-0.4304009498953356,17,6,11,8,0.22163596564430182,0.5563224689095879
원자재가격하락,-1,-0.43130015452689086,63,23,40,49,0.25880941294279103,0.6510661972692547
달러화올랐,-1,-0.43290458836239143,39,14,25,38,0.239465820208543,0.6047856850913155
회사채수익률오른,-1,-0.43290458836239143,39,14,25,26,0.239465820208543,0.6047856850913155
금리상승압력높,-1,-0.43579197448624174,79,29,50,94,0.267265923562585,0.679816209212236
국고금리상승,-1,-0.43825456544736896,126,47,79,124,0.29226547769785066,0.7479428071822608
하방위험높,-1,-0.44026167639091596,50,18,32,50,0.24427815822164697,0.6282533825857448
민간소비증가,-1,-0.4407009869572809,31,11,20,11,0.228768794833941,0.589006707629006
금리상승세제한,-1,-0.4407009869572809,31,11,20,34,0.228768794833941,0.589006707629006
기준금리하회,-1,-0.4407009869572809,31,11,20,61,0.228768794833941,0.589006707629006
물가낮,-1,-0.4407009869572809,31,11,20,40,0.228768794833941,0.589006707629006
금리하락확대,-1,-0.4407009869572809,31,11,20,27,0.228768794833941,0.589006707629006
달러화엔화오른,-1,-0.4407009869572809,31,11,20,23,0.228768794833941,0.589006707629006
성장위한,-1,-0.44129535697868083,74,27,47,81,0.2608649457432418,0.6726355874376679
cd금리떨어지,-1,-0.4466176554251263,20,7,13,16,0.21629505796526263,0.5651532747296356
경기회복세미약하,-1,-0.4466176554251263,20,7,13,22,0.21629505796526263,0.5651532747296356
기준금리인상앞당길,-1,-0.4466176554251263,20,7,13,9,0.21629505796526263,0.5651532747296356
기대인플레이션하락,-1,-0.4466176554251263,20,7,13,38,0.21629505796526263,0.5651532747296356
유로확대,-1,-0.4466176554251263,20,7,13,9,0.21629505796526263,0.5651532747296356
물가상승요인작용,-1,-0.4466176554251263,20,7,13,13,0.21629505796526263,0.5651532747296356
엔화강세보인,-1,-0.4466176554251263,20,7,13,13,0.21629505796526263,0.5651532747296356
금리인상신호주,-1,-0.4466176554251263,20,7,13,10,0.21629505796526263,0.5651532747296356
유로화내려앉,-1,-0.4466176554251263,20,7,13,13,0.21629505796526263,0.5651532747296356
금리인하기대심리반영,-1,-0.4466176554251263,20,7,13,19,0.21629505796526263,0.5651532747296356
자산매입줄이,-1,-0.4466176554251263,20,7,13,21,0.21629505796526263,0.5651532747296356
국채가격상승폭제한,-1,-0.4466176554251263,20,7,13,12,0.21629505796526263,0.5651532747296356
비용낮추,-1,-0.4466176554251263,20,7,13,9,0.21629505796526263,0.5651532747296356
소매판매상승,-1,-0.4466176554251263,20,7,13,17,0.21629505796526263,0.5651532747296356
수입물가하락,-1,-0.4466176554251263,20,7,13,29,0.21629505796526263,0.5651532747296356
금리상승추세,-1,-0.4466176554251263,20,7,13,14,0.21629505796526263,0.5651532747296356
가계부채증가따른,-1,-0.4466176554251263,20,7,13,18,0.21629505796526263,0.5651532747296356
달러강세불구하,-1,-0.4466176554251263,20,7,13,12,0.21629505796526263,0.5651532747296356
금리내려왔,-1,-0.4466176554251263,20,7,13,12,0.21629505796526263,0.5651532747296356
금융안정유의,-1,-0.44791996290876557,69,25,44,58,0.2538097237914942,0.6653365915103688
국채가격하락,-1,-0.45078399549086734,153,57,96,86,0.296171523436098,0.7819739645082053
소비자물가올라,-1,-0.45213437810552204,34,12,22,20,0.22541027291046614,0.5971663215924862
달러강세심화,-1,-0.459622705708267,23,8,15,29,0.21246937581425887,0.5736215356742628
달러화상승압력가했,-1,-0.459622705708267,23,8,15,15,0.21246937581425887,0.5736215356742628
금융시장변동성커질,-1,-0.459622705708267,23,8,15,26,0.21246937581425887,0.5736215356742628
엔화떨어졌,-1,-0.459622705708267,23,8,15,15,0.21246937581425887,0.5736215356742628
기대수익률낮,-1,-0.459622705708267,23,8,15,20,0.21246937581425887,0.5736215356742628
안전자산선호심리부각,-1,-0.459622705708267,23,8,15,17,0.21246937581425887,0.5736215356742628
달러화가치떨어질,-1,-0.459622705708267,23,8,15,7,0.21246937581425887,0.5736215356742628
재정지출확대따른,-1,-0.459622705708267,23,8,15,6,0.21246937581425887,0.5736215356742628
매출줄,-1,-0.459622705708267,23,8,15,19,0.21246937581425887,0.5736215356742628
기준금리인하쉽,-1,-0.459622705708267,23,8,15,14,0.21246937581425887,0.5736215356742628
부채늘,-1,-0.459622705708267,23,8,15,15,0.21246937581425887,0.5736215356742628
금리인하그칠,-1,-0.459622705708267,23,8,15,11,0.21246937581425887,0.5736215356742628
채권시장안정,-1,-0.4622250148796082,37,13,24,26,0.22266130823598423,0.6051218071772887
불안완화,-1,-0.4624849852341323,48,17,31,55,0.23098264110288683,0.6281516116749047
신규실업수당청구감소,-1,-0.4658572933264845,59,21,38,73,0.2371371195444802,0.6504542245271655
매출감소,-1,-0.4686895945195759,86,31,55,67,0.2529849048768909,0.6989688649874296
경제회복위해,-1,-0.47047025669652176,26,9,17,22,0.2096294121573551,0.581833622513968
서부텍사스산원유가격상승,-1,-0.47047025669652176,26,9,17,26,0.2096294121573551,0.581833622513968
기준금리인상가시화,-1,-0.47047025669652176,26,9,17,15,0.2096294121573551,0.581833622513968
높금리제공,-1,-0.47064072071301566,51,18,33,45,0.22890313689653932,0.6356066543741321
불안심리확대,-1,-0.47124664744908773,40,14,26,38,0.22038299636487807,0.6129016519191314
gdp성장,-1,-0.47316043332648816,62,22,40,55,0.23527799696005758,0.6575555530029417
금리끌어올리,-1,-0.4793993716120829,43,15,28,33,0.21847520545762864,0.6205252395515447
미국채금리급락,-1,-0.4793993716120829,43,15,28,32,0.21847520545762864,0.6205252395515447
금융위기수준회복,-1,-0.4793993716120829,43,15,28,47,0.21847520545762864,0.6205252395515447
달러약세부추기,-1,-0.4797871016327079,29,10,19,20,0.2074654263524998,0.5898481520444387
억제위해금리인상,-1,-0.4797871016327079,29,10,19,11,0.2074654263524998,0.5898481520444387
재무안정성개선,-1,-0.4797871016327079,29,10,19,25,0.2074654263524998,0.5898481520444387
주택시장회복,-1,-0.48796952090466184,32,11,21,18,0.2057843455213913,0.5976996255576701
재정지출늘리,-1,-0.48796952090466184,32,11,21,11,0.2057843455213913,0.5976996255576701
달러강세나타나,-1,-0.48796952090466184,32,11,21,40,0.2057843455213913,0.5976996255576701
경기침체이어질,-1,-0.48796952090466184,32,11,21,10,0.2057843455213913,0.5976996255576701
물가전망하향조정,-1,-0.48796952090466184,32,11,21,42,0.2057843455213913,0.5976996255576701
스왑베이시스확대,-1,-0.4890557890605838,138,50,88,91,0.26672151056751187,0.7769041194082099
기준금리동결결정,-1,-0.4915743131160437,60,21,39,53,0.22411174953169125,0.6571321122290303
금리변동성확대,-1,-0.49366874013708417,117,42,75,99,0.254909150160352,0.7515789133806002
하방위험커졌,-1,-0.4952806022086853,35,12,23,23,0.20445964758831853,0.6054093352246444
경기회복기대높,-1,-0.4952806022086853,35,12,23,30,0.20445964758831853,0.6054093352246444
금리인하이,-1,-0.4952806022086853,35,12,23,31,0.20445964758831853,0.6054093352246444
유동성확보위한,-1,-0.4952806022086853,35,12,23,13,0.20445964758831853,0.6054093352246444
금리상승세보이,-1,-0.5079639659149523,41,14,27,40,0.20255951851460927,0.6204531232988644
양적완화가능성시사,-1,-0.5090684934183936,15,5,10,12,0.1821916521177574,0.5597295056279635
성장둔화인한,-1,-0.5090684934183936,15,5,10,1,0.1821916521177574,0.5597295056279635
지급준비율낮추,-1,-0.5090684934183936,15,5,10,15,0.1821916521177574,0.5597295056279635
달러화벗어나,-1,-0.5090684934183936,15,5,10,12,0.1821916521177574,0.5597295056279635
성장무게두,-1,-0.5090684934183936,15,5,10,5,0.1821916521177574,0.5597295056279635
달러화밑돌,-1,-0.5090684934183936,15,5,10,5,0.1821916521177574,0.5597295056279635
신용위험확대,-1,-0.5090684934183936,15,5,10,11,0.1821916521177574,0.5597295056279635
채권시장강세견인,-1,-0.5090684934183936,15,5,10,21,0.1821916521177574,0.5597295056279635
유동성감소,-1,-0.5090684934183936,15,5,10,15,0.1821916521177574,0.5597295056279635
물가상승확대,-1,-0.5090684934183936,15,5,10,3,0.1821916521177574,0.5597295056279635
가능성장물가안정,-1,-0.5090684934183936,15,5,10,3,0.1821916521177574,0.5597295056279635
유가하락인한,-1,-0.5090684934183936,15,5,10,31,0.1821916521177574,0.5597295056279635
물가안정달성,-1,-0.5090684934183936,15,5,10,13,0.1821916521177574,0.5597295056279635
하방위험커,-1,-0.5090684934183936,15,5,10,12,0.1821916521177574,0.5597295056279635
단기물금리오르,-1,-0.5090684934183936,15,5,10,15,0.1821916521177574,0.5597295056279635
증시하락압력받,-1,-0.5090684934183936,15,5,10,5,0.1821916521177574,0.5597295056279635
채권시장강세요인작용,-1,-0.5090684934183936,15,5,10,16,0.1821916521177574,0.5597295056279635
금리내려가,-1,-0.5107833974226739,148,53,95,107,0.2573732487058507,0.794374303911643
경기악화,-1,-0.5108933193111269,121,43,78,88,0.2466306327077622,0.7614439334701864
주택가격떨어지,-1,-0.5132927207108464,18,6,12,14,0.18263840573508844,0.5675532671027657
성장둔화따른,-1,-0.5132927207108464,18,6,12,12,0.18263840573508844,0.5675532671027657
원화강세베팅하,-1,-0.5132927207108464,18,6,12,11,0.18263840573508844,0.5675532671027657
경기둔화우려완화,-1,-0.5132927207108464,18,6,12,19,0.18263840573508844,0.5675532671027657
달러화올라,-1,-0.5132927207108464,18,6,12,15,0.18263840573508844,0.5675532671027657
투자늘어난,-1,-0.5132927207108464,18,6,12,10,0.18263840573508844,0.5675532671027657
생산자물가오르,-1,-0.5132927207108464,18,6,12,5,0.18263840573508844,0.5675532671027657
미국채하락,-1,-0.5132927207108464,18,6,12,15,0.18263840573508844,0.5675532671027657
인플레이션확대,-1,-0.5132927207108464,18,6,12,7,0.18263840573508844,0.5675532671027657
금리인하검토,-1,-0.5132927207108464,18,6,12,16,0.18263840573508844,0.5675532671027657
저성장고착화,-1,-0.5132927207108464,18,6,12,27,0.18263840573508844,0.5675532671027657
금리인하나선,-1,-0.5132927207108464,18,6,12,28,0.18263840573508844,0.5675532671027657
crs금리급락,-1,-0.5135615764783585,44,15,29,13,0.20187901618327778,0.6278019718550962
금리인상예고,-1,-0.5164613630598833,61,21,40,57,0.21168987813842569,0.6635260210507642
경제성장률유지,-1,-0.5173945065302648,21,7,14,14,0.18307908217448565,0.5753103141656799
금리인상속도완만할,-1,-0.5173945065302648,21,7,14,38,0.18307908217448565,0.5753103141656799
낙찰금리높형성,-1,-0.5173945065302648,21,7,14,12,0.18307908217448565,0.5753103141656799
고용지표밑돌,-1,-0.5173945065302648,21,7,14,10,0.18307908217448565,0.5753103141656799
경기부양책필요,-1,-0.5173945065302648,21,7,14,17,0.18307908217448565,0.5753103141656799
유로화반락,-1,-0.5173945065302648,21,7,14,7,0.18307908217448565,0.5753103141656799
높실업률낮,-1,-0.5173945065302648,21,7,14,8,0.18307908217448565,0.5753103141656799
경쟁력강화위해,-1,-0.5173945065302648,21,7,14,11,0.18307908217448565,0.5753103141656799
공적자금투입,-1,-0.5212945872141651,64,22,42,35,0.21103627772541508,0.670281342364899
금리상승압력커질,-1,-0.5213770500406368,24,8,16,29,0.18351375018210087,0.5829978276050697
주택판매감소,-1,-0.5213770500406368,24,8,16,18,0.18351375018210087,0.5829978276050697
국채수익률오를,-1,-0.5213770500406368,24,8,16,17,0.18351375018210087,0.5829978276050697
단기금리급등,-1,-0.5213770500406368,24,8,16,29,0.18351375018210087,0.5829978276050697
손실줄이,-1,-0.5213770500406368,24,8,16,17,0.18351375018210087,0.5829978276050697
저축늘리,-1,-0.5213770500406368,24,8,16,15,0.18351375018210087,0.5829978276050697
신규주택판매증가,-1,-0.5213770500406368,24,8,16,26,0.18351375018210087,0.5829978276050697
소비자물가상승률물가안정목표유지,-1,-0.5213770500406368,24,8,16,29,0.18351375018210087,0.5829978276050697
자금사정개선,-1,-0.5213770500406368,24,8,16,17,0.18351375018210087,0.5829978276050697
원화강세보이,-1,-0.5236352101834766,50,17,33,49,0.20088964956390135,0.6421738667744328
금리상승막,-1,-0.525243483784525,27,9,18,20,0.18394247827447485,0.5906131187775748
무역수지적자확대,-1,-0.525243483784525,27,9,18,24,0.18394247827447485,0.5906131187775748
경기부양책나올,-1,-0.5289968732610062,30,10,20,17,0.1843653347115175,0.5981536300261273
달러화낙폭확대,-1,-0.5289968732610062,30,10,20,29,0.1843653347115175,0.5981536300261273
기준금리인하통해,-1,-0.5289968732610062,30,10,20,21,0.1843653347115175,0.5981536300261273
달러원급락,-1,-0.5325259794990334,56,19,37,47,0.2002568319208788,0.6561246147298889
주택담보대출금리상승,-1,-0.5325259794990334,56,19,37,23,0.2002568319208788,0.6561246147298889
금리상승불구하,-1,-0.5326402167009926,33,11,22,29,0.18478238747087133,0.6056169347543872
소비늘어날,-1,-0.5326402167009926,33,11,22,19,0.18478238747087133,0.6056169347543872
대외의존도높경제,-1,-0.5326402167009926,33,11,22,23,0.18478238747087133,0.6056169347543872
수요증가따른,-1,-0.5361764450227373,36,12,24,25,0.18519370422361622,0.613000737175229
경기침체장기화,-1,-0.5396084219513304,39,13,26,36,0.18559935231127647,0.6203028717514403
금리급락따른,-1,-0.5396084219513304,39,13,26,23,0.18559935231127647,0.6203028717514403
마이너스성장,-1,-0.5425944020625146,118,41,77,71,0.22704251123434263,0.7652442550560931
국제유가반등,-1,-0.542938944286949,42,14,28,38,0.18599939872408927,0.627521302347169
금리내린,-1,-0.5459748397887365,318,113,205,241,0.264982195928252,0.9017366940539825
금리동결주장,-1,-0.5461707423075678,45,15,30,37,0.18639391008049608,0.6346541211088936
기준금리내렸,-1,-0.5467062471095769,110,38,72,71,0.22129680162611126,0.7546461083571561
이자부담덜,-1,-0.5493064802927432,48,16,32,39,0.18678295260781688,0.6416995470947966
성장세이어질,-1,-0.5523487571559558,51,17,34,22,0.18716659212407002,0.6486559246713925
경기부양책,-1,-0.5562254103835813,133,46,87,101,0.2250422594343846,0.7886934231676187
소매판매감소,-1,-0.5581630008013756,57,19,38,45,0.18791792324756781,0.6622955275044731
기준금리인하따른,-1,-0.5602890873195916,80,27,53,92,0.19959327745584207,0.7078074921581644
금리상승압력작용,-1,-0.5658350472979146,86,29,57,82,0.19967919709141457,0.7197004797812486
하방위험상존,-1,-0.5745026528998913,34,11,23,32,0.1657374213774547,0.6128989508387335
금융위기확산,-1,-0.5746674795341793,37,12,25,20,0.16758823611808207,0.6200481889072451
달러약세부추겼,-1,-0.5746674795341793,37,12,25,27,0.16758823611808207,0.6200481889072451
경제지표호조따른,-1,-0.5746674795341793,37,12,25,38,0.16758823611808207,0.6200481889072451
주택담보대출금리하락,-1,-0.5748755758248719,31,10,21,8,0.16360963979019638,0.6057041899168286
양적완화나서,-1,-0.5748755758248719,31,10,21,40,0.16360963979019638,0.6057041899168286
양적완화하,-1,-0.5748755758248719,31,10,21,24,0.16360963979019638,0.6057041899168286
실업률높수준,-1,-0.5752283478981094,40,13,27,40,0.16922201046478463,0.6271422990782762
침체빠져,-1,-0.5759895636984814,28,9,19,12,0.16112007988072596,0.5984765977432301
금융시장따르오,-1,-0.5759895636984814,28,9,19,21,0.16112007988072596,0.5984765977432301
gdp성장률낮,-1,-0.5759895636984814,28,9,19,13,0.16112007988072596,0.5984765977432301
채권수익률급등,-1,-0.5759895636984814,28,9,19,10,0.16112007988072596,0.5984765977432301
경제성장위해,-1,-0.5759895636984814,28,9,19,25,0.16112007988072596,0.5984765977432301
경기부양필요,-1,-0.5759895636984814,28,9,19,21,0.16112007988072596,0.5984765977432301
금리인상해도,-1,-0.5759895636984814,28,9,19,23,0.16112007988072596,0.5984765977432301
경기둔화막,-1,-0.5760837269257549,43,14,29,32,0.17068228346328226,0.6341737881705615
유로화급등,-1,-0.5771591791923212,46,15,31,32,0.1720014489413554,0.6411366603664187
고용지표호조보인,-1,-0.578146246438346,25,8,17,14,0.1581446727999457,0.5912335597984986
수입줄어들,-1,-0.578146246438346,25,8,17,19,0.1581446727999457,0.5912335597984986
적자줄이,-1,-0.578146246438346,25,8,17,16,0.1581446727999457,0.5912335597984986
엔화유로화상승,-1,-0.578146246438346,25,8,17,25,0.1581446727999457,0.5912335597984986
서부텍사스산원유가격떨어진,-1,-0.578146246438346,25,8,17,13,0.1581446727999457,0.5912335597984986
성장계속,-1,-0.578146246438346,25,8,17,13,0.1581446727999457,0.5912335597984986
채권가격떨어졌,-1,-0.578146246438346,25,8,17,20,0.1581446727999457,0.5912335597984986
금리인하있,-1,-0.5783990665767522,49,16,33,26,0.17320410837877973,0.6480260165227858
금리상승이끌,-1,-0.5783990665767522,49,16,33,34,0.17320410837877973,0.6480260165227858
물가상승률목표달성,-1,-0.5818119006554787,22,7,15,10,0.15449452120713428,0.5839999294106054
수익줄,-1,-0.5818119006554787,22,7,15,18,0.15449452120713428,0.5839999294106054
물가올라,-1,-0.5818119006554787,22,7,15,27,0.15449452120713428,0.5839999294106054
채권시장국고하락,-1,-0.5818119006554787,22,7,15,24,0.15449452120713428,0.5839999294106054
금리인상전망따른,-1,-0.5818119006554787,22,7,15,23,0.15449452120713428,0.5839999294106054
경기하강위험여전하,-1,-0.5818119006554787,22,7,15,3,0.15449452120713428,0.5839999294106054
설비투자늘어나,-1,-0.5818119006554787,22,7,15,16,0.15449452120713428,0.5839999294106054
기준금리떨어지,-1,-0.5818119006554787,22,7,15,22,0.15449452120713428,0.5839999294106054
기준금리내리,-1,-0.5845947160475453,269,93,176,177,0.23593250562470347,0.8993908729963758
성장그쳤,-1,-0.587745428192908,19,6,13,15,0.14986752540269643,0.5768130807539642
금리인하여력있,-1,-0.587745428192908,19,6,13,10,0.14986752540269643,0.5768130807539642
대출규제완화,-1,-0.587745428192908,19,6,13,8,0.14986752540269643,0.5768130807539642
성장이어질,-1,-0.587745428192908,19,6,13,11,0.14986752540269643,0.5768130807539642
금리우호적작용,-1,-0.5972663173622248,16,5,11,11,0.14374968101261965,0.5697327293397443
환율하락인한,-1,-0.5972663173622248,16,5,11,15,0.14374968101261965,0.5697327293397443
채권금리끌어내리,-1,-0.5972663173622248,16,5,11,9,0.14374968101261965,0.5697327293397443
경제성장률그칠,-1,-0.5972663173622248,16,5,11,9,0.14374968101261965,0.5697327293397443
소비늘릴,-1,-0.5972663173622248,16,5,11,14,0.14374968101261965,0.5697327293397443
원화강세막,-1,-0.5972663173622248,16,5,11,16,0.14374968101261965,0.5697327293397443
인플레이션상회,-1,-0.5972663173622248,16,5,11,5,0.14374968101261965,0.5697327293397443
경기부양책고려,-1,-0.5972663173622248,16,5,11,4,0.14374968101261965,0.5697327293397443
국채선물올랐,-1,-0.5972663173622248,16,5,11,10,0.14374968101261965,0.5697327293397443
국채선물올라,-1,-0.5972663173622248,16,5,11,21,0.14374968101261965,0.5697327293397443
신용등급낮회사채,-1,-0.5972663173622248,16,5,11,10,0.14374968101261965,0.5697327293397443
완화정책나올,-1,-0.5972663173622248,16,5,11,7,0.14374968101261965,0.5697327293397443
소득줄,-1,-0.5972663173622248,16,5,11,17,0.14374968101261965,0.5697327293397443
기준금리떨어질,-1,-0.5972663173622248,16,5,11,6,0.14374968101261965,0.5697327293397443
유로화강세지지받,-1,-0.5972663173622248,16,5,11,13,0.14374968101261965,0.5697327293397443
경제지표상회,-1,-0.5972663173622248,16,5,11,7,0.14374968101261965,0.5697327293397443
지급준비율내리,-1,-0.5972663173622248,16,5,11,11,0.14374968101261965,0.5697327293397443
수출의존도높경제,-1,-0.5972663173622248,16,5,11,15,0.14374968101261965,0.5697327293397443
금리인하반대,-1,-0.5972663173622248,16,5,11,17,0.14374968101261965,0.5697327293397443
수출증가율높,-1,-0.5972663173622248,16,5,11,16,0.14374968101261965,0.5697327293397443
모기지금리낮추,-1,-0.5972663173622248,16,5,11,4,0.14374968101261965,0.5697327293397443
경기회복세뒷받침,-1,-0.5972663173622248,16,5,11,7,0.14374968101261965,0.5697327293397443
채권시장강세보이,-1,-0.6060109887424169,50,16,34,35,0.1605665131421034,0.6540595523405934
금가격상승,-1,-0.6060109887424169,50,16,34,41,0.1605665131421034,0.6540595523405934
장기물금리상승,-1,-0.6072118031962317,65,21,44,41,0.16794930190165122,0.6867360040110536
높금리,-1,-0.6073423623081108,44,14,30,25,0.1565689492879555,0.640467063973097
가계부채늘,-1,-0.6134266488507327,35,11,24,40,0.14857382383937612,0.6196569990424158
시장금리떨어지,-1,-0.6172449600290448,32,10,22,17,0.14509945501275126,0.6126453570721839
성장도모,-1,-0.6172449600290448,32,10,22,16,0.14509945501275126,0.6126453570721839
달러화하락압력가할,-1,-0.6172449600290448,32,10,22,24,0.14509945501275126,0.6126453570721839
금리인하압박,-1,-0.6224588014347312,29,9,20,32,0.1410284523477292,0.605619676693739
금리상승커졌,-1,-0.6224588014347312,29,9,20,10,0.1410284523477292,0.605619676693739
경제지표둔화,-1,-0.628590164361048,60,19,41,51,0.15505484259131253,0.6793946430501957
경제주체심리개선,-1,-0.6295705209951864,26,8,18,8,0.1361733899100265,0.5986008690497582
금리인하적극적,-1,-0.6295705209951864,26,8,18,12,0.1361733899100265,0.5986008690497582
시장금리상승따른,-1,-0.6295705209951864,26,8,18,23,0.1361733899100265,0.5986008690497582
금리인하위한,-1,-0.6295705209951864,26,8,18,12,0.1361733899100265,0.5986008690497582
금리인하불구하,-1,-0.6301317449481045,96,31,65,46,0.17027998336223654,0.7499221868002429
차입금증가,-1,-0.6341879434513473,117,38,79,81,0.1758020197863636,0.7847675068694047
유가높수준,-1,-0.639332896626365,23,7,16,11,0.13026031446710246,0.5916174555666646
gdp갭마이너스,-1,-0.639332896626365,23,7,16,20,0.13026031446710246,0.5916174555666646
금리인하이어질,-1,-0.639332896626365,23,7,16,11,0.13026031446710246,0.5916174555666646
성장모멘텀약화,-1,-0.639332896626365,23,7,16,21,0.13026031446710246,0.5916174555666646
임금오르,-1,-0.6399583490964738,42,13,29,19,0.14054263620815746,0.6396697233590989
지급준비율인하,-1,-0.6436992569900144,94,30,64,58,0.16249149068477547,0.7490316930567906
국채수익률급등,-1,-0.6441048241364911,39,12,27,28,0.13709621690859822,0.6328436247007525
금융시장안정위해,-1,-0.645386989001822,73,23,50,32,0.15299555397532252,0.7093400077863046
채권매수심리위축,-1,-0.6461607121373935,70,22,48,49,0.1512921932779587,0.7033057564945465
인플레이션위험남,-1,-0.6493619652178362,36,11,25,5,0.1331819127170043,0.6259799351227917
환율방어위해,-1,-0.6493619652178362,36,11,25,38,0.1331819127170043,0.6259799351227917
높금리주,-1,-0.6517374304805028,58,18,40,38,0.14313641754987508,0.6783285710444193
위축투자심리회복,-1,-0.6529213038051264,20,6,14,11,0.12287439740994978,0.5847094859111912
시스템리스크확산,-1,-0.6529213038051264,20,6,14,5,0.12287439740994978,0.5847094859111912
차입금늘,-1,-0.6529213038051264,20,6,14,15,0.12287439740994978,0.5847094859111912
주택판매증가,-1,-0.6529213038051264,20,6,14,15,0.12287439740994978,0.5847094859111912
유동성함정빠지,-1,-0.6529213038051264,20,6,14,5,0.12287439740994978,0.5847094859111912
일자리늘어나,-1,-0.6529213038051264,20,6,14,18,0.12287439740994978,0.5847094859111912
수출부진따른,-1,-0.6529213038051264,20,6,14,17,0.12287439740994978,0.5847094859111912
달러강세일시적,-1,-0.6529213038051264,20,6,14,0,0.12287439740994978,0.5847094859111912
금융시장충격줄,-1,-0.6529213038051264,20,6,14,23,0.12287439740994978,0.5847094859111912
금리하락압력,-1,-0.6529213038051264,20,6,14,19,0.12287439740994978,0.5847094859111912
인플레이션기대억제,-1,-0.6529213038051264,20,6,14,14,0.12287439740994978,0.5847094859111912
수출증가세둔화,-1,-0.6560421810822732,33,10,23,21,0.12868763563969937,0.6190906530789286
수요늘리,-1,-0.6560421810822732,33,10,23,26,0.12868763563969937,0.6190906530789286
고용자수증가,-1,-0.6581901569682913,89,28,61,55,0.1532117689844723,0.7426613202945632
경제전망하향조정,-1,-0.664132221494508,46,14,32,42,0.1317318905123129,0.6521579441832452
경기상승세이,-1,-0.664574450468975,30,9,21,6,0.12346327741883725,0.6121907552464991
변동성완화,-1,-0.664574450468975,30,9,21,46,0.12346327741883725,0.6121907552464991
달러화가치급락,-1,-0.664574450468975,30,9,21,22,0.12346327741883725,0.6121907552464991
실업률상승,-1,-0.6671971641856569,117,37,80,82,0.15819187166895426,0.7918137248372564
양적완화시행,-1,-0.6682025855492575,108,34,74,84,0.15482001038099855,0.7777511321649557
고성장종목종목수매매보,-1,-0.6722624898496894,17,5,12,1,0.11336200164646573,0.5779348196100851
성장보,-1,-0.6722624898496894,17,5,12,7,0.11336200164646573,0.5779348196100851
금리내린다고,-1,-0.6722624898496894,17,5,12,17,0.11336200164646573,0.5779348196100851
유가강세보였,-1,-0.6722624898496894,17,5,12,5,0.11336200164646573,0.5779348196100851
상품가격하락,-1,-0.6722624898496894,17,5,12,15,0.11336200164646573,0.5779348196100851
내수부진심화,-1,-0.6722624898496894,17,5,12,3,0.11336200164646573,0.5779348196100851
대출강화,-1,-0.6722624898496894,17,5,12,16,0.11336200164646573,0.5779348196100851
금리인하기대커지,-1,-0.6722624898496894,17,5,12,24,0.11336200164646573,0.5779348196100851
고용지표오,-1,-0.6722624898496894,17,5,12,2,0.11336200164646573,0.5779348196100851
금리하락요인,-1,-0.6722624898496894,17,5,12,11,0.11336200164646573,0.5779348196100851
성장중요,-1,-0.6722624898496894,17,5,12,11,0.11336200164646573,0.5779348196100851
가계부채늘어날,-1,-0.6722624898496894,17,5,12,24,0.11336200164646573,0.5779348196100851
제공적합한회원투자안정적수익,-1,-0.6722624898496894,17,5,12,1,0.11336200164646573,0.5779348196100851
채권시장확산,-1,-0.6722624898496894,17,5,12,11,0.11336200164646573,0.5779348196100851
수출감소세확대,-1,-0.6722624898496894,17,5,12,4,0.11336200164646573,0.5779348196100851
침체빠졌,-1,-0.6722624898496894,17,5,12,14,0.11336200164646573,0.5779348196100851
물가상승압력거세,-1,-0.6722624898496894,17,5,12,8,0.11336200164646573,0.5779348196100851
하방경직성유지,-1,-0.6728473901261353,59,18,41,42,0.1337879734472264,0.6835265333408319
달러화약세보일,-1,-0.675023728336398,40,12,28,28,0.12402571851216888,0.6387204922472057
수출줄,-1,-0.6823303845613695,37,11,26,46,0.11943146143506846,0.6319390885061512
물가안정목표달성,-1,-0.6898710231781783,24,7,17,11,0.10992543620740595,0.5984400129578856
물가안정목표하회,-1,-0.6898710231781783,24,7,17,17,0.10992543620740595,0.5984400129578856
금리인하실시,-1,-0.6898710231781783,24,7,17,46,0.10992543620740595,0.5984400129578856
경기후퇴따른,-1,-0.6898710231781783,24,7,17,11,0.10992543620740595,0.5984400129578856
소비자심리지수하락,-1,-0.6913067746857782,34,10,24,29,0.11419976450322267,0.6251292523136993
인플레이션압력높이,-1,-0.6913067746857782,34,10,24,14,0.11419976450322267,0.6251292523136993
만장일치기준금리동결,-1,-0.6913067746857782,34,10,24,65,0.11419976450322267,0.6251292523136993
베이시스확대,-1,-0.695987547604962,44,13,31,36,0.11680075845997116,0.6509985006914588
금리상승압력받,-1,-0.7003060867926401,70,21,49,80,0.12556570126591735,0.7117332933143545
변동성장세,-1,-0.7024099511477251,31,9,22,21,0.1081836879682563,0.6183033848672573
기준금리인하가능,-1,-0.7024099511477251,31,9,22,22,0.1081836879682563,0.6183033848672573
기준금리내린,-1,-0.7079989840909637,146,45,101,125,0.14391279680997873,0.8409857886905402
유로달러급락,-1,-0.7087866218982344,21,6,15,17,0.10092510397123416,0.5916441168088747
재무구조개선위해,-1,-0.7087866218982344,21,6,15,17,0.10092510397123416,0.5916441168088747
기준금리인하있,-1,-0.7087866218982344,21,6,15,15,0.10092510397123416,0.5916441168088747
소비자물가높상승률,-1,-0.7087866218982344,21,6,15,13,0.10092510397123416,0.5916441168088747
적자축소,-1,-0.7087866218982344,21,6,15,10,0.10092510397123416,0.5916441168088747
달러약세요인작용,-1,-0.7087866218982344,21,6,15,15,0.10092510397123416,0.5916441168088747
부채비율상승,-1,-0.7087866218982344,21,6,15,21,0.10092510397123416,0.5916441168088747
재할인율인상,-1,-0.7162589468419462,28,8,20,32,0.10119182847272665,0.6114761603591072
달러인덱스상승,-1,-0.7231607334976663,35,10,25,50,0.10145022003235765,0.6308316658367644
금리인하가능성열려,-1,-0.7231607334976663,35,10,25,25,0.10145022003235765,0.6308316658367644
내수위축,-1,-0.7244344327315337,65,19,46,35,0.1126641811282373,0.7043165479559422
경기둔화대응,-1,-0.7337026750925884,25,7,18,25,0.0929741760511546,0.6046646230144593
글로벌경제회복세완만할,-1,-0.7342506839712162,18,5,13,14,0.0897295770364859,0.5849500362292426
가계부채줄이,-1,-0.7342506839712162,18,5,13,18,0.0897295770364859,0.5849500362292426
금리인하보,-1,-0.7342506839712162,18,5,13,15,0.0897295770364859,0.5849500362292426
금융안정위한,-1,-0.7342506839712162,18,5,13,12,0.0897295770364859,0.5849500362292426
이자부담줄여,-1,-0.7342506839712162,18,5,13,15,0.0897295770364859,0.5849500362292426
금리인하동참,-1,-0.7342506839712162,18,5,13,17,0.0897295770364859,0.5849500362292426
기준금리인하실시,-1,-0.7342506839712162,18,5,13,17,0.0897295770364859,0.5849500362292426
금리인하반영,-1,-0.7347135049704236,59,17,42,57,0.10593390128902865,0.6919746606372661
금리인하가능성제기,-1,-0.7397387862552116,39,11,28,25,0.09629264412971582,0.6429854764258728
고용지표호조보일,-1,-0.7517864855392637,36,10,26,18,0.09025364639163991,0.6362539939966292
수출위축,-1,-0.7517864855392637,36,10,26,27,0.09025364639163991,0.6362539939966292
국고채스프레드확대,-1,-0.7559121774750294,22,6,16,20,0.08320729437399639,0.59788758990788
달러강세반영,-1,-0.7559121774750294,22,6,16,23,0.08320729437399639,0.59788758990788
금리인하포함,-1,-0.7559121774750294,22,6,16,14,0.08320729437399639,0.59788758990788
경제불확실성커지,-1,-0.7559121774750294,22,6,16,15,0.08320729437399639,0.59788758990788
물가올랐,-1,-0.7660782330325939,33,9,24,14,0.08347691642462066,0.6294841480434932
성장전망,-1,-0.7660782330325939,33,9,24,30,0.08347691642462066,0.6294841480434932
유동성확보위해,-1,-0.7660782330325939,33,9,24,20,0.08347691642462066,0.6294841480434932
경기지표둔화,-1,-0.7692303454155934,15,4,11,9,0.07553572481603399,0.5784020800006124
흑자행진이,-1,-0.7692303454155934,15,4,11,11,0.07553572481603399,0.5784020800006124
소비자물가상승률머물,-1,-0.7692303454155934,15,4,11,12,0.07553572481603399,0.5784020800006124
수요개선,-1,-0.7692303454155934,15,4,11,12,0.07553572481603399,0.5784020800006124
국채선물시장상승,-1,-0.7692303454155934,15,4,11,9,0.07553572481603399,0.5784020800006124
성장하방위험높,-1,-0.7692303454155934,15,4,11,6,0.07553572481603399,0.5784020800006124
내수부양위한,-1,-0.7692303454155934,15,4,11,14,0.07553572481603399,0.5784020800006124
높유지인플레이션기대심리,-1,-0.7692303454155934,15,4,11,10,0.07553572481603399,0.5784020800006124
양적완화나올,-1,-0.7692303454155934,15,4,11,12,0.07553572481603399,0.5784020800006124
국고지표금리낮,-1,-0.7692303454155934,15,4,11,4,0.07553572481603399,0.5784020800006124
원달러오른,-1,-0.7692303454155934,15,4,11,21,0.07553572481603399,0.5784020800006124
기준금리인상기대높,-1,-0.7692303454155934,15,4,11,17,0.07553572481603399,0.5784020800006124
유로화올라,-1,-0.7692303454155934,15,4,11,11,0.07553572481603399,0.5784020800006124
고용유지,-1,-0.7692303454155934,15,4,11,13,0.07553572481603399,0.5784020800006124
금융시장악화,-1,-0.7692303454155934,15,4,11,16,0.07553572481603399,0.5784020800006124
금리인하직접적,-1,-0.7692303454155934,15,4,11,5,0.07553572481603399,0.5784020800006124
양적완화이,-1,-0.7692303454155934,15,4,11,16,0.07553572481603399,0.5784020800006124
물가상승률최고치,-1,-0.7692303454155934,15,4,11,6,0.07553572481603399,0.5784020800006124
인플레이션우려있,-1,-0.7692303454155934,15,4,11,12,0.07553572481603399,0.5784020800006124
물가압력높,-1,-0.7692303454155934,15,4,11,15,0.07553572481603399,0.5784020800006124
금리내린다면,-1,-0.7692303454155934,15,4,11,12,0.07553572481603399,0.5784020800006124
금리끌어내리,-1,-0.7744569563251907,51,14,37,44,0.0862390670322268,0.6776403211934396
금리인하전망,-1,-0.7831048661480128,30,8,22,20,0.07584060969437924,0.6226813550026508
시중금리떨어지,-1,-0.7844831305004563,19,5,14,10,0.07148959143334842,0.5911630225661991
재무구조개선위한,-1,-0.7844831305004563,19,5,14,9,0.07148959143334842,0.5911630225661991
기준금리한인상,-1,-0.7844831305004563,19,5,14,4,0.07148959143334842,0.5911630225661991
고용지표양호,-1,-0.7844831305004563,19,5,14,29,0.07148959143334842,0.5911630225661991
물가상승률유지,-1,-0.7844831305004563,19,5,14,22,0.07148959143334842,0.5911630225661991
침체심화,-1,-0.7844831305004563,19,5,14,4,0.07148959143334842,0.5911630225661991
기준금리인상위한,-1,-0.7952214950250491,23,6,17,42,0.06894950025684365,0.6036254413313766
원달러급락,-1,-0.7952214950250491,23,6,17,15,0.06894950025684365,0.6036254413313766
인플레이션압력커질,-1,-0.7952214950250491,23,6,17,13,0.06894950025684365,0.6036254413313766
경기침체가능성높,-1,-0.7952214950250491,23,6,17,6,0.06894950025684365,0.6036254413313766
지정학적리스크확대,-1,-0.803453094644822,27,7,20,25,0.06721383064934762,0.6158491961444403
경기위축의미,-1,-0.803453094644822,27,7,20,8,0.06721383064934762,0.6158491961444403
수요증가힘입,-1,-0.803453094644822,27,7,20,20,0.06721383064934762,0.6158491961444403
주택가격하락따른,-1,-0.803453094644822,27,7,20,18,0.06721383064934762,0.6158491961444403
성장세회복지원,-1,-0.8206078738875593,39,10,29,17,0.06427127317841959,0.6512474523535993
리보금리상승,-1,-0.8214510247527521,16,4,12,6,0.05738671576837693,0.5844997137176975
저평가확대,-1,-0.8214510247527521,16,4,12,4,0.05738671576837693,0.5844997137176975
원유수요감소,-1,-0.8214510247527521,16,4,12,8,0.05738671576837693,0.5844997137176975
경기부양책나오,-1,-0.8214510247527521,16,4,12,14,0.05738671576837693,0.5844997137176975
기준금리밑도,-1,-0.8214510247527521,16,4,12,12,0.05738671576837693,0.5844997137176975
금리인하나섰,-1,-0.8214510247527521,16,4,12,16,0.05738671576837693,0.5844997137176975
기준금리지급준비율인하,-1,-0.8214510247527521,16,4,12,15,0.05738671576837693,0.5844997137176975
인플레이션위험낮,-1,-0.8214510247527521,16,4,12,9,0.05738671576837693,0.5844997137176975
높이자주,-1,-0.8214510247527521,16,4,12,7,0.05738671576837693,0.5844997137176975
환율변동성커지,-1,-0.8214510247527521,16,4,12,32,0.05738671576837693,0.5844997137176975
기대심리줄어든,-1,-0.8214510247527521,16,4,12,11,0.05738671576837693,0.5844997137176975
잠재성장률하회,-1,-0.8246933723756376,20,5,15,13,0.05743179638304102,0.5968205570982175
경기회복지연따른,-1,-0.8246933723756376,20,5,15,4,0.05743179638304102,0.5968205570982175
채권시장강세이어질,-1,-0.8277775364481782,24,6,18,22,0.05747611511261792,0.6089869094240227
금리밑돌,-1,-0.8277775364481782,24,6,18,26,0.05747611511261792,0.6089869094240227
엔화유로화하락,-1,-0.8277775364481782,24,6,18,32,0.05747611511261792,0.6089869094240227
경쟁력강화,-1,-0.8330961629603935,66,17,49,52,0.06588334550238147,0.7223678383807309
금리인상가능성없,-1,-0.8540648309105602,37,9,28,14,0.051192510590434254,0.649123593918007
부채부담높,-1,-0.8546373857862191,25,6,19,13,0.04822300238937478,0.6140633368134497
변동성확대따른,-1,-0.8607913173803599,17,4,13,12,0.04422914833896858,0.5900033688246764
유가급등인해,-1,-0.8607913173803599,17,4,13,3,0.04422914833896858,0.5900033688246764
금융위기해소,-1,-0.8607913173803599,17,4,13,12,0.04422914833896858,0.5900033688246764
금리인상이루어질,-1,-0.8607913173803599,17,4,13,12,0.04422914833896858,0.5900033688246764
달러화절상,-1,-0.8607913173803599,17,4,13,16,0.04422914833896858,0.5900033688246764
글로벌경제완만한회복세,-1,-0.8607913173803599,17,4,13,26,0.04422914833896858,0.5900033688246764
가계부채늘리,-1,-0.8607913173803599,17,4,13,13,0.04422914833896858,0.5900033688246764
재정확대,-1,-0.8607913173803599,17,4,13,12,0.04422914833896858,0.5900033688246764
금리하락베팅하,-1,-0.8607913173803599,17,4,13,13,0.04422914833896858,0.5900033688246764
경기침체대응,-1,-0.8607913173803599,17,4,13,11,0.04422914833896858,0.5900033688246764
침체막,-1,-0.8767700897731985,26,6,20,12,0.04073255708851032,0.6189201545938189
성장세보여,-1,-0.882082633187579,22,5,17,28,0.03812594078294455,0.6070629932566207
이익늘어나,-1,-0.882082633187579,22,5,17,10,0.03812594078294455,0.6070629932566207
경상수지흑자줄어들,-1,-0.8903554903133263,18,4,14,19,0.034607534135554605,0.5951130872883298
금리인상우려부각,-1,-0.8903554903133263,18,4,14,21,0.034607534135554605,0.5951130872883298
달러강세진정,-1,-0.8903554903133263,18,4,14,16,0.034607534135554605,0.5951130872883298
발행시장위축,-1,-0.8903554903133263,18,4,14,11,0.034607534135554605,0.5951130872883298
금리인상끝나,-1,-0.8903554903133263,18,4,14,13,0.034607534135554605,0.5951130872883298
유가상승인해,-1,-0.8903554903133263,18,4,14,4,0.034607534135554605,0.5951130872883298
제조업상승,-1,-0.8903554903133263,18,4,14,5,0.034607534135554605,0.5951130872883298
지급준비율올린,-1,-0.8903554903133263,18,4,14,8,0.034607534135554605,0.5951130872883298
침체장기화,-1,-0.8950205582196389,27,6,21,18,0.03464002673305984,0.6236048189586918
수출증가율낮,-1,-0.9022852913769391,23,5,18,15,0.03151968854854608,0.6118298707984758
재무구조악화,-1,-0.9022852913769391,23,5,18,27,0.03151968854854608,0.6118298707984758
경기하강위험남,-1,-0.9126494379316034,19,4,15,2,0.027489461896391624,0.5999530071693343
경기회복세완만하,-1,-0.9126494379316034,19,4,15,11,0.027489461896391624,0.5999530071693343
디플레이션우려커지,-1,-0.9126494379316034,19,4,15,21,0.027489461896391624,0.5999530071693343
이중침체가능성낮,-1,-0.9276793446383961,15,3,12,16,0.022147596470785604,0.588008039123163
조달비용증가,-1,-0.9276793446383961,15,3,12,3,0.022147596470785604,0.588008039123163
국고채스프레드축소,-1,-0.9295807293745847,20,4,16,16,0.022154434204256387,0.6046021874475741
침체국면접어들,-1,-0.931354510048255,25,5,20,20,0.022161149714383672,0.6209177882865136
유가올라,-1,-0.934555894572587,35,7,28,7,0.022174223689238808,0.6526225495376142
비용감소,-1,-0.9425582748561872,21,4,17,6,0.01810144727613353,0.6091121756117399
경기회복세미약한,-1,-0.9425582748561872,21,4,17,12,0.01810144727613353,0.6091121756117399
부양책기대,-1,-0.9446143866853453,16,3,13,13,0.016967550540193638,0.5926693984247898
경제성장부정적,-1,-0.9446143866853453,16,3,13,11,0.016967550540193638,0.5926693984247898
금리인하확신,-1,-0.9446143866853453,16,3,13,11,0.016967550540193638,0.5926693984247898
기준금리인하가능성,-1,-0.9446143866853453,16,3,13,8,0.016967550540193638,0.5926693984247898
장기금리떨어지,-1,-0.9446143866853453,16,3,13,12,0.016967550540193638,0.5926693984247898
기준금리오,-1,-0.9567362812225629,17,3,14,15,0.013291367452491794,0.5971793718119245
경상수지흑자줄이,-1,-0.9567362812225629,17,3,14,6,0.013291367452491794,0.5971793718119245
원화가치떨어지,-1,-0.9604750452285037,23,4,19,14,0.01254677421907606,0.617840889868377
부도위험낮,-1,-0.9655787277068063,18,3,15,24,0.010622925508356295,0.6015835016762585
재무안정성양호한,-1,-0.9655787277068063,18,3,15,5,0.010622925508356295,0.6015835016762585
성장잠재력확충,-1,-0.9655787277068063,18,3,15,23,0.010622925508356295,0.6015835016762585
성장잠재력훼손,-1,-0.9655787277068063,18,3,15,30,0.010622925508356295,0.6015835016762585
물가억제,-1,-0.9655787277068063,18,3,15,11,0.010622925508356295,0.6015835016762585
차입금확대,-1,-0.9655787277068063,18,3,15,3,0.010622925508356295,0.6015835016762585
양적완화시사,-1,-0.9666992765394038,24,4,20,28,0.010624498322737236,0.6220990360169261
유로화달러화하락,-1,-0.9719477007493139,37,6,31,23,0.009566290825029893,0.6656408765476568
투자증가낮,-1,-0.9721499850795661,19,3,16,5,0.008644826274071744,0.6059100329236567
실업률급등,-1,-0.9747588173057744,44,7,37,9,0.008898186481135049,0.6883087040396784
기준금리인하결정,-1,-0.9771206695058137,20,3,17,21,0.007149816182878561,0.6101769697646391
경기둔화우려반영,-1,-0.9809435124678743,21,3,18,17,0.005999728912978968,0.6143960648034521
금리인하지연,-1,-0.9839291439442803,22,3,19,9,0.005100577006424838,0.6185751467876555
주택담보대출금리오르,-1,-0.9862942324627312,23,3,20,10,0.004387183582799345,0.6227195188897924
달러화엔화움직여상승,-1,-0.9876146239000122,16,2,14,8,0.0038133181189280254,0.5980521659620514
하방위험커진,-1,-0.9876146239000122,16,2,14,9,0.0038133181189280254,0.5980521659620514
건설지출증가,-1,-0.9876146239000122,16,2,14,9,0.0038133181189280254,0.5980521659620514
기준금리하향조정,-1,-0.9896569912816412,63,8,55,19,0.0040156817344737614,0.7515467367952614
불확실성증대따른,-1,-0.9898968733600116,17,2,15,11,0.0031451144052982443,0.6022778506183296
금리내려도,-1,-0.9916110574261757,18,2,16,22,0.0026423174875851315,0.6064727732819586
제조업지수하회,-1,-0.9916110574261757,18,2,16,29,0.0026423174875851315,0.6064727732819586
경제성장률상회,-1,-0.9954340969592655,22,2,20,10,0.00151555971737703,0.6230009959321806
유가반락,-1,-0.9954340969592655,22,2,20,14,0.00151555971737703,0.6230009959321806
금리정상화유지,-1,-0.9977797072942205,15,1,14,10,0.0007513483248954432,0.5983283522930605
유가폭등,-1,-0.9977797072942205,15,1,14,1,0.0007513483248954432,0.5983283522930605
경기회복국면,-1,-0.9977797072942205,15,1,14,5,0.0007513483248954432,0.5983283522930605
경기후퇴겪,-1,-0.9977797072942205,15,1,14,3,0.0007513483248954432,0.5983283522930605
주택판매가격하락,-1,-0.9980881524168721,16,1,15,7,0.0006634697752019274,0.6025045363840107
경제주체심리부진,-1,-0.9980881524168721,16,1,15,4,0.0006634697752019274,0.6025045363840107
수출증가세보이,-1,-0.9980881524168721,16,1,15,8,0.0006634697752019274,0.6025045363840107
국제유가오른,-1,-0.9983319422488807,17,1,16,6,0.0005939581240170039,0.6066622875126934
원화강세이어졌,-1,-0.9985283780334487,18,1,17,1,0.000537917917773432,0.6108016070623131
재무안정성,-1,-0.9985283780334487,18,1,17,4,0.000537917917773432,0.6108016070623131
하향조정통화정책운용,-1,-0.9999921883579544,16,0,16,2,8.98803457428563e-05,0.6067087288312291
재정지출유연높수준,-1,-1.0,20,0,20,0,8.98803457428563e-05,0.6231397655281556
